zheyou73v0_A01	7957	8856	BnaA01T0000100ZY	0	+	0	0	899	0.0000000
zheyou73v0_A01	10071	14313	BnaA01T0000200ZY	0	+	0	0	4242	0.0000000
zheyou73v0_A01	22073	24151	BnaA01T0000300ZY	0	-	0	0	2078	0.0000000
zheyou73v0_A01	25515	25875	BnaA01T0000400ZY	0	-	0	0	360	0.0000000
zheyou73v0_A01	27102	28759	BnaA01T0000500ZY	0	-	0	0	1657	0.0000000
zheyou73v0_A01	34276	35125	BnaA01T0000600ZY	0	+	0	0	849	0.0000000
zheyou73v0_A01	37978	41487	BnaA01T0000700ZY	0	+	0	0	3509	0.0000000
zheyou73v0_A01	49589	51004	BnaA01T0000800ZY	0	+	0	0	1415	0.0000000
zheyou73v0_A01	53422	55002	BnaA01T0000900ZY	0	+	0	0	1580	0.0000000
zheyou73v0_A01	55006	56953	BnaA01T0001000ZY	0	+	0	0	1947	0.0000000
zheyou73v0_A01	58204	59428	BnaA01T0001100ZY	0	-	0	0	1224	0.0000000
zheyou73v0_A01	66483	67819	BnaA01T0001200ZY	0	+	0	0	1336	0.0000000
zheyou73v0_A01	72497	76107	BnaA01T0001300ZY	0	+	0	0	3610	0.0000000
zheyou73v0_A01	76334	76853	BnaA01T0001400ZY	0	-	0	0	519	0.0000000
zheyou73v0_A01	78223	79694	BnaA01T0001500ZY	0	-	0	0	1471	0.0000000
zheyou73v0_A01	97534	98144	BnaA01T0001600ZY	0	-	0	0	610	0.0000000
zheyou73v0_A01	103032	103753	BnaA01T0001700ZY	0	+	0	0	721	0.0000000
zheyou73v0_A01	105253	106394	BnaA01T0001800ZY	0	-	0	0	1141	0.0000000
zheyou73v0_A01	107949	108463	BnaA01T0001900ZY	0	-	0	0	514	0.0000000
zheyou73v0_A01	115880	116742	BnaA01T0002000ZY	0	+	0	0	862	0.0000000
zheyou73v0_A01	120803	121678	BnaA01T0002100ZY	0	+	0	0	875	0.0000000
zheyou73v0_A01	126066	127698	BnaA01T0002200ZY	0	+	0	0	1632	0.0000000
zheyou73v0_A01	127946	130784	BnaA01T0002300ZY	0	-	0	0	2838	0.0000000
zheyou73v0_A01	131279	133178	BnaA01T0002400ZY.2	0	-	0	0	1899	0.0000000
zheyou73v0_A01	131281	133178	BnaA01T0002400ZY	0	-	0	0	1897	0.0000000
zheyou73v0_A01	131281	133178	BnaA01T0002400ZY.1	0	-	0	0	1897	0.0000000
zheyou73v0_A01	133523	137369	BnaA01T0002500ZY	0	-	0	0	3846	0.0000000
zheyou73v0_A01	133523	137369	BnaA01T0002500ZY.1	0	-	0	0	3846	0.0000000
zheyou73v0_A01	138717	140758	BnaA01T0002600ZY	0	-	0	0	2041	0.0000000
zheyou73v0_A01	141899	144206	BnaA01T0002700ZY	0	-	0	0	2307	0.0000000
zheyou73v0_A01	145646	148970	BnaA01T0002800ZY	0	-	0	0	3324	0.0000000
zheyou73v0_A01	154706	157640	BnaA01T0002900ZY	0	+	0	0	2934	0.0000000
zheyou73v0_A01	159292	160848	BnaA01T0003000ZY	0	-	0	0	1556	0.0000000
zheyou73v0_A01	164589	169424	BnaA01T0003100ZY	0	+	0	0	4835	0.0000000
zheyou73v0_A01	164589	169148	BnaA01T0003100ZY.1	0	+	0	0	4559	0.0000000
zheyou73v0_A01	164589	169148	BnaA01T0003100ZY.2	0	+	0	0	4559	0.0000000
zheyou73v0_A01	172081	174136	BnaA01T0003200ZY	0	-	0	0	2055	0.0000000
zheyou73v0_A01	174969	175432	BnaA01T0003300ZY	0	-	0	0	463	0.0000000
zheyou73v0_A01	176492	179086	BnaA01T0003400ZY	0	-	0	0	2594	0.0000000
zheyou73v0_A01	179494	180553	BnaA01T0003500ZY	0	-	0	0	1059	0.0000000
zheyou73v0_A01	180771	181374	BnaA01T0003600ZY	0	-	0	0	603	0.0000000
zheyou73v0_A01	182180	184571	BnaA01T0003700ZY	0	-	0	0	2391	0.0000000
zheyou73v0_A01	182180	184571	BnaA01T0003700ZY.1	0	-	0	0	2391	0.0000000
zheyou73v0_A01	186194	188572	BnaA01T0003800ZY	0	-	0	0	2378	0.0000000
zheyou73v0_A01	188885	189948	BnaA01T0003900ZY	0	+	0	0	1063	0.0000000
zheyou73v0_A01	190457	190742	BnaA01T0004000ZY	0	-	0	0	285	0.0000000
zheyou73v0_A01	193072	194373	BnaA01T0004100ZY	0	-	0	0	1301	0.0000000
zheyou73v0_A01	193072	193949	BnaA01T0004100ZY.1	0	-	0	0	877	0.0000000
zheyou73v0_A01	194658	195739	BnaA01T0004200ZY	0	+	0	0	1081	0.0000000
zheyou73v0_A01	194658	196014	BnaA01T0004200ZY.1	0	+	0	0	1356	0.0000000
zheyou73v0_A01	196661	197249	BnaA01T0004300ZY	0	+	0	0	588	0.0000000
zheyou73v0_A01	197778	198168	BnaA01T0004400ZY	0	-	0	0	390	0.0000000
zheyou73v0_A01	200360	200807	BnaA01T0004500ZY	0	+	0	0	447	0.0000000
zheyou73v0_A01	200883	202791	BnaA01T0004600ZY	0	+	0	0	1908	0.0000000
zheyou73v0_A01	206801	217214	BnaA01T0004700ZY	0	+	0	0	10413	0.0000000
zheyou73v0_A01	219678	220023	BnaA01T0004800ZY	0	+	0	0	345	0.0000000
zheyou73v0_A01	223999	226109	BnaA01T0004900ZY	0	+	0	0	2110	0.0000000
zheyou73v0_A01	231274	234958	BnaA01T0005000ZY	0	+	0	0	3684	0.0000000
zheyou73v0_A01	240240	242780	BnaA01T0005100ZY	0	-	0	0	2540	0.0000000
zheyou73v0_A01	250242	265701	BnaA01T0005200ZY	0	+	0	0	15459	0.0000000
zheyou73v0_A01	268970	271709	BnaA01T0005300ZY	0	-	0	0	2739	0.0000000
zheyou73v0_A01	276424	279411	BnaA01T0005400ZY	0	+	0	0	2987	0.0000000
zheyou73v0_A01	284906	286257	BnaA01T0005500ZY	0	-	0	0	1351	0.0000000
zheyou73v0_A01	291007	291778	BnaA01T0005600ZY	0	-	0	0	771	0.0000000
zheyou73v0_A01	293314	294400	BnaA01T0005700ZY	0	-	0	0	1086	0.0000000
zheyou73v0_A01	294973	295359	BnaA01T0005800ZY	0	+	0	0	386	0.0000000
zheyou73v0_A01	296063	300468	BnaA01T0005900ZY	0	+	0	0	4405	0.0000000
zheyou73v0_A01	301314	301875	BnaA01T0006000ZY	0	+	0	0	561	0.0000000
zheyou73v0_A01	302758	305309	BnaA01T0006100ZY	0	+	0	0	2551	0.0000000
zheyou73v0_A01	308900	316821	BnaA01T0006200ZY	0	+	0	0	7921	0.0000000
zheyou73v0_A01	317378	318065	BnaA01T0006300ZY	0	-	0	0	687	0.0000000
zheyou73v0_A01	318620	321704	BnaA01T0006400ZY	0	+	0	0	3084	0.0000000
zheyou73v0_A01	318985	321936	BnaA01T0006400ZY.1	0	+	0	0	2951	0.0000000
zheyou73v0_A01	322928	325494	BnaA01T0006500ZY	0	+	0	0	2566	0.0000000
zheyou73v0_A01	328549	328765	BnaA01T0006600ZY	0	+	0	0	216	0.0000000
zheyou73v0_A01	329313	332094	BnaA01T0006700ZY	0	-	0	0	2781	0.0000000
zheyou73v0_A01	329313	332094	BnaA01T0006700ZY.1	0	-	0	0	2781	0.0000000
zheyou73v0_A01	343113	343647	BnaA01T0006800ZY	0	+	0	0	534	0.0000000
zheyou73v0_A01	345625	346522	BnaA01T0006900ZY	0	+	0	0	897	0.0000000
zheyou73v0_A01	347519	348811	BnaA01T0007000ZY	0	-	0	0	1292	0.0000000
zheyou73v0_A01	350885	351758	BnaA01T0007100ZY	0	-	0	0	873	0.0000000
zheyou73v0_A01	361553	362905	BnaA01T0007200ZY	0	-	0	0	1352	0.0000000
zheyou73v0_A01	363199	364294	BnaA01T0007300ZY	0	+	0	0	1095	0.0000000
zheyou73v0_A01	369770	372050	BnaA01T0007400ZY	0	-	0	0	2280	0.0000000
zheyou73v0_A01	375800	377018	BnaA01T0007500ZY	0	+	0	0	1218	0.0000000
zheyou73v0_A01	385502	386675	BnaA01T0007600ZY	0	-	0	0	1173	0.0000000
zheyou73v0_A01	391002	393536	BnaA01T0007700ZY	0	-	0	0	2534	0.0000000
zheyou73v0_A01	396469	397476	BnaA01T0007800ZY	0	+	0	0	1007	0.0000000
zheyou73v0_A01	398577	401554	BnaA01T0007900ZY	0	-	0	0	2977	0.0000000
zheyou73v0_A01	403665	404971	BnaA01T0008000ZY	0	-	0	0	1306	0.0000000
zheyou73v0_A01	405595	406704	BnaA01T0008100ZY	0	-	0	0	1109	0.0000000
zheyou73v0_A01	409278	410987	BnaA01T0008200ZY	0	+	0	0	1709	0.0000000
zheyou73v0_A01	412071	414150	BnaA01T0008300ZY	0	+	0	0	2079	0.0000000
zheyou73v0_A01	415107	416644	BnaA01T0008400ZY	0	+	0	0	1537	0.0000000
zheyou73v0_A01	418929	419784	BnaA01T0008500ZY	0	+	0	0	855	0.0000000
zheyou73v0_A01	420106	421407	BnaA01T0008600ZY	0	-	0	0	1301	0.0000000
zheyou73v0_A01	423817	426137	BnaA01T0008700ZY	0	-	0	0	2320	0.0000000
zheyou73v0_A01	423817	426137	BnaA01T0008700ZY.1	0	-	0	0	2320	0.0000000
zheyou73v0_A01	423817	425257	BnaA01T0008700ZY.2	0	-	0	0	1440	0.0000000
zheyou73v0_A01	427021	429037	BnaA01T0008800ZY	0	+	0	0	2016	0.0000000
zheyou73v0_A01	433788	435893	BnaA01T0008900ZY	0	+	0	0	2105	0.0000000
zheyou73v0_A01	436284	438638	BnaA01T0009000ZY	0	+	0	0	2354	0.0000000
zheyou73v0_A01	439369	442283	BnaA01T0009100ZY	0	+	0	0	2914	0.0000000
zheyou73v0_A01	445785	447973	BnaA01T0009200ZY	0	+	0	0	2188	0.0000000
zheyou73v0_A01	453392	456780	BnaA01T0009300ZY	0	-	0	0	3388	0.0000000
zheyou73v0_A01	457229	460177	BnaA01T0009400ZY	0	-	0	0	2948	0.0000000
zheyou73v0_A01	457229	460177	BnaA01T0009400ZY.1	0	-	0	0	2948	0.0000000
zheyou73v0_A01	461658	463500	BnaA01T0009500ZY	0	-	0	0	1842	0.0000000
zheyou73v0_A01	465690	466686	BnaA01T0009600ZY	0	+	0	0	996	0.0000000
zheyou73v0_A01	466351	467205	BnaA01T0009700ZY	0	-	0	0	854	0.0000000
zheyou73v0_A01	466351	467316	BnaA01T0009700ZY.1	0	-	0	0	965	0.0000000
zheyou73v0_A01	468149	471044	BnaA01T0009800ZY	0	-	0	0	2895	0.0000000
zheyou73v0_A01	468149	471044	BnaA01T0009800ZY.1	0	-	0	0	2895	0.0000000
zheyou73v0_A01	479796	480999	BnaA01T0009900ZY	0	+	0	0	1203	0.0000000
zheyou73v0_A01	485639	487256	BnaA01T0010000ZY	0	-	0	0	1617	0.0000000
zheyou73v0_A01	489588	491047	BnaA01T0010100ZY	0	+	0	0	1459	0.0000000
zheyou73v0_A01	491410	491842	BnaA01T0010200ZY	0	-	0	0	432	0.0000000
zheyou73v0_A01	495976	497707	BnaA01T0010300ZY	0	+	0	0	1731	0.0000000
zheyou73v0_A01	498280	501476	BnaA01T0010400ZY	0	+	0	0	3196	0.0000000
zheyou73v0_A01	500382	503196	BnaA01T0010500ZY	0	-	0	0	2814	0.0000000
zheyou73v0_A01	505320	508859	BnaA01T0010600ZY	0	+	0	0	3539	0.0000000
zheyou73v0_A01	509134	510374	BnaA01T0010700ZY	0	-	0	0	1240	0.0000000
zheyou73v0_A01	513639	514523	BnaA01T0010800ZY	0	-	0	0	884	0.0000000
zheyou73v0_A01	526130	526578	BnaA01T0010900ZY	0	-	0	0	448	0.0000000
zheyou73v0_A01	537984	540891	BnaA01T0011000ZY	0	+	0	0	2907	0.0000000
zheyou73v0_A01	541263	543126	BnaA01T0011100ZY	0	+	0	0	1863	0.0000000
zheyou73v0_A01	543238	545944	BnaA01T0011200ZY	0	+	0	0	2706	0.0000000
zheyou73v0_A01	546001	547758	BnaA01T0011300ZY	0	-	0	0	1757	0.0000000
zheyou73v0_A01	551166	554533	BnaA01T0011400ZY	0	+	0	0	3367	0.0000000
zheyou73v0_A01	555472	556853	BnaA01T0011500ZY	0	+	0	0	1381	0.0000000
zheyou73v0_A01	563135	564445	BnaA01T0011600ZY	0	+	0	0	1310	0.0000000
zheyou73v0_A01	575666	577890	BnaA01T0011700ZY	0	+	0	0	2224	0.0000000
zheyou73v0_A01	578578	579619	BnaA01T0011800ZY	0	+	0	0	1041	0.0000000
zheyou73v0_A01	583564	584344	BnaA01T0011900ZY	0	-	0	0	780	0.0000000
zheyou73v0_A01	588741	589643	BnaA01T0012000ZY	0	+	0	0	902	0.0000000
zheyou73v0_A01	599520	600981	BnaA01T0012100ZY	0	-	0	0	1461	0.0000000
zheyou73v0_A01	611672	612836	BnaA01T0012200ZY	0	+	0	0	1164	0.0000000
zheyou73v0_A01	618578	620500	BnaA01T0012300ZY	0	-	0	0	1922	0.0000000
zheyou73v0_A01	628377	630867	BnaA01T0012400ZY	0	-	0	0	2490	0.0000000
zheyou73v0_A01	633677	636217	BnaA01T0012500ZY	0	-	0	0	2540	0.0000000
zheyou73v0_A01	651020	652769	BnaA01T0012600ZY	0	+	0	0	1749	0.0000000
zheyou73v0_A01	657536	658850	BnaA01T0012700ZY	0	-	0	0	1314	0.0000000
zheyou73v0_A01	662171	664082	BnaA01T0012800ZY	0	-	0	0	1911	0.0000000
zheyou73v0_A01	665703	668204	BnaA01T0012900ZY	0	+	0	0	2501	0.0000000
zheyou73v0_A01	669881	671863	BnaA01T0013000ZY	0	-	0	0	1982	0.0000000
zheyou73v0_A01	677651	679238	BnaA01T0013100ZY	0	+	0	0	1587	0.0000000
zheyou73v0_A01	682472	684344	BnaA01T0013200ZY	0	-	0	0	1872	0.0000000
zheyou73v0_A01	695765	705806	BnaA01T0013300ZY	0	-	0	0	10041	0.0000000
zheyou73v0_A01	717999	719645	BnaA01T0013400ZY	0	-	0	0	1646	0.0000000
zheyou73v0_A01	724484	727323	BnaA01T0013500ZY	0	+	0	0	2839	0.0000000
zheyou73v0_A01	729015	729630	BnaA01T0013600ZY	0	+	0	0	615	0.0000000
zheyou73v0_A01	733229	739235	BnaA01T0013700ZY	0	+	0	0	6006	0.0000000
zheyou73v0_A01	740924	741860	BnaA01T0013800ZY	0	+	0	0	936	0.0000000
zheyou73v0_A01	744051	744804	BnaA01T0013900ZY	0	+	0	0	753	0.0000000
zheyou73v0_A01	752939	753564	BnaA01T0014000ZY	0	+	0	0	625	0.0000000
zheyou73v0_A01	753870	755671	BnaA01T0014100ZY	0	-	0	0	1801	0.0000000
zheyou73v0_A01	759474	761206	BnaA01T0014200ZY	0	+	0	0	1732	0.0000000
zheyou73v0_A01	759474	761206	BnaA01T0014200ZY.1	0	+	0	0	1732	0.0000000
zheyou73v0_A01	761368	763787	BnaA01T0014300ZY	0	-	0	0	2419	0.0000000
zheyou73v0_A01	765510	766324	BnaA01T0014400ZY	0	-	0	0	814	0.0000000
zheyou73v0_A01	769970	771698	BnaA01T0014500ZY	0	-	0	0	1728	0.0000000
zheyou73v0_A01	774483	776366	BnaA01T0014600ZY	0	-	0	0	1883	0.0000000
zheyou73v0_A01	788190	789766	BnaA01T0014700ZY	0	-	0	0	1576	0.0000000
zheyou73v0_A01	797978	800309	BnaA01T0014800ZY	0	-	0	0	2331	0.0000000
zheyou73v0_A01	809704	811706	BnaA01T0014900ZY	0	+	0	0	2002	0.0000000
zheyou73v0_A01	816644	819967	BnaA01T0015000ZY	0	+	0	0	3323	0.0000000
zheyou73v0_A01	821884	824465	BnaA01T0015100ZY	0	+	0	0	2581	0.0000000
zheyou73v0_A01	824693	826791	BnaA01T0015200ZY	0	-	0	0	2098	0.0000000
zheyou73v0_A01	830419	830734	BnaA01T0015300ZY	0	+	0	0	315	0.0000000
zheyou73v0_A01	831167	833771	BnaA01T0015400ZY	0	+	0	0	2604	0.0000000
zheyou73v0_A01	833780	839557	BnaA01T0015500ZY	0	+	0	0	5777	0.0000000
zheyou73v0_A01	839945	841019	BnaA01T0015600ZY	0	-	0	0	1074	0.0000000
zheyou73v0_A01	852692	855285	BnaA01T0015700ZY	0	+	0	0	2593	0.0000000
zheyou73v0_A01	855660	857728	BnaA01T0015800ZY	0	-	0	0	2068	0.0000000
zheyou73v0_A01	860336	863199	BnaA01T0015900ZY	0	-	0	0	2863	0.0000000
zheyou73v0_A01	870143	871246	BnaA01T0016000ZY	0	+	0	0	1103	0.0000000
zheyou73v0_A01	880038	880390	BnaA01T0016100ZY	0	-	0	0	352	0.0000000
zheyou73v0_A01	888339	890480	BnaA01T0016200ZY	0	+	0	0	2141	0.0000000
zheyou73v0_A01	903081	905026	BnaA01T0016300ZY	0	+	0	0	1945	0.0000000
zheyou73v0_A01	903081	905026	BnaA01T0016300ZY.1	0	+	0	0	1945	0.0000000
zheyou73v0_A01	906767	908071	BnaA01T0016400ZY	0	-	0	0	1304	0.0000000
zheyou73v0_A01	909586	910281	BnaA01T0016500ZY	0	+	0	0	695	0.0000000
zheyou73v0_A01	910998	912592	BnaA01T0016600ZY	0	-	0	0	1594	0.0000000
zheyou73v0_A01	915080	917917	BnaA01T0016700ZY	0	-	0	0	2837	0.0000000
zheyou73v0_A01	915080	917917	BnaA01T0016700ZY.1	0	-	0	0	2837	0.0000000
zheyou73v0_A01	922246	923926	BnaA01T0016800ZY	0	+	0	0	1680	0.0000000
zheyou73v0_A01	924866	927556	BnaA01T0016900ZY	0	+	0	0	2690	0.0000000
zheyou73v0_A01	928573	930757	BnaA01T0017000ZY	0	+	0	0	2184	0.0000000
zheyou73v0_A01	930714	934742	BnaA01T0017100ZY	0	-	0	0	4028	0.0000000
zheyou73v0_A01	941168	943676	BnaA01T0017200ZY	0	-	0	0	2508	0.0000000
zheyou73v0_A01	945552	947993	BnaA01T0017300ZY	0	-	0	0	2441	0.0000000
zheyou73v0_A01	953830	957075	BnaA01T0017400ZY	0	+	0	0	3245	0.0000000
zheyou73v0_A01	953830	957075	BnaA01T0017400ZY.1	0	+	0	0	3245	0.0000000
zheyou73v0_A01	957495	958757	BnaA01T0017500ZY	0	+	0	0	1262	0.0000000
zheyou73v0_A01	960538	963102	BnaA01T0017600ZY	0	-	0	0	2564	0.0000000
zheyou73v0_A01	965298	966815	BnaA01T0017700ZY	0	-	0	0	1517	0.0000000
zheyou73v0_A01	968038	969995	BnaA01T0017800ZY	0	+	0	0	1957	0.0000000
zheyou73v0_A01	970365	971828	BnaA01T0017900ZY	0	-	0	0	1463	0.0000000
zheyou73v0_A01	980690	982941	BnaA01T0018000ZY	0	-	0	0	2251	0.0000000
zheyou73v0_A01	984425	986518	BnaA01T0018100ZY	0	-	0	0	2093	0.0000000
zheyou73v0_A01	990409	992188	BnaA01T0018200ZY	0	+	0	0	1779	0.0000000
zheyou73v0_A01	994799	995575	BnaA01T0018300ZY	0	-	0	0	776	0.0000000
zheyou73v0_A01	996384	998205	BnaA01T0018400ZY	0	+	0	0	1821	0.0000000
zheyou73v0_A01	998821	1000331	BnaA01T0018500ZY	0	+	0	0	1510	0.0000000
zheyou73v0_A01	1009245	1010017	BnaA01T0018600ZY	0	+	0	0	772	0.0000000
zheyou73v0_A01	1012250	1014690	BnaA01T0018700ZY	0	+	0	0	2440	0.0000000
zheyou73v0_A01	1014914	1019668	BnaA01T0018800ZY	0	-	0	0	4754	0.0000000
zheyou73v0_A01	1026844	1030541	BnaA01T0018900ZY	0	+	0	0	3697	0.0000000
zheyou73v0_A01	1035177	1037479	BnaA01T0019000ZY	0	+	0	0	2302	0.0000000
zheyou73v0_A01	1038753	1039314	BnaA01T0019100ZY	0	-	0	0	561	0.0000000
zheyou73v0_A01	1041328	1042852	BnaA01T0019200ZY	0	-	0	0	1524	0.0000000
zheyou73v0_A01	1043837	1045528	BnaA01T0019300ZY	0	+	0	0	1691	0.0000000
zheyou73v0_A01	1044967	1046944	BnaA01T0019400ZY	0	-	0	0	1977	0.0000000
zheyou73v0_A01	1049472	1051238	BnaA01T0019500ZY	0	+	0	0	1766	0.0000000
zheyou73v0_A01	1052204	1053596	BnaA01T0019600ZY	0	+	0	0	1392	0.0000000
zheyou73v0_A01	1055903	1058308	BnaA01T0019700ZY	0	-	0	0	2405	0.0000000
zheyou73v0_A01	1059433	1065743	BnaA01T0019800ZY	0	-	0	0	6310	0.0000000
zheyou73v0_A01	1087886	1089956	BnaA01T0019900ZY	0	+	0	0	2070	0.0000000
zheyou73v0_A01	1092074	1094491	BnaA01T0020000ZY	0	+	0	0	2417	0.0000000
zheyou73v0_A01	1092074	1094491	BnaA01T0020000ZY.1	0	+	0	0	2417	0.0000000
zheyou73v0_A01	1094651	1096081	BnaA01T0020100ZY	0	-	0	0	1430	0.0000000
zheyou73v0_A01	1096175	1097845	BnaA01T0020200ZY	0	-	0	0	1670	0.0000000
zheyou73v0_A01	1104237	1106191	BnaA01T0020300ZY	0	+	0	0	1954	0.0000000
zheyou73v0_A01	1108429	1110326	BnaA01T0020400ZY	0	+	0	0	1897	0.0000000
zheyou73v0_A01	1110390	1111573	BnaA01T0020500ZY	0	+	0	0	1183	0.0000000
zheyou73v0_A01	1112455	1112794	BnaA01T0020600ZY	0	+	0	0	339	0.0000000
zheyou73v0_A01	1113312	1114374	BnaA01T0020700ZY	0	+	0	0	1062	0.0000000
zheyou73v0_A01	1121432	1125705	BnaA01T0020800ZY	0	+	0	0	4273	0.0000000
zheyou73v0_A01	1121432	1125705	BnaA01T0020800ZY.1	0	+	0	0	4273	0.0000000
zheyou73v0_A01	1129539	1130530	BnaA01T0020900ZY	0	+	0	0	991	0.0000000
zheyou73v0_A01	1133929	1137231	BnaA01T0021000ZY	0	+	0	0	3302	0.0000000
zheyou73v0_A01	1137943	1141653	BnaA01T0021100ZY	0	+	0	0	3710	0.0000000
zheyou73v0_A01	1141752	1144522	BnaA01T0021200ZY	0	-	0	0	2770	0.0000000
zheyou73v0_A01	1147064	1148144	BnaA01T0021300ZY	0	-	0	0	1080	0.0000000
zheyou73v0_A01	1154274	1156816	BnaA01T0021400ZY	0	+	0	0	2542	0.0000000
zheyou73v0_A01	1157735	1160741	BnaA01T0021500ZY	0	+	0	0	3006	0.0000000
zheyou73v0_A01	1158925	1160741	BnaA01T0021500ZY.1	0	+	0	0	1816	0.0000000
zheyou73v0_A01	1165618	1170019	BnaA01T0021600ZY	0	+	0	0	4401	0.0000000
zheyou73v0_A01	1170380	1172598	BnaA01T0021700ZY	0	+	0	0	2218	0.0000000
zheyou73v0_A01	1172779	1174546	BnaA01T0021800ZY	0	-	0	0	1767	0.0000000
zheyou73v0_A01	1172779	1174546	BnaA01T0021800ZY.1	0	-	0	0	1767	0.0000000
zheyou73v0_A01	1172779	1174546	BnaA01T0021800ZY.2	0	-	0	0	1767	0.0000000
zheyou73v0_A01	1177636	1180208	BnaA01T0021900ZY	0	+	0	0	2572	0.0000000
zheyou73v0_A01	1180707	1183925	BnaA01T0022000ZY	0	+	0	0	3218	0.0000000
zheyou73v0_A01	1186702	1189614	BnaA01T0022100ZY	0	+	0	0	2912	0.0000000
zheyou73v0_A01	1194533	1195667	BnaA01T0022200ZY	0	-	0	0	1134	0.0000000
zheyou73v0_A01	1194533	1195667	BnaA01T0022200ZY.1	0	-	0	0	1134	0.0000000
zheyou73v0_A01	1197837	1201313	BnaA01T0022300ZY	0	+	0	0	3476	0.0000000
zheyou73v0_A01	1203797	1208854	BnaA01T0022400ZY	0	+	0	0	5057	0.0000000
zheyou73v0_A01	1215083	1219643	BnaA01T0022500ZY	0	+	0	0	4560	0.0000000
zheyou73v0_A01	1221352	1229001	BnaA01T0022600ZY	0	+	0	0	7649	0.0000000
zheyou73v0_A01	1235272	1236594	BnaA01T0022700ZY	0	+	0	0	1322	0.0000000
zheyou73v0_A01	1238693	1241526	BnaA01T0022800ZY	0	-	0	0	2833	0.0000000
zheyou73v0_A01	1244284	1248614	BnaA01T0022900ZY	0	+	0	0	4330	0.0000000
zheyou73v0_A01	1248975	1249965	BnaA01T0023000ZY	0	-	0	0	990	0.0000000
zheyou73v0_A01	1254591	1256827	BnaA01T0023100ZY	0	+	0	0	2236	0.0000000
zheyou73v0_A01	1260431	1264533	BnaA01T0023200ZY	0	-	0	0	4102	0.0000000
zheyou73v0_A01	1264814	1267371	BnaA01T0023300ZY	0	-	0	0	2557	0.0000000
zheyou73v0_A01	1267642	1271774	BnaA01T0023400ZY	0	+	0	0	4132	0.0000000
zheyou73v0_A01	1287388	1289456	BnaA01T0023500ZY	0	+	0	0	2068	0.0000000
zheyou73v0_A01	1296183	1300693	BnaA01T0023600ZY	0	-	0	0	4510	0.0000000
zheyou73v0_A01	1301243	1306085	BnaA01T0023700ZY	0	+	0	0	4842	0.0000000
zheyou73v0_A01	1306714	1308181	BnaA01T0023800ZY	0	-	0	0	1467	0.0000000
zheyou73v0_A01	1309389	1312802	BnaA01T0023900ZY	0	+	0	0	3413	0.0000000
zheyou73v0_A01	1315379	1315694	BnaA01T0024000ZY	0	-	0	0	315	0.0000000
zheyou73v0_A01	1320858	1322833	BnaA01T0024100ZY	0	-	0	0	1975	0.0000000
zheyou73v0_A01	1323097	1324988	BnaA01T0024200ZY	0	+	0	0	1891	0.0000000
zheyou73v0_A01	1327009	1343690	BnaA01T0024300ZY	0	+	0	0	16681	0.0000000
zheyou73v0_A01	1343563	1344367	BnaA01T0024400ZY	0	-	0	0	804	0.0000000
zheyou73v0_A01	1344518	1344850	BnaA01T0024500ZY	0	-	0	0	332	0.0000000
zheyou73v0_A01	1345377	1347823	BnaA01T0024600ZY	0	+	0	0	2446	0.0000000
zheyou73v0_A01	1349863	1350713	BnaA01T0024700ZY	0	+	0	0	850	0.0000000
zheyou73v0_A01	1355887	1357875	BnaA01T0024800ZY	0	+	0	0	1988	0.0000000
zheyou73v0_A01	1358275	1359798	BnaA01T0024900ZY	0	-	0	0	1523	0.0000000
zheyou73v0_A01	1360040	1360513	BnaA01T0025000ZY	0	+	0	0	473	0.0000000
zheyou73v0_A01	1360768	1362159	BnaA01T0025100ZY	0	-	0	0	1391	0.0000000
zheyou73v0_A01	1362874	1365071	BnaA01T0025200ZY	0	+	0	0	2197	0.0000000
zheyou73v0_A01	1365050	1366381	BnaA01T0025300ZY	0	-	0	0	1331	0.0000000
zheyou73v0_A01	1369858	1373413	BnaA01T0025400ZY	0	+	0	0	3555	0.0000000
zheyou73v0_A01	1377436	1378522	BnaA01T0025500ZY	0	-	0	0	1086	0.0000000
zheyou73v0_A01	1384807	1387912	BnaA01T0025600ZY	0	-	0	0	3105	0.0000000
zheyou73v0_A01	1388829	1391426	BnaA01T0025700ZY	0	-	0	0	2597	0.0000000
zheyou73v0_A01	1392304	1393994	BnaA01T0025800ZY	0	+	0	0	1690	0.0000000
zheyou73v0_A01	1394401	1397293	BnaA01T0025900ZY	0	-	0	0	2892	0.0000000
zheyou73v0_A01	1399008	1400109	BnaA01T0026000ZY	0	-	0	0	1101	0.0000000
zheyou73v0_A01	1403566	1428408	BnaA01T0026100ZY	0	+	0	0	24842	0.0000000
zheyou73v0_A01	1429507	1435621	BnaA01T0026200ZY	0	+	0	0	6114	0.0000000
zheyou73v0_A01	1429507	1435621	BnaA01T0026200ZY.1	0	+	0	0	6114	0.0000000
zheyou73v0_A01	1435811	1436000	BnaA01T0026300ZY	0	-	0	0	189	0.0000000
zheyou73v0_A01	1438982	1440067	BnaA01T0026400ZY	0	-	0	0	1085	0.0000000
zheyou73v0_A01	1440365	1442632	BnaA01T0026500ZY	0	+	0	0	2267	0.0000000
zheyou73v0_A01	1443122	1443896	BnaA01T0026600ZY	0	+	0	0	774	0.0000000
zheyou73v0_A01	1444736	1446790	BnaA01T0026700ZY	0	-	0	0	2054	0.0000000
zheyou73v0_A01	1450435	1451374	BnaA01T0026800ZY	0	-	0	0	939	0.0000000
zheyou73v0_A01	1452239	1453142	BnaA01T0026900ZY	0	-	0	0	903	0.0000000
zheyou73v0_A01	1454964	1455868	BnaA01T0027000ZY	0	-	0	0	904	0.0000000
zheyou73v0_A01	1462581	1463562	BnaA01T0027100ZY	0	+	0	0	981	0.0000000
zheyou73v0_A01	1463876	1466569	BnaA01T0027200ZY	0	-	0	0	2693	0.0000000
zheyou73v0_A01	1468171	1478514	BnaA01T0027300ZY	0	-	0	0	10343	0.0000000
zheyou73v0_A01	1479364	1483547	BnaA01T0027400ZY	0	+	0	0	4183	0.0000000
zheyou73v0_A01	1486504	1487917	BnaA01T0027500ZY	0	+	0	0	1413	0.0000000
zheyou73v0_A01	1488138	1489542	BnaA01T0027600ZY	0	-	0	0	1404	0.0000000
zheyou73v0_A01	1489991	1491673	BnaA01T0027700ZY	0	+	0	0	1682	0.0000000
zheyou73v0_A01	1492392	1493598	BnaA01T0027800ZY	0	+	0	0	1206	0.0000000
zheyou73v0_A01	1496360	1498502	BnaA01T0027900ZY	0	-	0	0	2142	0.0000000
zheyou73v0_A01	1503218	1504277	BnaA01T0028000ZY	0	+	0	0	1059	0.0000000
zheyou73v0_A01	1512401	1515222	BnaA01T0028100ZY	0	-	0	0	2821	0.0000000
zheyou73v0_A01	1517555	1519751	BnaA01T0028200ZY	0	-	0	0	2196	0.0000000
zheyou73v0_A01	1517555	1519751	BnaA01T0028200ZY.1	0	-	0	0	2196	0.0000000
zheyou73v0_A01	1519760	1523861	BnaA01T0028300ZY	0	+	0	0	4101	0.0000000
zheyou73v0_A01	1524304	1525454	BnaA01T0028400ZY	0	+	0	0	1150	0.0000000
zheyou73v0_A01	1531546	1533249	BnaA01T0028500ZY	0	-	0	0	1703	0.0000000
zheyou73v0_A01	1533986	1535214	BnaA01T0028600ZY	0	-	0	0	1228	0.0000000
zheyou73v0_A01	1538864	1539773	BnaA01T0028700ZY	0	-	0	0	909	0.0000000
zheyou73v0_A01	1542819	1549578	BnaA01T0028800ZY	0	-	0	0	6759	0.0000000
zheyou73v0_A01	1551057	1552452	BnaA01T0028900ZY	0	-	0	0	1395	0.0000000
zheyou73v0_A01	1552535	1554763	BnaA01T0029000ZY	0	+	0	0	2228	0.0000000
zheyou73v0_A01	1555076	1556773	BnaA01T0029100ZY	0	-	0	0	1697	0.0000000
zheyou73v0_A01	1557313	1559386	BnaA01T0029200ZY	0	-	0	0	2073	0.0000000
zheyou73v0_A01	1560065	1560491	BnaA01T0029300ZY	0	+	0	0	426	0.0000000
zheyou73v0_A01	1562029	1569319	BnaA01T0029400ZY	0	-	0	0	7290	0.0000000
zheyou73v0_A01	1570906	1574528	BnaA01T0029500ZY	0	+	0	0	3622	0.0000000
zheyou73v0_A01	1570906	1574528	BnaA01T0029500ZY.1	0	+	0	0	3622	0.0000000
zheyou73v0_A01	1574925	1578618	BnaA01T0029600ZY	0	-	0	0	3693	0.0000000
zheyou73v0_A01	1580664	1583245	BnaA01T0029700ZY	0	+	0	0	2581	0.0000000
zheyou73v0_A01	1583478	1584306	BnaA01T0029800ZY	0	+	0	0	828	0.0000000
zheyou73v0_A01	1592009	1596253	BnaA01T0029900ZY	0	+	0	0	4244	0.0000000
zheyou73v0_A01	1597346	1599840	BnaA01T0030000ZY	0	+	0	0	2494	0.0000000
zheyou73v0_A01	1599878	1602508	BnaA01T0030100ZY	0	-	0	0	2630	0.0000000
zheyou73v0_A01	1600087	1602508	BnaA01T0030100ZY.1	0	-	0	0	2421	0.0000000
zheyou73v0_A01	1610504	1613232	BnaA01T0030200ZY	0	+	0	0	2728	0.0000000
zheyou73v0_A01	1615298	1618508	BnaA01T0030300ZY	0	+	0	0	3210	0.0000000
zheyou73v0_A01	1620153	1623782	BnaA01T0030400ZY	0	+	0	0	3629	0.0000000
zheyou73v0_A01	1626058	1626894	BnaA01T0030500ZY	0	-	0	0	836	0.0000000
zheyou73v0_A01	1627818	1628272	BnaA01T0030600ZY	0	+	0	0	454	0.0000000
zheyou73v0_A01	1628905	1631039	BnaA01T0030700ZY	0	+	0	0	2134	0.0000000
zheyou73v0_A01	1629433	1632390	BnaA01T0030800ZY.1	0	-	0	0	2957	0.0000000
zheyou73v0_A01	1630951	1632390	BnaA01T0030800ZY	0	-	0	0	1439	0.0000000
zheyou73v0_A01	1632751	1634184	BnaA01T0030900ZY	0	-	0	0	1433	0.0000000
zheyou73v0_A01	1640234	1642168	BnaA01T0031000ZY	0	+	0	0	1934	0.0000000
zheyou73v0_A01	1643944	1646154	BnaA01T0031100ZY.1	0	+	0	0	2210	0.0000000
zheyou73v0_A01	1644059	1646154	BnaA01T0031100ZY	0	+	0	0	2095	0.0000000
zheyou73v0_A01	1644059	1646154	BnaA01T0031100ZY.2	0	+	0	0	2095	0.0000000
zheyou73v0_A01	1646744	1649153	BnaA01T0031200ZY	0	+	0	0	2409	0.0000000
zheyou73v0_A01	1650358	1653938	BnaA01T0031300ZY	0	-	0	0	3580	0.0000000
zheyou73v0_A01	1657937	1660324	BnaA01T0031400ZY	0	+	0	0	2387	0.0000000
zheyou73v0_A01	1658750	1660324	BnaA01T0031400ZY.1	0	+	0	0	1574	0.0000000
zheyou73v0_A01	1661939	1663417	BnaA01T0031500ZY	0	-	0	0	1478	0.0000000
zheyou73v0_A01	1671048	1673243	BnaA01T0031600ZY	0	+	0	0	2195	0.0000000
zheyou73v0_A01	1673740	1675654	BnaA01T0031700ZY	0	-	0	0	1914	0.0000000
zheyou73v0_A01	1681990	1682599	BnaA01T0031800ZY	0	-	0	0	609	0.0000000
zheyou73v0_A01	1709740	1710281	BnaA01T0031900ZY	0	+	0	0	541	0.0000000
zheyou73v0_A01	1714715	1716242	BnaA01T0032000ZY	0	-	0	0	1527	0.0000000
zheyou73v0_A01	1725324	1727620	BnaA01T0032100ZY	0	-	0	0	2296	0.0000000
zheyou73v0_A01	1725324	1727316	BnaA01T0032100ZY.1	0	-	0	0	1992	0.0000000
zheyou73v0_A01	1725782	1727316	BnaA01T0032100ZY.2	0	-	0	0	1534	0.0000000
zheyou73v0_A01	1729355	1731183	BnaA01T0032200ZY	0	-	0	0	1828	0.0000000
zheyou73v0_A01	1731973	1736287	BnaA01T0032300ZY	0	+	0	0	4314	0.0000000
zheyou73v0_A01	1743108	1744419	BnaA01T0032400ZY	0	+	0	0	1311	0.0000000
zheyou73v0_A01	1746335	1749377	BnaA01T0032500ZY	0	-	0	0	3042	0.0000000
zheyou73v0_A01	1750165	1752060	BnaA01T0032600ZY	0	-	0	0	1895	0.0000000
zheyou73v0_A01	1756907	1759555	BnaA01T0032700ZY	0	+	0	0	2648	0.0000000
zheyou73v0_A01	1756907	1759555	BnaA01T0032700ZY.1	0	+	0	0	2648	0.0000000
zheyou73v0_A01	1760096	1762115	BnaA01T0032800ZY	0	-	0	0	2019	0.0000000
zheyou73v0_A01	1763360	1766402	BnaA01T0032900ZY	0	-	0	0	3042	0.0000000
zheyou73v0_A01	1766752	1770770	BnaA01T0033000ZY	0	+	0	0	4018	0.0000000
zheyou73v0_A01	1773291	1777934	BnaA01T0033100ZY	0	-	0	0	4643	0.0000000
zheyou73v0_A01	1782313	1783071	BnaA01T0033200ZY	0	-	0	0	758	0.0000000
zheyou73v0_A01	1785695	1788324	BnaA01T0033300ZY	0	+	0	0	2629	0.0000000
zheyou73v0_A01	1788356	1789712	BnaA01T0033400ZY	0	-	0	0	1356	0.0000000
zheyou73v0_A01	1790349	1796147	BnaA01T0033500ZY	0	+	0	0	5798	0.0000000
zheyou73v0_A01	1798923	1799411	BnaA01T0033600ZY	0	-	0	0	488	0.0000000
zheyou73v0_A01	1801401	1801719	BnaA01T0033700ZY	0	-	0	0	318	0.0000000
zheyou73v0_A01	1806734	1807299	BnaA01T0033800ZY	0	-	0	0	565	0.0000000
zheyou73v0_A01	1818487	1819163	BnaA01T0033900ZY	0	+	0	0	676	0.0000000
zheyou73v0_A01	1825051	1825972	BnaA01T0034000ZY	0	-	0	0	921	0.0000000
zheyou73v0_A01	1826942	1827898	BnaA01T0034100ZY	0	+	0	0	956	0.0000000
zheyou73v0_A01	1828749	1830774	BnaA01T0034200ZY	0	+	0	0	2025	0.0000000
zheyou73v0_A01	1830885	1833621	BnaA01T0034300ZY	0	+	0	0	2736	0.0000000
zheyou73v0_A01	1836606	1852500	BnaA01T0034400ZY	0	+	0	0	15894	0.0000000
zheyou73v0_A01	1852384	1853972	BnaA01T0034500ZY	0	-	0	0	1588	0.0000000
zheyou73v0_A01	1854828	1856352	BnaA01T0034600ZY	0	-	0	0	1524	0.0000000
zheyou73v0_A01	1859011	1860389	BnaA01T0034700ZY	0	-	0	0	1378	0.0000000
zheyou73v0_A01	1860790	1863680	BnaA01T0034800ZY	0	+	0	0	2890	0.0000000
zheyou73v0_A01	1860790	1863680	BnaA01T0034800ZY.1	0	+	0	0	2890	0.0000000
zheyou73v0_A01	1863678	1866514	BnaA01T0034900ZY	0	-	0	0	2836	0.0000000
zheyou73v0_A01	1863678	1866514	BnaA01T0034900ZY.1	0	-	0	0	2836	0.0000000
zheyou73v0_A01	1867603	1871208	BnaA01T0035000ZY	0	-	0	0	3605	0.0000000
zheyou73v0_A01	1872140	1873335	BnaA01T0035100ZY	0	+	0	0	1195	0.0000000
zheyou73v0_A01	1873914	1874711	BnaA01T0035200ZY	0	+	0	0	797	0.0000000
zheyou73v0_A01	1876095	1877209	BnaA01T0035300ZY	0	-	0	0	1114	0.0000000
zheyou73v0_A01	1882340	1885256	BnaA01T0035400ZY	0	-	0	0	2916	0.0000000
zheyou73v0_A01	1885731	1889700	BnaA01T0035500ZY	0	-	0	0	3969	0.0000000
zheyou73v0_A01	1890512	1893443	BnaA01T0035600ZY	0	+	0	0	2931	0.0000000
zheyou73v0_A01	1897946	1898579	BnaA01T0035700ZY	0	-	0	0	633	0.0000000
zheyou73v0_A01	1901553	1902799	BnaA01T0035800ZY	0	-	0	0	1246	0.0000000
zheyou73v0_A01	1903657	1905596	BnaA01T0035900ZY	0	-	0	0	1939	0.0000000
zheyou73v0_A01	1910878	1913809	BnaA01T0036000ZY	0	+	0	0	2931	0.0000000
zheyou73v0_A01	1914164	1916823	BnaA01T0036100ZY	0	+	0	0	2659	0.0000000
zheyou73v0_A01	1918353	1925902	BnaA01T0036200ZY	0	+	0	0	7549	0.0000000
zheyou73v0_A01	1926343	1931307	BnaA01T0036300ZY	0	-	0	0	4964	0.0000000
zheyou73v0_A01	1931597	1934713	BnaA01T0036400ZY	0	-	0	0	3116	0.0000000
zheyou73v0_A01	1935011	1941560	BnaA01T0036500ZY	0	-	0	0	6549	0.0000000
zheyou73v0_A01	1935011	1943509	BnaA01T0036500ZY.1	0	-	0	0	8498	0.0000000
zheyou73v0_A01	1944024	1946648	BnaA01T0036600ZY	0	+	0	0	2624	0.0000000
zheyou73v0_A01	1952620	1952857	BnaA01T0036700ZY	0	-	0	0	237	0.0000000
zheyou73v0_A01	1955990	1958288	BnaA01T0036800ZY	0	-	0	0	2298	0.0000000
zheyou73v0_A01	1960684	1962232	BnaA01T0036900ZY	0	-	0	0	1548	0.0000000
zheyou73v0_A01	1963467	1966599	BnaA01T0037000ZY	0	-	0	0	3132	0.0000000
zheyou73v0_A01	1963467	1966599	BnaA01T0037000ZY.1	0	-	0	0	3132	0.0000000
zheyou73v0_A01	1967487	1969224	BnaA01T0037100ZY	0	-	0	0	1737	0.0000000
zheyou73v0_A01	1970090	1972600	BnaA01T0037200ZY	0	+	0	0	2510	0.0000000
zheyou73v0_A01	1974261	1975540	BnaA01T0037300ZY	0	+	0	0	1279	0.0000000
zheyou73v0_A01	1975716	1980785	BnaA01T0037400ZY	0	-	0	0	5069	0.0000000
zheyou73v0_A01	1990025	1991155	BnaA01T0037500ZY	0	-	0	0	1130	0.0000000
zheyou73v0_A01	1993119	1997026	BnaA01T0037600ZY	0	-	0	0	3907	0.0000000
zheyou73v0_A01	1997381	1998711	BnaA01T0037700ZY	0	+	0	0	1330	0.0000000
zheyou73v0_A01	1999138	2001821	BnaA01T0037800ZY	0	+	0	0	2683	0.0000000
zheyou73v0_A01	1999138	2001821	BnaA01T0037800ZY.1	0	+	0	0	2683	0.0000000
zheyou73v0_A01	2001813	2003308	BnaA01T0037900ZY	0	-	0	0	1495	0.0000000
zheyou73v0_A01	2001813	2003308	BnaA01T0037900ZY.1	0	-	0	0	1495	0.0000000
zheyou73v0_A01	2001813	2003308	BnaA01T0037900ZY.2	0	-	0	0	1495	0.0000000
zheyou73v0_A01	2003829	2004534	BnaA01T0038000ZY	0	-	0	0	705	0.0000000
zheyou73v0_A01	2005690	2009501	BnaA01T0038100ZY	0	-	0	0	3811	0.0000000
zheyou73v0_A01	2012317	2013731	BnaA01T0038200ZY	0	-	0	0	1414	0.0000000
zheyou73v0_A01	2018538	2021660	BnaA01T0038300ZY	0	-	0	0	3122	0.0000000
zheyou73v0_A01	2022868	2024762	BnaA01T0038400ZY	0	+	0	0	1894	0.0000000
zheyou73v0_A01	2025848	2029095	BnaA01T0038500ZY	0	+	0	0	3247	0.0000000
zheyou73v0_A01	2025848	2029095	BnaA01T0038500ZY.1	0	+	0	0	3247	0.0000000
zheyou73v0_A01	2031313	2033922	BnaA01T0038600ZY	0	+	0	0	2609	0.0000000
zheyou73v0_A01	2034539	2036304	BnaA01T0038700ZY	0	+	0	0	1765	0.0000000
zheyou73v0_A01	2037844	2040836	BnaA01T0038800ZY	0	+	0	0	2992	0.0000000
zheyou73v0_A01	2042187	2043217	BnaA01T0038900ZY	0	+	0	0	1030	0.0000000
zheyou73v0_A01	2043242	2046798	BnaA01T0039000ZY	0	-	0	0	3556	0.0000000
zheyou73v0_A01	2048193	2049707	BnaA01T0039100ZY	0	+	0	0	1514	0.0000000
zheyou73v0_A01	2057864	2059433	BnaA01T0039200ZY	0	-	0	0	1569	0.0000000
zheyou73v0_A01	2060322	2065325	BnaA01T0039300ZY	0	-	0	0	5003	0.0000000
zheyou73v0_A01	2068065	2069997	BnaA01T0039400ZY	0	+	0	0	1932	0.0000000
zheyou73v0_A01	2070514	2072015	BnaA01T0039500ZY	0	+	0	0	1501	0.0000000
zheyou73v0_A01	2074282	2076019	BnaA01T0039600ZY	0	+	0	0	1737	0.0000000
zheyou73v0_A01	2076183	2078049	BnaA01T0039700ZY	0	-	0	0	1866	0.0000000
zheyou73v0_A01	2078415	2082420	BnaA01T0039800ZY	0	-	0	0	4005	0.0000000
zheyou73v0_A01	2089079	2093556	BnaA01T0039900ZY.1	0	-	0	0	4477	0.0000000
zheyou73v0_A01	2089332	2093556	BnaA01T0039900ZY	0	-	0	0	4224	0.0000000
zheyou73v0_A01	2094094	2100612	BnaA01T0040000ZY	0	-	0	0	6518	0.0000000
zheyou73v0_A01	2094094	2100336	BnaA01T0040000ZY.1	0	-	0	0	6242	0.0000000
zheyou73v0_A01	2101887	2104080	BnaA01T0040100ZY	0	+	0	0	2193	0.0000000
zheyou73v0_A01	2101887	2104080	BnaA01T0040100ZY.1	0	+	0	0	2193	0.0000000
zheyou73v0_A01	2104069	2106652	BnaA01T0040200ZY	0	-	0	0	2583	0.0000000
zheyou73v0_A01	2104069	2106652	BnaA01T0040200ZY.1	0	-	0	0	2583	0.0000000
zheyou73v0_A01	2104069	2106652	BnaA01T0040200ZY.2	0	-	0	0	2583	0.0000000
zheyou73v0_A01	2104069	2106652	BnaA01T0040200ZY.3	0	-	0	0	2583	0.0000000
zheyou73v0_A01	2112554	2114340	BnaA01T0040300ZY	0	+	0	0	1786	0.0000000
zheyou73v0_A01	2112554	2114340	BnaA01T0040300ZY.1	0	+	0	0	1786	0.0000000
zheyou73v0_A01	2112554	2114340	BnaA01T0040300ZY.2	0	+	0	0	1786	0.0000000
zheyou73v0_A01	2112554	2113706	BnaA01T0040300ZY.3	0	+	0	0	1152	0.0000000
zheyou73v0_A01	2115014	2117099	BnaA01T0040400ZY	0	+	0	0	2085	0.0000000
zheyou73v0_A01	2120825	2121522	BnaA01T0040500ZY	0	-	0	0	697	0.0000000
zheyou73v0_A01	2126475	2134283	BnaA01T0040600ZY	0	-	0	0	7808	0.0000000
zheyou73v0_A01	2126475	2134011	BnaA01T0040600ZY.1	0	-	0	0	7536	0.0000000
zheyou73v0_A01	2136907	2139804	BnaA01T0040700ZY	0	-	0	0	2897	0.0000000
zheyou73v0_A01	2140132	2141260	BnaA01T0040800ZY	0	-	0	0	1128	0.0000000
zheyou73v0_A01	2141789	2142672	BnaA01T0040900ZY	0	-	0	0	883	0.0000000
zheyou73v0_A01	2143248	2143806	BnaA01T0041000ZY	0	-	0	0	558	0.0000000
zheyou73v0_A01	2150546	2152134	BnaA01T0041100ZY	0	+	0	0	1588	0.0000000
zheyou73v0_A01	2155052	2156528	BnaA01T0041200ZY	0	+	0	0	1476	0.0000000
zheyou73v0_A01	2161331	2162625	BnaA01T0041300ZY	0	+	0	0	1294	0.0000000
zheyou73v0_A01	2161331	2162625	BnaA01T0041300ZY.1	0	+	0	0	1294	0.0000000
zheyou73v0_A01	2161331	2162625	BnaA01T0041300ZY.2	0	+	0	0	1294	0.0000000
zheyou73v0_A01	2164254	2165742	BnaA01T0041400ZY	0	+	0	0	1488	0.0000000
zheyou73v0_A01	2168603	2173858	BnaA01T0041500ZY	0	+	0	0	5255	0.0000000
zheyou73v0_A01	2168603	2172839	BnaA01T0041500ZY.1	0	+	0	0	4236	0.0000000
zheyou73v0_A01	2174525	2175957	BnaA01T0041600ZY	0	+	0	0	1432	0.0000000
zheyou73v0_A01	2179787	2182759	BnaA01T0041700ZY	0	+	0	0	2972	0.0000000
zheyou73v0_A01	2179787	2182759	BnaA01T0041700ZY.1	0	+	0	0	2972	0.0000000
zheyou73v0_A01	2183111	2186659	BnaA01T0041800ZY	0	+	0	0	3548	0.0000000
zheyou73v0_A01	2188489	2190471	BnaA01T0041900ZY	0	-	0	0	1982	0.0000000
zheyou73v0_A01	2188489	2190471	BnaA01T0041900ZY.1	0	-	0	0	1982	0.0000000
zheyou73v0_A01	2194922	2195441	BnaA01T0042000ZY	0	-	0	0	519	0.0000000
zheyou73v0_A01	2199368	2200215	BnaA01T0042100ZY	0	-	0	0	847	0.0000000
zheyou73v0_A01	2202704	2205182	BnaA01T0042200ZY	0	+	0	0	2478	0.0000000
zheyou73v0_A01	2205543	2205900	BnaA01T0042300ZY	0	-	0	0	357	0.0000000
zheyou73v0_A01	2207026	2210014	BnaA01T0042400ZY	0	+	0	0	2988	0.0000000
zheyou73v0_A01	2210118	2210535	BnaA01T0042500ZY	0	-	0	0	417	0.0000000
zheyou73v0_A01	2211451	2211864	BnaA01T0042600ZY	0	+	0	0	413	0.0000000
zheyou73v0_A01	2212521	2217862	BnaA01T0042700ZY	0	-	0	0	5341	0.0000000
zheyou73v0_A01	2218646	2219337	BnaA01T0042800ZY	0	+	0	0	691	0.0000000
zheyou73v0_A01	2219903	2221859	BnaA01T0042900ZY	0	+	0	0	1956	0.0000000
zheyou73v0_A01	2221430	2226749	BnaA01T0043000ZY	0	-	0	0	5319	0.0000000
zheyou73v0_A01	2227625	2230091	BnaA01T0043100ZY	0	-	0	0	2466	0.0000000
zheyou73v0_A01	2230261	2233166	BnaA01T0043200ZY	0	-	0	0	2905	0.0000000
zheyou73v0_A01	2233773	2237893	BnaA01T0043300ZY	0	+	0	0	4120	0.0000000
zheyou73v0_A01	2237921	2243087	BnaA01T0043400ZY	0	-	0	0	5166	0.0000000
zheyou73v0_A01	2243751	2246861	BnaA01T0043500ZY	0	-	0	0	3110	0.0000000
zheyou73v0_A01	2248819	2252393	BnaA01T0043600ZY	0	+	0	0	3574	0.0000000
zheyou73v0_A01	2248819	2252393	BnaA01T0043600ZY.1	0	+	0	0	3574	0.0000000
zheyou73v0_A01	2254326	2255574	BnaA01T0043700ZY	0	+	0	0	1248	0.0000000
zheyou73v0_A01	2256003	2257688	BnaA01T0043800ZY	0	+	0	0	1685	0.0000000
zheyou73v0_A01	2258426	2261197	BnaA01T0043900ZY	0	+	0	0	2771	0.0000000
zheyou73v0_A01	2261340	2264695	BnaA01T0044000ZY	0	+	0	0	3355	0.0000000
zheyou73v0_A01	2265074	2265676	BnaA01T0044100ZY	0	+	0	0	602	0.0000000
zheyou73v0_A01	2265921	2267797	BnaA01T0044200ZY	0	+	0	0	1876	0.0000000
zheyou73v0_A01	2268501	2269908	BnaA01T0044300ZY	0	+	0	0	1407	0.0000000
zheyou73v0_A01	2272805	2275878	BnaA01T0044400ZY	0	-	0	0	3073	0.0000000
zheyou73v0_A01	2283308	2286404	BnaA01T0044500ZY	0	+	0	0	3096	0.0000000
zheyou73v0_A01	2286745	2288392	BnaA01T0044600ZY	0	-	0	0	1647	0.0000000
zheyou73v0_A01	2298968	2301438	BnaA01T0044700ZY	0	-	0	0	2470	0.0000000
zheyou73v0_A01	2298968	2301438	BnaA01T0044700ZY.1	0	-	0	0	2470	0.0000000
zheyou73v0_A01	2304078	2304447	BnaA01T0044800ZY	0	-	0	0	369	0.0000000
zheyou73v0_A01	2305130	2307412	BnaA01T0044900ZY	0	+	0	0	2282	0.0000000
zheyou73v0_A01	2307692	2313018	BnaA01T0045000ZY	0	-	0	0	5326	0.0000000
zheyou73v0_A01	2313540	2315554	BnaA01T0045100ZY	0	+	0	0	2014	0.0000000
zheyou73v0_A01	2313540	2314811	BnaA01T0045100ZY.1	0	+	0	0	1271	0.0000000
zheyou73v0_A01	2317234	2320758	BnaA01T0045200ZY	0	+	0	0	3524	0.0000000
zheyou73v0_A01	2322012	2325969	BnaA01T0045300ZY	0	+	0	0	3957	0.0000000
zheyou73v0_A01	2327091	2328152	BnaA01T0045400ZY	0	+	0	0	1061	0.0000000
zheyou73v0_A01	2329709	2331220	BnaA01T0045500ZY	0	+	0	0	1511	0.0000000
zheyou73v0_A01	2332222	2339520	BnaA01T0045600ZY.1	0	+	0	0	7298	0.0000000
zheyou73v0_A01	2332265	2339819	BnaA01T0045600ZY	0	+	0	0	7554	0.0000000
zheyou73v0_A01	2340795	2343282	BnaA01T0045700ZY	0	-	0	0	2487	0.0000000
zheyou73v0_A01	2345256	2350142	BnaA01T0045800ZY	0	+	0	0	4886	0.0000000
zheyou73v0_A01	2353485	2363410	BnaA01T0045900ZY	0	+	0	0	9925	0.0000000
zheyou73v0_A01	2364013	2366102	BnaA01T0046000ZY	0	-	0	0	2089	0.0000000
zheyou73v0_A01	2364817	2366102	BnaA01T0046000ZY.1	0	-	0	0	1285	0.0000000
zheyou73v0_A01	2366461	2369428	BnaA01T0046100ZY	0	+	0	0	2967	0.0000000
zheyou73v0_A01	2369507	2370989	BnaA01T0046200ZY	0	-	0	0	1482	0.0000000
zheyou73v0_A01	2375569	2381369	BnaA01T0046300ZY	0	+	0	0	5800	0.0000000
zheyou73v0_A01	2381844	2382030	BnaA01T0046400ZY	0	+	0	0	186	0.0000000
zheyou73v0_A01	2383146	2383332	BnaA01T0046500ZY	0	+	0	0	186	0.0000000
zheyou73v0_A01	2384441	2384750	BnaA01T0046600ZY	0	+	0	0	309	0.0000000
zheyou73v0_A01	2385075	2387325	BnaA01T0046700ZY	0	-	0	0	2250	0.0000000
zheyou73v0_A01	2388137	2389983	BnaA01T0046800ZY	0	+	0	0	1846	0.0000000
zheyou73v0_A01	2399405	2401849	BnaA01T0046900ZY	0	+	0	0	2444	0.0000000
zheyou73v0_A01	2404217	2406517	BnaA01T0047000ZY	0	+	0	0	2300	0.0000000
zheyou73v0_A01	2406727	2407178	BnaA01T0047100ZY	0	-	0	0	451	0.0000000
zheyou73v0_A01	2407956	2412378	BnaA01T0047200ZY	0	+	0	0	4422	0.0000000
zheyou73v0_A01	2412920	2417157	BnaA01T0047300ZY	0	-	0	0	4237	0.0000000
zheyou73v0_A01	2419196	2422366	BnaA01T0047400ZY	0	-	0	0	3170	0.0000000
zheyou73v0_A01	2425620	2428113	BnaA01T0047500ZY	0	+	0	0	2493	0.0000000
zheyou73v0_A01	2432055	2432802	BnaA01T0047600ZY	0	+	0	0	747	0.0000000
zheyou73v0_A01	2437263	2439673	BnaA01T0047700ZY	0	-	0	0	2410	0.0000000
zheyou73v0_A01	2440752	2442934	BnaA01T0047800ZY	0	+	0	0	2182	0.0000000
zheyou73v0_A01	2445242	2449883	BnaA01T0047900ZY	0	+	0	0	4641	0.0000000
zheyou73v0_A01	2445242	2449883	BnaA01T0047900ZY.1	0	+	0	0	4641	0.0000000
zheyou73v0_A01	2445242	2449883	BnaA01T0047900ZY.2	0	+	0	0	4641	0.0000000
zheyou73v0_A01	2445242	2449883	BnaA01T0047900ZY.3	0	+	0	0	4641	0.0000000
zheyou73v0_A01	2452604	2454506	BnaA01T0048000ZY	0	-	0	0	1902	0.0000000
zheyou73v0_A01	2457552	2459964	BnaA01T0048100ZY	0	+	0	0	2412	0.0000000
zheyou73v0_A01	2460433	2460890	BnaA01T0048200ZY	0	-	0	0	457	0.0000000
zheyou73v0_A01	2464193	2465146	BnaA01T0048300ZY	0	-	0	0	953	0.0000000
zheyou73v0_A01	2465831	2466364	BnaA01T0048400ZY	0	-	0	0	533	0.0000000
zheyou73v0_A01	2474712	2475994	BnaA01T0048500ZY	0	-	0	0	1282	0.0000000
zheyou73v0_A01	2476065	2479277	BnaA01T0048600ZY	0	+	0	0	3212	0.0000000
zheyou73v0_A01	2476065	2479277	BnaA01T0048600ZY.1	0	+	0	0	3212	0.0000000
zheyou73v0_A01	2479248	2480430	BnaA01T0048700ZY	0	-	0	0	1182	0.0000000
zheyou73v0_A01	2482541	2489644	BnaA01T0048800ZY	0	+	0	0	7103	0.0000000
zheyou73v0_A01	2490261	2494268	BnaA01T0048900ZY	0	-	0	0	4007	0.0000000
zheyou73v0_A01	2494836	2496656	BnaA01T0049000ZY	0	+	0	0	1820	0.0000000
zheyou73v0_A01	2499275	2500544	BnaA01T0049100ZY	0	-	0	0	1269	0.0000000
zheyou73v0_A01	2506823	2512212	BnaA01T0049200ZY	0	+	0	0	5389	0.0000000
zheyou73v0_A01	2514625	2515222	BnaA01T0049300ZY	0	-	0	0	597	0.0000000
zheyou73v0_A01	2518872	2519454	BnaA01T0049400ZY	0	+	0	0	582	0.0000000
zheyou73v0_A01	2520447	2520615	BnaA01T0049500ZY	0	-	0	0	168	0.0000000
zheyou73v0_A01	2520915	2525422	BnaA01T0049600ZY	0	-	0	0	4507	0.0000000
zheyou73v0_A01	2520915	2525422	BnaA01T0049600ZY.1	0	-	0	0	4507	0.0000000
zheyou73v0_A01	2520915	2525422	BnaA01T0049600ZY.2	0	-	0	0	4507	0.0000000
zheyou73v0_A01	2526542	2529898	BnaA01T0049700ZY	0	+	0	0	3356	0.0000000
zheyou73v0_A01	2530146	2531962	BnaA01T0049800ZY	0	-	0	0	1816	0.0000000
zheyou73v0_A01	2534651	2544377	BnaA01T0049900ZY	0	+	0	0	9726	0.0000000
zheyou73v0_A01	2544361	2547904	BnaA01T0050000ZY	0	-	0	0	3543	0.0000000
zheyou73v0_A01	2555113	2556261	BnaA01T0050100ZY	0	-	0	0	1148	0.0000000
zheyou73v0_A01	2563193	2566694	BnaA01T0050200ZY	0	-	0	0	3501	0.0000000
zheyou73v0_A01	2568158	2568691	BnaA01T0050300ZY	0	-	0	0	533	0.0000000
zheyou73v0_A01	2590854	2593068	BnaA01T0050400ZY	0	-	0	0	2214	0.0000000
zheyou73v0_A01	2595894	2596221	BnaA01T0050500ZY	0	-	0	0	327	0.0000000
zheyou73v0_A01	2599059	2599788	BnaA01T0050600ZY	0	+	0	0	729	0.0000000
zheyou73v0_A01	2600056	2604495	BnaA01T0050700ZY	0	-	0	0	4439	0.0000000
zheyou73v0_A01	2605795	2608314	BnaA01T0050800ZY	0	-	0	0	2519	0.0000000
zheyou73v0_A01	2613053	2613731	BnaA01T0050900ZY	0	-	0	0	678	0.0000000
zheyou73v0_A01	2614353	2615239	BnaA01T0051000ZY	0	-	0	0	886	0.0000000
zheyou73v0_A01	2616317	2616958	BnaA01T0051100ZY	0	-	0	0	641	0.0000000
zheyou73v0_A01	2617289	2620634	BnaA01T0051200ZY	0	-	0	0	3345	0.0000000
zheyou73v0_A01	2620659	2621653	BnaA01T0051300ZY	0	+	0	0	994	0.0000000
zheyou73v0_A01	2625634	2638678	BnaA01T0051400ZY	0	-	0	0	13044	0.0000000
zheyou73v0_A01	2625634	2638678	BnaA01T0051400ZY.1	0	-	0	0	13044	0.0000000
zheyou73v0_A01	2639088	2641116	BnaA01T0051500ZY	0	+	0	0	2028	0.0000000
zheyou73v0_A01	2639088	2641116	BnaA01T0051500ZY.1	0	+	0	0	2028	0.0000000
zheyou73v0_A01	2641658	2644882	BnaA01T0051600ZY	0	+	0	0	3224	0.0000000
zheyou73v0_A01	2647578	2656206	BnaA01T0051700ZY	0	+	0	0	8628	0.0000000
zheyou73v0_A01	2656395	2659471	BnaA01T0051800ZY	0	-	0	0	3076	0.0000000
zheyou73v0_A01	2656395	2659471	BnaA01T0051800ZY.1	0	-	0	0	3076	0.0000000
zheyou73v0_A01	2660962	2664723	BnaA01T0051900ZY	0	+	0	0	3761	0.0000000
zheyou73v0_A01	2665574	2673576	BnaA01T0052000ZY	0	-	0	0	8002	0.0000000
zheyou73v0_A01	2674166	2677470	BnaA01T0052100ZY	0	-	0	0	3304	0.0000000
zheyou73v0_A01	2678213	2683861	BnaA01T0052200ZY	0	-	0	0	5648	0.0000000
zheyou73v0_A01	2689932	2696021	BnaA01T0052300ZY	0	+	0	0	6089	0.0000000
zheyou73v0_A01	2710791	2711452	BnaA01T0052400ZY	0	-	0	0	661	0.0000000
zheyou73v0_A01	2715759	2717514	BnaA01T0052500ZY	0	+	0	0	1755	0.0000000
zheyou73v0_A01	2719754	2721578	BnaA01T0052600ZY	0	-	0	0	1824	0.0000000
zheyou73v0_A01	2722482	2723869	BnaA01T0052700ZY	0	-	0	0	1387	0.0000000
zheyou73v0_A01	2722482	2723869	BnaA01T0052700ZY.2	0	-	0	0	1387	0.0000000
zheyou73v0_A01	2722581	2723869	BnaA01T0052700ZY.1	0	-	0	0	1288	0.0000000
zheyou73v0_A01	2725147	2731954	BnaA01T0052800ZY	0	+	0	0	6807	0.0000000
zheyou73v0_A01	2733135	2734973	BnaA01T0052900ZY	0	-	0	0	1838	0.0000000
zheyou73v0_A01	2735462	2740752	BnaA01T0053000ZY	0	-	0	0	5290	0.0000000
zheyou73v0_A01	2750252	2752742	BnaA01T0053100ZY	0	-	0	0	2490	0.0000000
zheyou73v0_A01	2758063	2759655	BnaA01T0053200ZY	0	-	0	0	1592	0.0000000
zheyou73v0_A01	2760230	2761776	BnaA01T0053300ZY	0	+	0	0	1546	0.0000000
zheyou73v0_A01	2762513	2768612	BnaA01T0053400ZY	0	+	0	0	6099	0.0000000
zheyou73v0_A01	2769377	2773233	BnaA01T0053500ZY	0	-	0	0	3856	0.0000000
zheyou73v0_A01	2774358	2776054	BnaA01T0053600ZY	0	+	0	0	1696	0.0000000
zheyou73v0_A01	2783451	2788656	BnaA01T0053700ZY	0	-	0	0	5205	0.0000000
zheyou73v0_A01	2791821	2794387	BnaA01T0053800ZY	0	-	0	0	2566	0.0000000
zheyou73v0_A01	2794990	2799220	BnaA01T0053900ZY	0	+	0	0	4230	0.0000000
zheyou73v0_A01	2800825	2805980	BnaA01T0054000ZY	0	+	0	0	5155	0.0000000
zheyou73v0_A01	2801875	2805980	BnaA01T0054000ZY.1	0	+	0	0	4105	0.0000000
zheyou73v0_A01	2805479	2807942	BnaA01T0054100ZY	0	-	0	0	2463	0.0000000
zheyou73v0_A01	2808871	2810413	BnaA01T0054200ZY	0	-	0	0	1542	0.0000000
zheyou73v0_A01	2813205	2816660	BnaA01T0054300ZY	0	-	0	0	3455	0.0000000
zheyou73v0_A01	2813205	2816660	BnaA01T0054300ZY.2	0	-	0	0	3455	0.0000000
zheyou73v0_A01	2815027	2816660	BnaA01T0054300ZY.1	0	-	0	0	1633	0.0000000
zheyou73v0_A01	2820818	2823865	BnaA01T0054400ZY	0	+	0	0	3047	0.0000000
zheyou73v0_A01	2834322	2839091	BnaA01T0054500ZY	0	-	0	0	4769	0.0000000
zheyou73v0_A01	2836144	2839091	BnaA01T0054500ZY.1	0	-	0	0	2947	0.0000000
zheyou73v0_A01	2840389	2842962	BnaA01T0054600ZY	0	-	0	0	2573	0.0000000
zheyou73v0_A01	2844206	2845659	BnaA01T0054700ZY	0	+	0	0	1453	0.0000000
zheyou73v0_A01	2844206	2845659	BnaA01T0054700ZY.1	0	+	0	0	1453	0.0000000
zheyou73v0_A01	2846271	2849280	BnaA01T0054800ZY	0	-	0	0	3009	0.0000000
zheyou73v0_A01	2846271	2849280	BnaA01T0054800ZY.1	0	-	0	0	3009	0.0000000
zheyou73v0_A01	2851998	2854446	BnaA01T0054900ZY	0	-	0	0	2448	0.0000000
zheyou73v0_A01	2854814	2857462	BnaA01T0055000ZY	0	-	0	0	2648	0.0000000
zheyou73v0_A01	2862429	2863854	BnaA01T0055100ZY	0	-	0	0	1425	0.0000000
zheyou73v0_A01	2865577	2866306	BnaA01T0055200ZY	0	+	0	0	729	0.0000000
zheyou73v0_A01	2867103	2868987	BnaA01T0055300ZY	0	-	0	0	1884	0.0000000
zheyou73v0_A01	2870908	2872242	BnaA01T0055400ZY	0	-	0	0	1334	0.0000000
zheyou73v0_A01	2870908	2872242	BnaA01T0055400ZY.1	0	-	0	0	1334	0.0000000
zheyou73v0_A01	2880059	2881963	BnaA01T0055500ZY	0	+	0	0	1904	0.0000000
zheyou73v0_A01	2880576	2881963	BnaA01T0055500ZY.1	0	+	0	0	1387	0.0000000
zheyou73v0_A01	2881569	2886253	BnaA01T0055600ZY	0	-	0	0	4684	0.0000000
zheyou73v0_A01	2888682	2891647	BnaA01T0055700ZY	0	-	0	0	2965	0.0000000
zheyou73v0_A01	2892469	2897366	BnaA01T0055800ZY	0	+	0	0	4897	0.0000000
zheyou73v0_A01	2897692	2901713	BnaA01T0055900ZY	0	-	0	0	4021	0.0000000
zheyou73v0_A01	2905525	2910943	BnaA01T0056000ZY	0	+	0	0	5418	0.0000000
zheyou73v0_A01	2913077	2913812	BnaA01T0056100ZY	0	+	0	0	735	0.0000000
zheyou73v0_A01	2917023	2917550	BnaA01T0056200ZY	0	+	0	0	527	0.0000000
zheyou73v0_A01	2919085	2920100	BnaA01T0056300ZY	0	+	0	0	1015	0.0000000
zheyou73v0_A01	2920866	2923937	BnaA01T0056400ZY	0	+	0	0	3071	0.0000000
zheyou73v0_A01	2924244	2926475	BnaA01T0056500ZY	0	-	0	0	2231	0.0000000
zheyou73v0_A01	2926739	2931407	BnaA01T0056600ZY	0	-	0	0	4668	0.0000000
zheyou73v0_A01	2926739	2931407	BnaA01T0056600ZY.1	0	-	0	0	4668	0.0000000
zheyou73v0_A01	2931872	2934267	BnaA01T0056700ZY	0	-	0	0	2395	0.0000000
zheyou73v0_A01	2931872	2934267	BnaA01T0056700ZY.1	0	-	0	0	2395	0.0000000
zheyou73v0_A01	2935137	2937570	BnaA01T0056800ZY	0	-	0	0	2433	0.0000000
zheyou73v0_A01	2939266	2940479	BnaA01T0056900ZY	0	-	0	0	1213	0.0000000
zheyou73v0_A01	2954611	2960257	BnaA01T0057000ZY	0	+	0	0	5646	0.0000000
zheyou73v0_A01	2954611	2960257	BnaA01T0057000ZY.1	0	+	0	0	5646	0.0000000
zheyou73v0_A01	2960603	2962267	BnaA01T0057100ZY	0	-	0	0	1664	0.0000000
zheyou73v0_A01	2963600	2965121	BnaA01T0057200ZY	0	-	0	0	1521	0.0000000
zheyou73v0_A01	2967998	2980560	BnaA01T0057300ZY	0	-	0	0	12562	0.0000000
zheyou73v0_A01	2986516	2991859	BnaA01T0057400ZY	0	-	0	0	5343	0.0000000
zheyou73v0_A01	2996927	2998213	BnaA01T0057500ZY	0	+	0	0	1286	0.0000000
zheyou73v0_A01	3001483	3004560	BnaA01T0057600ZY	0	+	0	0	3077	0.0000000
zheyou73v0_A01	3006929	3012618	BnaA01T0057700ZY	0	+	0	0	5689	0.0000000
zheyou73v0_A01	3016274	3018428	BnaA01T0057800ZY	0	+	0	0	2154	0.0000000
zheyou73v0_A01	3020264	3020657	BnaA01T0057900ZY	0	+	0	0	393	0.0000000
zheyou73v0_A01	3021411	3030030	BnaA01T0058000ZY	0	-	0	0	8619	0.0000000
zheyou73v0_A01	3030396	3031243	BnaA01T0058100ZY	0	-	0	0	847	0.0000000
zheyou73v0_A01	3031854	3032157	BnaA01T0058200ZY	0	+	0	0	303	0.0000000
zheyou73v0_A01	3038690	3042594	BnaA01T0058300ZY	0	+	0	0	3904	0.0000000
zheyou73v0_A01	3042883	3043996	BnaA01T0058400ZY	0	+	0	0	1113	0.0000000
zheyou73v0_A01	3045009	3046582	BnaA01T0058500ZY	0	-	0	0	1573	0.0000000
zheyou73v0_A01	3050887	3052795	BnaA01T0058600ZY	0	-	0	0	1908	0.0000000
zheyou73v0_A01	3053399	3055670	BnaA01T0058700ZY	0	-	0	0	2271	0.0000000
zheyou73v0_A01	3059950	3062014	BnaA01T0058800ZY	0	+	0	0	2064	0.0000000
zheyou73v0_A01	3062003	3064180	BnaA01T0058900ZY	0	-	0	0	2177	0.0000000
zheyou73v0_A01	3065546	3067382	BnaA01T0059000ZY	0	-	0	0	1836	0.0000000
zheyou73v0_A01	3071787	3074917	BnaA01T0059100ZY	0	+	0	0	3130	0.0000000
zheyou73v0_A01	3074235	3075735	BnaA01T0059200ZY	0	-	0	0	1500	0.0000000
zheyou73v0_A01	3076739	3078393	BnaA01T0059300ZY	0	+	0	0	1654	0.0000000
zheyou73v0_A01	3078861	3081801	BnaA01T0059400ZY	0	+	0	0	2940	0.0000000
zheyou73v0_A01	3085929	3089155	BnaA01T0059500ZY	0	-	0	0	3226	0.0000000
zheyou73v0_A01	3104999	3105329	BnaA01T0059600ZY	0	-	0	0	330	0.0000000
zheyou73v0_A01	3105543	3113491	BnaA01T0059700ZY	0	+	0	0	7948	0.0000000
zheyou73v0_A01	3118054	3121274	BnaA01T0059800ZY	0	+	0	0	3220	0.0000000
zheyou73v0_A01	3121928	3129105	BnaA01T0059900ZY	0	-	0	0	7177	0.0000000
zheyou73v0_A01	3129652	3130311	BnaA01T0060000ZY	0	-	0	0	659	0.0000000
zheyou73v0_A01	3135638	3137280	BnaA01T0060100ZY	0	+	0	0	1642	0.0000000
zheyou73v0_A01	3135638	3137280	BnaA01T0060100ZY.1	0	+	0	0	1642	0.0000000
zheyou73v0_A01	3139635	3141938	BnaA01T0060200ZY	0	+	0	0	2303	0.0000000
zheyou73v0_A01	3145793	3147431	BnaA01T0060300ZY	0	+	0	0	1638	0.0000000
zheyou73v0_A01	3145793	3147431	BnaA01T0060300ZY.1	0	+	0	0	1638	0.0000000
zheyou73v0_A01	3145793	3147431	BnaA01T0060300ZY.2	0	+	0	0	1638	0.0000000
zheyou73v0_A01	3145793	3147431	BnaA01T0060300ZY.3	0	+	0	0	1638	0.0000000
zheyou73v0_A01	3145793	3147431	BnaA01T0060300ZY.4	0	+	0	0	1638	0.0000000
zheyou73v0_A01	3145793	3147431	BnaA01T0060300ZY.5	0	+	0	0	1638	0.0000000
zheyou73v0_A01	3145793	3147431	BnaA01T0060300ZY.6	0	+	0	0	1638	0.0000000
zheyou73v0_A01	3145793	3147431	BnaA01T0060300ZY.7	0	+	0	0	1638	0.0000000
zheyou73v0_A01	3145793	3147431	BnaA01T0060300ZY.8	0	+	0	0	1638	0.0000000
zheyou73v0_A01	3145793	3147431	BnaA01T0060300ZY.9	0	+	0	0	1638	0.0000000
zheyou73v0_A01	3149711	3150407	BnaA01T0060400ZY	0	-	0	0	696	0.0000000
zheyou73v0_A01	3151869	3152391	BnaA01T0060500ZY	0	-	0	0	522	0.0000000
zheyou73v0_A01	3155097	3155346	BnaA01T0060600ZY	0	-	0	0	249	0.0000000
zheyou73v0_A01	3155823	3156501	BnaA01T0060700ZY	0	-	0	0	678	0.0000000
zheyou73v0_A01	3157253	3157889	BnaA01T0060800ZY	0	-	0	0	636	0.0000000
zheyou73v0_A01	3165784	3169377	BnaA01T0060900ZY	0	-	0	0	3593	0.0000000
zheyou73v0_A01	3170197	3171506	BnaA01T0061000ZY	0	+	0	0	1309	0.0000000
zheyou73v0_A01	3172213	3173325	BnaA01T0061100ZY	0	-	0	0	1112	0.0000000
zheyou73v0_A01	3174509	3174900	BnaA01T0061200ZY	0	-	0	0	391	0.0000000
zheyou73v0_A01	3175020	3177097	BnaA01T0061300ZY	0	-	0	0	2077	0.0000000
zheyou73v0_A01	3178123	3181330	BnaA01T0061400ZY	0	-	0	0	3207	0.0000000
zheyou73v0_A01	3182538	3184141	BnaA01T0061500ZY	0	+	0	0	1603	0.0000000
zheyou73v0_A01	3184545	3185730	BnaA01T0061600ZY	0	-	0	0	1185	0.0000000
zheyou73v0_A01	3186660	3190282	BnaA01T0061700ZY	0	-	0	0	3622	0.0000000
zheyou73v0_A01	3191601	3193243	BnaA01T0061800ZY	0	-	0	0	1642	0.0000000
zheyou73v0_A01	3196582	3197283	BnaA01T0061900ZY	0	-	0	0	701	0.0000000
zheyou73v0_A01	3210554	3211739	BnaA01T0062000ZY	0	-	0	0	1185	0.0000000
zheyou73v0_A01	3212378	3214370	BnaA01T0062100ZY	0	-	0	0	1992	0.0000000
zheyou73v0_A01	3216199	3216862	BnaA01T0062200ZY	0	+	0	0	663	0.0000000
zheyou73v0_A01	3217943	3220979	BnaA01T0062300ZY	0	-	0	0	3036	0.0000000
zheyou73v0_A01	3222726	3223963	BnaA01T0062400ZY	0	-	0	0	1237	0.0000000
zheyou73v0_A01	3229727	3230294	BnaA01T0062500ZY	0	+	0	0	567	0.0000000
zheyou73v0_A01	3232252	3234411	BnaA01T0062600ZY	0	-	0	0	2159	0.0000000
zheyou73v0_A01	3235010	3237312	BnaA01T0062700ZY	0	-	0	0	2302	0.0000000
zheyou73v0_A01	3239396	3246536	BnaA01T0062800ZY	0	+	0	0	7140	0.0000000
zheyou73v0_A01	3247449	3248914	BnaA01T0062900ZY	0	+	0	0	1465	0.0000000
zheyou73v0_A01	3249137	3255699	BnaA01T0063000ZY	0	-	0	0	6562	0.0000000
zheyou73v0_A01	3256144	3258284	BnaA01T0063100ZY	0	+	0	0	2140	0.0000000
zheyou73v0_A01	3258820	3261338	BnaA01T0063200ZY	0	-	0	0	2518	0.0000000
zheyou73v0_A01	3261502	3263863	BnaA01T0063300ZY	0	+	0	0	2361	0.0000000
zheyou73v0_A01	3261502	3263699	BnaA01T0063300ZY.1	0	+	0	0	2197	0.0000000
zheyou73v0_A01	3264944	3267439	BnaA01T0063400ZY	0	-	0	0	2495	0.0000000
zheyou73v0_A01	3272307	3273154	BnaA01T0063500ZY	0	+	0	0	847	0.0000000
zheyou73v0_A01	3273634	3277944	BnaA01T0063600ZY	0	-	0	0	4310	0.0000000
zheyou73v0_A01	3281265	3290344	BnaA01T0063700ZY	0	-	0	0	9079	0.0000000
zheyou73v0_A01	3290615	3291816	BnaA01T0063800ZY	0	-	0	0	1201	0.0000000
zheyou73v0_A01	3292333	3293552	BnaA01T0063900ZY	0	+	0	0	1219	0.0000000
zheyou73v0_A01	3295394	3298296	BnaA01T0064000ZY	0	-	0	0	2902	0.0000000
zheyou73v0_A01	3298472	3300904	BnaA01T0064100ZY	0	+	0	0	2432	0.0000000
zheyou73v0_A01	3303146	3304407	BnaA01T0064200ZY	0	+	0	0	1261	0.0000000
zheyou73v0_A01	3304896	3307122	BnaA01T0064300ZY	0	-	0	0	2226	0.0000000
zheyou73v0_A01	3307777	3309020	BnaA01T0064400ZY	0	-	0	0	1243	0.0000000
zheyou73v0_A01	3309511	3310164	BnaA01T0064500ZY	0	-	0	0	653	0.0000000
zheyou73v0_A01	3310183	3311366	BnaA01T0064600ZY	0	-	0	0	1183	0.0000000
zheyou73v0_A01	3313133	3315051	BnaA01T0064700ZY	0	-	0	0	1918	0.0000000
zheyou73v0_A01	3316699	3319295	BnaA01T0064800ZY	0	+	0	0	2596	0.0000000
zheyou73v0_A01	3342144	3343470	BnaA01T0064900ZY	0	-	0	0	1326	0.0000000
zheyou73v0_A01	3352566	3354956	BnaA01T0065000ZY	0	+	0	0	2390	0.0000000
zheyou73v0_A01	3360616	3362386	BnaA01T0065100ZY	0	+	0	0	1770	0.0000000
zheyou73v0_A01	3362660	3365287	BnaA01T0065200ZY	0	+	0	0	2627	0.0000000
zheyou73v0_A01	3365604	3367426	BnaA01T0065300ZY	0	-	0	0	1822	0.0000000
zheyou73v0_A01	3368364	3371674	BnaA01T0065400ZY	0	+	0	0	3310	0.0000000
zheyou73v0_A01	3371681	3372275	BnaA01T0065500ZY	0	-	0	0	594	0.0000000
zheyou73v0_A01	3378831	3380855	BnaA01T0065600ZY	0	+	0	0	2024	0.0000000
zheyou73v0_A01	3382506	3382871	BnaA01T0065700ZY	0	+	0	0	365	0.0000000
zheyou73v0_A01	3383776	3387839	BnaA01T0065800ZY	0	+	0	0	4063	0.0000000
zheyou73v0_A01	3385136	3387776	BnaA01T0065900ZY	0	-	0	0	2640	0.0000000
zheyou73v0_A01	3400473	3404461	BnaA01T0066000ZY	0	+	0	0	3988	0.0000000
zheyou73v0_A01	3404494	3407012	BnaA01T0066100ZY	0	-	0	0	2518	0.0000000
zheyou73v0_A01	3408274	3408736	BnaA01T0066200ZY	0	+	0	0	462	0.0000000
zheyou73v0_A01	3414299	3420631	BnaA01T0066300ZY	0	+	0	0	6332	0.0000000
zheyou73v0_A01	3421297	3424680	BnaA01T0066400ZY	0	+	0	0	3383	0.0000000
zheyou73v0_A01	3421297	3424680	BnaA01T0066400ZY.1	0	+	0	0	3383	0.0000000
zheyou73v0_A01	3425339	3426999	BnaA01T0066500ZY	0	-	0	0	1660	0.0000000
zheyou73v0_A01	3427646	3428143	BnaA01T0066600ZY	0	+	0	0	497	0.0000000
zheyou73v0_A01	3428977	3432039	BnaA01T0066700ZY	0	+	0	0	3062	0.0000000
zheyou73v0_A01	3432485	3438159	BnaA01T0066800ZY	0	-	0	0	5674	0.0000000
zheyou73v0_A01	3438231	3438938	BnaA01T0066900ZY	0	-	0	0	707	0.0000000
zheyou73v0_A01	3439291	3440628	BnaA01T0067000ZY	0	-	0	0	1337	0.0000000
zheyou73v0_A01	3449413	3450607	BnaA01T0067100ZY	0	+	0	0	1194	0.0000000
zheyou73v0_A01	3451263	3452208	BnaA01T0067200ZY	0	-	0	0	945	0.0000000
zheyou73v0_A01	3452217	3452520	BnaA01T0067300ZY	0	-	0	0	303	0.0000000
zheyou73v0_A01	3458413	3460826	BnaA01T0067400ZY	0	+	0	0	2413	0.0000000
zheyou73v0_A01	3462015	3463512	BnaA01T0067500ZY	0	-	0	0	1497	0.0000000
zheyou73v0_A01	3462411	3463512	BnaA01T0067500ZY.1	0	-	0	0	1101	0.0000000
zheyou73v0_A01	3470205	3471241	BnaA01T0067600ZY	0	+	0	0	1036	0.0000000
zheyou73v0_A01	3472518	3472923	BnaA01T0067700ZY	0	+	0	0	405	0.0000000
zheyou73v0_A01	3475809	3478179	BnaA01T0067800ZY	0	-	0	0	2370	0.0000000
zheyou73v0_A01	3483439	3484594	BnaA01T0067900ZY	0	-	0	0	1155	0.0000000
zheyou73v0_A01	3484672	3485474	BnaA01T0068000ZY	0	+	0	0	802	0.0000000
zheyou73v0_A01	3492636	3493254	BnaA01T0068100ZY	0	+	0	0	618	0.0000000
zheyou73v0_A01	3500363	3501911	BnaA01T0068200ZY	0	+	0	0	1548	0.0000000
zheyou73v0_A01	3504615	3506262	BnaA01T0068300ZY	0	+	0	0	1647	0.0000000
zheyou73v0_A01	3506084	3507964	BnaA01T0068400ZY	0	-	0	0	1880	0.0000000
zheyou73v0_A01	3512315	3512858	BnaA01T0068500ZY	0	+	0	0	543	0.0000000
zheyou73v0_A01	3520539	3521402	BnaA01T0068600ZY	0	-	0	0	863	0.0000000
zheyou73v0_A01	3522827	3523614	BnaA01T0068700ZY	0	+	0	0	787	0.0000000
zheyou73v0_A01	3524359	3528751	BnaA01T0068800ZY	0	+	0	0	4392	0.0000000
zheyou73v0_A01	3531794	3534669	BnaA01T0068900ZY	0	-	0	0	2875	0.0000000
zheyou73v0_A01	3542685	3545718	BnaA01T0069000ZY	0	+	0	0	3033	0.0000000
zheyou73v0_A01	3546489	3546996	BnaA01T0069100ZY	0	-	0	0	507	0.0000000
zheyou73v0_A01	3551481	3552820	BnaA01T0069200ZY	0	+	0	0	1339	0.0000000
zheyou73v0_A01	3554108	3557780	BnaA01T0069300ZY	0	+	0	0	3672	0.0000000
zheyou73v0_A01	3563907	3564952	BnaA01T0069400ZY	0	+	0	0	1045	0.0000000
zheyou73v0_A01	3565586	3567122	BnaA01T0069500ZY	0	+	0	0	1536	0.0000000
zheyou73v0_A01	3565586	3567122	BnaA01T0069500ZY.1	0	+	0	0	1536	0.0000000
zheyou73v0_A01	3570556	3572125	BnaA01T0069600ZY	0	+	0	0	1569	0.0000000
zheyou73v0_A01	3573717	3575632	BnaA01T0069700ZY	0	+	0	0	1915	0.0000000
zheyou73v0_A01	3573717	3575632	BnaA01T0069700ZY.1	0	+	0	0	1915	0.0000000
zheyou73v0_A01	3573717	3575311	BnaA01T0069700ZY.2	0	+	0	0	1594	0.0000000
zheyou73v0_A01	3576588	3585610	BnaA01T0069800ZY	0	-	0	0	9022	0.0000000
zheyou73v0_A01	3588743	3592817	BnaA01T0069900ZY	0	-	0	0	4074	0.0000000
zheyou73v0_A01	3602289	3606051	BnaA01T0070000ZY	0	+	0	0	3762	0.0000000
zheyou73v0_A01	3602289	3606051	BnaA01T0070000ZY.1	0	+	0	0	3762	0.0000000
zheyou73v0_A01	3634221	3639050	BnaA01T0070100ZY	0	+	0	0	4829	0.0000000
zheyou73v0_A01	3640226	3640715	BnaA01T0070200ZY	0	-	0	0	489	0.0000000
zheyou73v0_A01	3646287	3647850	BnaA01T0070300ZY	0	-	0	0	1563	0.0000000
zheyou73v0_A01	3654727	3659962	BnaA01T0070400ZY	0	-	0	0	5235	0.0000000
zheyou73v0_A01	3670443	3677326	BnaA01T0070500ZY	0	-	0	0	6883	0.0000000
zheyou73v0_A01	3678521	3681071	BnaA01T0070600ZY	0	-	0	0	2550	0.0000000
zheyou73v0_A01	3683643	3686783	BnaA01T0070700ZY	0	+	0	0	3140	0.0000000
zheyou73v0_A01	3693814	3698702	BnaA01T0070800ZY	0	+	0	0	4888	0.0000000
zheyou73v0_A01	3694243	3698507	BnaA01T0070800ZY.1	0	+	0	0	4264	0.0000000
zheyou73v0_A01	3699677	3702394	BnaA01T0070900ZY	0	+	0	0	2717	0.0000000
zheyou73v0_A01	3706732	3709338	BnaA01T0071000ZY	0	+	0	0	2606	0.0000000
zheyou73v0_A01	3714919	3715504	BnaA01T0071100ZY	0	-	0	0	585	0.0000000
zheyou73v0_A01	3717806	3719102	BnaA01T0071200ZY	0	+	0	0	1296	0.0000000
zheyou73v0_A01	3721398	3725447	BnaA01T0071300ZY	0	-	0	0	4049	0.0000000
zheyou73v0_A01	3729095	3730558	BnaA01T0071400ZY	0	-	0	0	1463	0.0000000
zheyou73v0_A01	3734921	3735269	BnaA01T0071500ZY	0	-	0	0	348	0.0000000
zheyou73v0_A01	3736534	3738853	BnaA01T0071600ZY	0	+	0	0	2319	0.0000000
zheyou73v0_A01	3740256	3743673	BnaA01T0071700ZY	0	+	0	0	3417	0.0000000
zheyou73v0_A01	3745042	3746377	BnaA01T0071800ZY	0	+	0	0	1335	0.0000000
zheyou73v0_A01	3748253	3751524	BnaA01T0071900ZY	0	-	0	0	3271	0.0000000
zheyou73v0_A01	3748253	3751524	BnaA01T0071900ZY.1	0	-	0	0	3271	0.0000000
zheyou73v0_A01	3764110	3767652	BnaA01T0072000ZY	0	+	0	0	3542	0.0000000
zheyou73v0_A01	3768043	3771727	BnaA01T0072100ZY	0	-	0	0	3684	0.0000000
zheyou73v0_A01	3773435	3773756	BnaA01T0072200ZY	0	-	0	0	321	0.0000000
zheyou73v0_A01	3782362	3785475	BnaA01T0072300ZY	0	+	0	0	3113	0.0000000
zheyou73v0_A01	3788387	3805922	BnaA01T0072400ZY	0	+	0	0	17535	0.0000000
zheyou73v0_A01	3806399	3808278	BnaA01T0072500ZY	0	-	0	0	1879	0.0000000
zheyou73v0_A01	3813859	3817609	BnaA01T0072600ZY	0	+	0	0	3750	0.0000000
zheyou73v0_A01	3816165	3817609	BnaA01T0072600ZY.1	0	+	0	0	1444	0.0000000
zheyou73v0_A01	3819036	3819277	BnaA01T0072700ZY	0	-	0	0	241	0.0000000
zheyou73v0_A01	3819541	3821477	BnaA01T0072800ZY	0	+	0	0	1936	0.0000000
zheyou73v0_A01	3823495	3825567	BnaA01T0072900ZY	0	+	0	0	2072	0.0000000
zheyou73v0_A01	3825926	3826602	BnaA01T0073000ZY	0	+	0	0	676	0.0000000
zheyou73v0_A01	3831307	3839445	BnaA01T0073100ZY	0	+	0	0	8138	0.0000000
zheyou73v0_A01	3840150	3840900	BnaA01T0073200ZY	0	-	0	0	750	0.0000000
zheyou73v0_A01	3841149	3843761	BnaA01T0073300ZY	0	+	0	0	2612	0.0000000
zheyou73v0_A01	3843809	3845234	BnaA01T0073400ZY	0	+	0	0	1425	0.0000000
zheyou73v0_A01	3845481	3848571	BnaA01T0073500ZY	0	-	0	0	3090	0.0000000
zheyou73v0_A01	3845635	3847219	BnaA01T0073600ZY	0	+	0	0	1584	0.0000000
zheyou73v0_A01	3848931	3850138	BnaA01T0073700ZY	0	+	0	0	1207	0.0000000
zheyou73v0_A01	3850831	3852687	BnaA01T0073800ZY	0	+	0	0	1856	0.0000000
zheyou73v0_A01	3854307	3855984	BnaA01T0073900ZY	0	+	0	0	1677	0.0000000
zheyou73v0_A01	3856635	3862566	BnaA01T0074000ZY	0	-	0	0	5931	0.0000000
zheyou73v0_A01	3864713	3866602	BnaA01T0074100ZY	0	-	0	0	1889	0.0000000
zheyou73v0_A01	3875537	3875732	BnaA01T0074200ZY	0	-	0	0	195	0.0000000
zheyou73v0_A01	3877284	3880696	BnaA01T0074300ZY	0	+	0	0	3412	0.0000000
zheyou73v0_A01	3888702	3889883	BnaA01T0074400ZY	0	+	0	0	1181	0.0000000
zheyou73v0_A01	3903451	3903763	BnaA01T0074500ZY	0	-	0	0	312	0.0000000
zheyou73v0_A01	3906904	3908384	BnaA01T0074600ZY	0	+	0	0	1480	0.0000000
zheyou73v0_A01	3909158	3910639	BnaA01T0074700ZY	0	+	0	0	1481	0.0000000
zheyou73v0_A01	3912377	3915988	BnaA01T0074800ZY	0	+	0	0	3611	0.0000000
zheyou73v0_A01	3916482	3917345	BnaA01T0074900ZY	0	+	0	0	863	0.0000000
zheyou73v0_A01	3917580	3918162	BnaA01T0075000ZY	0	+	0	0	582	0.0000000
zheyou73v0_A01	3929886	3931725	BnaA01T0075100ZY	0	+	0	0	1839	0.0000000
zheyou73v0_A01	3931806	3933743	BnaA01T0075200ZY	0	-	0	0	1937	0.0000000
zheyou73v0_A01	3934180	3937191	BnaA01T0075300ZY	0	-	0	0	3011	0.0000000
zheyou73v0_A01	3937858	3939056	BnaA01T0075400ZY	0	+	0	0	1198	0.0000000
zheyou73v0_A01	3939903	3940640	BnaA01T0075500ZY	0	+	0	0	737	0.0000000
zheyou73v0_A01	3941039	3942108	BnaA01T0075600ZY	0	+	0	0	1069	0.0000000
zheyou73v0_A01	3942935	3946553	BnaA01T0075700ZY	0	+	0	0	3618	0.0000000
zheyou73v0_A01	3948427	3950352	BnaA01T0075800ZY	0	+	0	0	1925	0.0000000
zheyou73v0_A01	3951440	3955074	BnaA01T0075900ZY	0	+	0	0	3634	0.0000000
zheyou73v0_A01	3955108	3956276	BnaA01T0076000ZY	0	-	0	0	1168	0.0000000
zheyou73v0_A01	3956482	3958306	BnaA01T0076100ZY	0	+	0	0	1824	0.0000000
zheyou73v0_A01	3958357	3960527	BnaA01T0076200ZY	0	+	0	0	2170	0.0000000
zheyou73v0_A01	3960612	3962360	BnaA01T0076300ZY	0	-	0	0	1748	0.0000000
zheyou73v0_A01	3962558	3963465	BnaA01T0076400ZY	0	+	0	0	907	0.0000000
zheyou73v0_A01	3963737	3970003	BnaA01T0076500ZY	0	-	0	0	6266	0.0000000
zheyou73v0_A01	3974274	3977505	BnaA01T0076600ZY	0	-	0	0	3231	0.0000000
zheyou73v0_A01	3988152	3988329	BnaA01T0076700ZY	0	-	0	0	177	0.0000000
zheyou73v0_A01	3990966	3993209	BnaA01T0076800ZY	0	+	0	0	2243	0.0000000
zheyou73v0_A01	3993411	3994468	BnaA01T0076900ZY	0	-	0	0	1057	0.0000000
zheyou73v0_A01	3998500	3999699	BnaA01T0077000ZY	0	-	0	0	1199	0.0000000
zheyou73v0_A01	4000410	4002561	BnaA01T0077100ZY	0	-	0	0	2151	0.0000000
zheyou73v0_A01	4000410	4002561	BnaA01T0077100ZY.1	0	-	0	0	2151	0.0000000
zheyou73v0_A01	4009772	4034661	BnaA01T0077200ZY	0	+	0	0	24889	0.0000000
zheyou73v0_A01	4036870	4038574	BnaA01T0077300ZY	0	+	0	0	1704	0.0000000
zheyou73v0_A01	4040047	4044791	BnaA01T0077400ZY	0	-	0	0	4744	0.0000000
zheyou73v0_A01	4057444	4060147	BnaA01T0077500ZY	0	+	0	0	2703	0.0000000
zheyou73v0_A01	4060458	4065187	BnaA01T0077600ZY	0	-	0	0	4729	0.0000000
zheyou73v0_A01	4074189	4075610	BnaA01T0077700ZY	0	+	0	0	1421	0.0000000
zheyou73v0_A01	4084751	4086580	BnaA01T0077800ZY	0	-	0	0	1829	0.0000000
zheyou73v0_A01	4091001	4092164	BnaA01T0077900ZY	0	-	0	0	1163	0.0000000
zheyou73v0_A01	4099552	4101169	BnaA01T0078000ZY	0	-	0	0	1617	0.0000000
zheyou73v0_A01	4130673	4134524	BnaA01T0078100ZY	0	-	0	0	3851	0.0000000
zheyou73v0_A01	4156739	4157564	BnaA01T0078200ZY	0	-	0	0	825	0.0000000
zheyou73v0_A01	4169833	4171538	BnaA01T0078300ZY	0	+	0	0	1705	0.0000000
zheyou73v0_A01	4169833	4170942	BnaA01T0078300ZY.1	0	+	0	0	1109	0.0000000
zheyou73v0_A01	4171636	4177235	BnaA01T0078400ZY	0	-	0	0	5599	0.0000000
zheyou73v0_A01	4184257	4186262	BnaA01T0078500ZY	0	+	0	0	2005	0.0000000
zheyou73v0_A01	4186467	4188902	BnaA01T0078600ZY	0	-	0	0	2435	0.0000000
zheyou73v0_A01	4190222	4202650	BnaA01T0078700ZY	0	-	0	0	12428	0.0000000
zheyou73v0_A01	4204139	4204820	BnaA01T0078800ZY	0	-	0	0	681	0.0000000
zheyou73v0_A01	4207925	4212479	BnaA01T0078900ZY	0	+	0	0	4554	0.0000000
zheyou73v0_A01	4207925	4212479	BnaA01T0078900ZY.1	0	+	0	0	4554	0.0000000
zheyou73v0_A01	4212779	4217837	BnaA01T0079000ZY	0	-	0	0	5058	0.0000000
zheyou73v0_A01	4218066	4220437	BnaA01T0079100ZY	0	-	0	0	2371	0.0000000
zheyou73v0_A01	4221439	4222557	BnaA01T0079200ZY	0	-	0	0	1118	0.0000000
zheyou73v0_A01	4223723	4229366	BnaA01T0079300ZY	0	-	0	0	5643	0.0000000
zheyou73v0_A01	4230739	4233153	BnaA01T0079400ZY	0	-	0	0	2414	0.0000000
zheyou73v0_A01	4242744	4244926	BnaA01T0079500ZY	0	+	0	0	2182	0.0000000
zheyou73v0_A01	4246710	4248132	BnaA01T0079600ZY	0	+	0	0	1422	0.0000000
zheyou73v0_A01	4249898	4252727	BnaA01T0079700ZY	0	-	0	0	2829	0.0000000
zheyou73v0_A01	4249898	4252717	BnaA01T0079700ZY.1	0	-	0	0	2819	0.0000000
zheyou73v0_A01	4253312	4254892	BnaA01T0079800ZY	0	-	0	0	1580	0.0000000
zheyou73v0_A01	4256561	4259198	BnaA01T0079900ZY	0	-	0	0	2637	0.0000000
zheyou73v0_A01	4275754	4277190	BnaA01T0080000ZY	0	-	0	0	1436	0.0000000
zheyou73v0_A01	4278699	4279876	BnaA01T0080100ZY	0	+	0	0	1177	0.0000000
zheyou73v0_A01	4280360	4282541	BnaA01T0080200ZY	0	-	0	0	2181	0.0000000
zheyou73v0_A01	4288700	4294316	BnaA01T0080300ZY	0	-	0	0	5616	0.0000000
zheyou73v0_A01	4296612	4299356	BnaA01T0080400ZY	0	-	0	0	2744	0.0000000
zheyou73v0_A01	4301927	4303548	BnaA01T0080500ZY	0	+	0	0	1621	0.0000000
zheyou73v0_A01	4303654	4307783	BnaA01T0080600ZY	0	-	0	0	4129	0.0000000
zheyou73v0_A01	4303654	4306606	BnaA01T0080600ZY.1	0	-	0	0	2952	0.0000000
zheyou73v0_A01	4311265	4312068	BnaA01T0080700ZY	0	+	0	0	803	0.0000000
zheyou73v0_A01	4312445	4313805	BnaA01T0080800ZY	0	-	0	0	1360	0.0000000
zheyou73v0_A01	4319748	4321309	BnaA01T0080900ZY	0	-	0	0	1561	0.0000000
zheyou73v0_A01	4339032	4339542	BnaA01T0081000ZY	0	-	0	0	510	0.0000000
zheyou73v0_A01	4340728	4355004	BnaA01T0081100ZY	0	-	0	0	14276	0.0000000
zheyou73v0_A01	4359602	4360252	BnaA01T0081200ZY	0	-	0	0	650	0.0000000
zheyou73v0_A01	4362264	4363770	BnaA01T0081300ZY	0	-	0	0	1506	0.0000000
zheyou73v0_A01	4364464	4372278	BnaA01T0081400ZY	0	-	0	0	7814	0.0000000
zheyou73v0_A01	4373975	4376528	BnaA01T0081500ZY	0	-	0	0	2553	0.0000000
zheyou73v0_A01	4376621	4377638	BnaA01T0081600ZY	0	-	0	0	1017	0.0000000
zheyou73v0_A01	4385428	4388916	BnaA01T0081700ZY	0	+	0	0	3488	0.0000000
zheyou73v0_A01	4385428	4390616	BnaA01T0081800ZY	0	-	0	0	5188	0.0000000
zheyou73v0_A01	4391939	4396625	BnaA01T0081900ZY	0	+	0	0	4686	0.0000000
zheyou73v0_A01	4398437	4400314	BnaA01T0082000ZY	0	+	0	0	1877	0.0000000
zheyou73v0_A01	4400274	4403883	BnaA01T0082100ZY	0	-	0	0	3609	0.0000000
zheyou73v0_A01	4408284	4409643	BnaA01T0082200ZY	0	+	0	0	1359	0.0000000
zheyou73v0_A01	4416057	4418866	BnaA01T0082300ZY	0	-	0	0	2809	0.0000000
zheyou73v0_A01	4443356	4447014	BnaA01T0082400ZY	0	+	0	0	3658	0.0000000
zheyou73v0_A01	4450239	4452413	BnaA01T0082500ZY	0	-	0	0	2174	0.0000000
zheyou73v0_A01	4455163	4458224	BnaA01T0082600ZY	0	+	0	0	3061	0.0000000
zheyou73v0_A01	4462278	4465732	BnaA01T0082700ZY	0	-	0	0	3454	0.0000000
zheyou73v0_A01	4467624	4468308	BnaA01T0082800ZY	0	+	0	0	684	0.0000000
zheyou73v0_A01	4468454	4470266	BnaA01T0082900ZY	0	-	0	0	1812	0.0000000
zheyou73v0_A01	4470485	4476126	BnaA01T0083000ZY	0	+	0	0	5641	0.0000000
zheyou73v0_A01	4476211	4476755	BnaA01T0083100ZY	0	-	0	0	544	0.0000000
zheyou73v0_A01	4487012	4488436	BnaA01T0083200ZY	0	-	0	0	1424	0.0000000
zheyou73v0_A01	4488743	4490689	BnaA01T0083300ZY	0	-	0	0	1946	0.0000000
zheyou73v0_A01	4491026	4493183	BnaA01T0083400ZY	0	-	0	0	2157	0.0000000
zheyou73v0_A01	4514803	4514968	BnaA01T0083500ZY	0	-	0	0	165	0.0000000
zheyou73v0_A01	4516096	4516471	BnaA01T0083600ZY	0	+	0	0	375	0.0000000
zheyou73v0_A01	4516787	4518201	BnaA01T0083700ZY	0	-	0	0	1414	0.0000000
zheyou73v0_A01	4525893	4527127	BnaA01T0083800ZY	0	-	0	0	1234	0.0000000
zheyou73v0_A01	4531618	4532575	BnaA01T0083900ZY	0	+	0	0	957	0.0000000
zheyou73v0_A01	4533067	4534537	BnaA01T0084000ZY	0	-	0	0	1470	0.0000000
zheyou73v0_A01	4534799	4536923	BnaA01T0084100ZY	0	+	0	0	2124	0.0000000
zheyou73v0_A01	4537180	4539034	BnaA01T0084200ZY	0	-	0	0	1854	0.0000000
zheyou73v0_A01	4539542	4541382	BnaA01T0084300ZY	0	+	0	0	1840	0.0000000
zheyou73v0_A01	4541470	4543160	BnaA01T0084400ZY	0	-	0	0	1690	0.0000000
zheyou73v0_A01	4548085	4549207	BnaA01T0084500ZY	0	-	0	0	1122	0.0000000
zheyou73v0_A01	4556210	4558675	BnaA01T0084600ZY	0	-	0	0	2465	0.0000000
zheyou73v0_A01	4556210	4559002	BnaA01T0084600ZY.1	0	-	0	0	2792	0.0000000
zheyou73v0_A01	4562912	4566680	BnaA01T0084700ZY	0	-	0	0	3768	0.0000000
zheyou73v0_A01	4567197	4576217	BnaA01T0084800ZY	0	-	0	0	9020	0.0000000
zheyou73v0_A01	4584063	4586923	BnaA01T0084900ZY	0	+	0	0	2860	0.0000000
zheyou73v0_A01	4594638	4597593	BnaA01T0085000ZY	0	+	0	0	2955	0.0000000
zheyou73v0_A01	4597920	4599855	BnaA01T0085100ZY	0	+	0	0	1935	0.0000000
zheyou73v0_A01	4597920	4599855	BnaA01T0085100ZY.1	0	+	0	0	1935	0.0000000
zheyou73v0_A01	4600001	4601392	BnaA01T0085200ZY	0	+	0	0	1391	0.0000000
zheyou73v0_A01	4600001	4601392	BnaA01T0085200ZY.1	0	+	0	0	1391	0.0000000
zheyou73v0_A01	4603391	4604761	BnaA01T0085300ZY	0	-	0	0	1370	0.0000000
zheyou73v0_A01	4619304	4620882	BnaA01T0085400ZY	0	+	0	0	1578	0.0000000
zheyou73v0_A01	4623727	4624240	BnaA01T0085500ZY	0	+	0	0	513	0.0000000
zheyou73v0_A01	4629858	4630902	BnaA01T0085600ZY	0	+	0	0	1044	0.0000000
zheyou73v0_A01	4631946	4635833	BnaA01T0085700ZY	0	-	0	0	3887	0.0000000
zheyou73v0_A01	4650385	4652188	BnaA01T0085800ZY	0	+	0	0	1803	0.0000000
zheyou73v0_A01	4652272	4653935	BnaA01T0085900ZY	0	-	0	0	1663	0.0000000
zheyou73v0_A01	4657244	4658255	BnaA01T0086000ZY	0	-	0	0	1011	0.0000000
zheyou73v0_A01	4661432	4663254	BnaA01T0086100ZY	0	-	0	0	1822	0.0000000
zheyou73v0_A01	4672124	4673525	BnaA01T0086200ZY	0	+	0	0	1401	0.0000000
zheyou73v0_A01	4676201	4677407	BnaA01T0086300ZY	0	-	0	0	1206	0.0000000
zheyou73v0_A01	4703917	4704526	BnaA01T0086400ZY	0	+	0	0	609	0.0000000
zheyou73v0_A01	4712616	4715520	BnaA01T0086500ZY	0	+	0	0	2904	0.0000000
zheyou73v0_A01	4715393	4717018	BnaA01T0086600ZY	0	-	0	0	1625	0.0000000
zheyou73v0_A01	4721117	4722053	BnaA01T0086700ZY	0	+	0	0	936	0.0000000
zheyou73v0_A01	4726163	4729165	BnaA01T0086800ZY	0	+	0	0	3002	0.0000000
zheyou73v0_A01	4730144	4730351	BnaA01T0086900ZY	0	+	0	0	207	0.0000000
zheyou73v0_A01	4731840	4732507	BnaA01T0087000ZY	0	+	0	0	667	0.0000000
zheyou73v0_A01	4737394	4737586	BnaA01T0087100ZY	0	-	0	0	192	0.0000000
zheyou73v0_A01	4748428	4750647	BnaA01T0087200ZY	0	-	0	0	2219	0.0000000
zheyou73v0_A01	4755629	4758124	BnaA01T0087300ZY	0	+	0	0	2495	0.0000000
zheyou73v0_A01	4755629	4758124	BnaA01T0087300ZY.1	0	+	0	0	2495	0.0000000
zheyou73v0_A01	4762413	4764750	BnaA01T0087400ZY	0	+	0	0	2337	0.0000000
zheyou73v0_A01	4765869	4767051	BnaA01T0087500ZY	0	-	0	0	1182	0.0000000
zheyou73v0_A01	4779003	4780175	BnaA01T0087600ZY	0	-	0	0	1172	0.0000000
zheyou73v0_A01	4782246	4783104	BnaA01T0087700ZY	0	+	0	0	858	0.0000000
zheyou73v0_A01	4783764	4785073	BnaA01T0087800ZY	0	-	0	0	1309	0.0000000
zheyou73v0_A01	4787880	4789304	BnaA01T0087900ZY	0	+	0	0	1424	0.0000000
zheyou73v0_A01	4794406	4795562	BnaA01T0088000ZY	0	-	0	0	1156	0.0000000
zheyou73v0_A01	4801339	4804393	BnaA01T0088100ZY	0	-	0	0	3054	0.0000000
zheyou73v0_A01	4801339	4804393	BnaA01T0088100ZY.1	0	-	0	0	3054	0.0000000
zheyou73v0_A01	4806671	4806999	BnaA01T0088200ZY	0	+	0	0	328	0.0000000
zheyou73v0_A01	4810744	4813745	BnaA01T0088300ZY	0	-	0	0	3001	0.0000000
zheyou73v0_A01	4830621	4833284	BnaA01T0088400ZY	0	-	0	0	2663	0.0000000
zheyou73v0_A01	4840375	4844283	BnaA01T0088500ZY	0	-	0	0	3908	0.0000000
zheyou73v0_A01	4840375	4844283	BnaA01T0088500ZY.1	0	-	0	0	3908	0.0000000
zheyou73v0_A01	4845069	4846525	BnaA01T0088600ZY	0	-	0	0	1456	0.0000000
zheyou73v0_A01	4845069	4846525	BnaA01T0088600ZY.1	0	-	0	0	1456	0.0000000
zheyou73v0_A01	4846988	4847620	BnaA01T0088700ZY	0	-	0	0	632	0.0000000
zheyou73v0_A01	4848700	4856043	BnaA01T0088800ZY	0	+	0	0	7343	0.0000000
zheyou73v0_A01	4861087	4864283	BnaA01T0088900ZY	0	+	0	0	3196	0.0000000
zheyou73v0_A01	4861087	4864283	BnaA01T0088900ZY.1	0	+	0	0	3196	0.0000000
zheyou73v0_A01	4861087	4864283	BnaA01T0088900ZY.2	0	+	0	0	3196	0.0000000
zheyou73v0_A01	4864575	4868087	BnaA01T0089000ZY	0	-	0	0	3512	0.0000000
zheyou73v0_A01	4870732	4874491	BnaA01T0089100ZY	0	+	0	0	3759	0.0000000
zheyou73v0_A01	4875884	4877395	BnaA01T0089200ZY	0	+	0	0	1511	0.0000000
zheyou73v0_A01	4878054	4878473	BnaA01T0089300ZY	0	+	0	0	419	0.0000000
zheyou73v0_A01	4896888	4898108	BnaA01T0089400ZY	0	+	0	0	1220	0.0000000
zheyou73v0_A01	4903535	4905824	BnaA01T0089500ZY	0	+	0	0	2289	0.0000000
zheyou73v0_A01	4906629	4907742	BnaA01T0089600ZY	0	+	0	0	1113	0.0000000
zheyou73v0_A01	4908268	4909523	BnaA01T0089700ZY	0	+	0	0	1255	0.0000000
zheyou73v0_A01	4909401	4911319	BnaA01T0089800ZY	0	-	0	0	1918	0.0000000
zheyou73v0_A01	4909401	4911173	BnaA01T0089800ZY.1	0	-	0	0	1772	0.0000000
zheyou73v0_A01	4914902	4915813	BnaA01T0089900ZY	0	+	0	0	911	0.0000000
zheyou73v0_A01	4922229	4925210	BnaA01T0090000ZY	0	-	0	0	2981	0.0000000
zheyou73v0_A01	4954366	4955187	BnaA01T0090100ZY	0	+	0	0	821	0.0000000
zheyou73v0_A01	4956831	4958620	BnaA01T0090200ZY	0	+	0	0	1789	0.0000000
zheyou73v0_A01	4960350	4960866	BnaA01T0090300ZY	0	+	0	0	516	0.0000000
zheyou73v0_A01	4961735	4963645	BnaA01T0090400ZY	0	-	0	0	1910	0.0000000
zheyou73v0_A01	4985295	4987206	BnaA01T0090500ZY	0	+	0	0	1911	0.0000000
zheyou73v0_A01	4989697	4991856	BnaA01T0090600ZY	0	-	0	0	2159	0.0000000
zheyou73v0_A01	4993322	4995651	BnaA01T0090700ZY	0	+	0	0	2329	0.0000000
zheyou73v0_A01	4994950	4995651	BnaA01T0090800ZY	0	-	0	0	701	0.0000000
zheyou73v0_A01	4996473	4998412	BnaA01T0090900ZY	0	+	0	0	1939	0.0000000
zheyou73v0_A01	5002383	5003718	BnaA01T0091000ZY	0	+	0	0	1335	0.0000000
zheyou73v0_A01	5008920	5011517	BnaA01T0091100ZY	0	-	0	0	2597	0.0000000
zheyou73v0_A01	5008920	5011356	BnaA01T0091100ZY.1	0	-	0	0	2436	0.0000000
zheyou73v0_A01	5024545	5024728	BnaA01T0091200ZY	0	+	0	0	183	0.0000000
zheyou73v0_A01	5024749	5025813	BnaA01T0091300ZY	0	-	0	0	1064	0.0000000
zheyou73v0_A01	5026245	5026718	BnaA01T0091400ZY	0	+	0	0	473	0.0000000
zheyou73v0_A01	5026751	5027286	BnaA01T0091500ZY	0	-	0	0	535	0.0000000
zheyou73v0_A01	5031033	5031867	BnaA01T0091600ZY	0	-	0	0	834	0.0000000
zheyou73v0_A01	5034550	5035761	BnaA01T0091700ZY	0	-	0	0	1211	0.0000000
zheyou73v0_A01	5037079	5040797	BnaA01T0091800ZY	0	-	0	0	3718	0.0000000
zheyou73v0_A01	5043198	5045407	BnaA01T0091900ZY	0	-	0	0	2209	0.0000000
zheyou73v0_A01	5053092	5055498	BnaA01T0092000ZY	0	+	0	0	2406	0.0000000
zheyou73v0_A01	5055781	5056864	BnaA01T0092100ZY	0	-	0	0	1083	0.0000000
zheyou73v0_A01	5057114	5061647	BnaA01T0092200ZY	0	+	0	0	4533	0.0000000
zheyou73v0_A01	5061937	5063509	BnaA01T0092300ZY	0	-	0	0	1572	0.0000000
zheyou73v0_A01	5066274	5076684	BnaA01T0092400ZY	0	-	0	0	10410	0.0000000
zheyou73v0_A01	5079660	5080111	BnaA01T0092500ZY	0	+	0	0	451	0.0000000
zheyou73v0_A01	5080581	5080833	BnaA01T0092600ZY	0	+	0	0	252	0.0000000
zheyou73v0_A01	5080946	5085239	BnaA01T0092700ZY	0	+	0	0	4293	0.0000000
zheyou73v0_A01	5087531	5091628	BnaA01T0092800ZY	0	+	0	0	4097	0.0000000
zheyou73v0_A01	5100115	5100436	BnaA01T0092900ZY	0	+	0	0	321	0.0000000
zheyou73v0_A01	5115242	5115479	BnaA01T0093000ZY	0	+	0	0	237	0.0000000
zheyou73v0_A01	5121235	5122531	BnaA01T0093100ZY	0	-	0	0	1296	0.0000000
zheyou73v0_A01	5122482	5125811	BnaA01T0093200ZY	0	+	0	0	3329	0.0000000
zheyou73v0_A01	5122482	5125811	BnaA01T0093200ZY.1	0	+	0	0	3329	0.0000000
zheyou73v0_A01	5128642	5130516	BnaA01T0093300ZY	0	-	0	0	1874	0.0000000
zheyou73v0_A01	5133100	5135727	BnaA01T0093400ZY	0	-	0	0	2627	0.0000000
zheyou73v0_A01	5140909	5143907	BnaA01T0093500ZY	0	+	0	0	2998	0.0000000
zheyou73v0_A01	5144186	5145123	BnaA01T0093600ZY	0	-	0	0	937	0.0000000
zheyou73v0_A01	5145962	5148602	BnaA01T0093700ZY	0	+	0	0	2640	0.0000000
zheyou73v0_A01	5149088	5149607	BnaA01T0093800ZY	0	+	0	0	519	0.0000000
zheyou73v0_A01	5150010	5157852	BnaA01T0093900ZY	0	-	0	0	7842	0.0000000
zheyou73v0_A01	5169059	5169825	BnaA01T0094000ZY	0	+	0	0	766	0.0000000
zheyou73v0_A01	5170652	5171350	BnaA01T0094100ZY	0	-	0	0	698	0.0000000
zheyou73v0_A01	5178718	5179219	BnaA01T0094200ZY	0	+	0	0	501	0.0000000
zheyou73v0_A01	5182016	5183894	BnaA01T0094300ZY	0	+	0	0	1878	0.0000000
zheyou73v0_A01	5185251	5188210	BnaA01T0094400ZY	0	+	0	0	2959	0.0000000
zheyou73v0_A01	5190958	5191957	BnaA01T0094500ZY	0	-	0	0	999	0.0000000
zheyou73v0_A01	5200273	5204085	BnaA01T0094600ZY	0	+	0	0	3812	0.0000000
zheyou73v0_A01	5208550	5209420	BnaA01T0094700ZY	0	+	0	0	870	0.0000000
zheyou73v0_A01	5210100	5211123	BnaA01T0094800ZY	0	-	0	0	1023	0.0000000
zheyou73v0_A01	5213046	5214224	BnaA01T0094900ZY	0	+	0	0	1178	0.0000000
zheyou73v0_A01	5216485	5218413	BnaA01T0095000ZY	0	-	0	0	1928	0.0000000
zheyou73v0_A01	5223179	5226022	BnaA01T0095100ZY	0	+	0	0	2843	0.0000000
zheyou73v0_A01	5223766	5226022	BnaA01T0095100ZY.1	0	+	0	0	2256	0.0000000
zheyou73v0_A01	5226509	5227380	BnaA01T0095200ZY	0	+	0	0	871	0.0000000
zheyou73v0_A01	5227604	5228500	BnaA01T0095300ZY	0	-	0	0	896	0.0000000
zheyou73v0_A01	5228760	5231567	BnaA01T0095400ZY	0	+	0	0	2807	0.0000000
zheyou73v0_A01	5231720	5233237	BnaA01T0095500ZY	0	-	0	0	1517	0.0000000
zheyou73v0_A01	5236400	5238135	BnaA01T0095600ZY	0	+	0	0	1735	0.0000000
zheyou73v0_A01	5239303	5240548	BnaA01T0095700ZY	0	-	0	0	1245	0.0000000
zheyou73v0_A01	5242532	5243969	BnaA01T0095800ZY	0	-	0	0	1437	0.0000000
zheyou73v0_A01	5245174	5246438	BnaA01T0095900ZY	0	-	0	0	1264	0.0000000
zheyou73v0_A01	5248145	5253941	BnaA01T0096000ZY	0	-	0	0	5796	0.0000000
zheyou73v0_A01	5285137	5285875	BnaA01T0096100ZY	0	-	0	0	738	0.0000000
zheyou73v0_A01	5286076	5289378	BnaA01T0096200ZY	0	-	0	0	3302	0.0000000
zheyou73v0_A01	5294859	5296808	BnaA01T0096300ZY	0	-	0	0	1949	0.0000000
zheyou73v0_A01	5304442	5308447	BnaA01T0096400ZY	0	+	0	0	4005	0.0000000
zheyou73v0_A01	5310773	5311984	BnaA01T0096500ZY	0	+	0	0	1211	0.0000000
zheyou73v0_A01	5310773	5313745	BnaA01T0096600ZY	0	-	0	0	2972	0.0000000
zheyou73v0_A01	5315743	5315938	BnaA01T0096700ZY	0	+	0	0	195	0.0000000
zheyou73v0_A01	5317920	5318885	BnaA01T0096800ZY	0	-	0	0	965	0.0000000
zheyou73v0_A01	5321447	5323256	BnaA01T0096900ZY	0	-	0	0	1809	0.0000000
zheyou73v0_A01	5337266	5339961	BnaA01T0097000ZY	0	+	0	0	2695	0.0000000
zheyou73v0_A01	5344823	5346856	BnaA01T0097100ZY	0	+	0	0	2033	0.0000000
zheyou73v0_A01	5347581	5350601	BnaA01T0097200ZY	0	+	0	0	3020	0.0000000
zheyou73v0_A01	5353079	5358362	BnaA01T0097300ZY	0	+	0	0	5283	0.0000000
zheyou73v0_A01	5360024	5365014	BnaA01T0097400ZY.1	0	+	0	0	4990	0.0000000
zheyou73v0_A01	5360024	5364953	BnaA01T0097400ZY.2	0	+	0	0	4929	0.0000000
zheyou73v0_A01	5360024	5364953	BnaA01T0097400ZY.3	0	+	0	0	4929	0.0000000
zheyou73v0_A01	5360198	5364953	BnaA01T0097400ZY	0	+	0	0	4755	0.0000000
zheyou73v0_A01	5367247	5368917	BnaA01T0097500ZY	0	-	0	0	1670	0.0000000
zheyou73v0_A01	5377755	5378307	BnaA01T0097600ZY	0	+	0	0	552	0.0000000
zheyou73v0_A01	5379039	5381383	BnaA01T0097700ZY	0	-	0	0	2344	0.0000000
zheyou73v0_A01	5381926	5383653	BnaA01T0097800ZY	0	-	0	0	1727	0.0000000
zheyou73v0_A01	5381926	5383653	BnaA01T0097800ZY.1	0	-	0	0	1727	0.0000000
zheyou73v0_A01	5381926	5383653	BnaA01T0097800ZY.2	0	-	0	0	1727	0.0000000
zheyou73v0_A01	5381926	5383653	BnaA01T0097800ZY.3	0	-	0	0	1727	0.0000000
zheyou73v0_A01	5383816	5386486	BnaA01T0097900ZY	0	-	0	0	2670	0.0000000
zheyou73v0_A01	5389901	5395735	BnaA01T0098000ZY	0	+	0	0	5834	0.0000000
zheyou73v0_A01	5396334	5402294	BnaA01T0098100ZY	0	-	0	0	5960	0.0000000
zheyou73v0_A01	5396334	5402294	BnaA01T0098100ZY.1	0	-	0	0	5960	0.0000000
zheyou73v0_A01	5403347	5407032	BnaA01T0098200ZY	0	-	0	0	3685	0.0000000
zheyou73v0_A01	5408319	5409675	BnaA01T0098300ZY	0	-	0	0	1356	0.0000000
zheyou73v0_A01	5411848	5415709	BnaA01T0098400ZY	0	-	0	0	3861	0.0000000
zheyou73v0_A01	5411848	5415709	BnaA01T0098400ZY.1	0	-	0	0	3861	0.0000000
zheyou73v0_A01	5422500	5425413	BnaA01T0098500ZY	0	+	0	0	2913	0.0000000
zheyou73v0_A01	5422500	5425413	BnaA01T0098500ZY.1	0	+	0	0	2913	0.0000000
zheyou73v0_A01	5424196	5425413	BnaA01T0098600ZY	0	-	0	0	1217	0.0000000
zheyou73v0_A01	5430383	5432463	BnaA01T0098700ZY	0	+	0	0	2080	0.0000000
zheyou73v0_A01	5435832	5438037	BnaA01T0098800ZY	0	+	0	0	2205	0.0000000
zheyou73v0_A01	5447631	5449917	BnaA01T0098900ZY	0	-	0	0	2286	0.0000000
zheyou73v0_A01	5450198	5453573	BnaA01T0099000ZY	0	-	0	0	3375	0.0000000
zheyou73v0_A01	5453919	5456591	BnaA01T0099100ZY	0	+	0	0	2672	0.0000000
zheyou73v0_A01	5457894	5459647	BnaA01T0099200ZY	0	+	0	0	1753	0.0000000
zheyou73v0_A01	5459624	5462323	BnaA01T0099300ZY	0	-	0	0	2699	0.0000000
zheyou73v0_A01	5463326	5464433	BnaA01T0099400ZY	0	+	0	0	1107	0.0000000
zheyou73v0_A01	5465484	5468681	BnaA01T0099500ZY	0	+	0	0	3197	0.0000000
zheyou73v0_A01	5485133	5487210	BnaA01T0099600ZY	0	+	0	0	2077	0.0000000
zheyou73v0_A01	5491042	5492878	BnaA01T0099700ZY	0	-	0	0	1836	0.0000000
zheyou73v0_A01	5493193	5495265	BnaA01T0099800ZY	0	+	0	0	2072	0.0000000
zheyou73v0_A01	5496136	5498096	BnaA01T0099900ZY	0	+	0	0	1960	0.0000000
zheyou73v0_A01	5503797	5505024	BnaA01T0100000ZY	0	+	0	0	1227	0.0000000
zheyou73v0_A01	5507650	5509649	BnaA01T0100100ZY	0	+	0	0	1999	0.0000000
zheyou73v0_A01	5524899	5526126	BnaA01T0100200ZY	0	+	0	0	1227	0.0000000
zheyou73v0_A01	5528859	5529578	BnaA01T0100300ZY	0	+	0	0	719	0.0000000
zheyou73v0_A01	5531741	5533269	BnaA01T0100400ZY	0	-	0	0	1528	0.0000000
zheyou73v0_A01	5533736	5538498	BnaA01T0100500ZY	0	-	0	0	4762	0.0000000
zheyou73v0_A01	5545905	5547503	BnaA01T0100600ZY	0	-	0	0	1598	0.0000000
zheyou73v0_A01	5554344	5566186	BnaA01T0100700ZY	0	-	0	0	11842	0.0000000
zheyou73v0_A01	5569788	5573012	BnaA01T0100800ZY	0	-	0	0	3224	0.0000000
zheyou73v0_A01	5569788	5573012	BnaA01T0100800ZY.1	0	-	0	0	3224	0.0000000
zheyou73v0_A01	5594711	5597004	BnaA01T0100900ZY	0	-	0	0	2293	0.0000000
zheyou73v0_A01	5596213	5596762	BnaA01T0101000ZY	0	+	0	0	549	0.0000000
zheyou73v0_A01	5599605	5600423	BnaA01T0101100ZY	0	-	0	0	818	0.0000000
zheyou73v0_A01	5608567	5613433	BnaA01T0101200ZY	0	+	0	0	4866	0.0000000
zheyou73v0_A01	5613635	5615334	BnaA01T0101300ZY	0	-	0	0	1699	0.0000000
zheyou73v0_A01	5617444	5622715	BnaA01T0101400ZY	0	+	0	0	5271	0.0000000
zheyou73v0_A01	5623849	5631083	BnaA01T0101500ZY	0	+	0	0	7234	0.0000000
zheyou73v0_A01	5623849	5631083	BnaA01T0101500ZY.1	0	+	0	0	7234	0.0000000
zheyou73v0_A01	5631457	5633028	BnaA01T0101600ZY	0	+	0	0	1571	0.0000000
zheyou73v0_A01	5633310	5634039	BnaA01T0101700ZY	0	-	0	0	729	0.0000000
zheyou73v0_A01	5634905	5637000	BnaA01T0101800ZY	0	+	0	0	2095	0.0000000
zheyou73v0_A01	5641097	5646142	BnaA01T0101900ZY	0	+	0	0	5045	0.0000000
zheyou73v0_A01	5646986	5656093	BnaA01T0102000ZY	0	+	0	0	9107	0.0000000
zheyou73v0_A01	5658669	5658934	BnaA01T0102100ZY	0	+	0	0	265	0.0000000
zheyou73v0_A01	5659590	5660319	BnaA01T0102200ZY	0	+	0	0	729	0.0000000
zheyou73v0_A01	5662233	5663025	BnaA01T0102300ZY	0	-	0	0	792	0.0000000
zheyou73v0_A01	5669324	5670907	BnaA01T0102400ZY	0	-	0	0	1583	0.0000000
zheyou73v0_A01	5669324	5670907	BnaA01T0102400ZY.1	0	-	0	0	1583	0.0000000
zheyou73v0_A01	5672566	5674044	BnaA01T0102500ZY	0	-	0	0	1478	0.0000000
zheyou73v0_A01	5679281	5680031	BnaA01T0102600ZY	0	-	0	0	750	0.0000000
zheyou73v0_A01	5686521	5688745	BnaA01T0102700ZY	0	+	0	0	2224	0.0000000
zheyou73v0_A01	5688816	5691623	BnaA01T0102800ZY	0	-	0	0	2807	0.0000000
zheyou73v0_A01	5693283	5695896	BnaA01T0102900ZY	0	-	0	0	2613	0.0000000
zheyou73v0_A01	5696885	5699917	BnaA01T0103000ZY	0	-	0	0	3032	0.0000000
zheyou73v0_A01	5696885	5699503	BnaA01T0103000ZY.1	0	-	0	0	2618	0.0000000
zheyou73v0_A01	5701795	5703321	BnaA01T0103100ZY	0	+	0	0	1526	0.0000000
zheyou73v0_A01	5714470	5715849	BnaA01T0103200ZY	0	+	0	0	1379	0.0000000
zheyou73v0_A01	5719101	5722993	BnaA01T0103300ZY	0	+	0	0	3892	0.0000000
zheyou73v0_A01	5728039	5729414	BnaA01T0103400ZY	0	+	0	0	1375	0.0000000
zheyou73v0_A01	5731831	5736096	BnaA01T0103500ZY	0	+	0	0	4265	0.0000000
zheyou73v0_A01	5744807	5746361	BnaA01T0103600ZY	0	+	0	0	1554	0.0000000
zheyou73v0_A01	5750259	5751625	BnaA01T0103700ZY	0	-	0	0	1366	0.0000000
zheyou73v0_A01	5767422	5772325	BnaA01T0103800ZY	0	+	0	0	4903	0.0000000
zheyou73v0_A01	5773729	5775878	BnaA01T0103900ZY	0	-	0	0	2149	0.0000000
zheyou73v0_A01	5785796	5787422	BnaA01T0104000ZY	0	+	0	0	1626	0.0000000
zheyou73v0_A01	5788806	5790070	BnaA01T0104100ZY	0	+	0	0	1264	0.0000000
zheyou73v0_A01	5792725	5795353	BnaA01T0104200ZY	0	-	0	0	2628	0.0000000
zheyou73v0_A01	5796689	5806604	BnaA01T0104300ZY	0	-	0	0	9915	0.0000000
zheyou73v0_A01	5807183	5809608	BnaA01T0104400ZY	0	-	0	0	2425	0.0000000
zheyou73v0_A01	5815039	5818277	BnaA01T0104500ZY	0	+	0	0	3238	0.0000000
zheyou73v0_A01	5819718	5822364	BnaA01T0104600ZY	0	+	0	0	2646	0.0000000
zheyou73v0_A01	5826232	5826781	BnaA01T0104700ZY	0	-	0	0	549	0.0000000
zheyou73v0_A01	5831345	5832999	BnaA01T0104800ZY	0	-	0	0	1654	0.0000000
zheyou73v0_A01	5831345	5832999	BnaA01T0104800ZY.1	0	-	0	0	1654	0.0000000
zheyou73v0_A01	5831345	5832999	BnaA01T0104800ZY.2	0	-	0	0	1654	0.0000000
zheyou73v0_A01	5833729	5836475	BnaA01T0104900ZY	0	+	0	0	2746	0.0000000
zheyou73v0_A01	5841465	5842086	BnaA01T0105000ZY	0	+	0	0	621	0.0000000
zheyou73v0_A01	5847510	5848396	BnaA01T0105100ZY	0	+	0	0	886	0.0000000
zheyou73v0_A01	5848487	5850004	BnaA01T0105200ZY	0	-	0	0	1517	0.0000000
zheyou73v0_A01	5851770	5854060	BnaA01T0105300ZY	0	-	0	0	2290	0.0000000
zheyou73v0_A01	5857452	5862215	BnaA01T0105400ZY	0	-	0	0	4763	0.0000000
zheyou73v0_A01	5864021	5866204	BnaA01T0105500ZY	0	-	0	0	2183	0.0000000
zheyou73v0_A01	5873240	5876209	BnaA01T0105600ZY	0	+	0	0	2969	0.0000000
zheyou73v0_A01	5879596	5884014	BnaA01T0105700ZY	0	+	0	0	4418	0.0000000
zheyou73v0_A01	5884413	5885413	BnaA01T0105800ZY	0	-	0	0	1000	0.0000000
zheyou73v0_A01	5886528	5886759	BnaA01T0105900ZY	0	-	0	0	231	0.0000000
zheyou73v0_A01	5890801	5891360	BnaA01T0106000ZY	0	-	0	0	559	0.0000000
zheyou73v0_A01	5893834	5898045	BnaA01T0106100ZY	0	+	0	0	4211	0.0000000
zheyou73v0_A01	5899932	5902661	BnaA01T0106200ZY	0	+	0	0	2729	0.0000000
zheyou73v0_A01	5904779	5905955	BnaA01T0106300ZY	0	-	0	0	1176	0.0000000
zheyou73v0_A01	5906551	5909827	BnaA01T0106400ZY	0	-	0	0	3276	0.0000000
zheyou73v0_A01	5910803	5913545	BnaA01T0106500ZY	0	-	0	0	2742	0.0000000
zheyou73v0_A01	5920777	5923568	BnaA01T0106600ZY.1	0	+	0	0	2791	0.0000000
zheyou73v0_A01	5920835	5923568	BnaA01T0106600ZY	0	+	0	0	2733	0.0000000
zheyou73v0_A01	5934174	5938817	BnaA01T0106700ZY	0	+	0	0	4643	0.0000000
zheyou73v0_A01	5940605	5945941	BnaA01T0106800ZY	0	+	0	0	5336	0.0000000
zheyou73v0_A01	5946575	5948805	BnaA01T0106900ZY	0	+	0	0	2230	0.0000000
zheyou73v0_A01	5974093	5975458	BnaA01T0107000ZY	0	-	0	0	1365	0.0000000
zheyou73v0_A01	5977799	5982407	BnaA01T0107100ZY	0	+	0	0	4608	0.0000000
zheyou73v0_A01	5977799	5982407	BnaA01T0107100ZY.1	0	+	0	0	4608	0.0000000
zheyou73v0_A01	5983016	5987238	BnaA01T0107200ZY	0	+	0	0	4222	0.0000000
zheyou73v0_A01	5987426	5988913	BnaA01T0107300ZY	0	+	0	0	1487	0.0000000
zheyou73v0_A01	5990277	5992473	BnaA01T0107400ZY	0	+	0	0	2196	0.0000000
zheyou73v0_A01	5992653	5994413	BnaA01T0107500ZY	0	-	0	0	1760	0.0000000
zheyou73v0_A01	5996233	5997736	BnaA01T0107600ZY	0	+	0	0	1503	0.0000000
zheyou73v0_A01	5998565	6003842	BnaA01T0107700ZY	0	+	0	0	5277	0.0000000
zheyou73v0_A01	5998565	6004092	BnaA01T0107700ZY.1	0	+	0	0	5527	0.0000000
zheyou73v0_A01	6004124	6006818	BnaA01T0107800ZY	0	-	0	0	2694	0.0000000
zheyou73v0_A01	6007250	6007670	BnaA01T0107900ZY	0	+	0	0	420	0.0000000
zheyou73v0_A01	6007835	6011414	BnaA01T0108000ZY	0	-	0	0	3579	0.0000000
zheyou73v0_A01	6013154	6014310	BnaA01T0108100ZY	0	-	0	0	1156	0.0000000
zheyou73v0_A01	6014936	6017810	BnaA01T0108200ZY	0	-	0	0	2874	0.0000000
zheyou73v0_A01	6014936	6017068	BnaA01T0108200ZY.1	0	-	0	0	2132	0.0000000
zheyou73v0_A01	6023223	6025873	BnaA01T0108300ZY	0	+	0	0	2650	0.0000000
zheyou73v0_A01	6032479	6033907	BnaA01T0108400ZY	0	+	0	0	1428	0.0000000
zheyou73v0_A01	6034095	6036405	BnaA01T0108500ZY	0	-	0	0	2310	0.0000000
zheyou73v0_A01	6039579	6040308	BnaA01T0108600ZY	0	-	0	0	729	0.0000000
zheyou73v0_A01	6048331	6050259	BnaA01T0108700ZY	0	-	0	0	1928	0.0000000
zheyou73v0_A01	6052928	6054512	BnaA01T0108800ZY	0	+	0	0	1584	0.0000000
zheyou73v0_A01	6062322	6064122	BnaA01T0108900ZY	0	+	0	0	1800	0.0000000
zheyou73v0_A01	6071146	6073152	BnaA01T0109000ZY	0	+	0	0	2006	0.0000000
zheyou73v0_A01	6077062	6079369	BnaA01T0109100ZY	0	+	0	0	2307	0.0000000
zheyou73v0_A01	6081893	6090440	BnaA01T0109200ZY	0	-	0	0	8547	0.0000000
zheyou73v0_A01	6094351	6096019	BnaA01T0109300ZY	0	+	0	0	1668	0.0000000
zheyou73v0_A01	6100104	6102353	BnaA01T0109400ZY	0	-	0	0	2249	0.0000000
zheyou73v0_A01	6100104	6102353	BnaA01T0109400ZY.1	0	-	0	0	2249	0.0000000
zheyou73v0_A01	6106659	6107877	BnaA01T0109500ZY	0	-	0	0	1218	0.0000000
zheyou73v0_A01	6113256	6124170	BnaA01T0109600ZY	0	-	0	0	10914	0.0000000
zheyou73v0_A01	6127814	6131206	BnaA01T0109700ZY	0	+	0	0	3392	0.0000000
zheyou73v0_A01	6131257	6131727	BnaA01T0109800ZY	0	+	0	0	470	0.0000000
zheyou73v0_A01	6134653	6135914	BnaA01T0109900ZY	0	+	0	0	1261	0.0000000
zheyou73v0_A01	6137228	6139877	BnaA01T0110000ZY	0	+	0	0	2649	0.0000000
zheyou73v0_A01	6141191	6142481	BnaA01T0110100ZY	0	+	0	0	1290	0.0000000
zheyou73v0_A01	6143578	6144924	BnaA01T0110200ZY	0	+	0	0	1346	0.0000000
zheyou73v0_A01	6147446	6148184	BnaA01T0110300ZY	0	+	0	0	738	0.0000000
zheyou73v0_A01	6152038	6152764	BnaA01T0110400ZY	0	+	0	0	726	0.0000000
zheyou73v0_A01	6158971	6159724	BnaA01T0110500ZY	0	+	0	0	753	0.0000000
zheyou73v0_A01	6162357	6163029	BnaA01T0110600ZY	0	+	0	0	672	0.0000000
zheyou73v0_A01	6177356	6180211	BnaA01T0110700ZY	0	+	0	0	2855	0.0000000
zheyou73v0_A01	6180704	6181445	BnaA01T0110800ZY	0	+	0	0	741	0.0000000
zheyou73v0_A01	6182228	6183360	BnaA01T0110900ZY	0	+	0	0	1132	0.0000000
zheyou73v0_A01	6184854	6189219	BnaA01T0111000ZY	0	+	0	0	4365	0.0000000
zheyou73v0_A01	6189315	6190961	BnaA01T0111100ZY	0	-	0	0	1646	0.0000000
zheyou73v0_A01	6192214	6193062	BnaA01T0111200ZY	0	+	0	0	848	0.0000000
zheyou73v0_A01	6193785	6195351	BnaA01T0111300ZY	0	-	0	0	1566	0.0000000
zheyou73v0_A01	6201770	6203133	BnaA01T0111400ZY	0	+	0	0	1363	0.0000000
zheyou73v0_A01	6203612	6204770	BnaA01T0111500ZY	0	-	0	0	1158	0.0000000
zheyou73v0_A01	6205841	6210879	BnaA01T0111600ZY	0	+	0	0	5038	0.0000000
zheyou73v0_A01	6211481	6213208	BnaA01T0111700ZY	0	+	0	0	1727	0.0000000
zheyou73v0_A01	6214854	6218001	BnaA01T0111800ZY	0	+	0	0	3147	0.0000000
zheyou73v0_A01	6216686	6218408	BnaA01T0111900ZY	0	-	0	0	1722	0.0000000
zheyou73v0_A01	6218744	6221922	BnaA01T0112000ZY	0	+	0	0	3178	0.0000000
zheyou73v0_A01	6221987	6223451	BnaA01T0112100ZY	0	-	0	0	1464	0.0000000
zheyou73v0_A01	6226669	6227931	BnaA01T0112200ZY	0	-	0	0	1262	0.0000000
zheyou73v0_A01	6232134	6235725	BnaA01T0112300ZY	0	-	0	0	3591	0.0000000
zheyou73v0_A01	6240462	6244740	BnaA01T0112400ZY	0	+	0	0	4278	0.0000000
zheyou73v0_A01	6248773	6250465	BnaA01T0112500ZY	0	+	0	0	1692	0.0000000
zheyou73v0_A01	6251485	6254651	BnaA01T0112600ZY	0	-	0	0	3166	0.0000000
zheyou73v0_A01	6251485	6254454	BnaA01T0112600ZY.2	0	-	0	0	2969	0.0000000
zheyou73v0_A01	6252328	6254651	BnaA01T0112600ZY.1	0	-	0	0	2323	0.0000000
zheyou73v0_A01	6252328	6254454	BnaA01T0112600ZY.3	0	-	0	0	2126	0.0000000
zheyou73v0_A01	6259207	6259743	BnaA01T0112700ZY	0	-	0	0	536	0.0000000
zheyou73v0_A01	6259797	6261697	BnaA01T0112800ZY	0	-	0	0	1900	0.0000000
zheyou73v0_A01	6263247	6264836	BnaA01T0112900ZY	0	+	0	0	1589	0.0000000
zheyou73v0_A01	6265544	6266575	BnaA01T0113000ZY	0	+	0	0	1031	0.0000000
zheyou73v0_A01	6265544	6266575	BnaA01T0113000ZY.1	0	+	0	0	1031	0.0000000
zheyou73v0_A01	6267345	6270866	BnaA01T0113100ZY	0	+	0	0	3521	0.0000000
zheyou73v0_A01	6267345	6270866	BnaA01T0113100ZY.1	0	+	0	0	3521	0.0000000
zheyou73v0_A01	6267795	6270866	BnaA01T0113200ZY.1	0	-	0	0	3071	0.0000000
zheyou73v0_A01	6269064	6270866	BnaA01T0113200ZY	0	-	0	0	1802	0.0000000
zheyou73v0_A01	6273264	6274084	BnaA01T0113300ZY	0	+	0	0	820	0.0000000
zheyou73v0_A01	6278560	6280193	BnaA01T0113400ZY	0	+	0	0	1633	0.0000000
zheyou73v0_A01	6281632	6283222	BnaA01T0113500ZY	0	-	0	0	1590	0.0000000
zheyou73v0_A01	6291343	6294271	BnaA01T0113600ZY	0	-	0	0	2928	0.0000000
zheyou73v0_A01	6296568	6299600	BnaA01T0113700ZY	0	-	0	0	3032	0.0000000
zheyou73v0_A01	6301267	6301870	BnaA01T0113800ZY	0	+	0	0	603	0.0000000
zheyou73v0_A01	6302056	6306531	BnaA01T0113900ZY	0	-	0	0	4475	0.0000000
zheyou73v0_A01	6316009	6317453	BnaA01T0114000ZY	0	-	0	0	1444	0.0000000
zheyou73v0_A01	6322913	6324011	BnaA01T0114100ZY	0	+	0	0	1098	0.0000000
zheyou73v0_A01	6326205	6328746	BnaA01T0114200ZY	0	+	0	0	2541	0.0000000
zheyou73v0_A01	6331722	6333855	BnaA01T0114300ZY	0	+	0	0	2133	0.0000000
zheyou73v0_A01	6331722	6333855	BnaA01T0114300ZY.1	0	+	0	0	2133	0.0000000
zheyou73v0_A01	6334123	6335964	BnaA01T0114400ZY	0	+	0	0	1841	0.0000000
zheyou73v0_A01	6335515	6338793	BnaA01T0114500ZY	0	-	0	0	3278	0.0000000
zheyou73v0_A01	6341434	6342394	BnaA01T0114600ZY	0	-	0	0	960	0.0000000
zheyou73v0_A01	6345853	6346051	BnaA01T0114700ZY	0	-	0	0	198	0.0000000
zheyou73v0_A01	6351970	6352757	BnaA01T0114800ZY	0	-	0	0	787	0.0000000
zheyou73v0_A01	6353147	6356149	BnaA01T0114900ZY	0	-	0	0	3002	0.0000000
zheyou73v0_A01	6356550	6361623	BnaA01T0115000ZY	0	+	0	0	5073	0.0000000
zheyou73v0_A01	6362328	6367915	BnaA01T0115100ZY	0	+	0	0	5587	0.0000000
zheyou73v0_A01	6368012	6368867	BnaA01T0115200ZY	0	-	0	0	855	0.0000000
zheyou73v0_A01	6370365	6372108	BnaA01T0115300ZY	0	-	0	0	1743	0.0000000
zheyou73v0_A01	6375350	6377622	BnaA01T0115400ZY	0	-	0	0	2272	0.0000000
zheyou73v0_A01	6379266	6381014	BnaA01T0115500ZY	0	+	0	0	1748	0.0000000
zheyou73v0_A01	6384019	6386064	BnaA01T0115600ZY	0	+	0	0	2045	0.0000000
zheyou73v0_A01	6388533	6390631	BnaA01T0115700ZY	0	+	0	0	2098	0.0000000
zheyou73v0_A01	6391854	6392962	BnaA01T0115800ZY	0	+	0	0	1108	0.0000000
zheyou73v0_A01	6398720	6402143	BnaA01T0115900ZY	0	-	0	0	3423	0.0000000
zheyou73v0_A01	6402664	6407855	BnaA01T0116000ZY	0	-	0	0	5191	0.0000000
zheyou73v0_A01	6411568	6415800	BnaA01T0116100ZY	0	+	0	0	4232	0.0000000
zheyou73v0_A01	6417265	6418937	BnaA01T0116200ZY	0	-	0	0	1672	0.0000000
zheyou73v0_A01	6432858	6435924	BnaA01T0116300ZY	0	+	0	0	3066	0.0000000
zheyou73v0_A01	6447357	6453838	BnaA01T0116400ZY	0	-	0	0	6481	0.0000000
zheyou73v0_A01	6454140	6455608	BnaA01T0116500ZY	0	+	0	0	1468	0.0000000
zheyou73v0_A01	6456306	6456871	BnaA01T0116600ZY	0	+	0	0	565	0.0000000
zheyou73v0_A01	6461092	6461896	BnaA01T0116700ZY	0	+	0	0	804	0.0000000
zheyou73v0_A01	6464222	6465441	BnaA01T0116800ZY	0	+	0	0	1219	0.0000000
zheyou73v0_A01	6494831	6497516	BnaA01T0116900ZY	0	-	0	0	2685	0.0000000
zheyou73v0_A01	6524488	6525443	BnaA01T0117000ZY	0	+	0	0	955	0.0000000
zheyou73v0_A01	6539857	6541770	BnaA01T0117100ZY	0	+	0	0	1913	0.0000000
zheyou73v0_A01	6542527	6545226	BnaA01T0117200ZY	0	+	0	0	2699	0.0000000
zheyou73v0_A01	6545938	6547562	BnaA01T0117300ZY	0	+	0	0	1624	0.0000000
zheyou73v0_A01	6547936	6549523	BnaA01T0117400ZY	0	-	0	0	1587	0.0000000
zheyou73v0_A01	6551420	6557992	BnaA01T0117500ZY	0	+	0	0	6572	0.0000000
zheyou73v0_A01	6558227	6559249	BnaA01T0117600ZY	0	-	0	0	1022	0.0000000
zheyou73v0_A01	6560029	6560722	BnaA01T0117700ZY	0	-	0	0	693	0.0000000
zheyou73v0_A01	6566554	6570984	BnaA01T0117800ZY	0	+	0	0	4430	0.0000000
zheyou73v0_A01	6571092	6572988	BnaA01T0117900ZY	0	-	0	0	1896	0.0000000
zheyou73v0_A01	6598437	6609063	BnaA01T0118000ZY	0	-	0	0	10626	0.0000000
zheyou73v0_A01	6626563	6627347	BnaA01T0118100ZY	0	+	0	0	784	0.0000000
zheyou73v0_A01	6627415	6630109	BnaA01T0118200ZY	0	+	0	0	2694	0.0000000
zheyou73v0_A01	6635482	6637753	BnaA01T0118300ZY	0	-	0	0	2271	0.0000000
zheyou73v0_A01	6642966	6643131	BnaA01T0118400ZY	0	+	0	0	165	0.0000000
zheyou73v0_A01	6643281	6643743	BnaA01T0118500ZY	0	+	0	0	462	0.0000000
zheyou73v0_A01	6649262	6650034	BnaA01T0118600ZY	0	+	0	0	772	0.0000000
zheyou73v0_A01	6650361	6652034	BnaA01T0118700ZY	0	-	0	0	1673	0.0000000
zheyou73v0_A01	6652564	6653901	BnaA01T0118800ZY	0	-	0	0	1337	0.0000000
zheyou73v0_A01	6652564	6653901	BnaA01T0118800ZY.1	0	-	0	0	1337	0.0000000
zheyou73v0_A01	6664403	6668219	BnaA01T0118900ZY	0	+	0	0	3816	0.0000000
zheyou73v0_A01	6675389	6677079	BnaA01T0119000ZY	0	+	0	0	1690	0.0000000
zheyou73v0_A01	6679280	6682527	BnaA01T0119100ZY	0	-	0	0	3247	0.0000000
zheyou73v0_A01	6685825	6688877	BnaA01T0119200ZY	0	-	0	0	3052	0.0000000
zheyou73v0_A01	6703608	6704112	BnaA01T0119300ZY	0	-	0	0	504	0.0000000
zheyou73v0_A01	6711535	6714267	BnaA01T0119400ZY	0	-	0	0	2732	0.0000000
zheyou73v0_A01	6718881	6722225	BnaA01T0119500ZY	0	-	0	0	3344	0.0000000
zheyou73v0_A01	6733703	6737646	BnaA01T0119600ZY	0	+	0	0	3943	0.0000000
zheyou73v0_A01	6737918	6740484	BnaA01T0119700ZY	0	-	0	0	2566	0.0000000
zheyou73v0_A01	6741928	6743510	BnaA01T0119800ZY	0	-	0	0	1582	0.0000000
zheyou73v0_A01	6743837	6744748	BnaA01T0119900ZY	0	+	0	0	911	0.0000000
zheyou73v0_A01	6745591	6746506	BnaA01T0120000ZY	0	-	0	0	915	0.0000000
zheyou73v0_A01	6758808	6760078	BnaA01T0120100ZY	0	-	0	0	1270	0.0000000
zheyou73v0_A01	6764820	6771546	BnaA01T0120200ZY	0	-	0	0	6726	0.0000000
zheyou73v0_A01	6776370	6776874	BnaA01T0120300ZY	0	-	0	0	504	0.0000000
zheyou73v0_A01	6798369	6798995	BnaA01T0120400ZY	0	+	0	0	626	0.0000000
zheyou73v0_A01	6808254	6809056	BnaA01T0120500ZY	0	-	0	0	802	0.0000000
zheyou73v0_A01	6812112	6813160	BnaA01T0120600ZY	0	-	0	0	1048	0.0000000
zheyou73v0_A01	6814141	6814768	BnaA01T0120700ZY	0	-	0	0	627	0.0000000
zheyou73v0_A01	6815469	6817253	BnaA01T0120800ZY	0	-	0	0	1784	0.0000000
zheyou73v0_A01	6818754	6821393	BnaA01T0120900ZY	0	+	0	0	2639	0.0000000
zheyou73v0_A01	6821898	6823808	BnaA01T0121000ZY	0	-	0	0	1910	0.0000000
zheyou73v0_A01	6821898	6823808	BnaA01T0121000ZY.1	0	-	0	0	1910	0.0000000
zheyou73v0_A01	6829062	6829608	BnaA01T0121100ZY	0	-	0	0	546	0.0000000
zheyou73v0_A01	6830699	6832008	BnaA01T0121200ZY	0	+	0	0	1309	0.0000000
zheyou73v0_A01	6835619	6837132	BnaA01T0121300ZY	0	+	0	0	1513	0.0000000
zheyou73v0_A01	6837375	6839093	BnaA01T0121400ZY	0	-	0	0	1718	0.0000000
zheyou73v0_A01	6842239	6843992	BnaA01T0121500ZY.1	0	+	0	0	1753	0.0000000
zheyou73v0_A01	6842968	6843992	BnaA01T0121500ZY	0	+	0	0	1024	0.0000000
zheyou73v0_A01	6843644	6846869	BnaA01T0121600ZY	0	-	0	0	3225	0.0000000
zheyou73v0_A01	6843644	6846869	BnaA01T0121600ZY.1	0	-	0	0	3225	0.0000000
zheyou73v0_A01	6843644	6846869	BnaA01T0121600ZY.2	0	-	0	0	3225	0.0000000
zheyou73v0_A01	6848312	6850208	BnaA01T0121700ZY	0	-	0	0	1896	0.0000000
zheyou73v0_A01	6852325	6853290	BnaA01T0121800ZY	0	-	0	0	965	0.0000000
zheyou73v0_A01	6853816	6855786	BnaA01T0121900ZY	0	+	0	0	1970	0.0000000
zheyou73v0_A01	6856003	6857254	BnaA01T0122000ZY	0	-	0	0	1251	0.0000000
zheyou73v0_A01	6857316	6858295	BnaA01T0122100ZY	0	-	0	0	979	0.0000000
zheyou73v0_A01	6858505	6860117	BnaA01T0122200ZY	0	+	0	0	1612	0.0000000
zheyou73v0_A01	6860137	6860340	BnaA01T0122300ZY	0	+	0	0	203	0.0000000
zheyou73v0_A01	6862457	6865774	BnaA01T0122400ZY	0	-	0	0	3317	0.0000000
zheyou73v0_A01	6869512	6870456	BnaA01T0122500ZY	0	+	0	0	944	0.0000000
zheyou73v0_A01	6872186	6872378	BnaA01T0122600ZY	0	+	0	0	192	0.0000000
zheyou73v0_A01	6872921	6873824	BnaA01T0122700ZY	0	-	0	0	903	0.0000000
zheyou73v0_A01	6874289	6875824	BnaA01T0122800ZY	0	+	0	0	1535	0.0000000
zheyou73v0_A01	6879787	6880132	BnaA01T0122900ZY	0	+	0	0	345	0.0000000
zheyou73v0_A01	6881809	6883212	BnaA01T0123000ZY	0	-	0	0	1403	0.0000000
zheyou73v0_A01	6883506	6888346	BnaA01T0123100ZY	0	-	0	0	4840	0.0000000
zheyou73v0_A01	6883506	6888271	BnaA01T0123100ZY.1	0	-	0	0	4765	0.0000000
zheyou73v0_A01	6903205	6904280	BnaA01T0123200ZY	0	-	0	0	1075	0.0000000
zheyou73v0_A01	6911532	6913243	BnaA01T0123300ZY	0	-	0	0	1711	0.0000000
zheyou73v0_A01	6914085	6917273	BnaA01T0123400ZY	0	-	0	0	3188	0.0000000
zheyou73v0_A01	6914085	6916572	BnaA01T0123400ZY.1	0	-	0	0	2487	0.0000000
zheyou73v0_A01	6923749	6925230	BnaA01T0123500ZY	0	+	0	0	1481	0.0000000
zheyou73v0_A01	6926399	6936655	BnaA01T0123600ZY	0	+	0	0	10256	0.0000000
zheyou73v0_A01	6937681	6938506	BnaA01T0123700ZY	0	-	0	0	825	0.0000000
zheyou73v0_A01	6945211	6946322	BnaA01T0123800ZY	0	+	0	0	1111	0.0000000
zheyou73v0_A01	6954719	6955741	BnaA01T0123900ZY	0	+	0	0	1022	0.0000000
zheyou73v0_A01	6957241	6959655	BnaA01T0124000ZY	0	+	0	0	2414	0.0000000
zheyou73v0_A01	6961199	6963238	BnaA01T0124100ZY	0	-	0	0	2039	0.0000000
zheyou73v0_A01	6966314	6967592	BnaA01T0124200ZY	0	-	0	0	1278	0.0000000
zheyou73v0_A01	6981719	6983294	BnaA01T0124300ZY	0	+	0	0	1575	0.0000000
zheyou73v0_A01	6985180	6987738	BnaA01T0124400ZY	0	+	0	0	2558	0.0000000
zheyou73v0_A01	6990214	6993070	BnaA01T0124500ZY	0	+	0	0	2856	0.0000000
zheyou73v0_A01	6990214	6993070	BnaA01T0124500ZY.1	0	+	0	0	2856	0.0000000
zheyou73v0_A01	6994445	6996257	BnaA01T0124600ZY	0	-	0	0	1812	0.0000000
zheyou73v0_A01	6997304	7003666	BnaA01T0124700ZY	0	+	0	0	6362	0.0000000
zheyou73v0_A01	7004308	7019565	BnaA01T0124800ZY	0	-	0	0	15257	0.0000000
zheyou73v0_A01	7020086	7021601	BnaA01T0124900ZY	0	-	0	0	1515	0.0000000
zheyou73v0_A01	7028932	7030991	BnaA01T0125000ZY	0	-	0	0	2059	0.0000000
zheyou73v0_A01	7037630	7039201	BnaA01T0125100ZY	0	+	0	0	1571	0.0000000
zheyou73v0_A01	7037630	7039201	BnaA01T0125100ZY.1	0	+	0	0	1571	0.0000000
zheyou73v0_A01	7039672	7041615	BnaA01T0125200ZY	0	+	0	0	1943	0.0000000
zheyou73v0_A01	7041744	7043201	BnaA01T0125300ZY	0	-	0	0	1457	0.0000000
zheyou73v0_A01	7047117	7049097	BnaA01T0125400ZY	0	-	0	0	1980	0.0000000
zheyou73v0_A01	7050076	7053118	BnaA01T0125500ZY	0	-	0	0	3042	0.0000000
zheyou73v0_A01	7061868	7063689	BnaA01T0125600ZY	0	-	0	0	1821	0.0000000
zheyou73v0_A01	7073405	7074563	BnaA01T0125700ZY	0	+	0	0	1158	0.0000000
zheyou73v0_A01	7078298	7079584	BnaA01T0125800ZY	0	-	0	0	1286	0.0000000
zheyou73v0_A01	7080681	7086623	BnaA01T0125900ZY	0	+	0	0	5942	0.0000000
zheyou73v0_A01	7087020	7088732	BnaA01T0126000ZY	0	-	0	0	1712	0.0000000
zheyou73v0_A01	7090391	7092012	BnaA01T0126100ZY	0	+	0	0	1621	0.0000000
zheyou73v0_A01	7093352	7093900	BnaA01T0126200ZY	0	+	0	0	548	0.0000000
zheyou73v0_A01	7095125	7098247	BnaA01T0126300ZY	0	+	0	0	3122	0.0000000
zheyou73v0_A01	7098085	7102577	BnaA01T0126400ZY	0	-	0	0	4492	0.0000000
zheyou73v0_A01	7123481	7133777	BnaA01T0126500ZY	0	+	0	0	10296	0.0000000
zheyou73v0_A01	7133880	7135874	BnaA01T0126600ZY	0	-	0	0	1994	0.0000000
zheyou73v0_A01	7137929	7141638	BnaA01T0126700ZY	0	-	0	0	3709	0.0000000
zheyou73v0_A01	7143533	7144438	BnaA01T0126800ZY	0	-	0	0	905	0.0000000
zheyou73v0_A01	7145694	7149396	BnaA01T0126900ZY	0	+	0	0	3702	0.0000000
zheyou73v0_A01	7149882	7160231	BnaA01T0127000ZY	0	-	0	0	10349	0.0000000
zheyou73v0_A01	7164957	7168021	BnaA01T0127100ZY	0	-	0	0	3064	0.0000000
zheyou73v0_A01	7166313	7168021	BnaA01T0127100ZY.1	0	-	0	0	1708	0.0000000
zheyou73v0_A01	7186962	7187825	BnaA01T0127200ZY	0	-	0	0	863	0.0000000
zheyou73v0_A01	7188657	7190074	BnaA01T0127300ZY	0	-	0	0	1417	0.0000000
zheyou73v0_A01	7191174	7193152	BnaA01T0127400ZY	0	-	0	0	1978	0.0000000
zheyou73v0_A01	7195209	7199315	BnaA01T0127500ZY	0	-	0	0	4106	0.0000000
zheyou73v0_A01	7201665	7201981	BnaA01T0127600ZY	0	+	0	0	316	0.0000000
zheyou73v0_A01	7203891	7206525	BnaA01T0127700ZY	0	-	0	0	2634	0.0000000
zheyou73v0_A01	7205065	7206704	BnaA01T0127700ZY.1	0	-	0	0	1639	0.0000000
zheyou73v0_A01	7210655	7212817	BnaA01T0127800ZY	0	-	0	0	2162	0.0000000
zheyou73v0_A01	7226187	7227859	BnaA01T0127900ZY	0	+	0	0	1672	0.0000000
zheyou73v0_A01	7233257	7233428	BnaA01T0128000ZY	0	-	0	0	171	0.0000000
zheyou73v0_A01	7241252	7241917	BnaA01T0128100ZY	0	+	0	0	665	0.0000000
zheyou73v0_A01	7246518	7249846	BnaA01T0128200ZY	0	+	0	0	3328	0.0000000
zheyou73v0_A01	7249945	7251358	BnaA01T0128300ZY	0	-	0	0	1413	0.0000000
zheyou73v0_A01	7256326	7257981	BnaA01T0128400ZY	0	+	0	0	1655	0.0000000
zheyou73v0_A01	7259286	7264073	BnaA01T0128500ZY	0	-	0	0	4787	0.0000000
zheyou73v0_A01	7259286	7262246	BnaA01T0128500ZY.1	0	-	0	0	2960	0.0000000
zheyou73v0_A01	7282102	7282303	BnaA01T0128600ZY	0	-	0	0	201	0.0000000
zheyou73v0_A01	7292654	7311952	BnaA01T0128700ZY	0	-	0	0	19298	0.0000000
zheyou73v0_A01	7365083	7366247	BnaA01T0128800ZY	0	+	0	0	1164	0.0000000
zheyou73v0_A01	7365083	7366247	BnaA01T0128800ZY.1	0	+	0	0	1164	0.0000000
zheyou73v0_A01	7366436	7368673	BnaA01T0128900ZY	0	-	0	0	2237	0.0000000
zheyou73v0_A01	7369841	7375897	BnaA01T0129000ZY	0	-	0	0	6056	0.0000000
zheyou73v0_A01	7378747	7380199	BnaA01T0129100ZY	0	+	0	0	1452	0.0000000
zheyou73v0_A01	7381958	7384440	BnaA01T0129200ZY	0	+	0	0	2482	0.0000000
zheyou73v0_A01	7389724	7393158	BnaA01T0129300ZY	0	+	0	0	3434	0.0000000
zheyou73v0_A01	7393163	7395022	BnaA01T0129400ZY	0	-	0	0	1859	0.0000000
zheyou73v0_A01	7393163	7395022	BnaA01T0129400ZY.1	0	-	0	0	1859	0.0000000
zheyou73v0_A01	7393163	7395022	BnaA01T0129400ZY.2	0	-	0	0	1859	0.0000000
zheyou73v0_A01	7404079	7406491	BnaA01T0129500ZY	0	+	0	0	2412	0.0000000
zheyou73v0_A01	7419919	7421700	BnaA01T0129600ZY	0	+	0	0	1781	0.0000000
zheyou73v0_A01	7422264	7424644	BnaA01T0129700ZY	0	-	0	0	2380	0.0000000
zheyou73v0_A01	7430054	7431525	BnaA01T0129800ZY	0	-	0	0	1471	0.0000000
zheyou73v0_A01	7431988	7432756	BnaA01T0129900ZY	0	-	0	0	768	0.0000000
zheyou73v0_A01	7443746	7446970	BnaA01T0130000ZY	0	+	0	0	3224	0.0000000
zheyou73v0_A01	7451931	7453156	BnaA01T0130100ZY	0	-	0	0	1225	0.0000000
zheyou73v0_A01	7458530	7466632	BnaA01T0130200ZY	0	-	0	0	8102	0.0000000
zheyou73v0_A01	7469555	7470620	BnaA01T0130300ZY	0	-	0	0	1065	0.0000000
zheyou73v0_A01	7477953	7479278	BnaA01T0130400ZY	0	+	0	0	1325	0.0000000
zheyou73v0_A01	7487821	7493212	BnaA01T0130500ZY	0	-	0	0	5391	0.0000000
zheyou73v0_A01	7498076	7499497	BnaA01T0130600ZY	0	-	0	0	1421	0.0000000
zheyou73v0_A01	7504933	7506574	BnaA01T0130700ZY	0	-	0	0	1641	0.0000000
zheyou73v0_A01	7512722	7513898	BnaA01T0130800ZY	0	+	0	0	1176	0.0000000
zheyou73v0_A01	7514058	7519364	BnaA01T0130900ZY	0	-	0	0	5306	0.0000000
zheyou73v0_A01	7539203	7539620	BnaA01T0131000ZY	0	+	0	0	417	0.0000000
zheyou73v0_A01	7548028	7549376	BnaA01T0131100ZY	0	+	0	0	1348	0.0000000
zheyou73v0_A01	7551911	7554599	BnaA01T0131200ZY	0	-	0	0	2688	0.0000000
zheyou73v0_A01	7557835	7558704	BnaA01T0131300ZY	0	+	0	0	869	0.0000000
zheyou73v0_A01	7569596	7580536	BnaA01T0131400ZY	0	+	0	0	10940	0.0000000
zheyou73v0_A01	7582907	7583755	BnaA01T0131500ZY	0	-	0	0	848	0.0000000
zheyou73v0_A01	7591796	7595928	BnaA01T0131600ZY	0	+	0	0	4132	0.0000000
zheyou73v0_A01	7595074	7597530	BnaA01T0131700ZY	0	-	0	0	2456	0.0000000
zheyou73v0_A01	7601542	7602766	BnaA01T0131800ZY	0	+	0	0	1224	0.0000000
zheyou73v0_A01	7603476	7607258	BnaA01T0131900ZY	0	-	0	0	3782	0.0000000
zheyou73v0_A01	7608233	7610606	BnaA01T0132000ZY	0	-	0	0	2373	0.0000000
zheyou73v0_A01	7611083	7613657	BnaA01T0132100ZY	0	-	0	0	2574	0.0000000
zheyou73v0_A01	7611083	7613657	BnaA01T0132100ZY.1	0	-	0	0	2574	0.0000000
zheyou73v0_A01	7621750	7622940	BnaA01T0132200ZY	0	-	0	0	1190	0.0000000
zheyou73v0_A01	7627828	7628300	BnaA01T0132300ZY	0	+	0	0	472	0.0000000
zheyou73v0_A01	7637454	7638032	BnaA01T0132400ZY	0	-	0	0	578	0.0000000
zheyou73v0_A01	7647982	7650161	BnaA01T0132500ZY	0	-	0	0	2179	0.0000000
zheyou73v0_A01	7659087	7660534	BnaA01T0132600ZY	0	+	0	0	1447	0.0000000
zheyou73v0_A01	7681624	7684399	BnaA01T0132700ZY	0	+	0	0	2775	0.0000000
zheyou73v0_A01	7681624	7684399	BnaA01T0132700ZY.1	0	+	0	0	2775	0.0000000
zheyou73v0_A01	7681624	7684399	BnaA01T0132700ZY.2	0	+	0	0	2775	0.0000000
zheyou73v0_A01	7685802	7688307	BnaA01T0132800ZY	0	+	0	0	2505	0.0000000
zheyou73v0_A01	7690294	7690776	BnaA01T0132900ZY	0	-	0	0	482	0.0000000
zheyou73v0_A01	7699847	7700843	BnaA01T0133000ZY	0	+	0	0	996	0.0000000
zheyou73v0_A01	7708325	7710431	BnaA01T0133100ZY	0	+	0	0	2106	0.0000000
zheyou73v0_A01	7710575	7711701	BnaA01T0133200ZY	0	-	0	0	1126	0.0000000
zheyou73v0_A01	7715834	7716419	BnaA01T0133300ZY	0	-	0	0	585	0.0000000
zheyou73v0_A01	7717938	7720983	BnaA01T0133400ZY	0	-	0	0	3045	0.0000000
zheyou73v0_A01	7722234	7726442	BnaA01T0133500ZY	0	-	0	0	4208	0.0000000
zheyou73v0_A01	7728186	7731965	BnaA01T0133600ZY	0	-	0	0	3779	0.0000000
zheyou73v0_A01	7734456	7736817	BnaA01T0133700ZY	0	+	0	0	2361	0.0000000
zheyou73v0_A01	7739191	7739545	BnaA01T0133800ZY	0	+	0	0	354	0.0000000
zheyou73v0_A01	7740682	7741517	BnaA01T0133900ZY	0	-	0	0	835	0.0000000
zheyou73v0_A01	7743682	7745592	BnaA01T0134000ZY	0	+	0	0	1910	0.0000000
zheyou73v0_A01	7744883	7745603	BnaA01T0134100ZY	0	-	0	0	720	0.0000000
zheyou73v0_A01	7747956	7749588	BnaA01T0134200ZY	0	+	0	0	1632	0.0000000
zheyou73v0_A01	7749674	7752353	BnaA01T0134300ZY	0	+	0	0	2679	0.0000000
zheyou73v0_A01	7754771	7758400	BnaA01T0134400ZY	0	+	0	0	3629	0.0000000
zheyou73v0_A01	7757762	7758368	BnaA01T0134500ZY	0	-	0	0	606	0.0000000
zheyou73v0_A01	7759147	7763815	BnaA01T0134600ZY	0	+	0	0	4668	0.0000000
zheyou73v0_A01	7764044	7766465	BnaA01T0134700ZY	0	+	0	0	2421	0.0000000
zheyou73v0_A01	7776236	7776485	BnaA01T0134800ZY	0	+	0	0	249	0.0000000
zheyou73v0_A01	7776571	7776880	BnaA01T0134900ZY	0	+	0	0	309	0.0000000
zheyou73v0_A01	7777000	7777396	BnaA01T0135000ZY	0	+	0	0	396	0.0000000
zheyou73v0_A01	7781749	7789103	BnaA01T0135100ZY	0	+	0	0	7354	0.0000000
zheyou73v0_A01	7790043	7793075	BnaA01T0135200ZY	0	+	0	0	3032	0.0000000
zheyou73v0_A01	7793130	7794446	BnaA01T0135300ZY	0	-	0	0	1316	0.0000000
zheyou73v0_A01	7817219	7821207	BnaA01T0135400ZY	0	+	0	0	3988	0.0000000
zheyou73v0_A01	7821873	7822433	BnaA01T0135500ZY	0	+	0	0	560	0.0000000
zheyou73v0_A01	7824307	7827237	BnaA01T0135600ZY	0	+	0	0	2930	0.0000000
zheyou73v0_A01	7834171	7836741	BnaA01T0135700ZY	0	+	0	0	2570	0.0000000
zheyou73v0_A01	7844895	7846797	BnaA01T0135800ZY	0	+	0	0	1902	0.0000000
zheyou73v0_A01	7864908	7866229	BnaA01T0135900ZY	0	-	0	0	1321	0.0000000
zheyou73v0_A01	7867778	7872243	BnaA01T0136000ZY	0	+	0	0	4465	0.0000000
zheyou73v0_A01	7874503	7876214	BnaA01T0136100ZY	0	+	0	0	1711	0.0000000
zheyou73v0_A01	7874503	7876214	BnaA01T0136100ZY.1	0	+	0	0	1711	0.0000000
zheyou73v0_A01	7876616	7881175	BnaA01T0136200ZY	0	+	0	0	4559	0.0000000
zheyou73v0_A01	7881808	7882552	BnaA01T0136300ZY	0	-	0	0	744	0.0000000
zheyou73v0_A01	7888244	7890945	BnaA01T0136400ZY	0	+	0	0	2701	0.0000000
zheyou73v0_A01	7898833	7899586	BnaA01T0136500ZY	0	+	0	0	753	0.0000000
zheyou73v0_A01	7906357	7910264	BnaA01T0136600ZY	0	-	0	0	3907	0.0000000
zheyou73v0_A01	7907726	7910264	BnaA01T0136600ZY.1	0	-	0	0	2538	0.0000000
zheyou73v0_A01	7917887	7919625	BnaA01T0136700ZY	0	+	0	0	1738	0.0000000
zheyou73v0_A01	7920830	7924348	BnaA01T0136800ZY	0	+	0	0	3518	0.0000000
zheyou73v0_A01	7925253	7928711	BnaA01T0136900ZY	0	+	0	0	3458	0.0000000
zheyou73v0_A01	7936632	7938481	BnaA01T0137000ZY	0	+	0	0	1849	0.0000000
zheyou73v0_A01	7938788	7940113	BnaA01T0137100ZY	0	-	0	0	1325	0.0000000
zheyou73v0_A01	7940566	7944547	BnaA01T0137200ZY	0	-	0	0	3981	0.0000000
zheyou73v0_A01	7946980	7947550	BnaA01T0137300ZY	0	-	0	0	570	0.0000000
zheyou73v0_A01	7948884	7949710	BnaA01T0137400ZY	0	+	0	0	826	0.0000000
zheyou73v0_A01	7950242	7951797	BnaA01T0137500ZY	0	+	0	0	1555	0.0000000
zheyou73v0_A01	7952068	7954148	BnaA01T0137600ZY	0	-	0	0	2080	0.0000000
zheyou73v0_A01	7952068	7954026	BnaA01T0137600ZY.1	0	-	0	0	1958	0.0000000
zheyou73v0_A01	7954772	7956618	BnaA01T0137700ZY	0	+	0	0	1846	0.0000000
zheyou73v0_A01	7956886	7967074	BnaA01T0137800ZY	0	-	0	0	10188	0.0000000
zheyou73v0_A01	7967346	7977060	BnaA01T0137900ZY	0	-	0	0	9714	0.0000000
zheyou73v0_A01	7992457	7993086	BnaA01T0138000ZY	0	+	0	0	629	0.0000000
zheyou73v0_A01	8004719	8007812	BnaA01T0138100ZY	0	+	0	0	3093	0.0000000
zheyou73v0_A01	8009477	8010260	BnaA01T0138200ZY	0	+	0	0	783	0.0000000
zheyou73v0_A01	8010326	8011803	BnaA01T0138300ZY	0	-	0	0	1477	0.0000000
zheyou73v0_A01	8012165	8014709	BnaA01T0138400ZY	0	-	0	0	2544	0.0000000
zheyou73v0_A01	8020863	8023147	BnaA01T0138500ZY	0	+	0	0	2284	0.0000000
zheyou73v0_A01	8023850	8026796	BnaA01T0138600ZY	0	+	0	0	2946	0.0000000
zheyou73v0_A01	8026269	8026785	BnaA01T0138700ZY	0	-	0	0	516	0.0000000
zheyou73v0_A01	8027237	8028282	BnaA01T0138800ZY	0	+	0	0	1045	0.0000000
zheyou73v0_A01	8028536	8030989	BnaA01T0138900ZY	0	-	0	0	2453	0.0000000
zheyou73v0_A01	8032700	8036075	BnaA01T0139000ZY	0	+	0	0	3375	0.0000000
zheyou73v0_A01	8032700	8036075	BnaA01T0139000ZY.1	0	+	0	0	3375	0.0000000
zheyou73v0_A01	8049920	8053254	BnaA01T0139100ZY	0	+	0	0	3334	0.0000000
zheyou73v0_A01	8056693	8065639	BnaA01T0139200ZY	0	+	0	0	8946	0.0000000
zheyou73v0_A01	8066514	8068983	BnaA01T0139300ZY	0	+	0	0	2469	0.0000000
zheyou73v0_A01	8070099	8072385	BnaA01T0139400ZY	0	+	0	0	2286	0.0000000
zheyou73v0_A01	8072120	8077471	BnaA01T0139500ZY	0	-	0	0	5351	0.0000000
zheyou73v0_A01	8077734	8082456	BnaA01T0139600ZY	0	+	0	0	4722	0.0000000
zheyou73v0_A01	8077734	8082456	BnaA01T0139600ZY.1	0	+	0	0	4722	0.0000000
zheyou73v0_A01	8082676	8085975	BnaA01T0139700ZY	0	-	0	0	3299	0.0000000
zheyou73v0_A01	8082676	8085975	BnaA01T0139700ZY.1	0	-	0	0	3299	0.0000000
zheyou73v0_A01	8087418	8088947	BnaA01T0139800ZY	0	+	0	0	1529	0.0000000
zheyou73v0_A01	8089654	8092171	BnaA01T0139900ZY	0	+	0	0	2517	0.0000000
zheyou73v0_A01	8092920	8097159	BnaA01T0140000ZY	0	+	0	0	4239	0.0000000
zheyou73v0_A01	8097460	8101490	BnaA01T0140100ZY	0	-	0	0	4030	0.0000000
zheyou73v0_A01	8102008	8107871	BnaA01T0140200ZY	0	-	0	0	5863	0.0000000
zheyou73v0_A01	8115396	8118888	BnaA01T0140300ZY	0	+	0	0	3492	0.0000000
zheyou73v0_A01	8118967	8123657	BnaA01T0140400ZY	0	-	0	0	4690	0.0000000
zheyou73v0_A01	8125058	8132834	BnaA01T0140500ZY	0	-	0	0	7776	0.0000000
zheyou73v0_A01	8125272	8126220	BnaA01T0140600ZY	0	+	0	0	948	0.0000000
zheyou73v0_A01	8137454	8138839	BnaA01T0140700ZY	0	+	0	0	1385	0.0000000
zheyou73v0_A01	8137454	8138839	BnaA01T0140700ZY.1	0	+	0	0	1385	0.0000000
zheyou73v0_A01	8141416	8148668	BnaA01T0140800ZY	0	-	0	0	7252	0.0000000
zheyou73v0_A01	8149227	8152698	BnaA01T0140900ZY	0	-	0	0	3471	0.0000000
zheyou73v0_A01	8156525	8159048	BnaA01T0141000ZY	0	+	0	0	2523	0.0000000
zheyou73v0_A01	8161835	8163050	BnaA01T0141100ZY	0	+	0	0	1215	0.0000000
zheyou73v0_A01	8165273	8166450	BnaA01T0141200ZY	0	-	0	0	1177	0.0000000
zheyou73v0_A01	8171308	8174385	BnaA01T0141300ZY	0	-	0	0	3077	0.0000000
zheyou73v0_A01	8175686	8182272	BnaA01T0141400ZY	0	+	0	0	6586	0.0000000
zheyou73v0_A01	8175686	8182272	BnaA01T0141400ZY.1	0	+	0	0	6586	0.0000000
zheyou73v0_A01	8188363	8191753	BnaA01T0141500ZY	0	+	0	0	3390	0.0000000
zheyou73v0_A01	8191867	8201701	BnaA01T0141600ZY	0	-	0	0	9834	0.0000000
zheyou73v0_A01	8198498	8201701	BnaA01T0141600ZY.1	0	-	0	0	3203	0.0000000
zheyou73v0_A01	8202565	8205401	BnaA01T0141700ZY	0	-	0	0	2836	0.0000000
zheyou73v0_A01	8205465	8213013	BnaA01T0141800ZY	0	-	0	0	7548	0.0000000
zheyou73v0_A01	8216056	8218221	BnaA01T0141900ZY	0	-	0	0	2165	0.0000000
zheyou73v0_A01	8216056	8218221	BnaA01T0141900ZY.1	0	-	0	0	2165	0.0000000
zheyou73v0_A01	8222400	8224367	BnaA01T0142000ZY	0	-	0	0	1967	0.0000000
zheyou73v0_A01	8226916	8228800	BnaA01T0142100ZY	0	-	0	0	1884	0.0000000
zheyou73v0_A01	8233276	8236154	BnaA01T0142200ZY	0	+	0	0	2878	0.0000000
zheyou73v0_A01	8236876	8239771	BnaA01T0142300ZY	0	+	0	0	2895	0.0000000
zheyou73v0_A01	8236876	8239576	BnaA01T0142300ZY.1	0	+	0	0	2700	0.0000000
zheyou73v0_A01	8239893	8240622	BnaA01T0142400ZY	0	+	0	0	729	0.0000000
zheyou73v0_A01	8242218	8243632	BnaA01T0142500ZY	0	-	0	0	1414	0.0000000
zheyou73v0_A01	8244119	8246562	BnaA01T0142600ZY	0	-	0	0	2443	0.0000000
zheyou73v0_A01	8246877	8251203	BnaA01T0142700ZY	0	-	0	0	4326	0.0000000
zheyou73v0_A01	8251737	8251905	BnaA01T0142800ZY	0	-	0	0	168	0.0000000
zheyou73v0_A01	8251971	8252350	BnaA01T0142900ZY	0	-	0	0	379	0.0000000
zheyou73v0_A01	8254432	8257275	BnaA01T0143000ZY	0	+	0	0	2843	0.0000000
zheyou73v0_A01	8257842	8261037	BnaA01T0143100ZY	0	-	0	0	3195	0.0000000
zheyou73v0_A01	8262853	8265661	BnaA01T0143200ZY	0	+	0	0	2808	0.0000000
zheyou73v0_A01	8265111	8266074	BnaA01T0143300ZY	0	-	0	0	963	0.0000000
zheyou73v0_A01	8266966	8267736	BnaA01T0143400ZY	0	-	0	0	770	0.0000000
zheyou73v0_A01	8272834	8273807	BnaA01T0143500ZY	0	-	0	0	973	0.0000000
zheyou73v0_A01	8275071	8277570	BnaA01T0143600ZY	0	+	0	0	2499	0.0000000
zheyou73v0_A01	8275071	8277570	BnaA01T0143600ZY.2	0	+	0	0	2499	0.0000000
zheyou73v0_A01	8275133	8277570	BnaA01T0143600ZY.1	0	+	0	0	2437	0.0000000
zheyou73v0_A01	8277708	8280238	BnaA01T0143700ZY	0	+	0	0	2530	0.0000000
zheyou73v0_A01	8281226	8281752	BnaA01T0143800ZY	0	+	0	0	526	0.0000000
zheyou73v0_A01	8285618	8289995	BnaA01T0143900ZY	0	+	0	0	4377	0.0000000
zheyou73v0_A01	8291818	8293635	BnaA01T0144000ZY	0	+	0	0	1817	0.0000000
zheyou73v0_A01	8291818	8293635	BnaA01T0144000ZY.1	0	+	0	0	1817	0.0000000
zheyou73v0_A01	8294469	8296107	BnaA01T0144100ZY	0	-	0	0	1638	0.0000000
zheyou73v0_A01	8294469	8296107	BnaA01T0144100ZY.1	0	-	0	0	1638	0.0000000
zheyou73v0_A01	8298712	8300386	BnaA01T0144200ZY	0	-	0	0	1674	0.0000000
zheyou73v0_A01	8299397	8300386	BnaA01T0144200ZY.1	0	-	0	0	989	0.0000000
zheyou73v0_A01	8305689	8306041	BnaA01T0144300ZY	0	-	0	0	352	0.0000000
zheyou73v0_A01	8306665	8308517	BnaA01T0144400ZY	0	+	0	0	1852	0.0000000
zheyou73v0_A01	8324491	8326004	BnaA01T0144500ZY	0	+	0	0	1513	0.0000000
zheyou73v0_A01	8326513	8327494	BnaA01T0144600ZY	0	+	0	0	981	0.0000000
zheyou73v0_A01	8328320	8331936	BnaA01T0144700ZY	0	+	0	0	3616	0.0000000
zheyou73v0_A01	8332281	8333560	BnaA01T0144800ZY	0	+	0	0	1279	0.0000000
zheyou73v0_A01	8333566	8335527	BnaA01T0144900ZY	0	-	0	0	1961	0.0000000
zheyou73v0_A01	8333566	8334965	BnaA01T0144900ZY.1	0	-	0	0	1399	0.0000000
zheyou73v0_A01	8335799	8337215	BnaA01T0145000ZY	0	-	0	0	1416	0.0000000
zheyou73v0_A01	8338095	8340418	BnaA01T0145100ZY	0	-	0	0	2323	0.0000000
zheyou73v0_A01	8342978	8345556	BnaA01T0145200ZY	0	-	0	0	2578	0.0000000
zheyou73v0_A01	8347986	8350915	BnaA01T0145300ZY	0	-	0	0	2929	0.0000000
zheyou73v0_A01	8351317	8352168	BnaA01T0145400ZY	0	+	0	0	851	0.0000000
zheyou73v0_A01	8352598	8354144	BnaA01T0145500ZY	0	-	0	0	1546	0.0000000
zheyou73v0_A01	8354369	8357883	BnaA01T0145600ZY	0	-	0	0	3514	0.0000000
zheyou73v0_A01	8361492	8363933	BnaA01T0145700ZY	0	+	0	0	2441	0.0000000
zheyou73v0_A01	8379878	8382087	BnaA01T0145800ZY	0	+	0	0	2209	0.0000000
zheyou73v0_A01	8384284	8385926	BnaA01T0145900ZY	0	-	0	0	1642	0.0000000
zheyou73v0_A01	8384284	8385926	BnaA01T0145900ZY.1	0	-	0	0	1642	0.0000000
zheyou73v0_A01	8388117	8390464	BnaA01T0146000ZY	0	-	0	0	2347	0.0000000
zheyou73v0_A01	8394271	8395469	BnaA01T0146100ZY	0	-	0	0	1198	0.0000000
zheyou73v0_A01	8395603	8395852	BnaA01T0146200ZY	0	-	0	0	249	0.0000000
zheyou73v0_A01	8396858	8397577	BnaA01T0146300ZY	0	+	0	0	719	0.0000000
zheyou73v0_A01	8399513	8400741	BnaA01T0146400ZY	0	+	0	0	1228	0.0000000
zheyou73v0_A01	8402419	8404414	BnaA01T0146500ZY	0	+	0	0	1995	0.0000000
zheyou73v0_A01	8404560	8404836	BnaA01T0146600ZY	0	-	0	0	276	0.0000000
zheyou73v0_A01	8405703	8416392	BnaA01T0146700ZY	0	+	0	0	10689	0.0000000
zheyou73v0_A01	8405703	8416392	BnaA01T0146700ZY.1	0	+	0	0	10689	0.0000000
zheyou73v0_A01	8407424	8416392	BnaA01T0146700ZY.2	0	+	0	0	8968	0.0000000
zheyou73v0_A01	8418880	8421777	BnaA01T0146800ZY	0	+	0	0	2897	0.0000000
zheyou73v0_A01	8430791	8431910	BnaA01T0146900ZY	0	-	0	0	1119	0.0000000
zheyou73v0_A01	8432302	8433880	BnaA01T0147000ZY	0	-	0	0	1578	0.0000000
zheyou73v0_A01	8434076	8435597	BnaA01T0147100ZY	0	-	0	0	1521	0.0000000
zheyou73v0_A01	8441838	8446049	BnaA01T0147200ZY	0	+	0	0	4211	0.0000000
zheyou73v0_A01	8470263	8471882	BnaA01T0147300ZY	0	+	0	0	1619	0.0000000
zheyou73v0_A01	8472511	8475397	BnaA01T0147400ZY	0	-	0	0	2886	0.0000000
zheyou73v0_A01	8472511	8475397	BnaA01T0147400ZY.1	0	-	0	0	2886	0.0000000
zheyou73v0_A01	8477053	8479251	BnaA01T0147500ZY	0	+	0	0	2198	0.0000000
zheyou73v0_A01	8490507	8491682	BnaA01T0147600ZY	0	+	0	0	1175	0.0000000
zheyou73v0_A01	8490507	8491574	BnaA01T0147600ZY.1	0	+	0	0	1067	0.0000000
zheyou73v0_A01	8502924	8505022	BnaA01T0147700ZY	0	-	0	0	2098	0.0000000
zheyou73v0_A01	8507918	8509409	BnaA01T0147800ZY	0	-	0	0	1491	0.0000000
zheyou73v0_A01	8533748	8536994	BnaA01T0147900ZY	0	-	0	0	3246	0.0000000
zheyou73v0_A01	8547129	8547617	BnaA01T0148000ZY	0	+	0	0	488	0.0000000
zheyou73v0_A01	8565194	8566244	BnaA01T0148100ZY	0	-	0	0	1050	0.0000000
zheyou73v0_A01	8568612	8569235	BnaA01T0148200ZY	0	-	0	0	623	0.0000000
zheyou73v0_A01	8575415	8577310	BnaA01T0148300ZY	0	-	0	0	1895	0.0000000
zheyou73v0_A01	8577992	8580496	BnaA01T0148400ZY	0	-	0	0	2504	0.0000000
zheyou73v0_A01	8588030	8590975	BnaA01T0148500ZY	0	+	0	0	2945	0.0000000
zheyou73v0_A01	8588030	8590975	BnaA01T0148500ZY.1	0	+	0	0	2945	0.0000000
zheyou73v0_A01	8601517	8602718	BnaA01T0148600ZY	0	-	0	0	1201	0.0000000
zheyou73v0_A01	8604988	8607161	BnaA01T0148700ZY	0	+	0	0	2173	0.0000000
zheyou73v0_A01	8611861	8615380	BnaA01T0148800ZY	0	+	0	0	3519	0.0000000
zheyou73v0_A01	8620061	8620402	BnaA01T0148900ZY	0	-	0	0	341	0.0000000
zheyou73v0_A01	8620593	8623652	BnaA01T0149000ZY	0	+	0	0	3059	0.0000000
zheyou73v0_A01	8624399	8625108	BnaA01T0149100ZY	0	+	0	0	709	0.0000000
zheyou73v0_A01	8633151	8634131	BnaA01T0149200ZY	0	-	0	0	980	0.0000000
zheyou73v0_A01	8636884	8637871	BnaA01T0149300ZY	0	+	0	0	987	0.0000000
zheyou73v0_A01	8642486	8644531	BnaA01T0149400ZY	0	+	0	0	2045	0.0000000
zheyou73v0_A01	8642486	8644524	BnaA01T0149400ZY.1	0	+	0	0	2038	0.0000000
zheyou73v0_A01	8647337	8652343	BnaA01T0149500ZY	0	+	0	0	5006	0.0000000
zheyou73v0_A01	8650722	8652168	BnaA01T0149600ZY	0	-	0	0	1446	0.0000000
zheyou73v0_A01	8656944	8659052	BnaA01T0149700ZY	0	+	0	0	2108	0.0000000
zheyou73v0_A01	8660098	8663469	BnaA01T0149800ZY	0	-	0	0	3371	0.0000000
zheyou73v0_A01	8664500	8666650	BnaA01T0149900ZY	0	-	0	0	2150	0.0000000
zheyou73v0_A01	8667374	8672528	BnaA01T0150000ZY	0	+	0	0	5154	0.0000000
zheyou73v0_A01	8668995	8669565	BnaA01T0150100ZY	0	-	0	0	570	0.0000000
zheyou73v0_A01	8669652	8669814	BnaA01T0150200ZY	0	-	0	0	162	0.0000000
zheyou73v0_A01	8672559	8673447	BnaA01T0150300ZY	0	-	0	0	888	0.0000000
zheyou73v0_A01	8673536	8673704	BnaA01T0150400ZY	0	-	0	0	168	0.0000000
zheyou73v0_A01	8678953	8680872	BnaA01T0150500ZY	0	-	0	0	1919	0.0000000
zheyou73v0_A01	8681755	8684291	BnaA01T0150600ZY	0	-	0	0	2536	0.0000000
zheyou73v0_A01	8681755	8684291	BnaA01T0150600ZY.1	0	-	0	0	2536	0.0000000
zheyou73v0_A01	8681755	8684320	BnaA01T0150600ZY.2	0	-	0	0	2565	0.0000000
zheyou73v0_A01	8681755	8684291	BnaA01T0150600ZY.3	0	-	0	0	2536	0.0000000
zheyou73v0_A01	8685307	8686909	BnaA01T0150700ZY	0	-	0	0	1602	0.0000000
zheyou73v0_A01	8688829	8690551	BnaA01T0150800ZY	0	-	0	0	1722	0.0000000
zheyou73v0_A01	8696895	8697585	BnaA01T0150900ZY	0	+	0	0	690	0.0000000
zheyou73v0_A01	8698455	8700872	BnaA01T0151000ZY	0	-	0	0	2417	0.0000000
zheyou73v0_A01	8698997	8700872	BnaA01T0151000ZY.1	0	-	0	0	1875	0.0000000
zheyou73v0_A01	8703353	8704348	BnaA01T0151100ZY	0	+	0	0	995	0.0000000
zheyou73v0_A01	8710298	8710907	BnaA01T0151200ZY	0	+	0	0	609	0.0000000
zheyou73v0_A01	8712301	8713501	BnaA01T0151300ZY	0	-	0	0	1200	0.0000000
zheyou73v0_A01	8715235	8718188	BnaA01T0151400ZY	0	+	0	0	2953	0.0000000
zheyou73v0_A01	8719075	8720561	BnaA01T0151500ZY	0	+	0	0	1486	0.0000000
zheyou73v0_A01	8724121	8729911	BnaA01T0151600ZY	0	+	0	0	5790	0.0000000
zheyou73v0_A01	8737444	8738658	BnaA01T0151700ZY	0	+	0	0	1214	0.0000000
zheyou73v0_A01	8739894	8742025	BnaA01T0151800ZY	0	+	0	0	2131	0.0000000
zheyou73v0_A01	8750238	8756085	BnaA01T0151900ZY	0	+	0	0	5847	0.0000000
zheyou73v0_A01	8753425	8756085	BnaA01T0151900ZY.1	0	+	0	0	2660	0.0000000
zheyou73v0_A01	8757217	8760953	BnaA01T0152000ZY	0	+	0	0	3736	0.0000000
zheyou73v0_A01	8760846	8762970	BnaA01T0152100ZY	0	-	0	0	2124	0.0000000
zheyou73v0_A01	8766226	8769672	BnaA01T0152200ZY	0	+	0	0	3446	0.0000000
zheyou73v0_A01	8769793	8777830	BnaA01T0152300ZY	0	-	0	0	8037	0.0000000
zheyou73v0_A01	8785763	8787564	BnaA01T0152400ZY	0	+	0	0	1801	0.0000000
zheyou73v0_A01	8788810	8791981	BnaA01T0152500ZY	0	+	0	0	3171	0.0000000
zheyou73v0_A01	8794212	8795494	BnaA01T0152600ZY	0	+	0	0	1282	0.0000000
zheyou73v0_A01	8795680	8798699	BnaA01T0152700ZY	0	-	0	0	3019	0.0000000
zheyou73v0_A01	8799505	8799997	BnaA01T0152800ZY	0	-	0	0	492	0.0000000
zheyou73v0_A01	8801556	8807500	BnaA01T0152900ZY	0	+	0	0	5944	0.0000000
zheyou73v0_A01	8803247	8807500	BnaA01T0152900ZY.1	0	+	0	0	4253	0.0000000
zheyou73v0_A01	8808635	8813789	BnaA01T0153000ZY	0	+	0	0	5154	0.0000000
zheyou73v0_A01	8813876	8815866	BnaA01T0153100ZY	0	+	0	0	1990	0.0000000
zheyou73v0_A01	8816406	8818022	BnaA01T0153200ZY	0	-	0	0	1616	0.0000000
zheyou73v0_A01	8827710	8829846	BnaA01T0153300ZY	0	+	0	0	2136	0.0000000
zheyou73v0_A01	8838344	8845515	BnaA01T0153400ZY	0	+	0	0	7171	0.0000000
zheyou73v0_A01	8854410	8861922	BnaA01T0153500ZY	0	+	0	0	7512	0.0000000
zheyou73v0_A01	8854410	8861695	BnaA01T0153500ZY.1	0	+	0	0	7285	0.0000000
zheyou73v0_A01	8862538	8863913	BnaA01T0153600ZY	0	+	0	0	1375	0.0000000
zheyou73v0_A01	8885718	8889795	BnaA01T0153700ZY	0	+	0	0	4077	0.0000000
zheyou73v0_A01	8890312	8892514	BnaA01T0153800ZY.1	0	-	0	0	2202	0.0000000
zheyou73v0_A01	8890547	8892514	BnaA01T0153800ZY	0	-	0	0	1967	0.0000000
zheyou73v0_A01	8899736	8899975	BnaA01T0153900ZY	0	+	0	0	239	0.0000000
zheyou73v0_A01	8900469	8903278	BnaA01T0154000ZY	0	+	0	0	2809	0.0000000
zheyou73v0_A01	8903446	8905305	BnaA01T0154100ZY.1	0	-	0	0	1859	0.0000000
zheyou73v0_A01	8903452	8905305	BnaA01T0154100ZY	0	-	0	0	1853	0.0000000
zheyou73v0_A01	8905460	8908401	BnaA01T0154200ZY	0	-	0	0	2941	0.0000000
zheyou73v0_A01	8908654	8911283	BnaA01T0154300ZY	0	+	0	0	2629	0.0000000
zheyou73v0_A01	8921407	8923798	BnaA01T0154400ZY	0	+	0	0	2391	0.0000000
zheyou73v0_A01	8925836	8928153	BnaA01T0154500ZY	0	+	0	0	2317	0.0000000
zheyou73v0_A01	8929557	8930801	BnaA01T0154600ZY	0	-	0	0	1244	0.0000000
zheyou73v0_A01	8937386	8941751	BnaA01T0154700ZY	0	-	0	0	4365	0.0000000
zheyou73v0_A01	8949935	8952053	BnaA01T0154800ZY	0	+	0	0	2118	0.0000000
zheyou73v0_A01	8952590	8953806	BnaA01T0154900ZY	0	+	0	0	1216	0.0000000
zheyou73v0_A01	8954281	8955891	BnaA01T0155000ZY	0	-	0	0	1610	0.0000000
zheyou73v0_A01	8961527	8963018	BnaA01T0155100ZY	0	+	0	0	1491	0.0000000
zheyou73v0_A01	8963122	8964933	BnaA01T0155200ZY	0	-	0	0	1811	0.0000000
zheyou73v0_A01	8985162	8986769	BnaA01T0155300ZY	0	+	0	0	1607	0.0000000
zheyou73v0_A01	9007073	9007902	BnaA01T0155400ZY	0	-	0	0	829	0.0000000
zheyou73v0_A01	9008402	9009388	BnaA01T0155500ZY	0	-	0	0	986	0.0000000
zheyou73v0_A01	9011891	9013419	BnaA01T0155600ZY	0	-	0	0	1528	0.0000000
zheyou73v0_A01	9018065	9021309	BnaA01T0155700ZY	0	-	0	0	3244	0.0000000
zheyou73v0_A01	9018065	9021309	BnaA01T0155700ZY.1	0	-	0	0	3244	0.0000000
zheyou73v0_A01	9025476	9026721	BnaA01T0155800ZY	0	-	0	0	1245	0.0000000
zheyou73v0_A01	9029831	9030559	BnaA01T0155900ZY	0	+	0	0	728	0.0000000
zheyou73v0_A01	9030254	9035450	BnaA01T0156000ZY	0	-	0	0	5196	0.0000000
zheyou73v0_A01	9030254	9035076	BnaA01T0156000ZY.1	0	-	0	0	4822	0.0000000
zheyou73v0_A01	9030254	9035450	BnaA01T0156000ZY.2	0	-	0	0	5196	0.0000000
zheyou73v0_A01	9043719	9044042	BnaA01T0156100ZY	0	-	0	0	323	0.0000000
zheyou73v0_A01	9045383	9045701	BnaA01T0156200ZY	0	-	0	0	318	0.0000000
zheyou73v0_A01	9046933	9048538	BnaA01T0156300ZY	0	+	0	0	1605	0.0000000
zheyou73v0_A01	9049665	9052090	BnaA01T0156400ZY	0	-	0	0	2425	0.0000000
zheyou73v0_A01	9052453	9054205	BnaA01T0156500ZY	0	-	0	0	1752	0.0000000
zheyou73v0_A01	9054441	9056904	BnaA01T0156600ZY	0	+	0	0	2463	0.0000000
zheyou73v0_A01	9056654	9056873	BnaA01T0156700ZY	0	-	0	0	219	0.0000000
zheyou73v0_A01	9058676	9060262	BnaA01T0156800ZY	0	-	0	0	1586	0.0000000
zheyou73v0_A01	9066813	9069073	BnaA01T0156900ZY	0	+	0	0	2260	0.0000000
zheyou73v0_A01	9069089	9070923	BnaA01T0157000ZY	0	-	0	0	1834	0.0000000
zheyou73v0_A01	9072434	9074641	BnaA01T0157100ZY	0	+	0	0	2207	0.0000000
zheyou73v0_A01	9076891	9079098	BnaA01T0157200ZY	0	+	0	0	2207	0.0000000
zheyou73v0_A01	9089242	9091450	BnaA01T0157300ZY	0	+	0	0	2208	0.0000000
zheyou73v0_A01	9105223	9107816	BnaA01T0157400ZY	0	+	0	0	2593	0.0000000
zheyou73v0_A01	9108789	9110594	BnaA01T0157500ZY	0	+	0	0	1805	0.0000000
zheyou73v0_A01	9121140	9122614	BnaA01T0157600ZY	0	+	0	0	1474	0.0000000
zheyou73v0_A01	9122714	9125965	BnaA01T0157700ZY	0	-	0	0	3251	0.0000000
zheyou73v0_A01	9129350	9130187	BnaA01T0157800ZY	0	-	0	0	837	0.0000000
zheyou73v0_A01	9132610	9136600	BnaA01T0157900ZY	0	-	0	0	3990	0.0000000
zheyou73v0_A01	9136939	9138805	BnaA01T0158000ZY	0	-	0	0	1866	0.0000000
zheyou73v0_A01	9138992	9142265	BnaA01T0158100ZY	0	+	0	0	3273	0.0000000
zheyou73v0_A01	9142962	9144275	BnaA01T0158200ZY	0	+	0	0	1313	0.0000000
zheyou73v0_A01	9146303	9150252	BnaA01T0158300ZY	0	-	0	0	3949	0.0000000
zheyou73v0_A01	9161929	9163697	BnaA01T0158400ZY	0	-	0	0	1768	0.0000000
zheyou73v0_A01	9169503	9174317	BnaA01T0158500ZY	0	-	0	0	4814	0.0000000
zheyou73v0_A01	9175561	9177195	BnaA01T0158600ZY	0	-	0	0	1634	0.0000000
zheyou73v0_A01	9182749	9185990	BnaA01T0158700ZY	0	-	0	0	3241	0.0000000
zheyou73v0_A01	9182749	9185990	BnaA01T0158700ZY.1	0	-	0	0	3241	0.0000000
zheyou73v0_A01	9182749	9185990	BnaA01T0158700ZY.2	0	-	0	0	3241	0.0000000
zheyou73v0_A01	9191884	9195380	BnaA01T0158800ZY	0	+	0	0	3496	0.0000000
zheyou73v0_A01	9192330	9195801	BnaA01T0158800ZY.1	0	+	0	0	3471	0.0000000
zheyou73v0_A01	9198558	9200271	BnaA01T0158900ZY	0	+	0	0	1713	0.0000000
zheyou73v0_A01	9200485	9202657	BnaA01T0159000ZY	0	-	0	0	2172	0.0000000
zheyou73v0_A01	9205557	9210045	BnaA01T0159100ZY	0	-	0	0	4488	0.0000000
zheyou73v0_A01	9216022	9219236	BnaA01T0159200ZY.2	0	-	0	0	3214	0.0000000
zheyou73v0_A01	9216260	9219236	BnaA01T0159200ZY	0	-	0	0	2976	0.0000000
zheyou73v0_A01	9216260	9218211	BnaA01T0159200ZY.1	0	-	0	0	1951	0.0000000
zheyou73v0_A01	9233802	9236244	BnaA01T0159300ZY	0	+	0	0	2442	0.0000000
zheyou73v0_A01	9233802	9235767	BnaA01T0159300ZY.1	0	+	0	0	1965	0.0000000
zheyou73v0_A01	9242339	9243612	BnaA01T0159400ZY	0	+	0	0	1273	0.0000000
zheyou73v0_A01	9243822	9244390	BnaA01T0159500ZY	0	-	0	0	568	0.0000000
zheyou73v0_A01	9244682	9250683	BnaA01T0159600ZY	0	+	0	0	6001	0.0000000
zheyou73v0_A01	9260653	9264984	BnaA01T0159700ZY	0	+	0	0	4331	0.0000000
zheyou73v0_A01	9260653	9264984	BnaA01T0159700ZY.1	0	+	0	0	4331	0.0000000
zheyou73v0_A01	9266003	9286817	BnaA01T0159800ZY	0	+	0	0	20814	0.0000000
zheyou73v0_A01	9288393	9289781	BnaA01T0159900ZY	0	-	0	0	1388	0.0000000
zheyou73v0_A01	9290311	9292888	BnaA01T0160000ZY	0	-	0	0	2577	0.0000000
zheyou73v0_A01	9293200	9295638	BnaA01T0160100ZY	0	-	0	0	2438	0.0000000
zheyou73v0_A01	9299536	9302088	BnaA01T0160200ZY	0	+	0	0	2552	0.0000000
zheyou73v0_A01	9302073	9303530	BnaA01T0160300ZY	0	-	0	0	1457	0.0000000
zheyou73v0_A01	9309737	9311545	BnaA01T0160400ZY	0	+	0	0	1808	0.0000000
zheyou73v0_A01	9309737	9311545	BnaA01T0160400ZY.1	0	+	0	0	1808	0.0000000
zheyou73v0_A01	9312865	9315050	BnaA01T0160500ZY	0	+	0	0	2185	0.0000000
zheyou73v0_A01	9315252	9315898	BnaA01T0160600ZY	0	-	0	0	646	0.0000000
zheyou73v0_A01	9315252	9315898	BnaA01T0160600ZY.1	0	-	0	0	646	0.0000000
zheyou73v0_A01	9316177	9317635	BnaA01T0160700ZY	0	+	0	0	1458	0.0000000
zheyou73v0_A01	9323033	9325456	BnaA01T0160800ZY	0	-	0	0	2423	0.0000000
zheyou73v0_A01	9325665	9325956	BnaA01T0160900ZY	0	-	0	0	291	0.0000000
zheyou73v0_A01	9329874	9331655	BnaA01T0161000ZY	0	-	0	0	1781	0.0000000
zheyou73v0_A01	9329874	9331655	BnaA01T0161000ZY.1	0	-	0	0	1781	0.0000000
zheyou73v0_A01	9333555	9334005	BnaA01T0161100ZY	0	-	0	0	450	0.0000000
zheyou73v0_A01	9337729	9339103	BnaA01T0161200ZY	0	+	0	0	1374	0.0000000
zheyou73v0_A01	9343314	9343506	BnaA01T0161300ZY	0	+	0	0	192	0.0000000
zheyou73v0_A01	9356820	9358139	BnaA01T0161400ZY	0	+	0	0	1319	0.0000000
zheyou73v0_A01	9358202	9360405	BnaA01T0161500ZY	0	+	0	0	2203	0.0000000
zheyou73v0_A01	9364909	9365411	BnaA01T0161600ZY	0	-	0	0	502	0.0000000
zheyou73v0_A01	9365714	9368521	BnaA01T0161700ZY	0	-	0	0	2807	0.0000000
zheyou73v0_A01	9369010	9371267	BnaA01T0161800ZY	0	+	0	0	2257	0.0000000
zheyou73v0_A01	9371479	9374249	BnaA01T0161900ZY	0	-	0	0	2770	0.0000000
zheyou73v0_A01	9374645	9377610	BnaA01T0162000ZY	0	-	0	0	2965	0.0000000
zheyou73v0_A01	9374645	9377610	BnaA01T0162000ZY.1	0	-	0	0	2965	0.0000000
zheyou73v0_A01	9377962	9387499	BnaA01T0162100ZY	0	+	0	0	9537	0.0000000
zheyou73v0_A01	9387631	9390360	BnaA01T0162200ZY	0	-	0	0	2729	0.0000000
zheyou73v0_A01	9390662	9393163	BnaA01T0162300ZY	0	-	0	0	2501	0.0000000
zheyou73v0_A01	9390667	9391564	BnaA01T0162400ZY	0	+	0	0	897	0.0000000
zheyou73v0_A01	9393663	9397313	BnaA01T0162500ZY	0	-	0	0	3650	0.0000000
zheyou73v0_A01	9397579	9398024	BnaA01T0162600ZY	0	+	0	0	445	0.0000000
zheyou73v0_A01	9398787	9399694	BnaA01T0162700ZY	0	-	0	0	907	0.0000000
zheyou73v0_A01	9400427	9403040	BnaA01T0162800ZY	0	+	0	0	2613	0.0000000
zheyou73v0_A01	9403710	9406727	BnaA01T0162900ZY	0	-	0	0	3017	0.0000000
zheyou73v0_A01	9408232	9410229	BnaA01T0163000ZY	0	-	0	0	1997	0.0000000
zheyou73v0_A01	9413747	9414458	BnaA01T0163100ZY	0	+	0	0	711	0.0000000
zheyou73v0_A01	9420716	9421259	BnaA01T0163200ZY	0	+	0	0	543	0.0000000
zheyou73v0_A01	9426190	9426730	BnaA01T0163300ZY	0	+	0	0	540	0.0000000
zheyou73v0_A01	9434695	9435244	BnaA01T0163400ZY	0	+	0	0	549	0.0000000
zheyou73v0_A01	9447912	9448260	BnaA01T0163500ZY	0	+	0	0	348	0.0000000
zheyou73v0_A01	9451939	9455409	BnaA01T0163600ZY	0	-	0	0	3470	0.0000000
zheyou73v0_A01	9461178	9462353	BnaA01T0163700ZY	0	+	0	0	1175	0.0000000
zheyou73v0_A01	9481705	9484639	BnaA01T0163800ZY	0	+	0	0	2934	0.0000000
zheyou73v0_A01	9483684	9485728	BnaA01T0163900ZY	0	-	0	0	2044	0.0000000
zheyou73v0_A01	9488152	9490055	BnaA01T0164000ZY	0	+	0	0	1903	0.0000000
zheyou73v0_A01	9492722	9497453	BnaA01T0164100ZY	0	-	0	0	4731	0.0000000
zheyou73v0_A01	9533622	9536287	BnaA01T0164200ZY	0	+	0	0	2665	0.0000000
zheyou73v0_A01	9544449	9546645	BnaA01T0164300ZY	0	-	0	0	2196	0.0000000
zheyou73v0_A01	9550463	9553489	BnaA01T0164400ZY	0	+	0	0	3026	0.0000000
zheyou73v0_A01	9553415	9556909	BnaA01T0164500ZY	0	-	0	0	3494	0.0000000
zheyou73v0_A01	9560529	9561514	BnaA01T0164600ZY	0	+	0	0	985	0.0000000
zheyou73v0_A01	9563842	9566103	BnaA01T0164700ZY	0	-	0	0	2261	0.0000000
zheyou73v0_A01	9567290	9568458	BnaA01T0164800ZY	0	-	0	0	1168	0.0000000
zheyou73v0_A01	9572346	9575454	BnaA01T0164900ZY	0	-	0	0	3108	0.0000000
zheyou73v0_A01	9575873	9577887	BnaA01T0165000ZY	0	-	0	0	2014	0.0000000
zheyou73v0_A01	9580486	9581190	BnaA01T0165100ZY	0	+	0	0	704	0.0000000
zheyou73v0_A01	9581892	9592191	BnaA01T0165200ZY	0	-	0	0	10299	0.0000000
zheyou73v0_A01	9592658	9593557	BnaA01T0165300ZY	0	+	0	0	899	0.0000000
zheyou73v0_A01	9593830	9595203	BnaA01T0165400ZY	0	-	0	0	1373	0.0000000
zheyou73v0_A01	9598758	9601241	BnaA01T0165500ZY	0	-	0	0	2483	0.0000000
zheyou73v0_A01	9621445	9626029	BnaA01T0165600ZY	0	+	0	0	4584	0.0000000
zheyou73v0_A01	9622393	9626029	BnaA01T0165600ZY.1	0	+	0	0	3636	0.0000000
zheyou73v0_A01	9627999	9629480	BnaA01T0165700ZY	0	+	0	0	1481	0.0000000
zheyou73v0_A01	9629944	9631793	BnaA01T0165800ZY	0	+	0	0	1849	0.0000000
zheyou73v0_A01	9632259	9633475	BnaA01T0165900ZY	0	-	0	0	1216	0.0000000
zheyou73v0_A01	9654343	9655671	BnaA01T0166000ZY	0	+	0	0	1328	0.0000000
zheyou73v0_A01	9656116	9657572	BnaA01T0166100ZY	0	+	0	0	1456	0.0000000
zheyou73v0_A01	9657857	9668519	BnaA01T0166200ZY	0	-	0	0	10662	0.0000000
zheyou73v0_A01	9672872	9674561	BnaA01T0166300ZY	0	+	0	0	1689	0.0000000
zheyou73v0_A01	9679105	9679564	BnaA01T0166400ZY	0	-	0	0	459	0.0000000
zheyou73v0_A01	9679889	9688797	BnaA01T0166500ZY	0	+	0	0	8908	0.0000000
zheyou73v0_A01	9688749	9691733	BnaA01T0166600ZY	0	-	0	0	2984	0.0000000
zheyou73v0_A01	9696424	9697975	BnaA01T0166700ZY	0	-	0	0	1551	0.0000000
zheyou73v0_A01	9703831	9705444	BnaA01T0166800ZY	0	-	0	0	1613	0.0000000
zheyou73v0_A01	9703831	9705444	BnaA01T0166800ZY.1	0	-	0	0	1613	0.0000000
zheyou73v0_A01	9708028	9708471	BnaA01T0166900ZY	0	-	0	0	443	0.0000000
zheyou73v0_A01	9708794	9711611	BnaA01T0167000ZY	0	-	0	0	2817	0.0000000
zheyou73v0_A01	9712350	9713489	BnaA01T0167100ZY	0	-	0	0	1139	0.0000000
zheyou73v0_A01	9714460	9715184	BnaA01T0167200ZY	0	-	0	0	724	0.0000000
zheyou73v0_A01	9721319	9722106	BnaA01T0167300ZY	0	+	0	0	787	0.0000000
zheyou73v0_A01	9729040	9731309	BnaA01T0167400ZY.1	0	-	0	0	2269	0.0000000
zheyou73v0_A01	9729203	9731134	BnaA01T0167400ZY	0	-	0	0	1931	0.0000000
zheyou73v0_A01	9731969	9734191	BnaA01T0167500ZY	0	-	0	0	2222	0.0000000
zheyou73v0_A01	9738431	9741060	BnaA01T0167600ZY	0	+	0	0	2629	0.0000000
zheyou73v0_A01	9744915	9747718	BnaA01T0167700ZY	0	+	0	0	2803	0.0000000
zheyou73v0_A01	9756403	9757872	BnaA01T0167800ZY	0	+	0	0	1469	0.0000000
zheyou73v0_A01	9758013	9760321	BnaA01T0167900ZY	0	-	0	0	2308	0.0000000
zheyou73v0_A01	9761186	9765105	BnaA01T0168000ZY	0	-	0	0	3919	0.0000000
zheyou73v0_A01	9765608	9770961	BnaA01T0168100ZY	0	-	0	0	5353	0.0000000
zheyou73v0_A01	9771983	9775523	BnaA01T0168200ZY	0	-	0	0	3540	0.0000000
zheyou73v0_A01	9777270	9778986	BnaA01T0168300ZY	0	+	0	0	1716	0.0000000
zheyou73v0_A01	9792902	9793091	BnaA01T0168400ZY	0	+	0	0	189	0.0000000
zheyou73v0_A01	9794279	9795694	BnaA01T0168500ZY	0	-	0	0	1415	0.0000000
zheyou73v0_A01	9796930	9799255	BnaA01T0168600ZY	0	+	0	0	2325	0.0000000
zheyou73v0_A01	9796930	9799255	BnaA01T0168600ZY.1	0	+	0	0	2325	0.0000000
zheyou73v0_A01	9799290	9799670	BnaA01T0168700ZY	0	-	0	0	380	0.0000000
zheyou73v0_A01	9805813	9806299	BnaA01T0168800ZY	0	+	0	0	486	0.0000000
zheyou73v0_A01	9815537	9816885	BnaA01T0168900ZY	0	+	0	0	1348	0.0000000
zheyou73v0_A01	9828298	9828487	BnaA01T0169000ZY	0	+	0	0	189	0.0000000
zheyou73v0_A01	9828683	9829631	BnaA01T0169100ZY	0	-	0	0	948	0.0000000
zheyou73v0_A01	9836080	9836435	BnaA01T0169200ZY	0	+	0	0	355	0.0000000
zheyou73v0_A01	9850941	9852405	BnaA01T0169300ZY	0	+	0	0	1464	0.0000000
zheyou73v0_A01	9854750	9855530	BnaA01T0169400ZY	0	-	0	0	780	0.0000000
zheyou73v0_A01	9861457	9861739	BnaA01T0169500ZY	0	+	0	0	282	0.0000000
zheyou73v0_A01	9864340	9865230	BnaA01T0169600ZY	0	-	0	0	890	0.0000000
zheyou73v0_A01	9865787	9870269	BnaA01T0169700ZY	0	+	0	0	4482	0.0000000
zheyou73v0_A01	9870389	9871514	BnaA01T0169800ZY	0	-	0	0	1125	0.0000000
zheyou73v0_A01	9873158	9875834	BnaA01T0169900ZY	0	+	0	0	2676	0.0000000
zheyou73v0_A01	9878180	9880317	BnaA01T0170000ZY	0	+	0	0	2137	0.0000000
zheyou73v0_A01	9880314	9883783	BnaA01T0170100ZY	0	-	0	0	3469	0.0000000
zheyou73v0_A01	9880314	9883783	BnaA01T0170100ZY.1	0	-	0	0	3469	0.0000000
zheyou73v0_A01	9880314	9883783	BnaA01T0170100ZY.2	0	-	0	0	3469	0.0000000
zheyou73v0_A01	9886456	9887988	BnaA01T0170200ZY	0	-	0	0	1532	0.0000000
zheyou73v0_A01	9897330	9897991	BnaA01T0170300ZY	0	+	0	0	661	0.0000000
zheyou73v0_A01	9898309	9900002	BnaA01T0170400ZY	0	+	0	0	1693	0.0000000
zheyou73v0_A01	9898309	9900002	BnaA01T0170400ZY.1	0	+	0	0	1693	0.0000000
zheyou73v0_A01	9898309	9900002	BnaA01T0170400ZY.3	0	+	0	0	1693	0.0000000
zheyou73v0_A01	9898309	9900002	BnaA01T0170400ZY.4	0	+	0	0	1693	0.0000000
zheyou73v0_A01	9898686	9900002	BnaA01T0170400ZY.2	0	+	0	0	1316	0.0000000
zheyou73v0_A01	9898686	9900002	BnaA01T0170400ZY.5	0	+	0	0	1316	0.0000000
zheyou73v0_A01	9900202	9901833	BnaA01T0170500ZY	0	+	0	0	1631	0.0000000
zheyou73v0_A01	9902763	9905680	BnaA01T0170600ZY	0	+	0	0	2917	0.0000000
zheyou73v0_A01	9906109	9908407	BnaA01T0170700ZY	0	+	0	0	2298	0.0000000
zheyou73v0_A01	9908527	9910148	BnaA01T0170800ZY	0	+	0	0	1621	0.0000000
zheyou73v0_A01	9916271	9917036	BnaA01T0170900ZY	0	-	0	0	765	0.0000000
zheyou73v0_A01	9925623	9928694	BnaA01T0171000ZY	0	+	0	0	3071	0.0000000
zheyou73v0_A01	9929092	9931496	BnaA01T0171100ZY	0	+	0	0	2404	0.0000000
zheyou73v0_A01	9929092	9931496	BnaA01T0171100ZY.1	0	+	0	0	2404	0.0000000
zheyou73v0_A01	9937218	9941220	BnaA01T0171200ZY	0	+	0	0	4002	0.0000000
zheyou73v0_A01	9941490	9943183	BnaA01T0171300ZY	0	+	0	0	1693	0.0000000
zheyou73v0_A01	9943940	9944930	BnaA01T0171400ZY	0	+	0	0	990	0.0000000
zheyou73v0_A01	9949899	9950671	BnaA01T0171500ZY	0	+	0	0	772	0.0000000
zheyou73v0_A01	9955897	9959343	BnaA01T0171600ZY	0	+	0	0	3446	0.0000000
zheyou73v0_A01	9959934	9961068	BnaA01T0171700ZY	0	-	0	0	1134	0.0000000
zheyou73v0_A01	9981407	9982598	BnaA01T0171800ZY	0	-	0	0	1191	0.0000000
zheyou73v0_A01	9991967	9996632	BnaA01T0171900ZY	0	-	0	0	4665	0.0000000
zheyou73v0_A01	10001530	10005560	BnaA01T0172000ZY	0	+	0	0	4030	0.0000000
zheyou73v0_A01	10017026	10021461	BnaA01T0172100ZY	0	-	0	0	4435	0.0000000
zheyou73v0_A01	10022942	10024365	BnaA01T0172200ZY	0	+	0	0	1423	0.0000000
zheyou73v0_A01	10024673	10025731	BnaA01T0172300ZY	0	-	0	0	1058	0.0000000
zheyou73v0_A01	10025986	10027029	BnaA01T0172400ZY	0	-	0	0	1043	0.0000000
zheyou73v0_A01	10027389	10029791	BnaA01T0172500ZY	0	+	0	0	2402	0.0000000
zheyou73v0_A01	10030387	10030639	BnaA01T0172600ZY	0	+	0	0	252	0.0000000
zheyou73v0_A01	10031639	10032042	BnaA01T0172700ZY	0	+	0	0	403	0.0000000
zheyou73v0_A01	10032399	10032934	BnaA01T0172800ZY	0	-	0	0	535	0.0000000
zheyou73v0_A01	10034241	10035896	BnaA01T0172900ZY	0	-	0	0	1655	0.0000000
zheyou73v0_A01	10037427	10038616	BnaA01T0173000ZY	0	-	0	0	1189	0.0000000
zheyou73v0_A01	10041700	10042582	BnaA01T0173100ZY	0	-	0	0	882	0.0000000
zheyou73v0_A01	10044051	10044513	BnaA01T0173200ZY	0	+	0	0	462	0.0000000
zheyou73v0_A01	10044851	10045019	BnaA01T0173300ZY	0	-	0	0	168	0.0000000
zheyou73v0_A01	10045269	10046111	BnaA01T0173400ZY	0	+	0	0	842	0.0000000
zheyou73v0_A01	10046458	10047235	BnaA01T0173500ZY	0	-	0	0	777	0.0000000
zheyou73v0_A01	10049026	10050773	BnaA01T0173600ZY	0	+	0	0	1747	0.0000000
zheyou73v0_A01	10051956	10053172	BnaA01T0173700ZY	0	+	0	0	1216	0.0000000
zheyou73v0_A01	10054488	10055847	BnaA01T0173800ZY	0	-	0	0	1359	0.0000000
zheyou73v0_A01	10056514	10056775	BnaA01T0173900ZY	0	-	0	0	261	0.0000000
zheyou73v0_A01	10070807	10072279	BnaA01T0174000ZY	0	-	0	0	1472	0.0000000
zheyou73v0_A01	10083188	10084787	BnaA01T0174100ZY	0	-	0	0	1599	0.0000000
zheyou73v0_A01	10089419	10090151	BnaA01T0174200ZY	0	+	0	0	732	0.0000000
zheyou73v0_A01	10095636	10096704	BnaA01T0174300ZY	0	-	0	0	1068	0.0000000
zheyou73v0_A01	10095636	10096704	BnaA01T0174300ZY.1	0	-	0	0	1068	0.0000000
zheyou73v0_A01	10098258	10100424	BnaA01T0174400ZY	0	+	0	0	2166	0.0000000
zheyou73v0_A01	10101040	10101214	BnaA01T0174500ZY	0	+	0	0	174	0.0000000
zheyou73v0_A01	10102152	10103154	BnaA01T0174600ZY	0	+	0	0	1002	0.0000000
zheyou73v0_A01	10109968	10112063	BnaA01T0174700ZY	0	-	0	0	2095	0.0000000
zheyou73v0_A01	10117942	10118928	BnaA01T0174800ZY	0	-	0	0	986	0.0000000
zheyou73v0_A01	10148289	10149826	BnaA01T0174900ZY	0	+	0	0	1537	0.0000000
zheyou73v0_A01	10155450	10156565	BnaA01T0175000ZY	0	-	0	0	1115	0.0000000
zheyou73v0_A01	10157053	10158949	BnaA01T0175100ZY	0	-	0	0	1896	0.0000000
zheyou73v0_A01	10159639	10160077	BnaA01T0175200ZY	0	+	0	0	438	0.0000000
zheyou73v0_A01	10162032	10162409	BnaA01T0175300ZY	0	+	0	0	377	0.0000000
zheyou73v0_A01	10162660	10163515	BnaA01T0175400ZY	0	-	0	0	855	0.0000000
zheyou73v0_A01	10164509	10166914	BnaA01T0175500ZY	0	+	0	0	2405	0.0000000
zheyou73v0_A01	10172459	10173969	BnaA01T0175600ZY	0	+	0	0	1510	0.0000000
zheyou73v0_A01	10174851	10176761	BnaA01T0175700ZY	0	+	0	0	1910	0.0000000
zheyou73v0_A01	10178028	10180851	BnaA01T0175800ZY	0	+	0	0	2823	0.0000000
zheyou73v0_A01	10182545	10184022	BnaA01T0175900ZY	0	-	0	0	1477	0.0000000
zheyou73v0_A01	10196882	10197651	BnaA01T0176000ZY	0	-	0	0	769	0.0000000
zheyou73v0_A01	10206973	10217950	BnaA01T0176100ZY	0	+	0	0	10977	0.0000000
zheyou73v0_A01	10219338	10220236	BnaA01T0176200ZY	0	+	0	0	898	0.0000000
zheyou73v0_A01	10220277	10220914	BnaA01T0176300ZY	0	+	0	0	637	0.0000000
zheyou73v0_A01	10221474	10226950	BnaA01T0176400ZY	0	-	0	0	5476	0.0000000
zheyou73v0_A01	10230223	10232076	BnaA01T0176500ZY	0	+	0	0	1853	0.0000000
zheyou73v0_A01	10245614	10247492	BnaA01T0176600ZY	0	+	0	0	1878	0.0000000
zheyou73v0_A01	10301088	10306207	BnaA01T0176700ZY	0	-	0	0	5119	0.0000000
zheyou73v0_A01	10305798	10306904	BnaA01T0176800ZY	0	+	0	0	1106	0.0000000
zheyou73v0_A01	10308259	10310011	BnaA01T0176900ZY	0	+	0	0	1752	0.0000000
zheyou73v0_A01	10310905	10312110	BnaA01T0177000ZY	0	-	0	0	1205	0.0000000
zheyou73v0_A01	10314048	10315179	BnaA01T0177100ZY	0	-	0	0	1131	0.0000000
zheyou73v0_A01	10322531	10323454	BnaA01T0177200ZY	0	+	0	0	923	0.0000000
zheyou73v0_A01	10332116	10333366	BnaA01T0177300ZY	0	+	0	0	1250	0.0000000
zheyou73v0_A01	10336504	10339382	BnaA01T0177400ZY	0	-	0	0	2878	0.0000000
zheyou73v0_A01	10349454	10350971	BnaA01T0177500ZY	0	+	0	0	1517	0.0000000
zheyou73v0_A01	10351328	10352425	BnaA01T0177600ZY	0	-	0	0	1097	0.0000000
zheyou73v0_A01	10352486	10353547	BnaA01T0177700ZY	0	-	0	0	1061	0.0000000
zheyou73v0_A01	10355672	10357250	BnaA01T0177800ZY	0	-	0	0	1578	0.0000000
zheyou73v0_A01	10360237	10362356	BnaA01T0177900ZY	0	+	0	0	2119	0.0000000
zheyou73v0_A01	10365446	10365964	BnaA01T0178000ZY	0	+	0	0	518	0.0000000
zheyou73v0_A01	10365976	10367330	BnaA01T0178100ZY	0	+	0	0	1354	0.0000000
zheyou73v0_A01	10368700	10370752	BnaA01T0178200ZY	0	+	0	0	2052	0.0000000
zheyou73v0_A01	10378773	10381422	BnaA01T0178300ZY	0	+	0	0	2649	0.0000000
zheyou73v0_A01	10382836	10385235	BnaA01T0178400ZY	0	+	0	0	2399	0.0000000
zheyou73v0_A01	10385715	10386273	BnaA01T0178500ZY	0	-	0	0	558	0.0000000
zheyou73v0_A01	10388249	10389911	BnaA01T0178600ZY	0	+	0	0	1662	0.0000000
zheyou73v0_A01	10390856	10393662	BnaA01T0178700ZY	0	-	0	0	2806	0.0000000
zheyou73v0_A01	10395333	10395630	BnaA01T0178800ZY	0	+	0	0	297	0.0000000
zheyou73v0_A01	10400848	10402476	BnaA01T0178900ZY	0	+	0	0	1628	0.0000000
zheyou73v0_A01	10405913	10408065	BnaA01T0179000ZY	0	+	0	0	2152	0.0000000
zheyou73v0_A01	10410468	10411261	BnaA01T0179100ZY	0	+	0	0	793	0.0000000
zheyou73v0_A01	10411967	10414413	BnaA01T0179200ZY	0	-	0	0	2446	0.0000000
zheyou73v0_A01	10423553	10426021	BnaA01T0179300ZY	0	+	0	0	2468	0.0000000
zheyou73v0_A01	10426318	10427735	BnaA01T0179400ZY	0	+	0	0	1417	0.0000000
zheyou73v0_A01	10428371	10430180	BnaA01T0179500ZY	0	-	0	0	1809	0.0000000
zheyou73v0_A01	10431800	10434578	BnaA01T0179600ZY	0	-	0	0	2778	0.0000000
zheyou73v0_A01	10434820	10438146	BnaA01T0179700ZY	0	+	0	0	3326	0.0000000
zheyou73v0_A01	10434820	10438146	BnaA01T0179700ZY.1	0	+	0	0	3326	0.0000000
zheyou73v0_A01	10444117	10445538	BnaA01T0179800ZY	0	+	0	0	1421	0.0000000
zheyou73v0_A01	10447130	10449935	BnaA01T0179900ZY	0	+	0	0	2805	0.0000000
zheyou73v0_A01	10451393	10454409	BnaA01T0180000ZY	0	+	0	0	3016	0.0000000
zheyou73v0_A01	10454532	10456344	BnaA01T0180100ZY	0	-	0	0	1812	0.0000000
zheyou73v0_A01	10454532	10456344	BnaA01T0180100ZY.1	0	-	0	0	1812	0.0000000
zheyou73v0_A01	10454532	10456344	BnaA01T0180100ZY.2	0	-	0	0	1812	0.0000000
zheyou73v0_A01	10463181	10465857	BnaA01T0180200ZY	0	+	0	0	2676	0.0000000
zheyou73v0_A01	10468649	10469256	BnaA01T0180300ZY	0	-	0	0	607	0.0000000
zheyou73v0_A01	10471946	10476516	BnaA01T0180400ZY	0	+	0	0	4570	0.0000000
zheyou73v0_A01	10477226	10478897	BnaA01T0180500ZY	0	-	0	0	1671	0.0000000
zheyou73v0_A01	10479134	10481898	BnaA01T0180600ZY	0	-	0	0	2764	0.0000000
zheyou73v0_A01	10479134	10481889	BnaA01T0180600ZY.1	0	-	0	0	2755	0.0000000
zheyou73v0_A01	10493810	10495349	BnaA01T0180700ZY	0	-	0	0	1539	0.0000000
zheyou73v0_A01	10519709	10522645	BnaA01T0180800ZY	0	+	0	0	2936	0.0000000
zheyou73v0_A01	10525105	10528486	BnaA01T0180900ZY	0	-	0	0	3381	0.0000000
zheyou73v0_A01	10528524	10529103	BnaA01T0181000ZY	0	-	0	0	579	0.0000000
zheyou73v0_A01	10536652	10538378	BnaA01T0181100ZY	0	+	0	0	1726	0.0000000
zheyou73v0_A01	10539203	10540621	BnaA01T0181200ZY	0	-	0	0	1418	0.0000000
zheyou73v0_A01	10564642	10565359	BnaA01T0181300ZY	0	-	0	0	717	0.0000000
zheyou73v0_A01	10566481	10568511	BnaA01T0181400ZY	0	+	0	0	2030	0.0000000
zheyou73v0_A01	10578399	10581935	BnaA01T0181500ZY	0	+	0	0	3536	0.0000000
zheyou73v0_A01	10591160	10591706	BnaA01T0181600ZY	0	+	0	0	546	0.0000000
zheyou73v0_A01	10608777	10609302	BnaA01T0181700ZY	0	+	0	0	525	0.0000000
zheyou73v0_A01	10629740	10632131	BnaA01T0181800ZY	0	-	0	0	2391	0.0000000
zheyou73v0_A01	10640121	10647051	BnaA01T0181900ZY	0	-	0	0	6930	0.0000000
zheyou73v0_A01	10669640	10671084	BnaA01T0182000ZY	0	+	0	0	1444	0.0000000
zheyou73v0_A01	10671338	10672477	BnaA01T0182100ZY	0	-	0	0	1139	0.0000000
zheyou73v0_A01	10673173	10674940	BnaA01T0182200ZY	0	+	0	0	1767	0.0000000
zheyou73v0_A01	10675814	10676057	BnaA01T0182300ZY	0	-	0	0	243	0.0000000
zheyou73v0_A01	10678475	10679840	BnaA01T0182400ZY	0	+	0	0	1365	0.0000000
zheyou73v0_A01	10685801	10686190	BnaA01T0182500ZY	0	+	0	0	389	0.0000000
zheyou73v0_A01	10686530	10686737	BnaA01T0182600ZY	0	+	0	0	207	0.0000000
zheyou73v0_A01	10690486	10693192	BnaA01T0182700ZY	0	+	0	0	2706	0.0000000
zheyou73v0_A01	10693531	10696131	BnaA01T0182800ZY	0	-	0	0	2600	0.0000000
zheyou73v0_A01	10706328	10710206	BnaA01T0182900ZY	0	-	0	0	3878	0.0000000
zheyou73v0_A01	10711019	10713994	BnaA01T0183000ZY	0	-	0	0	2975	0.0000000
zheyou73v0_A01	10715972	10716866	BnaA01T0183100ZY	0	+	0	0	894	0.0000000
zheyou73v0_A01	10734332	10735502	BnaA01T0183200ZY	0	+	0	0	1170	0.0000000
zheyou73v0_A01	10736449	10743365	BnaA01T0183300ZY	0	+	0	0	6916	0.0000000
zheyou73v0_A01	10744544	10745644	BnaA01T0183400ZY	0	-	0	0	1100	0.0000000
zheyou73v0_A01	10748608	10752151	BnaA01T0183500ZY	0	-	0	0	3543	0.0000000
zheyou73v0_A01	10754394	10756184	BnaA01T0183600ZY	0	-	0	0	1790	0.0000000
zheyou73v0_A01	10756834	10757682	BnaA01T0183700ZY	0	+	0	0	848	0.0000000
zheyou73v0_A01	10758557	10760739	BnaA01T0183800ZY	0	+	0	0	2182	0.0000000
zheyou73v0_A01	10761692	10780745	BnaA01T0183900ZY	0	-	0	0	19053	0.0000000
zheyou73v0_A01	10786904	10788512	BnaA01T0184000ZY	0	+	0	0	1608	0.0000000
zheyou73v0_A01	10788941	10792809	BnaA01T0184100ZY	0	-	0	0	3868	0.0000000
zheyou73v0_A01	10793837	10795293	BnaA01T0184200ZY	0	+	0	0	1456	0.0000000
zheyou73v0_A01	10793837	10795293	BnaA01T0184200ZY.1	0	+	0	0	1456	0.0000000
zheyou73v0_A01	10798389	10800397	BnaA01T0184300ZY	0	+	0	0	2008	0.0000000
zheyou73v0_A01	10803271	10804142	BnaA01T0184400ZY	0	+	0	0	871	0.0000000
zheyou73v0_A01	10805218	10806412	BnaA01T0184500ZY	0	+	0	0	1194	0.0000000
zheyou73v0_A01	10816489	10816822	BnaA01T0184600ZY	0	-	0	0	333	0.0000000
zheyou73v0_A01	10819198	10819604	BnaA01T0184700ZY	0	-	0	0	406	0.0000000
zheyou73v0_A01	10820513	10821567	BnaA01T0184800ZY	0	+	0	0	1054	0.0000000
zheyou73v0_A01	10823368	10823641	BnaA01T0184900ZY	0	+	0	0	273	0.0000000
zheyou73v0_A01	10823791	10825643	BnaA01T0185000ZY	0	-	0	0	1852	0.0000000
zheyou73v0_A01	10828500	10828867	BnaA01T0185100ZY	0	+	0	0	367	0.0000000
zheyou73v0_A01	10830672	10831205	BnaA01T0185200ZY	0	+	0	0	533	0.0000000
zheyou73v0_A01	10833480	10836374	BnaA01T0185300ZY	0	+	0	0	2894	0.0000000
zheyou73v0_A01	10837531	10838533	BnaA01T0185400ZY	0	+	0	0	1002	0.0000000
zheyou73v0_A01	10840083	10840613	BnaA01T0185500ZY	0	+	0	0	530	0.0000000
zheyou73v0_A01	10854379	10855953	BnaA01T0185600ZY	0	+	0	0	1574	0.0000000
zheyou73v0_A01	10856567	10861353	BnaA01T0185700ZY	0	-	0	0	4786	0.0000000
zheyou73v0_A01	10863891	10866208	BnaA01T0185800ZY	0	+	0	0	2317	0.0000000
zheyou73v0_A01	10867034	10868266	BnaA01T0185900ZY	0	-	0	0	1232	0.0000000
zheyou73v0_A01	10888812	10889340	BnaA01T0186000ZY	0	-	0	0	528	0.0000000
zheyou73v0_A01	10891115	10892214	BnaA01T0186100ZY	0	-	0	0	1099	0.0000000
zheyou73v0_A01	10893316	10893997	BnaA01T0186200ZY	0	-	0	0	681	0.0000000
zheyou73v0_A01	10897036	10897615	BnaA01T0186300ZY	0	-	0	0	579	0.0000000
zheyou73v0_A01	10897630	10899299	BnaA01T0186400ZY	0	-	0	0	1669	0.0000000
zheyou73v0_A01	10912770	10918438	BnaA01T0186500ZY	0	+	0	0	5668	0.0000000
zheyou73v0_A01	10920129	10921162	BnaA01T0186600ZY	0	+	0	0	1033	0.0000000
zheyou73v0_A01	10922446	10926601	BnaA01T0186700ZY	0	+	0	0	4155	0.0000000
zheyou73v0_A01	10922446	10924188	BnaA01T0186700ZY.1	0	+	0	0	1742	0.0000000
zheyou73v0_A01	10925070	10926632	BnaA01T0186800ZY	0	-	0	0	1562	0.0000000
zheyou73v0_A01	10933874	10934419	BnaA01T0186900ZY	0	+	0	0	545	0.0000000
zheyou73v0_A01	10934593	10936764	BnaA01T0187000ZY	0	-	0	0	2171	0.0000000
zheyou73v0_A01	10936999	10939359	BnaA01T0187100ZY	0	-	0	0	2360	0.0000000
zheyou73v0_A01	10959877	10971414	BnaA01T0187200ZY	0	+	0	0	11537	0.0000000
zheyou73v0_A01	10971922	10973150	BnaA01T0187300ZY	0	+	0	0	1228	0.0000000
zheyou73v0_A01	10974788	10982270	BnaA01T0187400ZY	0	+	0	0	7482	0.0000000
zheyou73v0_A01	10985565	10986929	BnaA01T0187500ZY	0	-	0	0	1364	0.0000000
zheyou73v0_A01	10988360	10990005	BnaA01T0187600ZY	0	+	0	0	1645	0.0000000
zheyou73v0_A01	10991183	10993282	BnaA01T0187700ZY	0	+	0	0	2099	0.0000000
zheyou73v0_A01	11002234	11005426	BnaA01T0187800ZY	0	-	0	0	3192	0.0000000
zheyou73v0_A01	11021388	11023329	BnaA01T0187900ZY	0	+	0	0	1941	0.0000000
zheyou73v0_A01	11027964	11028951	BnaA01T0188000ZY	0	+	0	0	987	0.0000000
zheyou73v0_A01	11031719	11033986	BnaA01T0188100ZY	0	-	0	0	2267	0.0000000
zheyou73v0_A01	11034359	11039296	BnaA01T0188200ZY	0	+	0	0	4937	0.0000000
zheyou73v0_A01	11039793	11042646	BnaA01T0188300ZY	0	-	0	0	2853	0.0000000
zheyou73v0_A01	11042663	11042976	BnaA01T0188400ZY	0	-	0	0	313	0.0000000
zheyou73v0_A01	11043070	11043742	BnaA01T0188500ZY	0	-	0	0	672	0.0000000
zheyou73v0_A01	11045212	11046886	BnaA01T0188600ZY	0	-	0	0	1674	0.0000000
zheyou73v0_A01	11047290	11054589	BnaA01T0188700ZY	0	+	0	0	7299	0.0000000
zheyou73v0_A01	11064886	11071536	BnaA01T0188800ZY	0	+	0	0	6650	0.0000000
zheyou73v0_A01	11072672	11072882	BnaA01T0188900ZY	0	+	0	0	210	0.0000000
zheyou73v0_A01	11076430	11076640	BnaA01T0189000ZY	0	-	0	0	210	0.0000000
zheyou73v0_A01	11076897	11078108	BnaA01T0189100ZY	0	+	0	0	1211	0.0000000
zheyou73v0_A01	11078262	11079114	BnaA01T0189200ZY	0	+	0	0	852	0.0000000
zheyou73v0_A01	11084947	11086851	BnaA01T0189300ZY	0	+	0	0	1904	0.0000000
zheyou73v0_A01	11098251	11098934	BnaA01T0189400ZY	0	-	0	0	683	0.0000000
zheyou73v0_A01	11110752	11113059	BnaA01T0189500ZY	0	+	0	0	2307	0.0000000
zheyou73v0_A01	11115587	11117900	BnaA01T0189600ZY	0	+	0	0	2313	0.0000000
zheyou73v0_A01	11118201	11118496	BnaA01T0189700ZY	0	+	0	0	295	0.0000000
zheyou73v0_A01	11118931	11119412	BnaA01T0189800ZY	0	+	0	0	481	0.0000000
zheyou73v0_A01	11122205	11125002	BnaA01T0189900ZY	0	+	0	0	2797	0.0000000
zheyou73v0_A01	11132336	11133540	BnaA01T0190000ZY	0	+	0	0	1204	0.0000000
zheyou73v0_A01	11135582	11136573	BnaA01T0190100ZY	0	-	0	0	991	0.0000000
zheyou73v0_A01	11137722	11145437	BnaA01T0190200ZY	0	-	0	0	7715	0.0000000
zheyou73v0_A01	11147124	11148349	BnaA01T0190300ZY	0	+	0	0	1225	0.0000000
zheyou73v0_A01	11151986	11153143	BnaA01T0190400ZY	0	-	0	0	1157	0.0000000
zheyou73v0_A01	11155328	11157792	BnaA01T0190500ZY	0	+	0	0	2464	0.0000000
zheyou73v0_A01	11158520	11161293	BnaA01T0190600ZY	0	-	0	0	2773	0.0000000
zheyou73v0_A01	11158520	11161293	BnaA01T0190600ZY.1	0	-	0	0	2773	0.0000000
zheyou73v0_A01	11182906	11183332	BnaA01T0190700ZY	0	-	0	0	426	0.0000000
zheyou73v0_A01	11187611	11189738	BnaA01T0190800ZY	0	-	0	0	2127	0.0000000
zheyou73v0_A01	11221141	11221739	BnaA01T0190900ZY	0	-	0	0	598	0.0000000
zheyou73v0_A01	11227424	11228148	BnaA01T0191000ZY	0	+	0	0	724	0.0000000
zheyou73v0_A01	11230723	11232656	BnaA01T0191100ZY	0	+	0	0	1933	0.0000000
zheyou73v0_A01	11242501	11244463	BnaA01T0191200ZY	0	-	0	0	1962	0.0000000
zheyou73v0_A01	11258450	11265683	BnaA01T0191300ZY	0	-	0	0	7233	0.0000000
zheyou73v0_A01	11279246	11280189	BnaA01T0191400ZY	0	-	0	0	943	0.0000000
zheyou73v0_A01	11289436	11292199	BnaA01T0191500ZY	0	-	0	0	2763	0.0000000
zheyou73v0_A01	11294022	11294445	BnaA01T0191600ZY	0	+	0	0	423	0.0000000
zheyou73v0_A01	11304190	11307401	BnaA01T0191700ZY	0	+	0	0	3211	0.0000000
zheyou73v0_A01	11307635	11308490	BnaA01T0191800ZY	0	+	0	0	855	0.0000000
zheyou73v0_A01	11309337	11317878	BnaA01T0191900ZY	0	+	0	0	8541	0.0000000
zheyou73v0_A01	11318660	11320572	BnaA01T0192000ZY	0	-	0	0	1912	0.0000000
zheyou73v0_A01	11321209	11326273	BnaA01T0192100ZY	0	-	0	0	5064	0.0000000
zheyou73v0_A01	11329124	11329509	BnaA01T0192200ZY	0	+	0	0	385	0.0000000
zheyou73v0_A01	11341088	11341473	BnaA01T0192300ZY	0	-	0	0	385	0.0000000
zheyou73v0_A01	11341919	11342537	BnaA01T0192400ZY	0	+	0	0	618	0.0000000
zheyou73v0_A01	11347911	11350090	BnaA01T0192500ZY	0	+	0	0	2179	0.0000000
zheyou73v0_A01	11350974	11351538	BnaA01T0192600ZY	0	-	0	0	564	0.0000000
zheyou73v0_A01	11355689	11356682	BnaA01T0192700ZY	0	+	0	0	993	0.0000000
zheyou73v0_A01	11370095	11376893	BnaA01T0192800ZY	0	-	0	0	6798	0.0000000
zheyou73v0_A01	11377354	11377931	BnaA01T0192900ZY	0	+	0	0	577	0.0000000
zheyou73v0_A01	11388941	11390267	BnaA01T0193000ZY	0	+	0	0	1326	0.0000000
zheyou73v0_A01	11397462	11398293	BnaA01T0193100ZY	0	+	0	0	831	0.0000000
zheyou73v0_A01	11403982	11404594	BnaA01T0193200ZY	0	+	0	0	612	0.0000000
zheyou73v0_A01	11408814	11409524	BnaA01T0193300ZY	0	+	0	0	710	0.0000000
zheyou73v0_A01	11414118	11418874	BnaA01T0193400ZY	0	+	0	0	4756	0.0000000
zheyou73v0_A01	11439113	11439584	BnaA01T0193500ZY	0	-	0	0	471	0.0000000
zheyou73v0_A01	11449154	11456293	BnaA01T0193600ZY	0	+	0	0	7139	0.0000000
zheyou73v0_A01	11456550	11461585	BnaA01T0193700ZY	0	-	0	0	5035	0.0000000
zheyou73v0_A01	11456550	11461585	BnaA01T0193700ZY.1	0	-	0	0	5035	0.0000000
zheyou73v0_A01	11462111	11463446	BnaA01T0193800ZY	0	-	0	0	1335	0.0000000
zheyou73v0_A01	11465259	11468858	BnaA01T0193900ZY	0	-	0	0	3599	0.0000000
zheyou73v0_A01	11474115	11476164	BnaA01T0194000ZY	0	+	0	0	2049	0.0000000
zheyou73v0_A01	11476182	11477918	BnaA01T0194100ZY	0	-	0	0	1736	0.0000000
zheyou73v0_A01	11484063	11484997	BnaA01T0194200ZY	0	+	0	0	934	0.0000000
zheyou73v0_A01	11504846	11507039	BnaA01T0194300ZY	0	+	0	0	2193	0.0000000
zheyou73v0_A01	11508699	11515447	BnaA01T0194400ZY	0	+	0	0	6748	0.0000000
zheyou73v0_A01	11515161	11516815	BnaA01T0194500ZY	0	-	0	0	1654	0.0000000
zheyou73v0_A01	11517373	11518767	BnaA01T0194600ZY	0	-	0	0	1394	0.0000000
zheyou73v0_A01	11519096	11523752	BnaA01T0194700ZY	0	-	0	0	4656	0.0000000
zheyou73v0_A01	11528952	11529874	BnaA01T0194800ZY	0	-	0	0	922	0.0000000
zheyou73v0_A01	11530387	11531944	BnaA01T0194900ZY	0	+	0	0	1557	0.0000000
zheyou73v0_A01	11535124	11536131	BnaA01T0195000ZY	0	+	0	0	1007	0.0000000
zheyou73v0_A01	11557931	11559643	BnaA01T0195100ZY	0	+	0	0	1712	0.0000000
zheyou73v0_A01	11567263	11568694	BnaA01T0195200ZY	0	+	0	0	1431	0.0000000
zheyou73v0_A01	11576403	11578597	BnaA01T0195300ZY	0	-	0	0	2194	0.0000000
zheyou73v0_A01	11579400	11580733	BnaA01T0195400ZY	0	+	0	0	1333	0.0000000
zheyou73v0_A01	11583475	11585093	BnaA01T0195500ZY	0	+	0	0	1618	0.0000000
zheyou73v0_A01	11590149	11593389	BnaA01T0195600ZY	0	-	0	0	3240	0.0000000
zheyou73v0_A01	11614843	11615503	BnaA01T0195700ZY	0	+	0	0	660	0.0000000
zheyou73v0_A01	11619566	11620853	BnaA01T0195800ZY	0	-	0	0	1287	0.0000000
zheyou73v0_A01	11627028	11627688	BnaA01T0195900ZY	0	+	0	0	660	0.0000000
zheyou73v0_A01	11635742	11637289	BnaA01T0196000ZY	0	-	0	0	1547	0.0000000
zheyou73v0_A01	11639970	11642165	BnaA01T0196100ZY	0	-	0	0	2195	0.0000000
zheyou73v0_A01	11649773	11654247	BnaA01T0196200ZY	0	-	0	0	4474	0.0000000
zheyou73v0_A01	11658176	11658335	BnaA01T0196300ZY	0	+	0	0	159	0.0000000
zheyou73v0_A01	11673935	11674752	BnaA01T0196400ZY	0	-	0	0	817	0.0000000
zheyou73v0_A01	11696172	11697662	BnaA01T0196500ZY	0	+	0	0	1490	0.0000000
zheyou73v0_A01	11698110	11699454	BnaA01T0196600ZY	0	+	0	0	1344	0.0000000
zheyou73v0_A01	11702269	11704177	BnaA01T0196700ZY	0	-	0	0	1908	0.0000000
zheyou73v0_A01	11707876	11708413	BnaA01T0196800ZY	0	-	0	0	537	0.0000000
zheyou73v0_A01	11714051	11716523	BnaA01T0196900ZY	0	+	0	0	2472	0.0000000
zheyou73v0_A01	11717333	11729905	BnaA01T0197000ZY	0	+	0	0	12572	0.0000000
zheyou73v0_A01	11730011	11731380	BnaA01T0197100ZY	0	+	0	0	1369	0.0000000
zheyou73v0_A01	11738583	11741742	BnaA01T0197200ZY	0	+	0	0	3159	0.0000000
zheyou73v0_A01	11741864	11752222	BnaA01T0197300ZY	0	-	0	0	10358	0.0000000
zheyou73v0_A01	11758485	11759361	BnaA01T0197400ZY	0	-	0	0	876	0.0000000
zheyou73v0_A01	11777922	11779516	BnaA01T0197500ZY	0	-	0	0	1594	0.0000000
zheyou73v0_A01	11777922	11779516	BnaA01T0197500ZY.1	0	-	0	0	1594	0.0000000
zheyou73v0_A01	11777922	11779516	BnaA01T0197500ZY.2	0	-	0	0	1594	0.0000000
zheyou73v0_A01	11783669	11784402	BnaA01T0197600ZY	0	-	0	0	733	0.0000000
zheyou73v0_A01	11789524	11790592	BnaA01T0197700ZY	0	+	0	0	1068	0.0000000
zheyou73v0_A01	11801145	11804701	BnaA01T0197800ZY	0	+	0	0	3556	0.0000000
zheyou73v0_A01	11801407	11804701	BnaA01T0197800ZY.1	0	+	0	0	3294	0.0000000
zheyou73v0_A01	11807034	11815647	BnaA01T0197900ZY	0	-	0	0	8613	0.0000000
zheyou73v0_A01	11828817	11829659	BnaA01T0198000ZY	0	-	0	0	842	0.0000000
zheyou73v0_A01	11840823	11847786	BnaA01T0198100ZY	0	+	0	0	6963	0.0000000
zheyou73v0_A01	11862913	11864034	BnaA01T0198200ZY	0	-	0	0	1121	0.0000000
zheyou73v0_A01	11864371	11868280	BnaA01T0198300ZY	0	+	0	0	3909	0.0000000
zheyou73v0_A01	11867928	11870383	BnaA01T0198400ZY	0	-	0	0	2455	0.0000000
zheyou73v0_A01	11884032	11886247	BnaA01T0198500ZY	0	+	0	0	2215	0.0000000
zheyou73v0_A01	11886739	11887439	BnaA01T0198600ZY	0	-	0	0	700	0.0000000
zheyou73v0_A01	11890702	11894341	BnaA01T0198700ZY	0	+	0	0	3639	0.0000000
zheyou73v0_A01	11898493	11900352	BnaA01T0198800ZY	0	-	0	0	1859	0.0000000
zheyou73v0_A01	11903197	11906360	BnaA01T0198900ZY	0	-	0	0	3163	0.0000000
zheyou73v0_A01	11909900	11919811	BnaA01T0199000ZY	0	-	0	0	9911	0.0000000
zheyou73v0_A01	11922347	11934195	BnaA01T0199100ZY	0	+	0	0	11848	0.0000000
zheyou73v0_A01	11942153	11943161	BnaA01T0199200ZY	0	+	0	0	1008	0.0000000
zheyou73v0_A01	11954514	11954793	BnaA01T0199300ZY	0	-	0	0	279	0.0000000
zheyou73v0_A01	11955643	11957730	BnaA01T0199400ZY	0	+	0	0	2087	0.0000000
zheyou73v0_A01	11955643	11957730	BnaA01T0199400ZY.1	0	+	0	0	2087	0.0000000
zheyou73v0_A01	11958622	11959078	BnaA01T0199500ZY	0	-	0	0	456	0.0000000
zheyou73v0_A01	11959356	11962642	BnaA01T0199600ZY	0	+	0	0	3286	0.0000000
zheyou73v0_A01	11959356	11962642	BnaA01T0199600ZY.1	0	+	0	0	3286	0.0000000
zheyou73v0_A01	11959688	11962642	BnaA01T0199600ZY.2	0	+	0	0	2954	0.0000000
zheyou73v0_A01	11962098	11962620	BnaA01T0199700ZY	0	-	0	0	522	0.0000000
zheyou73v0_A01	11962803	11963448	BnaA01T0199800ZY	0	-	0	0	645	0.0000000
zheyou73v0_A01	11969989	11972372	BnaA01T0199900ZY	0	+	0	0	2383	0.0000000
zheyou73v0_A01	11978110	11978622	BnaA01T0200000ZY	0	-	0	0	512	0.0000000
zheyou73v0_A01	11981577	11981941	BnaA01T0200100ZY	0	-	0	0	364	0.0000000
zheyou73v0_A01	11987190	11987860	BnaA01T0200200ZY	0	-	0	0	670	0.0000000
zheyou73v0_A01	11988002	11989635	BnaA01T0200300ZY	0	-	0	0	1633	0.0000000
zheyou73v0_A01	11989870	11993898	BnaA01T0200400ZY	0	+	0	0	4028	0.0000000
zheyou73v0_A01	11989870	11992961	BnaA01T0200400ZY.1	0	+	0	0	3091	0.0000000
zheyou73v0_A01	12025632	12028995	BnaA01T0200500ZY	0	+	0	0	3363	0.0000000
zheyou73v0_A01	12029189	12034582	BnaA01T0200600ZY	0	-	0	0	5393	0.0000000
zheyou73v0_A01	12050254	12051643	BnaA01T0200700ZY	0	-	0	0	1389	0.0000000
zheyou73v0_A01	12068511	12075598	BnaA01T0200800ZY	0	-	0	0	7087	0.0000000
zheyou73v0_A01	12082809	12084573	BnaA01T0200900ZY	0	+	0	0	1764	0.0000000
zheyou73v0_A01	12084658	12085143	BnaA01T0201000ZY	0	+	0	0	485	0.0000000
zheyou73v0_A01	12100062	12101883	BnaA01T0201100ZY	0	+	0	0	1821	0.0000000
zheyou73v0_A01	12100227	12101883	BnaA01T0201100ZY.1	0	+	0	0	1656	0.0000000
zheyou73v0_A01	12103409	12109986	BnaA01T0201200ZY	0	+	0	0	6577	0.0000000
zheyou73v0_A01	12126893	12127352	BnaA01T0201300ZY	0	+	0	0	459	0.0000000
zheyou73v0_A01	12136840	12140635	BnaA01T0201400ZY	0	+	0	0	3795	0.0000000
zheyou73v0_A01	12143456	12144659	BnaA01T0201500ZY	0	-	0	0	1203	0.0000000
zheyou73v0_A01	12182707	12183279	BnaA01T0201600ZY	0	-	0	0	572	0.0000000
zheyou73v0_A01	12202259	12202676	BnaA01T0201700ZY	0	-	0	0	417	0.0000000
zheyou73v0_A01	12209729	12212020	BnaA01T0201800ZY	0	+	0	0	2291	0.0000000
zheyou73v0_A01	12212996	12214983	BnaA01T0201900ZY	0	+	0	0	1987	0.0000000
zheyou73v0_A01	12220117	12221396	BnaA01T0202000ZY	0	-	0	0	1279	0.0000000
zheyou73v0_A01	12225500	12227492	BnaA01T0202100ZY	0	+	0	0	1992	0.0000000
zheyou73v0_A01	12229949	12234007	BnaA01T0202200ZY	0	+	0	0	4058	0.0000000
zheyou73v0_A01	12242763	12243779	BnaA01T0202300ZY	0	+	0	0	1016	0.0000000
zheyou73v0_A01	12244175	12245573	BnaA01T0202400ZY	0	-	0	0	1398	0.0000000
zheyou73v0_A01	12244175	12245573	BnaA01T0202400ZY.1	0	-	0	0	1398	0.0000000
zheyou73v0_A01	12275603	12277158	BnaA01T0202500ZY	0	+	0	0	1555	0.0000000
zheyou73v0_A01	12286171	12288297	BnaA01T0202600ZY	0	-	0	0	2126	0.0000000
zheyou73v0_A01	12342574	12346281	BnaA01T0202700ZY	0	-	0	0	3707	0.0000000
zheyou73v0_A01	12368026	12369087	BnaA01T0202800ZY	0	-	0	0	1061	0.0000000
zheyou73v0_A01	12386113	12387644	BnaA01T0202900ZY	0	+	0	0	1531	0.0000000
zheyou73v0_A01	12398932	12402120	BnaA01T0203000ZY	0	+	0	0	3188	0.0000000
zheyou73v0_A01	12412104	12421332	BnaA01T0203100ZY	0	-	0	0	9228	0.0000000
zheyou73v0_A01	12433127	12434176	BnaA01T0203200ZY	0	+	0	0	1049	0.0000000
zheyou73v0_A01	12444949	12449279	BnaA01T0203300ZY	0	+	0	0	4330	0.0000000
zheyou73v0_A01	12448762	12450916	BnaA01T0203400ZY	0	-	0	0	2154	0.0000000
zheyou73v0_A01	12453983	12457978	BnaA01T0203500ZY	0	-	0	0	3995	0.0000000
zheyou73v0_A01	12459087	12459420	BnaA01T0203600ZY	0	+	0	0	333	0.0000000
zheyou73v0_A01	12460234	12468436	BnaA01T0203700ZY	0	+	0	0	8202	0.0000000
zheyou73v0_A01	12473561	12478815	BnaA01T0203800ZY	0	+	0	0	5254	0.0000000
zheyou73v0_A01	12497135	12500137	BnaA01T0203900ZY	0	-	0	0	3002	0.0000000
zheyou73v0_A01	12500729	12501742	BnaA01T0204000ZY	0	+	0	0	1013	0.0000000
zheyou73v0_A01	12503964	12507297	BnaA01T0204100ZY	0	-	0	0	3333	0.0000000
zheyou73v0_A01	12514331	12516777	BnaA01T0204200ZY	0	+	0	0	2446	0.0000000
zheyou73v0_A01	12519300	12520101	BnaA01T0204300ZY	0	+	0	0	801	0.0000000
zheyou73v0_A01	12526597	12527256	BnaA01T0204400ZY	0	+	0	0	659	0.0000000
zheyou73v0_A01	12528799	12530027	BnaA01T0204500ZY	0	-	0	0	1228	0.0000000
zheyou73v0_A01	12533604	12533924	BnaA01T0204600ZY	0	+	0	0	320	0.0000000
zheyou73v0_A01	12535296	12538419	BnaA01T0204700ZY	0	+	0	0	3123	0.0000000
zheyou73v0_A01	12540379	12542329	BnaA01T0204800ZY	0	-	0	0	1950	0.0000000
zheyou73v0_A01	12540379	12542329	BnaA01T0204800ZY.1	0	-	0	0	1950	0.0000000
zheyou73v0_A01	12542685	12543844	BnaA01T0204900ZY	0	-	0	0	1159	0.0000000
zheyou73v0_A01	12544272	12544587	BnaA01T0205000ZY	0	-	0	0	315	0.0000000
zheyou73v0_A01	12547736	12550350	BnaA01T0205100ZY	0	+	0	0	2614	0.0000000
zheyou73v0_A01	12551131	12552549	BnaA01T0205200ZY	0	+	0	0	1418	0.0000000
zheyou73v0_A01	12554420	12558406	BnaA01T0205300ZY	0	-	0	0	3986	0.0000000
zheyou73v0_A01	12563245	12564944	BnaA01T0205400ZY	0	-	0	0	1699	0.0000000
zheyou73v0_A01	12563245	12564944	BnaA01T0205400ZY.1	0	-	0	0	1699	0.0000000
zheyou73v0_A01	12567071	12569065	BnaA01T0205500ZY	0	-	0	0	1994	0.0000000
zheyou73v0_A01	12567071	12569065	BnaA01T0205500ZY.1	0	-	0	0	1994	0.0000000
zheyou73v0_A01	12582466	12583533	BnaA01T0205600ZY	0	+	0	0	1067	0.0000000
zheyou73v0_A01	12583553	12584844	BnaA01T0205700ZY	0	-	0	0	1291	0.0000000
zheyou73v0_A01	12592324	12593649	BnaA01T0205800ZY	0	-	0	0	1325	0.0000000
zheyou73v0_A01	12592324	12593649	BnaA01T0205800ZY.1	0	-	0	0	1325	0.0000000
zheyou73v0_A01	12609546	12611149	BnaA01T0205900ZY	0	+	0	0	1603	0.0000000
zheyou73v0_A01	12618471	12620119	BnaA01T0206000ZY	0	-	0	0	1648	0.0000000
zheyou73v0_A01	12626498	12627903	BnaA01T0206100ZY	0	-	0	0	1405	0.0000000
zheyou73v0_A01	12629160	12629648	BnaA01T0206200ZY	0	-	0	0	488	0.0000000
zheyou73v0_A01	12629854	12633046	BnaA01T0206300ZY	0	-	0	0	3192	0.0000000
zheyou73v0_A01	12634880	12635874	BnaA01T0206400ZY	0	+	0	0	994	0.0000000
zheyou73v0_A01	12643176	12644725	BnaA01T0206500ZY	0	-	0	0	1549	0.0000000
zheyou73v0_A01	12649147	12650415	BnaA01T0206600ZY	0	+	0	0	1268	0.0000000
zheyou73v0_A01	12652894	12653988	BnaA01T0206700ZY	0	-	0	0	1094	0.0000000
zheyou73v0_A01	12657609	12662401	BnaA01T0206800ZY	0	+	0	0	4792	0.0000000
zheyou73v0_A01	12675497	12676130	BnaA01T0206900ZY	0	-	0	0	633	0.0000000
zheyou73v0_A01	12683472	12685265	BnaA01T0207000ZY	0	+	0	0	1793	0.0000000
zheyou73v0_A01	12687764	12689310	BnaA01T0207100ZY	0	-	0	0	1546	0.0000000
zheyou73v0_A01	12703247	12707052	BnaA01T0207200ZY	0	-	0	0	3805	0.0000000
zheyou73v0_A01	12736032	12737974	BnaA01T0207300ZY	0	-	0	0	1942	0.0000000
zheyou73v0_A01	12776984	12778298	BnaA01T0207400ZY	0	+	0	0	1314	0.0000000
zheyou73v0_A01	12781902	12783415	BnaA01T0207500ZY	0	+	0	0	1513	0.0000000
zheyou73v0_A01	12789143	12790478	BnaA01T0207600ZY	0	+	0	0	1335	0.0000000
zheyou73v0_A01	12790809	12791127	BnaA01T0207700ZY	0	-	0	0	318	0.0000000
zheyou73v0_A01	12791208	12792216	BnaA01T0207800ZY	0	-	0	0	1008	0.0000000
zheyou73v0_A01	12795375	12797433	BnaA01T0207900ZY	0	-	0	0	2058	0.0000000
zheyou73v0_A01	12804925	12806879	BnaA01T0208000ZY	0	-	0	0	1954	0.0000000
zheyou73v0_A01	12816790	12818037	BnaA01T0208100ZY	0	-	0	0	1247	0.0000000
zheyou73v0_A01	12820083	12820946	BnaA01T0208200ZY	0	-	0	0	863	0.0000000
zheyou73v0_A01	12840353	12842425	BnaA01T0208300ZY	0	-	0	0	2072	0.0000000
zheyou73v0_A01	12845466	12846178	BnaA01T0208400ZY	0	-	0	0	712	0.0000000
zheyou73v0_A01	12850101	12852018	BnaA01T0208500ZY	0	-	0	0	1917	0.0000000
zheyou73v0_A01	12866577	12867138	BnaA01T0208600ZY	0	+	0	0	561	0.0000000
zheyou73v0_A01	12870342	12871782	BnaA01T0208700ZY	0	+	0	0	1440	0.0000000
zheyou73v0_A01	12870342	12871782	BnaA01T0208700ZY.1	0	+	0	0	1440	0.0000000
zheyou73v0_A01	12881515	12883214	BnaA01T0208800ZY	0	+	0	0	1699	0.0000000
zheyou73v0_A01	12885570	12886134	BnaA01T0208900ZY	0	-	0	0	564	0.0000000
zheyou73v0_A01	12906289	12907524	BnaA01T0209000ZY	0	+	0	0	1235	0.0000000
zheyou73v0_A01	12943312	12943492	BnaA01T0209100ZY	0	+	0	0	180	0.0000000
zheyou73v0_A01	12958773	12961362	BnaA01T0209200ZY	0	+	0	0	2589	0.0000000
zheyou73v0_A01	12969108	12972200	BnaA01T0209300ZY	0	-	0	0	3092	0.0000000
zheyou73v0_A01	12972501	12974411	BnaA01T0209400ZY	0	-	0	0	1910	0.0000000
zheyou73v0_A01	12998895	13002104	BnaA01T0209500ZY	0	+	0	0	3209	0.0000000
zheyou73v0_A01	12998895	13004587	BnaA01T0209500ZY.1	0	+	0	0	5692	0.0000000
zheyou73v0_A01	13023033	13023609	BnaA01T0209600ZY	0	+	0	0	576	0.0000000
zheyou73v0_A01	13048018	13049086	BnaA01T0209700ZY	0	+	0	0	1068	0.0000000
zheyou73v0_A01	13053077	13053503	BnaA01T0209800ZY	0	+	0	0	426	0.0000000
zheyou73v0_A01	13072206	13072755	BnaA01T0209900ZY	0	-	0	0	549	0.0000000
zheyou73v0_A01	13074936	13075194	BnaA01T0210000ZY	0	+	0	0	258	0.0000000
zheyou73v0_A01	13077572	13080706	BnaA01T0210100ZY	0	+	0	0	3134	0.0000000
zheyou73v0_A01	13089345	13092298	BnaA01T0210200ZY	0	-	0	0	2953	0.0000000
zheyou73v0_A01	13101712	13102873	BnaA01T0210300ZY	0	-	0	0	1161	0.0000000
zheyou73v0_A01	13123062	13123608	BnaA01T0210400ZY	0	+	0	0	546	0.0000000
zheyou73v0_A01	13126302	13128214	BnaA01T0210500ZY	0	-	0	0	1912	0.0000000
zheyou73v0_A01	13133418	13136426	BnaA01T0210600ZY	0	-	0	0	3008	0.0000000
zheyou73v0_A01	13137453	13138161	BnaA01T0210700ZY	0	-	0	0	708	0.0000000
zheyou73v0_A01	13146655	13148807	BnaA01T0210800ZY	0	-	0	0	2152	0.0000000
zheyou73v0_A01	13159337	13173666	BnaA01T0210900ZY	0	+	0	0	14329	0.0000000
zheyou73v0_A01	13174343	13174691	BnaA01T0211000ZY	0	+	0	0	348	0.0000000
zheyou73v0_A01	13175493	13177016	BnaA01T0211100ZY	0	-	0	0	1523	0.0000000
zheyou73v0_A01	13196589	13198058	BnaA01T0211200ZY	0	+	0	0	1469	0.0000000
zheyou73v0_A01	13222061	13222754	BnaA01T0211300ZY	0	+	0	0	693	0.0000000
zheyou73v0_A01	13236407	13237427	BnaA01T0211400ZY	0	+	0	0	1020	0.0000000
zheyou73v0_A01	13244365	13245021	BnaA01T0211500ZY	0	-	0	0	656	0.0000000
zheyou73v0_A01	13247750	13249300	BnaA01T0211600ZY	0	-	0	0	1550	0.0000000
zheyou73v0_A01	13250703	13250955	BnaA01T0211700ZY	0	-	0	0	252	0.0000000
zheyou73v0_A01	13257017	13259801	BnaA01T0211800ZY	0	-	0	0	2784	0.0000000
zheyou73v0_A01	13277017	13278941	BnaA01T0211900ZY	0	-	0	0	1924	0.0000000
zheyou73v0_A01	13289220	13291140	BnaA01T0212000ZY	0	-	0	0	1920	0.0000000
zheyou73v0_A01	13293027	13294811	BnaA01T0212100ZY	0	-	0	0	1784	0.0000000
zheyou73v0_A01	13296445	13296655	BnaA01T0212200ZY	0	+	0	0	210	0.0000000
zheyou73v0_A01	13307300	13308772	BnaA01T0212300ZY	0	+	0	0	1472	0.0000000
zheyou73v0_A01	13310714	13314631	BnaA01T0212400ZY	0	-	0	0	3917	0.0000000
zheyou73v0_A01	13319825	13320492	BnaA01T0212500ZY	0	+	0	0	667	0.0000000
zheyou73v0_A01	13326106	13329260	BnaA01T0212600ZY	0	+	0	0	3154	0.0000000
zheyou73v0_A01	13333468	13334863	BnaA01T0212700ZY	0	+	0	0	1395	0.0000000
zheyou73v0_A01	13336823	13338559	BnaA01T0212800ZY	0	+	0	0	1736	0.0000000
zheyou73v0_A01	13348095	13350538	BnaA01T0212900ZY	0	-	0	0	2443	0.0000000
zheyou73v0_A01	13359176	13360208	BnaA01T0213000ZY	0	-	0	0	1032	0.0000000
zheyou73v0_A01	13364253	13364694	BnaA01T0213100ZY	0	-	0	0	441	0.0000000
zheyou73v0_A01	13366086	13367965	BnaA01T0213200ZY	0	+	0	0	1879	0.0000000
zheyou73v0_A01	13369631	13371325	BnaA01T0213300ZY	0	-	0	0	1694	0.0000000
zheyou73v0_A01	13371691	13374355	BnaA01T0213400ZY	0	+	0	0	2664	0.0000000
zheyou73v0_A01	13374572	13376212	BnaA01T0213500ZY	0	-	0	0	1640	0.0000000
zheyou73v0_A01	13378359	13379428	BnaA01T0213600ZY	0	-	0	0	1069	0.0000000
zheyou73v0_A01	13391103	13391505	BnaA01T0213700ZY	0	-	0	0	402	0.0000000
zheyou73v0_A01	13406714	13409104	BnaA01T0213800ZY	0	+	0	0	2390	0.0000000
zheyou73v0_A01	13418234	13420112	BnaA01T0213900ZY	0	+	0	0	1878	0.0000000
zheyou73v0_A01	13425369	13426649	BnaA01T0214000ZY	0	+	0	0	1280	0.0000000
zheyou73v0_A01	13440619	13441607	BnaA01T0214100ZY	0	-	0	0	988	0.0000000
zheyou73v0_A01	13464955	13465243	BnaA01T0214200ZY	0	+	0	0	288	0.0000000
zheyou73v0_A01	13468149	13468425	BnaA01T0214300ZY	0	+	0	0	276	0.0000000
zheyou73v0_A01	13481681	13482759	BnaA01T0214400ZY	0	+	0	0	1078	0.0000000
zheyou73v0_A01	13484936	13486897	BnaA01T0214500ZY	0	+	0	0	1961	0.0000000
zheyou73v0_A01	13484936	13486897	BnaA01T0214500ZY.1	0	+	0	0	1961	0.0000000
zheyou73v0_A01	13490233	13492810	BnaA01T0214600ZY	0	-	0	0	2577	0.0000000
zheyou73v0_A01	13506949	13511040	BnaA01T0214700ZY	0	-	0	0	4091	0.0000000
zheyou73v0_A01	13524145	13524313	BnaA01T0214800ZY	0	-	0	0	168	0.0000000
zheyou73v0_A01	13524691	13525420	BnaA01T0214900ZY	0	+	0	0	729	0.0000000
zheyou73v0_A01	13527021	13527474	BnaA01T0215000ZY	0	-	0	0	453	0.0000000
zheyou73v0_A01	13529704	13530133	BnaA01T0215100ZY	0	-	0	0	429	0.0000000
zheyou73v0_A01	13538842	13539259	BnaA01T0215200ZY	0	+	0	0	417	0.0000000
zheyou73v0_A01	13559383	13561721	BnaA01T0215300ZY	0	+	0	0	2338	0.0000000
zheyou73v0_A01	13567248	13568280	BnaA01T0215400ZY	0	-	0	0	1032	0.0000000
zheyou73v0_A01	13574533	13579863	BnaA01T0215500ZY	0	-	0	0	5330	0.0000000
zheyou73v0_A01	13588742	13590195	BnaA01T0215600ZY	0	+	0	0	1453	0.0000000
zheyou73v0_A01	13594378	13599228	BnaA01T0215700ZY	0	+	0	0	4850	0.0000000
zheyou73v0_A01	13602822	13605883	BnaA01T0215800ZY	0	+	0	0	3061	0.0000000
zheyou73v0_A01	13611005	13613914	BnaA01T0215900ZY	0	-	0	0	2909	0.0000000
zheyou73v0_A01	13615222	13618879	BnaA01T0216000ZY	0	-	0	0	3657	0.0000000
zheyou73v0_A01	13619327	13624365	BnaA01T0216100ZY	0	+	0	0	5038	0.0000000
zheyou73v0_A01	13626988	13630130	BnaA01T0216200ZY	0	-	0	0	3142	0.0000000
zheyou73v0_A01	13642193	13643353	BnaA01T0216300ZY	0	+	0	0	1160	0.0000000
zheyou73v0_A01	13676426	13678060	BnaA01T0216400ZY	0	+	0	0	1634	0.0000000
zheyou73v0_A01	13680579	13682614	BnaA01T0216500ZY	0	-	0	0	2035	0.0000000
zheyou73v0_A01	13688929	13691501	BnaA01T0216600ZY	0	+	0	0	2572	0.0000000
zheyou73v0_A01	13698773	13700714	BnaA01T0216700ZY	0	-	0	0	1941	0.0000000
zheyou73v0_A01	13703802	13707671	BnaA01T0216800ZY	0	-	0	0	3869	0.0000000
zheyou73v0_A01	13714019	13718099	BnaA01T0216900ZY	0	+	0	0	4080	0.0000000
zheyou73v0_A01	13734420	13734931	BnaA01T0217000ZY	0	-	0	0	511	0.0000000
zheyou73v0_A01	13736105	13736675	BnaA01T0217100ZY	0	-	0	0	570	0.0000000
zheyou73v0_A01	13753329	13757347	BnaA01T0217200ZY	0	+	0	0	4018	0.0000000
zheyou73v0_A01	13766468	13769647	BnaA01T0217300ZY	0	+	0	0	3179	0.0000000
zheyou73v0_A01	13772479	13774660	BnaA01T0217400ZY	0	-	0	0	2181	0.0000000
zheyou73v0_A01	13777860	13782033	BnaA01T0217500ZY	0	+	0	0	4173	0.0000000
zheyou73v0_A01	13786570	13788632	BnaA01T0217600ZY	0	+	0	0	2062	0.0000000
zheyou73v0_A01	13801374	13804067	BnaA01T0217700ZY	0	-	0	0	2693	0.0000000
zheyou73v0_A01	13821906	13830428	BnaA01T0217800ZY	0	-	0	0	8522	0.0000000
zheyou73v0_A01	13831464	13832796	BnaA01T0217900ZY	0	+	0	0	1332	0.0000000
zheyou73v0_A01	13833073	13834453	BnaA01T0218000ZY	0	-	0	0	1380	0.0000000
zheyou73v0_A01	13834696	13836103	BnaA01T0218100ZY	0	-	0	0	1407	0.0000000
zheyou73v0_A01	13839958	13841164	BnaA01T0218200ZY	0	+	0	0	1206	0.0000000
zheyou73v0_A01	13845207	13846514	BnaA01T0218300ZY	0	+	0	0	1307	0.0000000
zheyou73v0_A01	13848473	13848977	BnaA01T0218400ZY	0	-	0	0	504	0.0000000
zheyou73v0_A01	13849464	13853674	BnaA01T0218500ZY	0	+	0	0	4210	0.0000000
zheyou73v0_A01	13854716	13856281	BnaA01T0218600ZY	0	+	0	0	1565	0.0000000
zheyou73v0_A01	13859118	13860336	BnaA01T0218700ZY	0	+	0	0	1218	0.0000000
zheyou73v0_A01	13860726	13864894	BnaA01T0218800ZY	0	-	0	0	4168	0.0000000
zheyou73v0_A01	13876714	13878610	BnaA01T0218900ZY	0	-	0	0	1896	0.0000000
zheyou73v0_A01	13876714	13878610	BnaA01T0218900ZY.1	0	-	0	0	1896	0.0000000
zheyou73v0_A01	13879535	13883138	BnaA01T0219000ZY	0	+	0	0	3603	0.0000000
zheyou73v0_A01	13887385	13889350	BnaA01T0219100ZY	0	-	0	0	1965	0.0000000
zheyou73v0_A01	13893511	13894699	BnaA01T0219200ZY	0	+	0	0	1188	0.0000000
zheyou73v0_A01	13894819	13897498	BnaA01T0219300ZY	0	-	0	0	2679	0.0000000
zheyou73v0_A01	13899564	13900938	BnaA01T0219400ZY	0	-	0	0	1374	0.0000000
zheyou73v0_A01	13903036	13904843	BnaA01T0219500ZY	0	-	0	0	1807	0.0000000
zheyou73v0_A01	13948037	13952030	BnaA01T0219600ZY	0	+	0	0	3993	0.0000000
zheyou73v0_A01	13970510	13970929	BnaA01T0219700ZY	0	-	0	0	419	0.0000000
zheyou73v0_A01	13979465	13985791	BnaA01T0219800ZY	0	+	0	0	6326	0.0000000
zheyou73v0_A01	13994338	13994718	BnaA01T0219900ZY	0	+	0	0	380	0.0000000
zheyou73v0_A01	14004945	14011257	BnaA01T0220000ZY	0	+	0	0	6312	0.0000000
zheyou73v0_A01	14013524	14013680	BnaA01T0220100ZY	0	+	0	0	156	0.0000000
zheyou73v0_A01	14015758	14023268	BnaA01T0220200ZY	0	+	0	0	7510	0.0000000
zheyou73v0_A01	14031192	14032190	BnaA01T0220300ZY	0	-	0	0	998	0.0000000
zheyou73v0_A01	14047896	14050133	BnaA01T0220400ZY	0	+	0	0	2237	0.0000000
zheyou73v0_A01	14068687	14075419	BnaA01T0220500ZY	0	-	0	0	6732	0.0000000
zheyou73v0_A01	14084467	14086819	BnaA01T0220600ZY	0	-	0	0	2352	0.0000000
zheyou73v0_A01	14095404	14097755	BnaA01T0220700ZY	0	+	0	0	2351	0.0000000
zheyou73v0_A01	14098294	14100265	BnaA01T0220800ZY	0	-	0	0	1971	0.0000000
zheyou73v0_A01	14106809	14108905	BnaA01T0220900ZY	0	-	0	0	2096	0.0000000
zheyou73v0_A01	14126288	14127097	BnaA01T0221000ZY	0	-	0	0	809	0.0000000
zheyou73v0_A01	14161996	14162430	BnaA01T0221100ZY	0	-	0	0	434	0.0000000
zheyou73v0_A01	14176521	14179323	BnaA01T0221200ZY	0	-	0	0	2802	0.0000000
zheyou73v0_A01	14176521	14179323	BnaA01T0221200ZY.1	0	-	0	0	2802	0.0000000
zheyou73v0_A01	14176521	14179132	BnaA01T0221200ZY.2	0	-	0	0	2611	0.0000000
zheyou73v0_A01	14186240	14188365	BnaA01T0221300ZY	0	+	0	0	2125	0.0000000
zheyou73v0_A01	14188671	14189759	BnaA01T0221400ZY	0	+	0	0	1088	0.0000000
zheyou73v0_A01	14190037	14190277	BnaA01T0221500ZY	0	-	0	0	240	0.0000000
zheyou73v0_A01	14193674	14201916	BnaA01T0221600ZY	0	-	0	0	8242	0.0000000
zheyou73v0_A01	14218294	14222003	BnaA01T0221700ZY	0	-	0	0	3709	0.0000000
zheyou73v0_A01	14244247	14245206	BnaA01T0221800ZY	0	+	0	0	959	0.0000000
zheyou73v0_A01	14251940	14252538	BnaA01T0221900ZY	0	+	0	0	598	0.0000000
zheyou73v0_A01	14285199	14286736	BnaA01T0222000ZY	0	+	0	0	1537	0.0000000
zheyou73v0_A01	14289109	14289262	BnaA01T0222100ZY	0	-	0	0	153	0.0000000
zheyou73v0_A01	14291493	14293604	BnaA01T0222200ZY	0	-	0	0	2111	0.0000000
zheyou73v0_A01	14291493	14294006	BnaA01T0222200ZY.1	0	-	0	0	2513	0.0000000
zheyou73v0_A01	14305895	14307535	BnaA01T0222300ZY	0	+	0	0	1640	0.0000000
zheyou73v0_A01	14341979	14343542	BnaA01T0222400ZY	0	+	0	0	1563	0.0000000
zheyou73v0_A01	14354116	14354790	BnaA01T0222500ZY	0	-	0	0	674	0.0000000
zheyou73v0_A01	14355608	14356344	BnaA01T0222600ZY	0	+	0	0	736	0.0000000
zheyou73v0_A01	14369921	14372993	BnaA01T0222700ZY	0	+	0	0	3072	0.0000000
zheyou73v0_A01	14382006	14382480	BnaA01T0222800ZY	0	+	0	0	474	0.0000000
zheyou73v0_A01	14387119	14388063	BnaA01T0222900ZY	0	-	0	0	944	0.0000000
zheyou73v0_A01	14425001	14427129	BnaA01T0223000ZY	0	+	0	0	2128	0.0000000
zheyou73v0_A01	14427320	14429373	BnaA01T0223100ZY	0	-	0	0	2053	0.0000000
zheyou73v0_A01	14438043	14438426	BnaA01T0223200ZY	0	+	0	0	383	0.0000000
zheyou73v0_A01	14442795	14444922	BnaA01T0223300ZY	0	+	0	0	2127	0.0000000
zheyou73v0_A01	14445113	14447166	BnaA01T0223400ZY	0	-	0	0	2053	0.0000000
zheyou73v0_A01	14455848	14456489	BnaA01T0223500ZY	0	+	0	0	641	0.0000000
zheyou73v0_A01	14476073	14479585	BnaA01T0223600ZY	0	-	0	0	3512	0.0000000
zheyou73v0_A01	14476073	14479585	BnaA01T0223600ZY.1	0	-	0	0	3512	0.0000000
zheyou73v0_A01	14507834	14511027	BnaA01T0223700ZY	0	+	0	0	3193	0.0000000
zheyou73v0_A01	14516766	14517936	BnaA01T0223800ZY	0	+	0	0	1170	0.0000000
zheyou73v0_A01	14522837	14524322	BnaA01T0223900ZY	0	-	0	0	1485	0.0000000
zheyou73v0_A01	14522837	14524322	BnaA01T0223900ZY.1	0	-	0	0	1485	0.0000000
zheyou73v0_A01	14529034	14533615	BnaA01T0224000ZY	0	-	0	0	4581	0.0000000
zheyou73v0_A01	14552835	14553738	BnaA01T0224100ZY	0	-	0	0	903	0.0000000
zheyou73v0_A01	14559992	14561042	BnaA01T0224200ZY	0	-	0	0	1050	0.0000000
zheyou73v0_A01	14567768	14569580	BnaA01T0224300ZY	0	-	0	0	1812	0.0000000
zheyou73v0_A01	14567768	14569600	BnaA01T0224300ZY.1	0	-	0	0	1832	0.0000000
zheyou73v0_A01	14567768	14569600	BnaA01T0224300ZY.2	0	-	0	0	1832	0.0000000
zheyou73v0_A01	14583147	14583354	BnaA01T0224400ZY	0	-	0	0	207	0.0000000
zheyou73v0_A01	14583857	14585443	BnaA01T0224500ZY	0	-	0	0	1586	0.0000000
zheyou73v0_A01	14609378	14609975	BnaA01T0224600ZY	0	-	0	0	597	0.0000000
zheyou73v0_A01	14613121	14614004	BnaA01T0224700ZY	0	+	0	0	883	0.0000000
zheyou73v0_A01	14652681	14656987	BnaA01T0224800ZY	0	-	0	0	4306	0.0000000
zheyou73v0_A01	14663305	14663569	BnaA01T0224900ZY	0	-	0	0	264	0.0000000
zheyou73v0_A01	14667122	14679787	BnaA01T0225000ZY	0	-	0	0	12665	0.0000000
zheyou73v0_A01	14711983	14712907	BnaA01T0225100ZY	0	-	0	0	924	0.0000000
zheyou73v0_A01	14716532	14719265	BnaA01T0225200ZY	0	+	0	0	2733	0.0000000
zheyou73v0_A01	14731360	14732063	BnaA01T0225300ZY	0	-	0	0	703	0.0000000
zheyou73v0_A01	14731360	14732063	BnaA01T0225300ZY.1	0	-	0	0	703	0.0000000
zheyou73v0_A01	14731360	14732063	BnaA01T0225300ZY.2	0	-	0	0	703	0.0000000
zheyou73v0_A01	14737185	14738792	BnaA01T0225400ZY	0	+	0	0	1607	0.0000000
zheyou73v0_A01	14768307	14768570	BnaA01T0225500ZY	0	-	0	0	263	0.0000000
zheyou73v0_A01	14773832	14775055	BnaA01T0225600ZY	0	-	0	0	1223	0.0000000
zheyou73v0_A01	14793567	14795136	BnaA01T0225700ZY	0	+	0	0	1569	0.0000000
zheyou73v0_A01	14799859	14800587	BnaA01T0225800ZY	0	+	0	0	728	0.0000000
zheyou73v0_A01	14803096	14805064	BnaA01T0225900ZY	0	+	0	0	1968	0.0000000
zheyou73v0_A01	14817099	14819152	BnaA01T0226000ZY	0	-	0	0	2053	0.0000000
zheyou73v0_A01	14824355	14825345	BnaA01T0226100ZY	0	-	0	0	990	0.0000000
zheyou73v0_A01	14825756	14827427	BnaA01T0226200ZY	0	-	0	0	1671	0.0000000
zheyou73v0_A01	14834004	14835513	BnaA01T0226300ZY	0	+	0	0	1509	0.0000000
zheyou73v0_A01	14844280	14847462	BnaA01T0226400ZY	0	+	0	0	3182	0.0000000
zheyou73v0_A01	14847746	14848277	BnaA01T0226500ZY	0	+	0	0	531	0.0000000
zheyou73v0_A01	14848333	14849527	BnaA01T0226600ZY	0	+	0	0	1194	0.0000000
zheyou73v0_A01	14852978	14854056	BnaA01T0226700ZY	0	+	0	0	1078	0.0000000
zheyou73v0_A01	14854106	14855558	BnaA01T0226800ZY	0	+	0	0	1452	0.0000000
zheyou73v0_A01	14861410	14874988	BnaA01T0226900ZY	0	-	0	0	13578	0.0000000
zheyou73v0_A01	14888080	14890074	BnaA01T0227000ZY	0	-	0	0	1994	0.0000000
zheyou73v0_A01	14913971	14914470	BnaA01T0227100ZY	0	+	0	0	499	0.0000000
zheyou73v0_A01	14934864	14936192	BnaA01T0227200ZY	0	-	0	0	1328	0.0000000
zheyou73v0_A01	14940547	14942515	BnaA01T0227300ZY.1	0	-	0	0	1968	0.0000000
zheyou73v0_A01	14940556	14942484	BnaA01T0227300ZY	0	-	0	0	1928	0.0000000
zheyou73v0_A01	14970892	14989568	BnaA01T0227400ZY	0	-	0	0	18676	0.0000000
zheyou73v0_A01	15008145	15008977	BnaA01T0227500ZY	0	-	0	0	832	0.0000000
zheyou73v0_A01	15034869	15037559	BnaA01T0227600ZY	0	+	0	0	2690	0.0000000
zheyou73v0_A01	15040182	15066336	BnaA01T0227700ZY	0	-	0	0	26154	0.0000000
zheyou73v0_A01	15073052	15075381	BnaA01T0227800ZY	0	-	0	0	2329	0.0000000
zheyou73v0_A01	15145565	15150059	BnaA01T0227900ZY	0	+	0	0	4494	0.0000000
zheyou73v0_A01	15151425	15152572	BnaA01T0228000ZY	0	-	0	0	1147	0.0000000
zheyou73v0_A01	15155228	15158435	BnaA01T0228100ZY	0	-	0	0	3207	0.0000000
zheyou73v0_A01	15191871	15192117	BnaA01T0228200ZY	0	-	0	0	246	0.0000000
zheyou73v0_A01	15202780	15204997	BnaA01T0228300ZY	0	-	0	0	2217	0.0000000
zheyou73v0_A01	15209207	15209512	BnaA01T0228400ZY	0	-	0	0	305	0.0000000
zheyou73v0_A01	15209956	15210702	BnaA01T0228500ZY	0	-	0	0	746	0.0000000
zheyou73v0_A01	15215295	15221027	BnaA01T0228600ZY	0	+	0	0	5732	0.0000000
zheyou73v0_A01	15231977	15234294	BnaA01T0228700ZY	0	+	0	0	2317	0.0000000
zheyou73v0_A01	15231977	15234294	BnaA01T0228700ZY.1	0	+	0	0	2317	0.0000000
zheyou73v0_A01	15246961	15248131	BnaA01T0228800ZY	0	+	0	0	1170	0.0000000
zheyou73v0_A01	15253234	15255250	BnaA01T0228900ZY	0	-	0	0	2016	0.0000000
zheyou73v0_A01	15273064	15275653	BnaA01T0229000ZY	0	+	0	0	2589	0.0000000
zheyou73v0_A01	15300236	15302538	BnaA01T0229100ZY	0	+	0	0	2302	0.0000000
zheyou73v0_A01	15300236	15302538	BnaA01T0229100ZY.1	0	+	0	0	2302	0.0000000
zheyou73v0_A01	15300236	15302538	BnaA01T0229100ZY.2	0	+	0	0	2302	0.0000000
zheyou73v0_A01	15300236	15302538	BnaA01T0229100ZY.3	0	+	0	0	2302	0.0000000
zheyou73v0_A01	15359687	15375320	BnaA01T0229200ZY	0	+	0	0	15633	0.0000000
zheyou73v0_A01	15376857	15377310	BnaA01T0229300ZY	0	+	0	0	453	0.0000000
zheyou73v0_A01	15501578	15504202	BnaA01T0229400ZY	0	+	0	0	2624	0.0000000
zheyou73v0_A01	15536400	15538310	BnaA01T0229500ZY	0	+	0	0	1910	0.0000000
zheyou73v0_A01	15538409	15539492	BnaA01T0229600ZY	0	-	0	0	1083	0.0000000
zheyou73v0_A01	15538409	15539492	BnaA01T0229600ZY.1	0	-	0	0	1083	0.0000000
zheyou73v0_A01	15548770	15551469	BnaA01T0229700ZY	0	+	0	0	2699	0.0000000
zheyou73v0_A01	15548770	15551469	BnaA01T0229700ZY.1	0	+	0	0	2699	0.0000000
zheyou73v0_A01	15553450	15554303	BnaA01T0229800ZY	0	-	0	0	853	0.0000000
zheyou73v0_A01	15567432	15567666	BnaA01T0229900ZY	0	+	0	0	234	0.0000000
zheyou73v0_A01	15599398	15599698	BnaA01T0230000ZY	0	+	0	0	300	0.0000000
zheyou73v0_A01	15671725	15673682	BnaA01T0230100ZY	0	+	0	0	1957	0.0000000
zheyou73v0_A01	15690703	15692285	BnaA01T0230200ZY	0	+	0	0	1582	0.0000000
zheyou73v0_A01	15708084	15710743	BnaA01T0230300ZY	0	-	0	0	2659	0.0000000
zheyou73v0_A01	15710969	15712562	BnaA01T0230400ZY	0	-	0	0	1593	0.0000000
zheyou73v0_A01	15710969	15712562	BnaA01T0230400ZY.1	0	-	0	0	1593	0.0000000
zheyou73v0_A01	15710969	15712562	BnaA01T0230400ZY.2	0	-	0	0	1593	0.0000000
zheyou73v0_A01	15710969	15712562	BnaA01T0230400ZY.3	0	-	0	0	1593	0.0000000
zheyou73v0_A01	15722826	15725625	BnaA01T0230500ZY	0	-	0	0	2799	0.0000000
zheyou73v0_A01	15722826	15725625	BnaA01T0230500ZY.1	0	-	0	0	2799	0.0000000
zheyou73v0_A01	15728010	15736507	BnaA01T0230600ZY	0	+	0	0	8497	0.0000000
zheyou73v0_A01	15736602	15740016	BnaA01T0230700ZY	0	-	0	0	3414	0.0000000
zheyou73v0_A01	15744175	15744539	BnaA01T0230800ZY	0	+	0	0	364	0.0000000
zheyou73v0_A01	15745989	15747260	BnaA01T0230900ZY	0	-	0	0	1271	0.0000000
zheyou73v0_A01	15753597	15755818	BnaA01T0231000ZY	0	+	0	0	2221	0.0000000
zheyou73v0_A01	15765494	15772564	BnaA01T0231100ZY	0	+	0	0	7070	0.0000000
zheyou73v0_A01	15774273	15774810	BnaA01T0231200ZY	0	+	0	0	537	0.0000000
zheyou73v0_A01	15775228	15781931	BnaA01T0231300ZY	0	-	0	0	6703	0.0000000
zheyou73v0_A01	15844102	15845486	BnaA01T0231400ZY	0	+	0	0	1384	0.0000000
zheyou73v0_A01	15845719	15852419	BnaA01T0231500ZY	0	-	0	0	6700	0.0000000
zheyou73v0_A01	15852934	15918772	BnaA01T0231600ZY	0	+	0	0	65838	0.0000000
zheyou73v0_A01	15993081	15994619	BnaA01T0231700ZY	0	+	0	0	1538	0.0000000
zheyou73v0_A01	16000273	16002226	BnaA01T0231800ZY	0	+	0	0	1953	0.0000000
zheyou73v0_A01	16031206	16033277	BnaA01T0231900ZY	0	+	0	0	2071	0.0000000
zheyou73v0_A01	16041761	16042226	BnaA01T0232000ZY	0	+	0	0	465	0.0000000
zheyou73v0_A01	16048279	16048489	BnaA01T0232100ZY	0	-	0	0	210	0.0000000
zheyou73v0_A01	16049625	16051316	BnaA01T0232200ZY	0	-	0	0	1691	0.0000000
zheyou73v0_A01	16057381	16067587	BnaA01T0232300ZY	0	-	0	0	10206	0.0000000
zheyou73v0_A01	16067960	16069651	BnaA01T0232400ZY	0	+	0	0	1691	0.0000000
zheyou73v0_A01	16070787	16070997	BnaA01T0232500ZY	0	+	0	0	210	0.0000000
zheyou73v0_A01	16076810	16078501	BnaA01T0232600ZY	0	+	0	0	1691	0.0000000
zheyou73v0_A01	16079637	16079847	BnaA01T0232700ZY	0	+	0	0	210	0.0000000
zheyou73v0_A01	16088329	16091899	BnaA01T0232800ZY	0	-	0	0	3570	0.0000000
zheyou73v0_A01	16095652	16095862	BnaA01T0232900ZY	0	-	0	0	210	0.0000000
zheyou73v0_A01	16097000	16099326	BnaA01T0233000ZY	0	-	0	0	2326	0.0000000
zheyou73v0_A01	16100243	16100474	BnaA01T0233100ZY	0	-	0	0	231	0.0000000
zheyou73v0_A01	16105865	16107410	BnaA01T0233200ZY	0	+	0	0	1545	0.0000000
zheyou73v0_A01	16108692	16108902	BnaA01T0233300ZY	0	+	0	0	210	0.0000000
zheyou73v0_A01	16114266	16117001	BnaA01T0233400ZY	0	+	0	0	2735	0.0000000
zheyou73v0_A01	16124956	16125166	BnaA01T0233500ZY	0	+	0	0	210	0.0000000
zheyou73v0_A01	16129864	16132852	BnaA01T0233600ZY	0	+	0	0	2988	0.0000000
zheyou73v0_A01	16133988	16134198	BnaA01T0233700ZY	0	+	0	0	210	0.0000000
zheyou73v0_A01	16139574	16141373	BnaA01T0233800ZY	0	+	0	0	1799	0.0000000
zheyou73v0_A01	16141728	16141929	BnaA01T0233900ZY	0	+	0	0	201	0.0000000
zheyou73v0_A01	16144564	16145062	BnaA01T0234000ZY	0	-	0	0	498	0.0000000
zheyou73v0_A01	16150115	16152448	BnaA01T0234100ZY	0	+	0	0	2333	0.0000000
zheyou73v0_A01	16153508	16153718	BnaA01T0234200ZY	0	+	0	0	210	0.0000000
zheyou73v0_A01	16176357	16176567	BnaA01T0234300ZY	0	-	0	0	210	0.0000000
zheyou73v0_A01	16177703	16179394	BnaA01T0234400ZY	0	-	0	0	1691	0.0000000
zheyou73v0_A01	16185209	16185419	BnaA01T0234500ZY	0	-	0	0	210	0.0000000
zheyou73v0_A01	16186555	16188172	BnaA01T0234600ZY	0	-	0	0	1617	0.0000000
zheyou73v0_A01	16202247	16202397	BnaA01T0234700ZY	0	-	0	0	150	0.0000000
zheyou73v0_A01	16244060	16244270	BnaA01T0234800ZY	0	-	0	0	210	0.0000000
zheyou73v0_A01	16244789	16246857	BnaA01T0234900ZY	0	+	0	0	2068	0.0000000
zheyou73v0_A01	16247469	16275327	BnaA01T0235000ZY	0	+	0	0	27858	0.0000000
zheyou73v0_A01	16277021	16277231	BnaA01T0235100ZY	0	+	0	0	210	0.0000000
zheyou73v0_A01	16283071	16284762	BnaA01T0235200ZY	0	+	0	0	1691	0.0000000
zheyou73v0_A01	16285898	16286108	BnaA01T0235300ZY	0	+	0	0	210	0.0000000
zheyou73v0_A01	16291921	16293612	BnaA01T0235400ZY	0	+	0	0	1691	0.0000000
zheyou73v0_A01	16294748	16294958	BnaA01T0235500ZY	0	+	0	0	210	0.0000000
zheyou73v0_A01	16300771	16302462	BnaA01T0235600ZY	0	+	0	0	1691	0.0000000
zheyou73v0_A01	16303929	16305063	BnaA01T0235700ZY	0	+	0	0	1134	0.0000000
zheyou73v0_A01	16305288	16306237	BnaA01T0235800ZY	0	-	0	0	949	0.0000000
zheyou73v0_A01	16306756	16306966	BnaA01T0235900ZY	0	+	0	0	210	0.0000000
zheyou73v0_A01	16328317	16341438	BnaA01T0236000ZY	0	+	0	0	13121	0.0000000
zheyou73v0_A01	16342574	16342784	BnaA01T0236100ZY	0	+	0	0	210	0.0000000
zheyou73v0_A01	16377692	16377902	BnaA01T0236200ZY	0	-	0	0	210	0.0000000
zheyou73v0_A01	16379038	16382027	BnaA01T0236300ZY	0	-	0	0	2989	0.0000000
zheyou73v0_A01	16382280	16382609	BnaA01T0236400ZY	0	-	0	0	329	0.0000000
zheyou73v0_A01	16397418	16397747	BnaA01T0236500ZY	0	-	0	0	329	0.0000000
zheyou73v0_A01	16401681	16401891	BnaA01T0236600ZY	0	-	0	0	210	0.0000000
zheyou73v0_A01	16403585	16404719	BnaA01T0236700ZY	0	-	0	0	1134	0.0000000
zheyou73v0_A01	16404924	16405196	BnaA01T0236800ZY	0	-	0	0	272	0.0000000
zheyou73v0_A01	16406270	16406599	BnaA01T0236900ZY	0	-	0	0	329	0.0000000
zheyou73v0_A01	16411259	16413504	BnaA01T0237000ZY	0	+	0	0	2245	0.0000000
zheyou73v0_A01	16413772	16414045	BnaA01T0237100ZY	0	-	0	0	273	0.0000000
zheyou73v0_A01	16415329	16417097	BnaA01T0237200ZY	0	-	0	0	1768	0.0000000
zheyou73v0_A01	16427806	16428016	BnaA01T0237300ZY	0	-	0	0	210	0.0000000
zheyou73v0_A01	16428535	16430605	BnaA01T0237400ZY	0	+	0	0	2070	0.0000000
zheyou73v0_A01	16430656	16431479	BnaA01T0237500ZY	0	-	0	0	823	0.0000000
zheyou73v0_A01	16432396	16432964	BnaA01T0237600ZY	0	-	0	0	568	0.0000000
zheyou73v0_A01	16896774	16896984	BnaA01T0237700ZY	0	+	0	0	210	0.0000000
zheyou73v0_A01	16902797	16904488	BnaA01T0237800ZY	0	+	0	0	1691	0.0000000
zheyou73v0_A01	16905624	16905834	BnaA01T0237900ZY	0	+	0	0	210	0.0000000
zheyou73v0_A01	16914376	16914586	BnaA01T0238000ZY	0	+	0	0	210	0.0000000
zheyou73v0_A01	16949088	16952077	BnaA01T0238100ZY	0	+	0	0	2989	0.0000000
zheyou73v0_A01	16953213	16953423	BnaA01T0238200ZY	0	+	0	0	210	0.0000000
zheyou73v0_A01	18474603	18475322	BnaA01T0238300ZY	0	+	0	0	719	0.0000000
zheyou73v0_A01	18475880	18476215	BnaA01T0238400ZY	0	-	0	0	335	0.0000000
zheyou73v0_A01	18496381	18497974	BnaA01T0238500ZY	0	+	0	0	1593	0.0000000
zheyou73v0_A01	18517119	18518810	BnaA01T0238600ZY	0	+	0	0	1691	0.0000000
zheyou73v0_A01	18541437	18541813	BnaA01T0238700ZY	0	-	0	0	376	0.0000000
zheyou73v0_A01	18542864	18543774	BnaA01T0238800ZY	0	-	0	0	910	0.0000000
zheyou73v0_A01	18547802	18548131	BnaA01T0238900ZY	0	+	0	0	329	0.0000000
zheyou73v0_A01	18549682	18551373	BnaA01T0239000ZY	0	+	0	0	1691	0.0000000
zheyou73v0_A01	18552509	18552719	BnaA01T0239100ZY	0	+	0	0	210	0.0000000
zheyou73v0_A01	18556020	18556349	BnaA01T0239200ZY	0	+	0	0	329	0.0000000
zheyou73v0_A01	18557900	18559591	BnaA01T0239300ZY	0	+	0	0	1691	0.0000000
zheyou73v0_A01	18560727	18560937	BnaA01T0239400ZY	0	+	0	0	210	0.0000000
zheyou73v0_A01	18564238	18564567	BnaA01T0239500ZY	0	+	0	0	329	0.0000000
zheyou73v0_A01	18566118	18567809	BnaA01T0239600ZY	0	+	0	0	1691	0.0000000
zheyou73v0_A01	18568945	18569155	BnaA01T0239700ZY	0	+	0	0	210	0.0000000
zheyou73v0_A01	18572456	18572785	BnaA01T0239800ZY	0	+	0	0	329	0.0000000
zheyou73v0_A01	18574336	18576027	BnaA01T0239900ZY	0	+	0	0	1691	0.0000000
zheyou73v0_A01	18577163	18577373	BnaA01T0240000ZY	0	+	0	0	210	0.0000000
zheyou73v0_A01	18581958	18582287	BnaA01T0240100ZY	0	+	0	0	329	0.0000000
zheyou73v0_A01	18583838	18584797	BnaA01T0240200ZY	0	+	0	0	959	0.0000000
zheyou73v0_A01	18586665	18586875	BnaA01T0240300ZY	0	+	0	0	210	0.0000000
zheyou73v0_A01	18595024	18595296	BnaA01T0240400ZY	0	-	0	0	272	0.0000000
zheyou73v0_A01	18618477	18618687	BnaA01T0240500ZY	0	-	0	0	210	0.0000000
zheyou73v0_A01	18619823	18622812	BnaA01T0240600ZY	0	-	0	0	2989	0.0000000
zheyou73v0_A01	18623065	18623324	BnaA01T0240700ZY	0	-	0	0	259	0.0000000
zheyou73v0_A01	18995105	18995315	BnaA01T0240800ZY	0	+	0	0	210	0.0000000
zheyou73v0_A01	18999248	18999577	BnaA01T0240900ZY	0	+	0	0	329	0.0000000
zheyou73v0_A01	19000651	19000923	BnaA01T0241000ZY	0	+	0	0	272	0.0000000
zheyou73v0_A01	19001128	19002819	BnaA01T0241100ZY	0	+	0	0	1691	0.0000000
zheyou73v0_A01	19003955	19004165	BnaA01T0241200ZY	0	+	0	0	210	0.0000000
zheyou73v0_A01	19025848	19027059	BnaA01T0241300ZY	0	-	0	0	1211	0.0000000
zheyou73v0_A01	19027316	19027526	BnaA01T0241400ZY	0	+	0	0	210	0.0000000
zheyou73v0_A01	19031438	19031767	BnaA01T0241500ZY	0	+	0	0	329	0.0000000
zheyou73v0_A01	19032841	19033113	BnaA01T0241600ZY	0	+	0	0	272	0.0000000
zheyou73v0_A01	19033318	19035009	BnaA01T0241700ZY	0	+	0	0	1691	0.0000000
zheyou73v0_A01	19036145	19036355	BnaA01T0241800ZY	0	+	0	0	210	0.0000000
zheyou73v0_A01	19059736	19060065	BnaA01T0241900ZY	0	+	0	0	329	0.0000000
zheyou73v0_A01	19061139	19061411	BnaA01T0242000ZY	0	+	0	0	272	0.0000000
zheyou73v0_A01	19061616	19063307	BnaA01T0242100ZY	0	+	0	0	1691	0.0000000
zheyou73v0_A01	19064443	19064653	BnaA01T0242200ZY	0	+	0	0	210	0.0000000
zheyou73v0_A01	19076407	19077496	BnaA01T0242300ZY	0	+	0	0	1089	0.0000000
zheyou73v0_A01	19080287	19080497	BnaA01T0242400ZY	0	-	0	0	210	0.0000000
zheyou73v0_A01	19081633	19083959	BnaA01T0242500ZY	0	-	0	0	2326	0.0000000
zheyou73v0_A01	19084334	19084484	BnaA01T0242600ZY	0	-	0	0	150	0.0000000
zheyou73v0_A01	19103230	19103440	BnaA01T0242700ZY	0	-	0	0	210	0.0000000
zheyou73v0_A01	19104576	19106267	BnaA01T0242800ZY	0	-	0	0	1691	0.0000000
zheyou73v0_A01	19112075	19112285	BnaA01T0242900ZY	0	-	0	0	210	0.0000000
zheyou73v0_A01	19112542	19113752	BnaA01T0243000ZY	0	+	0	0	1210	0.0000000
zheyou73v0_A01	19114152	19116310	BnaA01T0243100ZY	0	-	0	0	2158	0.0000000
zheyou73v0_A01	19116894	19118105	BnaA01T0243200ZY	0	-	0	0	1211	0.0000000
zheyou73v0_A01	19118362	19118572	BnaA01T0243300ZY	0	+	0	0	210	0.0000000
zheyou73v0_A01	19118752	19118974	BnaA01T0243400ZY	0	+	0	0	222	0.0000000
zheyou73v0_A01	19128059	19128269	BnaA01T0243500ZY	0	+	0	0	210	0.0000000
zheyou73v0_A01	19128449	19128671	BnaA01T0243600ZY	0	+	0	0	222	0.0000000
zheyou73v0_A01	19130984	19131194	BnaA01T0243700ZY	0	+	0	0	210	0.0000000
zheyou73v0_A01	19131374	19131596	BnaA01T0243800ZY	0	+	0	0	222	0.0000000
zheyou73v0_A01	19142441	19143454	BnaA01T0243900ZY	0	-	0	0	1013	0.0000000
zheyou73v0_A01	19143584	19145764	BnaA01T0244000ZY	0	-	0	0	2180	0.0000000
zheyou73v0_A01	19152289	19154615	BnaA01T0244100ZY	0	-	0	0	2326	0.0000000
zheyou73v0_A01	19174911	19175121	BnaA01T0244200ZY	0	-	0	0	210	0.0000000
zheyou73v0_A01	19176257	19177948	BnaA01T0244300ZY	0	-	0	0	1691	0.0000000
zheyou73v0_A01	19183690	19183900	BnaA01T0244400ZY	0	-	0	0	210	0.0000000
zheyou73v0_A01	19185036	19186727	BnaA01T0244500ZY	0	-	0	0	1691	0.0000000
zheyou73v0_A01	19186932	19187204	BnaA01T0244600ZY	0	-	0	0	272	0.0000000
zheyou73v0_A01	19192521	19192731	BnaA01T0244700ZY	0	-	0	0	210	0.0000000
zheyou73v0_A01	19194013	19197781	BnaA01T0244800ZY	0	-	0	0	3768	0.0000000
zheyou73v0_A01	19215815	19217408	BnaA01T0244900ZY	0	-	0	0	1593	0.0000000
zheyou73v0_A01	19222586	19222796	BnaA01T0245000ZY	0	-	0	0	210	0.0000000
zheyou73v0_A01	19223932	19226921	BnaA01T0245100ZY	0	-	0	0	2989	0.0000000
zheyou73v0_A01	19231151	19231361	BnaA01T0245200ZY	0	-	0	0	210	0.0000000
zheyou73v0_A01	19231618	19232829	BnaA01T0245300ZY	0	+	0	0	1211	0.0000000
zheyou73v0_A01	19232983	19233450	BnaA01T0245400ZY	0	+	0	0	467	0.0000000
zheyou73v0_A01	19235790	19236276	BnaA01T0245500ZY	0	-	0	0	486	0.0000000
zheyou73v0_A01	19257289	19257499	BnaA01T0245600ZY	0	-	0	0	210	0.0000000
zheyou73v0_A01	19258635	19261118	BnaA01T0245700ZY	0	-	0	0	2483	0.0000000
zheyou73v0_A01	19261335	19261485	BnaA01T0245800ZY	0	-	0	0	150	0.0000000
zheyou73v0_A01	19261877	19262206	BnaA01T0245900ZY	0	-	0	0	329	0.0000000
zheyou73v0_A01	19579185	19580789	BnaA01T0246000ZY	0	+	0	0	1604	0.0000000
zheyou73v0_A01	19909553	19910057	BnaA01T0246100ZY	0	+	0	0	504	0.0000000
zheyou73v0_A01	20279263	20279773	BnaA01T0246200ZY	0	+	0	0	510	0.0000000
zheyou73v0_A01	20280538	20286145	BnaA01T0246300ZY	0	-	0	0	5607	0.0000000
zheyou73v0_A01	20305374	20306581	BnaA01T0246400ZY	0	+	0	0	1207	0.0000000
zheyou73v0_A01	20309428	20311691	BnaA01T0246500ZY	0	+	0	0	2263	0.0000000
zheyou73v0_A01	20394438	20396838	BnaA01T0246600ZY	0	+	0	0	2400	0.0000000
zheyou73v0_A01	20397595	20399239	BnaA01T0246700ZY	0	-	0	0	1644	0.0000000
zheyou73v0_A01	20406863	20407073	BnaA01T0246800ZY	0	-	0	0	210	0.0000000
zheyou73v0_A01	20408209	20409900	BnaA01T0246900ZY	0	-	0	0	1691	0.0000000
zheyou73v0_A01	20415680	20415890	BnaA01T0247000ZY	0	-	0	0	210	0.0000000
zheyou73v0_A01	20416147	20417329	BnaA01T0247100ZY	0	+	0	0	1182	0.0000000
zheyou73v0_A01	20700383	20702421	BnaA01T0247200ZY	0	-	0	0	2038	0.0000000
zheyou73v0_A01	20773200	20773410	BnaA01T0247300ZY	0	-	0	0	210	0.0000000
zheyou73v0_A01	20828681	20828837	BnaA01T0247400ZY	0	+	0	0	156	0.0000000
zheyou73v0_A01	20926968	20927439	BnaA01T0247500ZY	0	-	0	0	471	0.0000000
zheyou73v0_A01	21181243	21181453	BnaA01T0247600ZY	0	-	0	0	210	0.0000000
zheyou73v0_A01	21182589	21184280	BnaA01T0247700ZY	0	-	0	0	1691	0.0000000
zheyou73v0_A01	21190088	21190298	BnaA01T0247800ZY	0	-	0	0	210	0.0000000
zheyou73v0_A01	21190555	21191766	BnaA01T0247900ZY	0	+	0	0	1211	0.0000000
zheyou73v0_A01	21196253	21196463	BnaA01T0248000ZY	0	-	0	0	210	0.0000000
zheyou73v0_A01	21196982	21199049	BnaA01T0248100ZY	0	+	0	0	2067	0.0000000
zheyou73v0_A01	21199100	21200587	BnaA01T0248200ZY	0	-	0	0	1487	0.0000000
zheyou73v0_A01	21225642	21225852	BnaA01T0248300ZY	0	-	0	0	210	0.0000000
zheyou73v0_A01	21226988	21229967	BnaA01T0248400ZY	0	-	0	0	2979	0.0000000
zheyou73v0_A01	21454704	21456937	BnaA01T0248500ZY	0	-	0	0	2233	0.0000000
zheyou73v0_A01	21523213	21524989	BnaA01T0248600ZY	0	+	0	0	1776	0.0000000
zheyou73v0_A01	21698733	21699162	BnaA01T0248700ZY	0	+	0	0	429	0.0000000
zheyou73v0_A01	22022892	22023324	BnaA01T0248800ZY	0	-	0	0	432	0.0000000
zheyou73v0_A01	22023351	22023709	BnaA01T0248900ZY	0	-	0	0	358	0.0000000
zheyou73v0_A01	22037777	22038691	BnaA01T0249000ZY	0	-	0	0	914	0.0000000
zheyou73v0_A01	22143248	22143663	BnaA01T0249100ZY	0	-	0	0	415	0.0000000
zheyou73v0_A01	22277579	22282299	BnaA01T0249200ZY	0	-	0	0	4720	0.0000000
zheyou73v0_A01	22374850	22378455	BnaA01T0249300ZY	0	+	0	0	3605	0.0000000
zheyou73v0_A01	22378727	22382919	BnaA01T0249400ZY	0	-	0	0	4192	0.0000000
zheyou73v0_A01	22378727	22382919	BnaA01T0249400ZY.1	0	-	0	0	4192	0.0000000
zheyou73v0_A01	22378727	22382343	BnaA01T0249400ZY.2	0	-	0	0	3616	0.0000000
zheyou73v0_A01	22398204	22401967	BnaA01T0249500ZY	0	-	0	0	3763	0.0000000
zheyou73v0_A01	22411679	22413338	BnaA01T0249600ZY	0	+	0	0	1659	0.0000000
zheyou73v0_A01	22437159	22437659	BnaA01T0249700ZY	0	-	0	0	500	0.0000000
zheyou73v0_A01	22473343	22474467	BnaA01T0249800ZY	0	+	0	0	1124	0.0000000
zheyou73v0_A01	22488873	22490449	BnaA01T0249900ZY	0	-	0	0	1576	0.0000000
zheyou73v0_A01	22508143	22512886	BnaA01T0250000ZY	0	+	0	0	4743	0.0000000
zheyou73v0_A01	22527475	22529135	BnaA01T0250100ZY	0	+	0	0	1660	0.0000000
zheyou73v0_A01	22527475	22529135	BnaA01T0250100ZY.1	0	+	0	0	1660	0.0000000
zheyou73v0_A01	22527475	22529135	BnaA01T0250100ZY.2	0	+	0	0	1660	0.0000000
zheyou73v0_A01	22531021	22534379	BnaA01T0250200ZY	0	-	0	0	3358	0.0000000
zheyou73v0_A01	22649039	22658300	BnaA01T0250300ZY	0	+	0	0	9261	0.0000000
zheyou73v0_A01	22664893	22666024	BnaA01T0250400ZY	0	+	0	0	1131	0.0000000
zheyou73v0_A01	22688949	22690115	BnaA01T0250500ZY	0	-	0	0	1166	0.0000000
zheyou73v0_A01	22719954	22721318	BnaA01T0250600ZY	0	+	0	0	1364	0.0000000
zheyou73v0_A01	22724321	22725691	BnaA01T0250700ZY	0	-	0	0	1370	0.0000000
zheyou73v0_A01	22729623	22731141	BnaA01T0250800ZY	0	+	0	0	1518	0.0000000
zheyou73v0_A01	22733340	22735423	BnaA01T0250900ZY	0	+	0	0	2083	0.0000000
zheyou73v0_A01	22736462	22736777	BnaA01T0251000ZY	0	+	0	0	315	0.0000000
zheyou73v0_A01	22837203	22843044	BnaA01T0251100ZY	0	+	0	0	5841	0.0000000
zheyou73v0_A01	22837203	22843044	BnaA01T0251100ZY.1	0	+	0	0	5841	0.0000000
zheyou73v0_A01	22860116	22860398	BnaA01T0251200ZY	0	+	0	0	282	0.0000000
zheyou73v0_A01	22865781	22868140	BnaA01T0251300ZY	0	+	0	0	2359	0.0000000
zheyou73v0_A01	22880627	22889399	BnaA01T0251400ZY	0	-	0	0	8772	0.0000000
zheyou73v0_A01	22890049	22890346	BnaA01T0251500ZY	0	+	0	0	297	0.0000000
zheyou73v0_A01	22910424	22913604	BnaA01T0251600ZY	0	-	0	0	3180	0.0000000
zheyou73v0_A01	22910424	22913604	BnaA01T0251600ZY.1	0	-	0	0	3180	0.0000000
zheyou73v0_A01	22910424	22913604	BnaA01T0251600ZY.2	0	-	0	0	3180	0.0000000
zheyou73v0_A01	22910424	22913604	BnaA01T0251600ZY.3	0	-	0	0	3180	0.0000000
zheyou73v0_A01	22910424	22913604	BnaA01T0251600ZY.4	0	-	0	0	3180	0.0000000
zheyou73v0_A01	22927810	22928846	BnaA01T0251700ZY	0	-	0	0	1036	0.0000000
zheyou73v0_A01	22953562	22955168	BnaA01T0251800ZY	0	-	0	0	1606	0.0000000
zheyou73v0_A01	22953562	22955168	BnaA01T0251800ZY.1	0	-	0	0	1606	0.0000000
zheyou73v0_A01	22958104	22958788	BnaA01T0251900ZY	0	-	0	0	684	0.0000000
zheyou73v0_A01	22959694	22960063	BnaA01T0252000ZY	0	+	0	0	369	0.0000000
zheyou73v0_A01	22979115	22980679	BnaA01T0252100ZY	0	-	0	0	1564	0.0000000
zheyou73v0_A01	22979115	22980679	BnaA01T0252100ZY.1	0	-	0	0	1564	0.0000000
zheyou73v0_A01	22990757	22991794	BnaA01T0252200ZY	0	+	0	0	1037	0.0000000
zheyou73v0_A01	22991860	22992784	BnaA01T0252300ZY	0	+	0	0	924	0.0000000
zheyou73v0_A01	23010299	23017144	BnaA01T0252400ZY	0	+	0	0	6845	0.0000000
zheyou73v0_A01	23018277	23018445	BnaA01T0252500ZY	0	+	0	0	168	0.0000000
zheyou73v0_A01	23019605	23021828	BnaA01T0252600ZY	0	-	0	0	2223	0.0000000
zheyou73v0_A01	23028611	23029922	BnaA01T0252700ZY	0	-	0	0	1311	0.0000000
zheyou73v0_A01	23048413	23049700	BnaA01T0252800ZY	0	+	0	0	1287	0.0000000
zheyou73v0_A01	23063072	23065460	BnaA01T0252900ZY	0	-	0	0	2388	0.0000000
zheyou73v0_A01	23063072	23065276	BnaA01T0252900ZY.1	0	-	0	0	2204	0.0000000
zheyou73v0_A01	23067684	23068689	BnaA01T0253000ZY	0	-	0	0	1005	0.0000000
zheyou73v0_A01	23070346	23072316	BnaA01T0253100ZY	0	+	0	0	1970	0.0000000
zheyou73v0_A01	23084340	23087517	BnaA01T0253200ZY	0	+	0	0	3177	0.0000000
zheyou73v0_A01	23088662	23091017	BnaA01T0253300ZY	0	-	0	0	2355	0.0000000
zheyou73v0_A01	23103040	23104903	BnaA01T0253400ZY	0	+	0	0	1863	0.0000000
zheyou73v0_A01	23125279	23128059	BnaA01T0253500ZY	0	+	0	0	2780	0.0000000
zheyou73v0_A01	23142018	23142862	BnaA01T0253600ZY	0	-	0	0	844	0.0000000
zheyou73v0_A01	23142869	23143929	BnaA01T0253700ZY	0	-	0	0	1060	0.0000000
zheyou73v0_A01	23147031	23147933	BnaA01T0253800ZY	0	-	0	0	902	0.0000000
zheyou73v0_A01	23163418	23166777	BnaA01T0253900ZY	0	+	0	0	3359	0.0000000
zheyou73v0_A01	23175525	23176985	BnaA01T0254000ZY	0	+	0	0	1460	0.0000000
zheyou73v0_A01	23196337	23196748	BnaA01T0254100ZY	0	-	0	0	411	0.0000000
zheyou73v0_A01	23283419	23283641	BnaA01T0254200ZY	0	+	0	0	222	0.0000000
zheyou73v0_A01	23290882	23291343	BnaA01T0254300ZY	0	+	0	0	461	0.0000000
zheyou73v0_A01	23322824	23323091	BnaA01T0254400ZY	0	+	0	0	267	0.0000000
zheyou73v0_A01	23446666	23483486	BnaA01T0254500ZY	0	+	0	0	36820	0.0000000
zheyou73v0_A01	23460861	23463162	BnaA01T0254600ZY	0	-	0	0	2301	0.0000000
zheyou73v0_A01	23482159	23482459	BnaA01T0254700ZY	0	+	0	0	300	0.0000000
zheyou73v0_A01	23525000	23525612	BnaA01T0254800ZY	0	+	0	0	612	0.0000000
zheyou73v0_A01	23559440	23560825	BnaA01T0254900ZY	0	+	0	0	1385	0.0000000
zheyou73v0_A01	23630212	23632644	BnaA01T0255000ZY	0	-	0	0	2432	0.0000000
zheyou73v0_A01	23647505	23647715	BnaA01T0255100ZY	0	+	0	0	210	0.0000000
zheyou73v0_A01	23653484	23655217	BnaA01T0255200ZY	0	+	0	0	1733	0.0000000
zheyou73v0_A01	23665050	23665379	BnaA01T0255300ZY	0	+	0	0	329	0.0000000
zheyou73v0_A01	23666453	23666725	BnaA01T0255400ZY	0	+	0	0	272	0.0000000
zheyou73v0_A01	23666930	23668621	BnaA01T0255500ZY	0	+	0	0	1691	0.0000000
zheyou73v0_A01	23669757	23669967	BnaA01T0255600ZY	0	+	0	0	210	0.0000000
zheyou73v0_A01	23690182	23696611	BnaA01T0255700ZY	0	+	0	0	6429	0.0000000
zheyou73v0_A01	23697747	23697957	BnaA01T0255800ZY	0	+	0	0	210	0.0000000
zheyou73v0_A01	23701869	23702198	BnaA01T0255900ZY	0	+	0	0	329	0.0000000
zheyou73v0_A01	23703272	23703544	BnaA01T0256000ZY	0	+	0	0	272	0.0000000
zheyou73v0_A01	23703749	23705440	BnaA01T0256100ZY	0	+	0	0	1691	0.0000000
zheyou73v0_A01	23706576	23706786	BnaA01T0256200ZY	0	+	0	0	210	0.0000000
zheyou73v0_A01	23712266	23712595	BnaA01T0256300ZY	0	+	0	0	329	0.0000000
zheyou73v0_A01	23713669	23713941	BnaA01T0256400ZY	0	+	0	0	272	0.0000000
zheyou73v0_A01	23714146	23715837	BnaA01T0256500ZY	0	+	0	0	1691	0.0000000
zheyou73v0_A01	23716973	23717183	BnaA01T0256600ZY	0	+	0	0	210	0.0000000
zheyou73v0_A01	23765417	23765627	BnaA01T0256700ZY	0	-	0	0	210	0.0000000
zheyou73v0_A01	23785451	23785712	BnaA01T0256800ZY	0	-	0	0	261	0.0000000
zheyou73v0_A01	23785866	23787077	BnaA01T0256900ZY	0	-	0	0	1211	0.0000000
zheyou73v0_A01	23787334	23787544	BnaA01T0257000ZY	0	+	0	0	210	0.0000000
zheyou73v0_A01	23792880	23793152	BnaA01T0257100ZY	0	+	0	0	272	0.0000000
zheyou73v0_A01	23793357	23795048	BnaA01T0257200ZY	0	+	0	0	1691	0.0000000
zheyou73v0_A01	23796184	23796394	BnaA01T0257300ZY	0	+	0	0	210	0.0000000
zheyou73v0_A01	23818328	23824308	BnaA01T0257400ZY	0	+	0	0	5980	0.0000000
zheyou73v0_A01	23825444	23825654	BnaA01T0257500ZY	0	+	0	0	210	0.0000000
zheyou73v0_A01	23833362	23835687	BnaA01T0257600ZY	0	+	0	0	2325	0.0000000
zheyou73v0_A01	23836823	23837033	BnaA01T0257700ZY	0	+	0	0	210	0.0000000
zheyou73v0_A01	23837212	23837434	BnaA01T0257800ZY	0	+	0	0	222	0.0000000
zheyou73v0_A01	23842999	23845324	BnaA01T0257900ZY	0	+	0	0	2325	0.0000000
zheyou73v0_A01	23846460	23846670	BnaA01T0258000ZY	0	+	0	0	210	0.0000000
zheyou73v0_A01	23846849	23847071	BnaA01T0258100ZY	0	+	0	0	222	0.0000000
zheyou73v0_A01	23852636	23854961	BnaA01T0258200ZY	0	+	0	0	2325	0.0000000
zheyou73v0_A01	23856097	23856307	BnaA01T0258300ZY	0	+	0	0	210	0.0000000
zheyou73v0_A01	23856486	23856708	BnaA01T0258400ZY	0	+	0	0	222	0.0000000
zheyou73v0_A01	23862273	23864598	BnaA01T0258500ZY	0	+	0	0	2325	0.0000000
zheyou73v0_A01	23871295	23873620	BnaA01T0258600ZY	0	+	0	0	2325	0.0000000
zheyou73v0_A01	23874756	23874966	BnaA01T0258700ZY	0	+	0	0	210	0.0000000
zheyou73v0_A01	23875145	23875367	BnaA01T0258800ZY	0	+	0	0	222	0.0000000
zheyou73v0_A01	23881490	23883815	BnaA01T0258900ZY	0	+	0	0	2325	0.0000000
zheyou73v0_A01	23884951	23885161	BnaA01T0259000ZY	0	+	0	0	210	0.0000000
zheyou73v0_A01	23885340	23885562	BnaA01T0259100ZY	0	+	0	0	222	0.0000000
zheyou73v0_A01	23891806	23892016	BnaA01T0259200ZY	0	+	0	0	210	0.0000000
zheyou73v0_A01	23975743	23975953	BnaA01T0259300ZY	0	+	0	0	210	0.0000000
zheyou73v0_A01	23981766	23983457	BnaA01T0259400ZY	0	+	0	0	1691	0.0000000
zheyou73v0_A01	23984593	23984803	BnaA01T0259500ZY	0	+	0	0	210	0.0000000
zheyou73v0_A01	24015746	24016018	BnaA01T0259600ZY	0	+	0	0	272	0.0000000
zheyou73v0_A01	24024373	24024583	BnaA01T0259700ZY	0	+	0	0	210	0.0000000
zheyou73v0_A01	24093518	24093979	BnaA01T0259800ZY	0	+	0	0	461	0.0000000
zheyou73v0_A01	24152326	24153134	BnaA01T0259900ZY	0	-	0	0	808	0.0000000
zheyou73v0_A01	24169452	24169704	BnaA01T0260000ZY	0	-	0	0	252	0.0000000
zheyou73v0_A01	24174129	24175952	BnaA01T0260100ZY	0	+	0	0	1823	0.0000000
zheyou73v0_A01	24174129	24175952	BnaA01T0260100ZY.1	0	+	0	0	1823	0.0000000
zheyou73v0_A01	24187372	24188258	BnaA01T0260200ZY	0	+	0	0	886	0.0000000
zheyou73v0_A01	24188476	24189067	BnaA01T0260300ZY	0	+	0	0	591	0.0000000
zheyou73v0_A01	24190403	24190968	BnaA01T0260400ZY	0	+	0	0	565	0.0000000
zheyou73v0_A01	24206817	24207656	BnaA01T0260500ZY	0	-	0	0	839	0.0000000
zheyou73v0_A01	24212880	24214027	BnaA01T0260600ZY	0	-	0	0	1147	0.0000000
zheyou73v0_A01	24220210	24235170	BnaA01T0260700ZY	0	-	0	0	14960	0.0000000
zheyou73v0_A01	24286561	24288135	BnaA01T0260800ZY	0	+	0	0	1574	0.0000000
zheyou73v0_A01	24286673	24288135	BnaA01T0260800ZY.1	0	+	0	0	1462	0.0000000
zheyou73v0_A01	24294884	24295079	BnaA01T0260900ZY	0	+	0	0	195	0.0000000
zheyou73v0_A01	24296196	24299415	BnaA01T0261000ZY	0	-	0	0	3219	0.0000000
zheyou73v0_A01	24296196	24299415	BnaA01T0261000ZY.1	0	-	0	0	3219	0.0000000
zheyou73v0_A01	24305648	24307669	BnaA01T0261100ZY	0	-	0	0	2021	0.0000000
zheyou73v0_A01	24305648	24307669	BnaA01T0261100ZY.1	0	-	0	0	2021	0.0000000
zheyou73v0_A01	24311186	24311501	BnaA01T0261200ZY	0	-	0	0	315	0.0000000
zheyou73v0_A01	24316041	24318266	BnaA01T0261300ZY	0	-	0	0	2225	0.0000000
zheyou73v0_A01	24322511	24324027	BnaA01T0261400ZY	0	-	0	0	1516	0.0000000
zheyou73v0_A01	24338685	24341834	BnaA01T0261500ZY	0	-	0	0	3149	0.0000000
zheyou73v0_A01	24338685	24341834	BnaA01T0261500ZY.1	0	-	0	0	3149	0.0000000
zheyou73v0_A01	24363754	24366503	BnaA01T0261600ZY	0	-	0	0	2749	0.0000000
zheyou73v0_A01	24385731	24386991	BnaA01T0261700ZY	0	+	0	0	1260	0.0000000
zheyou73v0_A01	24387246	24389203	BnaA01T0261800ZY	0	-	0	0	1957	0.0000000
zheyou73v0_A01	24397491	24414475	BnaA01T0261900ZY	0	+	0	0	16984	0.0000000
zheyou73v0_A01	24430987	24435689	BnaA01T0262000ZY	0	-	0	0	4702	0.0000000
zheyou73v0_A01	24438520	24438920	BnaA01T0262100ZY	0	-	0	0	400	0.0000000
zheyou73v0_A01	24468818	24469628	BnaA01T0262200ZY	0	+	0	0	810	0.0000000
zheyou73v0_A01	24469870	24472768	BnaA01T0262300ZY	0	+	0	0	2898	0.0000000
zheyou73v0_A01	24472798	24476544	BnaA01T0262400ZY	0	-	0	0	3746	0.0000000
zheyou73v0_A01	24483484	24485988	BnaA01T0262500ZY	0	+	0	0	2504	0.0000000
zheyou73v0_A01	24487288	24488569	BnaA01T0262600ZY	0	-	0	0	1281	0.0000000
zheyou73v0_A01	24496580	24509980	BnaA01T0262700ZY	0	+	0	0	13400	0.0000000
zheyou73v0_A01	24512114	24523747	BnaA01T0262800ZY	0	-	0	0	11633	0.0000000
zheyou73v0_A01	24538703	24539041	BnaA01T0262900ZY	0	+	0	0	338	0.0000000
zheyou73v0_A01	24539460	24542335	BnaA01T0263000ZY	0	+	0	0	2875	0.0000000
zheyou73v0_A01	24545089	24546909	BnaA01T0263100ZY	0	+	0	0	1820	0.0000000
zheyou73v0_A01	24551999	24552861	BnaA01T0263200ZY	0	+	0	0	862	0.0000000
zheyou73v0_A01	24557774	24559654	BnaA01T0263300ZY	0	-	0	0	1880	0.0000000
zheyou73v0_A01	24560163	24561564	BnaA01T0263400ZY	0	-	0	0	1401	0.0000000
zheyou73v0_A01	24577499	24581956	BnaA01T0263500ZY	0	-	0	0	4457	0.0000000
zheyou73v0_A01	24586601	24588781	BnaA01T0263600ZY	0	-	0	0	2180	0.0000000
zheyou73v0_A01	24612360	24612735	BnaA01T0263700ZY	0	+	0	0	375	0.0000000
zheyou73v0_A01	24627817	24631491	BnaA01T0263800ZY	0	+	0	0	3674	0.0000000
zheyou73v0_A01	24639896	24658918	BnaA01T0263900ZY	0	+	0	0	19022	0.0000000
zheyou73v0_A01	24664556	24666155	BnaA01T0264000ZY	0	+	0	0	1599	0.0000000
zheyou73v0_A01	24664556	24666755	BnaA01T0264000ZY.1	0	+	0	0	2199	0.0000000
zheyou73v0_A01	24675001	24675840	BnaA01T0264100ZY	0	-	0	0	839	0.0000000
zheyou73v0_A01	24685001	24688754	BnaA01T0264200ZY	0	+	0	0	3753	0.0000000
zheyou73v0_A01	24691717	24693315	BnaA01T0264300ZY	0	-	0	0	1598	0.0000000
zheyou73v0_A01	24700153	24704544	BnaA01T0264400ZY	0	+	0	0	4391	0.0000000
zheyou73v0_A01	24700153	24704544	BnaA01T0264400ZY.1	0	+	0	0	4391	0.0000000
zheyou73v0_A01	24725701	24727268	BnaA01T0264500ZY	0	+	0	0	1567	0.0000000
zheyou73v0_A01	24727326	24736304	BnaA01T0264600ZY	0	-	0	0	8978	0.0000000
zheyou73v0_A01	24745540	24746816	BnaA01T0264700ZY	0	+	0	0	1276	0.0000000
zheyou73v0_A01	24750049	24752417	BnaA01T0264800ZY	0	-	0	0	2368	0.0000000
zheyou73v0_A01	24750049	24752417	BnaA01T0264800ZY.1	0	-	0	0	2368	0.0000000
zheyou73v0_A01	24751146	24752417	BnaA01T0264800ZY.2	0	-	0	0	1271	0.0000000
zheyou73v0_A01	24775740	24783358	BnaA01T0264900ZY	0	+	0	0	7618	0.0000000
zheyou73v0_A01	24788179	24792408	BnaA01T0265000ZY	0	+	0	0	4229	0.0000000
zheyou73v0_A01	24793129	24797377	BnaA01T0265100ZY	0	+	0	0	4248	0.0000000
zheyou73v0_A01	24798083	24798733	BnaA01T0265200ZY	0	-	0	0	650	0.0000000
zheyou73v0_A01	24811168	24812002	BnaA01T0265300ZY	0	-	0	0	834	0.0000000
zheyou73v0_A01	24816015	24821635	BnaA01T0265400ZY	0	+	0	0	5620	0.0000000
zheyou73v0_A01	24832346	24832535	BnaA01T0265500ZY	0	+	0	0	189	0.0000000
zheyou73v0_A01	24832637	24833634	BnaA01T0265600ZY	0	+	0	0	997	0.0000000
zheyou73v0_A01	24848368	24852089	BnaA01T0265700ZY	0	+	0	0	3721	0.0000000
zheyou73v0_A01	24852351	24853655	BnaA01T0265800ZY	0	-	0	0	1304	0.0000000
zheyou73v0_A01	24861005	24864901	BnaA01T0265900ZY	0	-	0	0	3896	0.0000000
zheyou73v0_A01	24879487	24882728	BnaA01T0266000ZY	0	-	0	0	3241	0.0000000
zheyou73v0_A01	24898772	24899822	BnaA01T0266100ZY	0	+	0	0	1050	0.0000000
zheyou73v0_A01	24904279	24904844	BnaA01T0266200ZY	0	-	0	0	565	0.0000000
zheyou73v0_A01	24905366	24914172	BnaA01T0266300ZY	0	+	0	0	8806	0.0000000
zheyou73v0_A01	24915096	24917246	BnaA01T0266400ZY	0	+	0	0	2150	0.0000000
zheyou73v0_A01	24915096	24917246	BnaA01T0266400ZY.1	0	+	0	0	2150	0.0000000
zheyou73v0_A01	24916688	24918068	BnaA01T0266500ZY	0	-	0	0	1380	0.0000000
zheyou73v0_A01	24926035	24926479	BnaA01T0266600ZY	0	-	0	0	444	0.0000000
zheyou73v0_A01	24935742	24940936	BnaA01T0266700ZY	0	+	0	0	5194	0.0000000
zheyou73v0_A01	24956434	24959215	BnaA01T0266800ZY	0	+	0	0	2781	0.0000000
zheyou73v0_A01	24959226	24962046	BnaA01T0266900ZY	0	-	0	0	2820	0.0000000
zheyou73v0_A01	24974905	24976437	BnaA01T0267000ZY	0	-	0	0	1532	0.0000000
zheyou73v0_A01	24982824	24985383	BnaA01T0267100ZY	0	-	0	0	2559	0.0000000
zheyou73v0_A01	24982824	24984804	BnaA01T0267100ZY.1	0	-	0	0	1980	0.0000000
zheyou73v0_A01	24988946	24991475	BnaA01T0267200ZY	0	+	0	0	2529	0.0000000
zheyou73v0_A01	25003048	25004361	BnaA01T0267300ZY	0	-	0	0	1313	0.0000000
zheyou73v0_A01	25020660	25020957	BnaA01T0267400ZY	0	+	0	0	297	0.0000000
zheyou73v0_A01	25038104	25040903	BnaA01T0267500ZY	0	-	0	0	2799	0.0000000
zheyou73v0_A01	25059190	25060776	BnaA01T0267600ZY	0	-	0	0	1586	0.0000000
zheyou73v0_A01	25068857	25069244	BnaA01T0267700ZY	0	+	0	0	387	0.0000000
zheyou73v0_A01	25093512	25096106	BnaA01T0267800ZY	0	+	0	0	2594	0.0000000
zheyou73v0_A01	25093512	25096106	BnaA01T0267800ZY.1	0	+	0	0	2594	0.0000000
zheyou73v0_A01	25100804	25100996	BnaA01T0267900ZY	0	-	0	0	192	0.0000000
zheyou73v0_A01	25128665	25132814	BnaA01T0268000ZY	0	-	0	0	4149	0.0000000
zheyou73v0_A01	25139239	25140768	BnaA01T0268100ZY	0	-	0	0	1529	0.0000000
zheyou73v0_A01	25143547	25143772	BnaA01T0268200ZY	0	-	0	0	225	0.0000000
zheyou73v0_A01	25143790	25144935	BnaA01T0268300ZY	0	-	0	0	1145	0.0000000
zheyou73v0_A01	25149811	25153703	BnaA01T0268400ZY	0	-	0	0	3892	0.0000000
zheyou73v0_A01	25149811	25153703	BnaA01T0268400ZY.1	0	-	0	0	3892	0.0000000
zheyou73v0_A01	25184910	25188412	BnaA01T0268500ZY	0	-	0	0	3502	0.0000000
zheyou73v0_A01	25189992	25190594	BnaA01T0268600ZY	0	+	0	0	602	0.0000000
zheyou73v0_A01	25193090	25195310	BnaA01T0268700ZY	0	+	0	0	2220	0.0000000
zheyou73v0_A01	25200185	25202402	BnaA01T0268800ZY	0	+	0	0	2217	0.0000000
zheyou73v0_A01	25202738	25207000	BnaA01T0268900ZY	0	-	0	0	4262	0.0000000
zheyou73v0_A01	25217313	25221106	BnaA01T0269000ZY	0	-	0	0	3793	0.0000000
zheyou73v0_A01	25221758	25222714	BnaA01T0269100ZY	0	-	0	0	956	0.0000000
zheyou73v0_A01	25227309	25228602	BnaA01T0269200ZY	0	+	0	0	1293	0.0000000
zheyou73v0_A01	25237987	25239534	BnaA01T0269300ZY	0	+	0	0	1547	0.0000000
zheyou73v0_A01	25240711	25243057	BnaA01T0269400ZY	0	+	0	0	2346	0.0000000
zheyou73v0_A01	25251510	25252631	BnaA01T0269500ZY	0	-	0	0	1121	0.0000000
zheyou73v0_A01	25257799	25258666	BnaA01T0269600ZY	0	+	0	0	867	0.0000000
zheyou73v0_A01	25264642	25266722	BnaA01T0269700ZY	0	-	0	0	2080	0.0000000
zheyou73v0_A01	25272739	25284467	BnaA01T0269800ZY	0	-	0	0	11728	0.0000000
zheyou73v0_A01	25312557	25315467	BnaA01T0269900ZY	0	+	0	0	2910	0.0000000
zheyou73v0_A01	25324735	25327274	BnaA01T0270000ZY	0	+	0	0	2539	0.0000000
zheyou73v0_A01	25364863	25367196	BnaA01T0270100ZY	0	+	0	0	2333	0.0000000
zheyou73v0_A01	25370069	25371024	BnaA01T0270200ZY	0	-	0	0	955	0.0000000
zheyou73v0_A01	25376831	25378491	BnaA01T0270300ZY	0	-	0	0	1660	0.0000000
zheyou73v0_A01	25383155	25385959	BnaA01T0270400ZY	0	-	0	0	2804	0.0000000
zheyou73v0_A01	25394614	25396073	BnaA01T0270500ZY	0	+	0	0	1459	0.0000000
zheyou73v0_A01	25397473	25397737	BnaA01T0270600ZY	0	+	0	0	264	0.0000000
zheyou73v0_A01	25398892	25412748	BnaA01T0270700ZY	0	-	0	0	13856	0.0000000
zheyou73v0_A01	25418365	25420551	BnaA01T0270800ZY	0	+	0	0	2186	0.0000000
zheyou73v0_A01	25435768	25437886	BnaA01T0270900ZY	0	-	0	0	2118	0.0000000
zheyou73v0_A01	25438901	25440398	BnaA01T0271000ZY	0	-	0	0	1497	0.0000000
zheyou73v0_A01	25442522	25443561	BnaA01T0271100ZY	0	+	0	0	1039	0.0000000
zheyou73v0_A01	25443618	25444026	BnaA01T0271200ZY	0	+	0	0	408	0.0000000
zheyou73v0_A01	25444035	25444251	BnaA01T0271300ZY	0	+	0	0	216	0.0000000
zheyou73v0_A01	25444362	25445016	BnaA01T0271400ZY	0	-	0	0	654	0.0000000
zheyou73v0_A01	25452270	25455380	BnaA01T0271500ZY	0	+	0	0	3110	0.0000000
zheyou73v0_A01	25452270	25455380	BnaA01T0271500ZY.1	0	+	0	0	3110	0.0000000
zheyou73v0_A01	25455921	25457602	BnaA01T0271600ZY	0	-	0	0	1681	0.0000000
zheyou73v0_A01	25467989	25469161	BnaA01T0271700ZY	0	-	0	0	1172	0.0000000
zheyou73v0_A01	25482420	25484385	BnaA01T0271800ZY	0	+	0	0	1965	0.0000000
zheyou73v0_A01	25498639	25500515	BnaA01T0271900ZY	0	-	0	0	1876	0.0000000
zheyou73v0_A01	25506324	25507737	BnaA01T0272000ZY	0	+	0	0	1413	0.0000000
zheyou73v0_A01	25510981	25511581	BnaA01T0272100ZY	0	+	0	0	600	0.0000000
zheyou73v0_A01	25511741	25514845	BnaA01T0272200ZY	0	-	0	0	3104	0.0000000
zheyou73v0_A01	25530254	25531235	BnaA01T0272300ZY	0	-	0	0	981	0.0000000
zheyou73v0_A01	25558310	25561761	BnaA01T0272400ZY	0	-	0	0	3451	0.0000000
zheyou73v0_A01	25594254	25599852	BnaA01T0272500ZY	0	-	0	0	5598	0.0000000
zheyou73v0_A01	25620948	25624418	BnaA01T0272600ZY	0	+	0	0	3470	0.0000000
zheyou73v0_A01	25624867	25630789	BnaA01T0272700ZY	0	-	0	0	5922	0.0000000
zheyou73v0_A01	25640448	25642851	BnaA01T0272800ZY	0	-	0	0	2403	0.0000000
zheyou73v0_A01	25656978	25658207	BnaA01T0272900ZY	0	-	0	0	1229	0.0000000
zheyou73v0_A01	25663169	25664576	BnaA01T0273000ZY	0	+	0	0	1407	0.0000000
zheyou73v0_A01	25673257	25676893	BnaA01T0273100ZY	0	+	0	0	3636	0.0000000
zheyou73v0_A01	25677640	25678321	BnaA01T0273200ZY	0	+	0	0	681	0.0000000
zheyou73v0_A01	25683631	25685372	BnaA01T0273300ZY	0	-	0	0	1741	0.0000000
zheyou73v0_A01	25683631	25685372	BnaA01T0273300ZY.1	0	-	0	0	1741	0.0000000
zheyou73v0_A01	25694938	25698328	BnaA01T0273400ZY	0	-	0	0	3390	0.0000000
zheyou73v0_A01	25720093	25722061	BnaA01T0273500ZY	0	+	0	0	1968	0.0000000
zheyou73v0_A01	25725477	25726002	BnaA01T0273600ZY	0	+	0	0	525	0.0000000
zheyou73v0_A01	25728858	25736090	BnaA01T0273700ZY	0	-	0	0	7232	0.0000000
zheyou73v0_A01	25742233	25744787	BnaA01T0273800ZY	0	-	0	0	2554	0.0000000
zheyou73v0_A01	25742233	25744787	BnaA01T0273800ZY.1	0	-	0	0	2554	0.0000000
zheyou73v0_A01	25756249	25757958	BnaA01T0273900ZY	0	-	0	0	1709	0.0000000
zheyou73v0_A01	25765703	25771614	BnaA01T0274000ZY	0	-	0	0	5911	0.0000000
zheyou73v0_A01	25778827	25780311	BnaA01T0274100ZY	0	-	0	0	1484	0.0000000
zheyou73v0_A01	25782727	25785598	BnaA01T0274200ZY	0	-	0	0	2871	0.0000000
zheyou73v0_A01	25785957	25788652	BnaA01T0274300ZY	0	+	0	0	2695	0.0000000
zheyou73v0_A01	25789679	25790246	BnaA01T0274400ZY	0	-	0	0	567	0.0000000
zheyou73v0_A01	25800857	25801215	BnaA01T0274500ZY	0	-	0	0	358	0.0000000
zheyou73v0_A01	25806648	25809727	BnaA01T0274600ZY	0	-	0	0	3079	0.0000000
zheyou73v0_A01	25820324	25823735	BnaA01T0274700ZY	0	-	0	0	3411	0.0000000
zheyou73v0_A01	25830504	25832451	BnaA01T0274800ZY	0	-	0	0	1947	0.0000000
zheyou73v0_A01	25857122	25860835	BnaA01T0274900ZY	0	-	0	0	3713	0.0000000
zheyou73v0_A01	25865538	25870985	BnaA01T0275000ZY	0	-	0	0	5447	0.0000000
zheyou73v0_A01	25876325	25876779	BnaA01T0275100ZY	0	-	0	0	454	0.0000000
zheyou73v0_A01	25881951	25882471	BnaA01T0275200ZY	0	+	0	0	520	0.0000000
zheyou73v0_A01	25883552	25885075	BnaA01T0275300ZY	0	+	0	0	1523	0.0000000
zheyou73v0_A01	25886349	25888150	BnaA01T0275400ZY	0	+	0	0	1801	0.0000000
zheyou73v0_A01	25889674	25890602	BnaA01T0275500ZY	0	+	0	0	928	0.0000000
zheyou73v0_A01	25939924	25945875	BnaA01T0275600ZY	0	+	0	0	5951	0.0000000
zheyou73v0_A01	25947328	25949612	BnaA01T0275700ZY	0	+	0	0	2284	0.0000000
zheyou73v0_A01	25954308	25957734	BnaA01T0275800ZY	0	+	0	0	3426	0.0000000
zheyou73v0_A01	25959844	25962180	BnaA01T0275900ZY	0	+	0	0	2336	0.0000000
zheyou73v0_A01	25959844	25962180	BnaA01T0275900ZY.1	0	+	0	0	2336	0.0000000
zheyou73v0_A01	25963993	25964503	BnaA01T0276000ZY	0	-	0	0	510	0.0000000
zheyou73v0_A01	25969567	25970569	BnaA01T0276100ZY	0	-	0	0	1002	0.0000000
zheyou73v0_A01	25982148	25983293	BnaA01T0276200ZY	0	-	0	0	1145	0.0000000
zheyou73v0_A01	26008203	26010018	BnaA01T0276300ZY	0	+	0	0	1815	0.0000000
zheyou73v0_A01	26017295	26017809	BnaA01T0276400ZY	0	-	0	0	514	0.0000000
zheyou73v0_A01	26020532	26022469	BnaA01T0276500ZY	0	+	0	0	1937	0.0000000
zheyou73v0_A01	26037330	26038605	BnaA01T0276600ZY	0	+	0	0	1275	0.0000000
zheyou73v0_A01	26043961	26045568	BnaA01T0276700ZY	0	-	0	0	1607	0.0000000
zheyou73v0_A01	26049252	26052536	BnaA01T0276800ZY	0	-	0	0	3284	0.0000000
zheyou73v0_A01	26055793	26056063	BnaA01T0276900ZY	0	+	0	0	270	0.0000000
zheyou73v0_A01	26067482	26070564	BnaA01T0277000ZY	0	+	0	0	3082	0.0000000
zheyou73v0_A01	26071794	26075500	BnaA01T0277100ZY	0	-	0	0	3706	0.0000000
zheyou73v0_A01	26071794	26075226	BnaA01T0277100ZY.1	0	-	0	0	3432	0.0000000
zheyou73v0_A01	26094816	26095444	BnaA01T0277200ZY	0	+	0	0	628	0.0000000
zheyou73v0_A01	26101095	26102417	BnaA01T0277300ZY	0	+	0	0	1322	0.0000000
zheyou73v0_A01	26105366	26108834	BnaA01T0277400ZY	0	-	0	0	3468	0.0000000
zheyou73v0_A01	26131509	26132168	BnaA01T0277500ZY	0	+	0	0	659	0.0000000
zheyou73v0_A01	26136864	26138030	BnaA01T0277600ZY	0	-	0	0	1166	0.0000000
zheyou73v0_A01	26136864	26138030	BnaA01T0277600ZY.1	0	-	0	0	1166	0.0000000
zheyou73v0_A01	26140240	26141803	BnaA01T0277700ZY	0	-	0	0	1563	0.0000000
zheyou73v0_A01	26161490	26163847	BnaA01T0277800ZY	0	-	0	0	2357	0.0000000
zheyou73v0_A01	26169248	26170208	BnaA01T0277900ZY	0	+	0	0	960	0.0000000
zheyou73v0_A01	26170666	26170816	BnaA01T0278000ZY	0	+	0	0	150	0.0000000
zheyou73v0_A01	26186464	26186665	BnaA01T0278100ZY	0	+	0	0	201	0.0000000
zheyou73v0_A01	26191847	26206725	BnaA01T0278200ZY	0	+	0	0	14878	0.0000000
zheyou73v0_A01	26216567	26218155	BnaA01T0278300ZY	0	+	0	0	1588	0.0000000
zheyou73v0_A01	26218546	26220904	BnaA01T0278400ZY	0	+	0	0	2358	0.0000000
zheyou73v0_A01	26226038	26228068	BnaA01T0278500ZY	0	+	0	0	2030	0.0000000
zheyou73v0_A01	26228341	26231060	BnaA01T0278600ZY	0	-	0	0	2719	0.0000000
zheyou73v0_A01	26237170	26237371	BnaA01T0278700ZY	0	+	0	0	201	0.0000000
zheyou73v0_A01	26244855	26246810	BnaA01T0278800ZY	0	-	0	0	1955	0.0000000
zheyou73v0_A01	26254426	26257027	BnaA01T0278900ZY	0	-	0	0	2601	0.0000000
zheyou73v0_A01	26254794	26257027	BnaA01T0278900ZY.1	0	-	0	0	2233	0.0000000
zheyou73v0_A01	26254794	26257027	BnaA01T0278900ZY.3	0	-	0	0	2233	0.0000000
zheyou73v0_A01	26255415	26257027	BnaA01T0278900ZY.2	0	-	0	0	1612	0.0000000
zheyou73v0_A01	26270009	26270210	BnaA01T0279000ZY	0	+	0	0	201	0.0000000
zheyou73v0_A01	26294374	26295383	BnaA01T0279100ZY	0	-	0	0	1009	0.0000000
zheyou73v0_A01	26303226	26305103	BnaA01T0279200ZY	0	-	0	0	1877	0.0000000
zheyou73v0_A01	26312365	26312740	BnaA01T0279300ZY	0	+	0	0	375	0.0000000
zheyou73v0_A01	26325455	26325991	BnaA01T0279400ZY	0	+	0	0	536	0.0000000
zheyou73v0_A01	26332880	26333386	BnaA01T0279500ZY	0	-	0	0	506	0.0000000
zheyou73v0_A01	26333544	26334512	BnaA01T0279600ZY	0	-	0	0	968	0.0000000
zheyou73v0_A01	26338806	26339658	BnaA01T0279700ZY	0	-	0	0	852	0.0000000
zheyou73v0_A01	26347911	26350050	BnaA01T0279800ZY	0	+	0	0	2139	0.0000000
zheyou73v0_A01	26361757	26363604	BnaA01T0279900ZY	0	+	0	0	1847	0.0000000
zheyou73v0_A01	26365971	26366576	BnaA01T0280000ZY	0	+	0	0	605	0.0000000
zheyou73v0_A01	26368528	26372241	BnaA01T0280100ZY	0	-	0	0	3713	0.0000000
zheyou73v0_A01	26372450	26373159	BnaA01T0280200ZY	0	+	0	0	709	0.0000000
zheyou73v0_A01	26373821	26375594	BnaA01T0280300ZY	0	-	0	0	1773	0.0000000
zheyou73v0_A01	26376302	26377366	BnaA01T0280400ZY	0	-	0	0	1064	0.0000000
zheyou73v0_A01	26380197	26383552	BnaA01T0280500ZY	0	-	0	0	3355	0.0000000
zheyou73v0_A01	26418827	26419594	BnaA01T0280600ZY	0	-	0	0	767	0.0000000
zheyou73v0_A01	26425663	26427952	BnaA01T0280700ZY	0	+	0	0	2289	0.0000000
zheyou73v0_A01	26430893	26431934	BnaA01T0280800ZY	0	+	0	0	1041	0.0000000
zheyou73v0_A01	26451793	26453767	BnaA01T0280900ZY	0	+	0	0	1974	0.0000000
zheyou73v0_A01	26477960	26478881	BnaA01T0281000ZY	0	+	0	0	921	0.0000000
zheyou73v0_A01	26501784	26503753	BnaA01T0281100ZY	0	+	0	0	1969	0.0000000
zheyou73v0_A01	26515462	26519579	BnaA01T0281200ZY	0	+	0	0	4117	0.0000000
zheyou73v0_A01	26515462	26519579	BnaA01T0281200ZY.1	0	+	0	0	4117	0.0000000
zheyou73v0_A01	26515462	26519579	BnaA01T0281200ZY.2	0	+	0	0	4117	0.0000000
zheyou73v0_A01	26515462	26519579	BnaA01T0281200ZY.3	0	+	0	0	4117	0.0000000
zheyou73v0_A01	26515462	26519579	BnaA01T0281200ZY.4	0	+	0	0	4117	0.0000000
zheyou73v0_A01	26576582	26577308	BnaA01T0281300ZY	0	-	0	0	726	0.0000000
zheyou73v0_A01	26577991	26578156	BnaA01T0281400ZY	0	-	0	0	165	0.0000000
zheyou73v0_A01	26578783	26578960	BnaA01T0281500ZY	0	-	0	0	177	0.0000000
zheyou73v0_A01	26580647	26583055	BnaA01T0281600ZY	0	-	0	0	2408	0.0000000
zheyou73v0_A01	26587003	26588643	BnaA01T0281700ZY	0	-	0	0	1640	0.0000000
zheyou73v0_A01	26591219	26594941	BnaA01T0281800ZY	0	+	0	0	3722	0.0000000
zheyou73v0_A01	26595399	26595549	BnaA01T0281900ZY	0	+	0	0	150	0.0000000
zheyou73v0_A01	26600020	26603085	BnaA01T0282000ZY	0	+	0	0	3065	0.0000000
zheyou73v0_A01	26604321	26605585	BnaA01T0282100ZY	0	+	0	0	1264	0.0000000
zheyou73v0_A01	26623576	26625350	BnaA01T0282200ZY	0	-	0	0	1774	0.0000000
zheyou73v0_A01	26625669	26627308	BnaA01T0282300ZY	0	-	0	0	1639	0.0000000
zheyou73v0_A01	26629679	26632735	BnaA01T0282400ZY	0	-	0	0	3056	0.0000000
zheyou73v0_A01	26646228	26647156	BnaA01T0282500ZY	0	-	0	0	928	0.0000000
zheyou73v0_A01	26666697	26667318	BnaA01T0282600ZY	0	-	0	0	621	0.0000000
zheyou73v0_A01	26677725	26680201	BnaA01T0282700ZY	0	-	0	0	2476	0.0000000
zheyou73v0_A01	26681706	26683360	BnaA01T0282800ZY	0	+	0	0	1654	0.0000000
zheyou73v0_A01	26690356	26691977	BnaA01T0282900ZY	0	+	0	0	1621	0.0000000
zheyou73v0_A01	26692735	26694528	BnaA01T0283000ZY	0	+	0	0	1793	0.0000000
zheyou73v0_A01	26694627	26695267	BnaA01T0283100ZY	0	+	0	0	640	0.0000000
zheyou73v0_A01	26695734	26701409	BnaA01T0283200ZY	0	+	0	0	5675	0.0000000
zheyou73v0_A01	26705413	26705989	BnaA01T0283300ZY	0	-	0	0	576	0.0000000
zheyou73v0_A01	26717301	26719534	BnaA01T0283400ZY	0	+	0	0	2233	0.0000000
zheyou73v0_A01	26720948	26735374	BnaA01T0283500ZY	0	+	0	0	14426	0.0000000
zheyou73v0_A01	26737871	26739321	BnaA01T0283600ZY	0	-	0	0	1450	0.0000000
zheyou73v0_A01	26754919	26756130	BnaA01T0283700ZY	0	+	0	0	1211	0.0000000
zheyou73v0_A01	26770315	26771791	BnaA01T0283800ZY	0	+	0	0	1476	0.0000000
zheyou73v0_A01	26781228	26784384	BnaA01T0283900ZY	0	+	0	0	3156	0.0000000
zheyou73v0_A01	26794564	26795302	BnaA01T0284000ZY	0	+	0	0	738	0.0000000
zheyou73v0_A01	26795625	26798174	BnaA01T0284100ZY	0	-	0	0	2549	0.0000000
zheyou73v0_A01	26795625	26798174	BnaA01T0284100ZY.1	0	-	0	0	2549	0.0000000
zheyou73v0_A01	26801728	26802037	BnaA01T0284200ZY	0	-	0	0	309	0.0000000
zheyou73v0_A01	26812687	26813536	BnaA01T0284300ZY	0	-	0	0	849	0.0000000
zheyou73v0_A01	26817179	26817614	BnaA01T0284400ZY	0	-	0	0	435	0.0000000
zheyou73v0_A01	26821349	26822738	BnaA01T0284500ZY	0	+	0	0	1389	0.0000000
zheyou73v0_A01	26828993	26829179	BnaA01T0284600ZY	0	+	0	0	186	0.0000000
zheyou73v0_A01	26835774	26836361	BnaA01T0284700ZY	0	-	0	0	587	0.0000000
zheyou73v0_A01	26844157	26845054	BnaA01T0284800ZY	0	+	0	0	897	0.0000000
zheyou73v0_A01	26844157	26845054	BnaA01T0284800ZY.1	0	+	0	0	897	0.0000000
zheyou73v0_A01	26845844	26849787	BnaA01T0284900ZY	0	-	0	0	3943	0.0000000
zheyou73v0_A01	26865522	26866896	BnaA01T0285000ZY	0	-	0	0	1374	0.0000000
zheyou73v0_A01	26873131	26875499	BnaA01T0285100ZY	0	-	0	0	2368	0.0000000
zheyou73v0_A01	26881887	26882611	BnaA01T0285200ZY	0	-	0	0	724	0.0000000
zheyou73v0_A01	26882754	26883941	BnaA01T0285300ZY	0	-	0	0	1187	0.0000000
zheyou73v0_A01	26893954	26895176	BnaA01T0285400ZY	0	-	0	0	1222	0.0000000
zheyou73v0_A01	26896187	26898905	BnaA01T0285500ZY	0	+	0	0	2718	0.0000000
zheyou73v0_A01	26899428	26900310	BnaA01T0285600ZY	0	+	0	0	882	0.0000000
zheyou73v0_A01	26900858	26901115	BnaA01T0285700ZY	0	-	0	0	257	0.0000000
zheyou73v0_A01	26902375	26906423	BnaA01T0285800ZY	0	+	0	0	4048	0.0000000
zheyou73v0_A01	26916098	26916328	BnaA01T0285900ZY	0	+	0	0	230	0.0000000
zheyou73v0_A01	26940020	26940278	BnaA01T0286000ZY	0	-	0	0	258	0.0000000
zheyou73v0_A01	26956662	26957827	BnaA01T0286100ZY	0	+	0	0	1165	0.0000000
zheyou73v0_A01	26963986	26964373	BnaA01T0286200ZY	0	+	0	0	387	0.0000000
zheyou73v0_A01	26965253	26966447	BnaA01T0286300ZY	0	-	0	0	1194	0.0000000
zheyou73v0_A01	26967528	26968264	BnaA01T0286400ZY	0	+	0	0	736	0.0000000
zheyou73v0_A01	26972386	26974268	BnaA01T0286500ZY	0	-	0	0	1882	0.0000000
zheyou73v0_A01	27003300	27004573	BnaA01T0286600ZY	0	-	0	0	1273	0.0000000
zheyou73v0_A01	27006985	27008207	BnaA01T0286700ZY	0	+	0	0	1222	0.0000000
zheyou73v0_A01	27006985	27008207	BnaA01T0286700ZY.1	0	+	0	0	1222	0.0000000
zheyou73v0_A01	27011123	27013261	BnaA01T0286800ZY	0	+	0	0	2138	0.0000000
zheyou73v0_A01	27013530	27014329	BnaA01T0286900ZY	0	-	0	0	799	0.0000000
zheyou73v0_A01	27019271	27020789	BnaA01T0287000ZY	0	-	0	0	1518	0.0000000
zheyou73v0_A01	27028644	27031954	BnaA01T0287100ZY	0	-	0	0	3310	0.0000000
zheyou73v0_A01	27033636	27039506	BnaA01T0287200ZY	0	-	0	0	5870	0.0000000
zheyou73v0_A01	27045166	27046385	BnaA01T0287300ZY	0	+	0	0	1219	0.0000000
zheyou73v0_A01	27046549	27048895	BnaA01T0287400ZY	0	-	0	0	2346	0.0000000
zheyou73v0_A01	27053087	27053766	BnaA01T0287500ZY	0	-	0	0	679	0.0000000
zheyou73v0_A01	27062659	27065011	BnaA01T0287600ZY	0	+	0	0	2352	0.0000000
zheyou73v0_A01	27065074	27070984	BnaA01T0287700ZY	0	-	0	0	5910	0.0000000
zheyou73v0_A01	27072486	27075469	BnaA01T0287800ZY	0	-	0	0	2983	0.0000000
zheyou73v0_A01	27075997	27076336	BnaA01T0287900ZY	0	+	0	0	339	0.0000000
zheyou73v0_A01	27079499	27110868	BnaA01T0288000ZY	0	-	0	0	31369	0.0000000
zheyou73v0_A01	27126954	27128703	BnaA01T0288100ZY	0	+	0	0	1749	0.0000000
zheyou73v0_A01	27161632	27161824	BnaA01T0288200ZY	0	+	0	0	192	0.0000000
zheyou73v0_A01	27175954	27176836	BnaA01T0288300ZY	0	-	0	0	882	0.0000000
zheyou73v0_A01	27221815	27223777	BnaA01T0288400ZY	0	-	0	0	1962	0.0000000
zheyou73v0_A01	27224707	27226252	BnaA01T0288500ZY	0	-	0	0	1545	0.0000000
zheyou73v0_A01	27226713	27228771	BnaA01T0288600ZY	0	-	0	0	2058	0.0000000
zheyou73v0_A01	27226713	27228771	BnaA01T0288600ZY.1	0	-	0	0	2058	0.0000000
zheyou73v0_A01	27233006	27233438	BnaA01T0288700ZY	0	-	0	0	432	0.0000000
zheyou73v0_A01	27243515	27245328	BnaA01T0288800ZY	0	-	0	0	1813	0.0000000
zheyou73v0_A01	27246588	27253735	BnaA01T0288900ZY	0	-	0	0	7147	0.0000000
zheyou73v0_A01	27261156	27262319	BnaA01T0289000ZY	0	+	0	0	1163	0.0000000
zheyou73v0_A01	27261156	27262913	BnaA01T0289000ZY.1	0	+	0	0	1757	0.0000000
zheyou73v0_A01	27261156	27265650	BnaA01T0289000ZY.2	0	+	0	0	4494	0.0000000
zheyou73v0_A01	27262511	27265356	BnaA01T0289100ZY	0	-	0	0	2845	0.0000000
zheyou73v0_A01	27266454	27267573	BnaA01T0289200ZY	0	+	0	0	1119	0.0000000
zheyou73v0_A01	27290322	27292572	BnaA01T0289300ZY	0	+	0	0	2250	0.0000000
zheyou73v0_A01	27290322	27292898	BnaA01T0289300ZY.1	0	+	0	0	2576	0.0000000
zheyou73v0_A01	27295618	27300370	BnaA01T0289400ZY	0	+	0	0	4752	0.0000000
zheyou73v0_A01	27304556	27308199	BnaA01T0289500ZY	0	-	0	0	3643	0.0000000
zheyou73v0_A01	27310309	27311782	BnaA01T0289600ZY	0	+	0	0	1473	0.0000000
zheyou73v0_A01	27316000	27321104	BnaA01T0289700ZY	0	-	0	0	5104	0.0000000
zheyou73v0_A01	27336232	27350296	BnaA01T0289800ZY	0	-	0	0	14064	0.0000000
zheyou73v0_A01	27350868	27352354	BnaA01T0289900ZY	0	-	0	0	1486	0.0000000
zheyou73v0_A01	27361944	27363170	BnaA01T0290000ZY	0	+	0	0	1226	0.0000000
zheyou73v0_A01	27369850	27381033	BnaA01T0290100ZY	0	-	0	0	11183	0.0000000
zheyou73v0_A01	27401172	27407256	BnaA01T0290200ZY	0	+	0	0	6084	0.0000000
zheyou73v0_A01	27401172	27407256	BnaA01T0290200ZY.1	0	+	0	0	6084	0.0000000
zheyou73v0_A01	27407733	27408824	BnaA01T0290300ZY	0	-	0	0	1091	0.0000000
zheyou73v0_A01	27415335	27416925	BnaA01T0290400ZY	0	-	0	0	1590	0.0000000
zheyou73v0_A01	27431806	27432904	BnaA01T0290500ZY	0	-	0	0	1098	0.0000000
zheyou73v0_A01	27436554	27438090	BnaA01T0290600ZY	0	+	0	0	1536	0.0000000
zheyou73v0_A01	27440323	27443298	BnaA01T0290700ZY	0	-	0	0	2975	0.0000000
zheyou73v0_A01	27456516	27456998	BnaA01T0290800ZY	0	-	0	0	482	0.0000000
zheyou73v0_A01	27462663	27465153	BnaA01T0290900ZY	0	+	0	0	2490	0.0000000
zheyou73v0_A01	27465390	27466272	BnaA01T0291000ZY	0	-	0	0	882	0.0000000
zheyou73v0_A01	27477871	27483273	BnaA01T0291100ZY	0	-	0	0	5402	0.0000000
zheyou73v0_A01	27477871	27483273	BnaA01T0291100ZY.1	0	-	0	0	5402	0.0000000
zheyou73v0_A01	27494803	27496148	BnaA01T0291200ZY	0	-	0	0	1345	0.0000000
zheyou73v0_A01	27501540	27504140	BnaA01T0291300ZY	0	-	0	0	2600	0.0000000
zheyou73v0_A01	27510007	27514324	BnaA01T0291400ZY	0	-	0	0	4317	0.0000000
zheyou73v0_A01	27524862	27527800	BnaA01T0291500ZY	0	-	0	0	2938	0.0000000
zheyou73v0_A01	27534165	27535508	BnaA01T0291600ZY	0	-	0	0	1343	0.0000000
zheyou73v0_A01	27556943	27559793	BnaA01T0291700ZY	0	-	0	0	2850	0.0000000
zheyou73v0_A01	27579220	27580099	BnaA01T0291800ZY	0	-	0	0	879	0.0000000
zheyou73v0_A01	27587956	27588189	BnaA01T0291900ZY	0	+	0	0	233	0.0000000
zheyou73v0_A01	27602135	27602327	BnaA01T0292000ZY	0	+	0	0	192	0.0000000
zheyou73v0_A01	27612976	27613393	BnaA01T0292100ZY	0	+	0	0	417	0.0000000
zheyou73v0_A01	27618898	27619261	BnaA01T0292200ZY	0	-	0	0	363	0.0000000
zheyou73v0_A01	27633074	27640486	BnaA01T0292300ZY	0	-	0	0	7412	0.0000000
zheyou73v0_A01	27641185	27641871	BnaA01T0292400ZY	0	-	0	0	686	0.0000000
zheyou73v0_A01	27667489	27668936	BnaA01T0292500ZY	0	+	0	0	1447	0.0000000
zheyou73v0_A01	27669402	27670783	BnaA01T0292600ZY	0	-	0	0	1381	0.0000000
zheyou73v0_A01	27675289	27676325	BnaA01T0292700ZY	0	-	0	0	1036	0.0000000
zheyou73v0_A01	27682132	27683579	BnaA01T0292800ZY	0	-	0	0	1447	0.0000000
zheyou73v0_A01	27688813	27690086	BnaA01T0292900ZY	0	+	0	0	1273	0.0000000
zheyou73v0_A01	27692769	27695652	BnaA01T0293000ZY	0	-	0	0	2883	0.0000000
zheyou73v0_A01	27692769	27695652	BnaA01T0293000ZY.1	0	-	0	0	2883	0.0000000
zheyou73v0_A01	27699770	27699923	BnaA01T0293100ZY	0	-	0	0	153	0.0000000
zheyou73v0_A01	27718066	27718937	BnaA01T0293200ZY	0	-	0	0	871	0.0000000
zheyou73v0_A01	27726300	27727120	BnaA01T0293300ZY	0	+	0	0	820	0.0000000
zheyou73v0_A01	27728870	27729992	BnaA01T0293400ZY	0	+	0	0	1122	0.0000000
zheyou73v0_A01	27732393	27733515	BnaA01T0293500ZY	0	-	0	0	1122	0.0000000
zheyou73v0_A01	27738399	27739944	BnaA01T0293600ZY	0	-	0	0	1545	0.0000000
zheyou73v0_A01	27738399	27739944	BnaA01T0293600ZY.1	0	-	0	0	1545	0.0000000
zheyou73v0_A01	27757596	27759911	BnaA01T0293700ZY	0	+	0	0	2315	0.0000000
zheyou73v0_A01	27779489	27800544	BnaA01T0293800ZY	0	-	0	0	21055	0.0000000
zheyou73v0_A01	27802749	27804210	BnaA01T0293900ZY	0	+	0	0	1461	0.0000000
zheyou73v0_A01	27802906	27803245	BnaA01T0294000ZY	0	-	0	0	339	0.0000000
zheyou73v0_A01	27812437	27812656	BnaA01T0294100ZY	0	-	0	0	219	0.0000000
zheyou73v0_A01	27832914	27834298	BnaA01T0294200ZY	0	+	0	0	1384	0.0000000
zheyou73v0_A01	27844080	27844590	BnaA01T0294300ZY	0	+	0	0	510	0.0000000
zheyou73v0_A01	27844793	27845238	BnaA01T0294400ZY	0	-	0	0	445	0.0000000
zheyou73v0_A01	27846504	27847749	BnaA01T0294500ZY	0	-	0	0	1245	0.0000000
zheyou73v0_A01	27859383	27860441	BnaA01T0294600ZY	0	-	0	0	1058	0.0000000
zheyou73v0_A01	27869200	27870046	BnaA01T0294700ZY	0	-	0	0	846	0.0000000
zheyou73v0_A01	27870388	27872799	BnaA01T0294800ZY	0	-	0	0	2411	0.0000000
zheyou73v0_A01	27870388	27872799	BnaA01T0294800ZY.1	0	-	0	0	2411	0.0000000
zheyou73v0_A01	27879747	27879900	BnaA01T0294900ZY	0	-	0	0	153	0.0000000
zheyou73v0_A01	27904878	27908291	BnaA01T0295000ZY	0	+	0	0	3413	0.0000000
zheyou73v0_A01	27908677	27910169	BnaA01T0295100ZY	0	-	0	0	1492	0.0000000
zheyou73v0_A01	27912658	27914563	BnaA01T0295200ZY	0	+	0	0	1905	0.0000000
zheyou73v0_A01	27939634	27942844	BnaA01T0295300ZY	0	+	0	0	3210	0.0000000
zheyou73v0_A01	27951573	27957970	BnaA01T0295400ZY	0	+	0	0	6397	0.0000000
zheyou73v0_A01	27959450	27959687	BnaA01T0295500ZY	0	-	0	0	237	0.0000000
zheyou73v0_A01	27977239	27980293	BnaA01T0295600ZY	0	+	0	0	3054	0.0000000
zheyou73v0_A01	27980433	27980961	BnaA01T0295700ZY	0	-	0	0	528	0.0000000
zheyou73v0_A01	27981355	27981767	BnaA01T0295800ZY	0	-	0	0	412	0.0000000
zheyou73v0_A01	27983021	27984708	BnaA01T0295900ZY	0	-	0	0	1687	0.0000000
zheyou73v0_A01	27987972	27989515	BnaA01T0296000ZY	0	-	0	0	1543	0.0000000
zheyou73v0_A01	27990892	27991860	BnaA01T0296100ZY	0	-	0	0	968	0.0000000
zheyou73v0_A01	28008775	28011781	BnaA01T0296200ZY	0	+	0	0	3006	0.0000000
zheyou73v0_A01	28008775	28011781	BnaA01T0296200ZY.1	0	+	0	0	3006	0.0000000
zheyou73v0_A01	28012023	28013328	BnaA01T0296300ZY	0	-	0	0	1305	0.0000000
zheyou73v0_A01	28026741	28028394	BnaA01T0296400ZY	0	+	0	0	1653	0.0000000
zheyou73v0_A01	28034762	28036599	BnaA01T0296500ZY	0	-	0	0	1837	0.0000000
zheyou73v0_A01	28060626	28061638	BnaA01T0296600ZY	0	+	0	0	1012	0.0000000
zheyou73v0_A01	28062401	28062788	BnaA01T0296700ZY	0	+	0	0	387	0.0000000
zheyou73v0_A01	28078055	28081319	BnaA01T0296800ZY	0	-	0	0	3264	0.0000000
zheyou73v0_A01	28089754	28091168	BnaA01T0296900ZY	0	+	0	0	1414	0.0000000
zheyou73v0_A01	28091259	28091744	BnaA01T0297000ZY	0	+	0	0	485	0.0000000
zheyou73v0_A01	28091864	28093397	BnaA01T0297100ZY	0	+	0	0	1533	0.0000000
zheyou73v0_A01	28103167	28104451	BnaA01T0297200ZY	0	+	0	0	1284	0.0000000
zheyou73v0_A01	28126935	28132492	BnaA01T0297300ZY	0	+	0	0	5557	0.0000000
zheyou73v0_A01	28132551	28133983	BnaA01T0297400ZY	0	-	0	0	1432	0.0000000
zheyou73v0_A01	28134814	28135195	BnaA01T0297500ZY	0	+	0	0	381	0.0000000
zheyou73v0_A01	28135580	28135964	BnaA01T0297600ZY	0	+	0	0	384	0.0000000
zheyou73v0_A01	28138744	28141772	BnaA01T0297700ZY	0	-	0	0	3028	0.0000000
zheyou73v0_A01	28155697	28156148	BnaA01T0297800ZY	0	-	0	0	451	0.0000000
zheyou73v0_A01	28160058	28162889	BnaA01T0297900ZY	0	-	0	0	2831	0.0000000
zheyou73v0_A01	28210823	28212686	BnaA01T0298000ZY	0	+	0	0	1863	0.0000000
zheyou73v0_A01	28213141	28213728	BnaA01T0298100ZY	0	+	0	0	587	0.0000000
zheyou73v0_A01	28214124	28215583	BnaA01T0298200ZY	0	+	0	0	1459	0.0000000
zheyou73v0_A01	28216837	28218827	BnaA01T0298300ZY	0	+	0	0	1990	0.0000000
zheyou73v0_A01	28222611	28223136	BnaA01T0298400ZY	0	-	0	0	525	0.0000000
zheyou73v0_A01	28223690	28223999	BnaA01T0298500ZY	0	+	0	0	309	0.0000000
zheyou73v0_A01	28224231	28225071	BnaA01T0298600ZY	0	-	0	0	840	0.0000000
zheyou73v0_A01	28225785	28226675	BnaA01T0298700ZY	0	+	0	0	890	0.0000000
zheyou73v0_A01	28231846	28233441	BnaA01T0298800ZY.1	0	+	0	0	1595	0.0000000
zheyou73v0_A01	28231846	28233786	BnaA01T0298800ZY.2	0	+	0	0	1940	0.0000000
zheyou73v0_A01	28231846	28233786	BnaA01T0298800ZY.3	0	+	0	0	1940	0.0000000
zheyou73v0_A01	28232060	28233441	BnaA01T0298800ZY	0	+	0	0	1381	0.0000000
zheyou73v0_A01	28237547	28238036	BnaA01T0298900ZY	0	+	0	0	489	0.0000000
zheyou73v0_A01	28238620	28241002	BnaA01T0299000ZY	0	-	0	0	2382	0.0000000
zheyou73v0_A01	28238620	28241002	BnaA01T0299000ZY.1	0	-	0	0	2382	0.0000000
zheyou73v0_A01	28250331	28251651	BnaA01T0299100ZY	0	-	0	0	1320	0.0000000
zheyou73v0_A01	28251718	28253893	BnaA01T0299200ZY	0	-	0	0	2175	0.0000000
zheyou73v0_A01	28256815	28258586	BnaA01T0299300ZY	0	-	0	0	1771	0.0000000
zheyou73v0_A01	28260463	28261272	BnaA01T0299400ZY	0	-	0	0	809	0.0000000
zheyou73v0_A01	28273149	28275650	BnaA01T0299500ZY	0	+	0	0	2501	0.0000000
zheyou73v0_A01	28281377	28286028	BnaA01T0299600ZY	0	-	0	0	4651	0.0000000
zheyou73v0_A01	28300386	28305935	BnaA01T0299700ZY	0	-	0	0	5549	0.0000000
zheyou73v0_A01	28300386	28305935	BnaA01T0299700ZY.1	0	-	0	0	5549	0.0000000
zheyou73v0_A01	28323442	28323736	BnaA01T0299800ZY	0	+	0	0	294	0.0000000
zheyou73v0_A01	28324345	28324615	BnaA01T0299900ZY	0	+	0	0	270	0.0000000
zheyou73v0_A01	28334217	28335004	BnaA01T0300000ZY	0	-	0	0	787	0.0000000
zheyou73v0_A01	28335531	28337112	BnaA01T0300100ZY	0	-	0	0	1581	0.0000000
zheyou73v0_A01	28337546	28340026	BnaA01T0300200ZY	0	-	0	0	2480	0.0000000
zheyou73v0_A01	28343358	28344606	BnaA01T0300300ZY	0	+	0	0	1248	0.0000000
zheyou73v0_A01	28346280	28346592	BnaA01T0300400ZY	0	-	0	0	312	0.0000000
zheyou73v0_A01	28358946	28362390	BnaA01T0300500ZY	0	-	0	0	3444	0.0000000
zheyou73v0_A01	28363481	28365731	BnaA01T0300600ZY	0	-	0	0	2250	0.0000000
zheyou73v0_A01	28363481	28365731	BnaA01T0300600ZY.1	0	-	0	0	2250	0.0000000
zheyou73v0_A01	28366605	28372465	BnaA01T0300700ZY	0	-	0	0	5860	0.0000000
zheyou73v0_A01	28381410	28382111	BnaA01T0300800ZY	0	+	0	0	701	0.0000000
zheyou73v0_A01	28385012	28385654	BnaA01T0300900ZY	0	+	0	0	642	0.0000000
zheyou73v0_A01	28385784	28398020	BnaA01T0301000ZY	0	-	0	0	12236	0.0000000
zheyou73v0_A01	28399081	28400987	BnaA01T0301100ZY	0	+	0	0	1906	0.0000000
zheyou73v0_A01	28401116	28403784	BnaA01T0301200ZY	0	-	0	0	2668	0.0000000
zheyou73v0_A01	28401116	28403840	BnaA01T0301200ZY.1	0	-	0	0	2724	0.0000000
zheyou73v0_A01	28411372	28415116	BnaA01T0301300ZY	0	+	0	0	3744	0.0000000
zheyou73v0_A01	28411372	28414390	BnaA01T0301300ZY.1	0	+	0	0	3018	0.0000000
zheyou73v0_A01	28427576	28428553	BnaA01T0301400ZY	0	+	0	0	977	0.0000000
zheyou73v0_A01	28435622	28436611	BnaA01T0301500ZY	0	+	0	0	989	0.0000000
zheyou73v0_A01	28443617	28444981	BnaA01T0301600ZY	0	+	0	0	1364	0.0000000
zheyou73v0_A01	28455304	28456783	BnaA01T0301700ZY	0	+	0	0	1479	0.0000000
zheyou73v0_A01	28465414	28466234	BnaA01T0301800ZY	0	+	0	0	820	0.0000000
zheyou73v0_A01	28468856	28469743	BnaA01T0301900ZY	0	-	0	0	887	0.0000000
zheyou73v0_A01	28469839	28470172	BnaA01T0302000ZY	0	-	0	0	333	0.0000000
zheyou73v0_A01	28471222	28472333	BnaA01T0302100ZY	0	-	0	0	1111	0.0000000
zheyou73v0_A01	28499909	28501053	BnaA01T0302200ZY	0	-	0	0	1144	0.0000000
zheyou73v0_A01	28515472	28516154	BnaA01T0302300ZY	0	+	0	0	682	0.0000000
zheyou73v0_A01	28517281	28519226	BnaA01T0302400ZY	0	-	0	0	1945	0.0000000
zheyou73v0_A01	28519844	28520461	BnaA01T0302500ZY	0	+	0	0	617	0.0000000
zheyou73v0_A01	28521251	28523257	BnaA01T0302600ZY	0	+	0	0	2006	0.0000000
zheyou73v0_A01	28524111	28527399	BnaA01T0302700ZY	0	-	0	0	3288	0.0000000
zheyou73v0_A01	28524111	28527399	BnaA01T0302700ZY.1	0	-	0	0	3288	0.0000000
zheyou73v0_A01	28544854	28546468	BnaA01T0302800ZY	0	+	0	0	1614	0.0000000
zheyou73v0_A01	28547498	28549217	BnaA01T0302900ZY	0	-	0	0	1719	0.0000000
zheyou73v0_A01	28560623	28561021	BnaA01T0303000ZY	0	-	0	0	398	0.0000000
zheyou73v0_A01	28583789	28584469	BnaA01T0303100ZY	0	-	0	0	680	0.0000000
zheyou73v0_A01	28595617	28596518	BnaA01T0303200ZY	0	-	0	0	901	0.0000000
zheyou73v0_A01	28600741	28602186	BnaA01T0303300ZY	0	-	0	0	1445	0.0000000
zheyou73v0_A01	28600741	28602158	BnaA01T0303300ZY.1	0	-	0	0	1417	0.0000000
zheyou73v0_A01	28605031	28606496	BnaA01T0303400ZY	0	-	0	0	1465	0.0000000
zheyou73v0_A01	28619115	28622722	BnaA01T0303500ZY	0	-	0	0	3607	0.0000000
zheyou73v0_A01	28621006	28622722	BnaA01T0303500ZY.1	0	-	0	0	1716	0.0000000
zheyou73v0_A01	28624595	28632060	BnaA01T0303600ZY	0	-	0	0	7465	0.0000000
zheyou73v0_A01	28642322	28642855	BnaA01T0303700ZY	0	+	0	0	533	0.0000000
zheyou73v0_A01	28660394	28662814	BnaA01T0303800ZY	0	+	0	0	2420	0.0000000
zheyou73v0_A01	28662957	28664483	BnaA01T0303900ZY	0	+	0	0	1526	0.0000000
zheyou73v0_A01	28664576	28664729	BnaA01T0304000ZY	0	+	0	0	153	0.0000000
zheyou73v0_A01	28668736	28669123	BnaA01T0304100ZY	0	+	0	0	387	0.0000000
zheyou73v0_A01	28683569	28684223	BnaA01T0304200ZY	0	+	0	0	654	0.0000000
zheyou73v0_A01	28688878	28690659	BnaA01T0304300ZY	0	-	0	0	1781	0.0000000
zheyou73v0_A01	28714911	28715748	BnaA01T0304400ZY	0	+	0	0	837	0.0000000
zheyou73v0_A01	28717195	28717804	BnaA01T0304500ZY	0	-	0	0	609	0.0000000
zheyou73v0_A01	28721692	28722837	BnaA01T0304600ZY	0	+	0	0	1145	0.0000000
zheyou73v0_A01	28738503	28740037	BnaA01T0304700ZY	0	-	0	0	1534	0.0000000
zheyou73v0_A01	28741004	28743014	BnaA01T0304800ZY	0	+	0	0	2010	0.0000000
zheyou73v0_A01	28765588	28775277	BnaA01T0304900ZY	0	-	0	0	9689	0.0000000
zheyou73v0_A01	28802090	28803765	BnaA01T0305000ZY	0	-	0	0	1675	0.0000000
zheyou73v0_A01	28804810	28807963	BnaA01T0305100ZY	0	+	0	0	3153	0.0000000
zheyou73v0_A01	28821195	28823254	BnaA01T0305200ZY	0	+	0	0	2059	0.0000000
zheyou73v0_A01	28835866	28836073	BnaA01T0305300ZY	0	-	0	0	207	0.0000000
zheyou73v0_A01	28838721	28839324	BnaA01T0305400ZY	0	-	0	0	603	0.0000000
zheyou73v0_A01	28845874	28848308	BnaA01T0305500ZY	0	-	0	0	2434	0.0000000
zheyou73v0_A01	28868051	28869882	BnaA01T0305600ZY	0	+	0	0	1831	0.0000000
zheyou73v0_A01	28876137	28878786	BnaA01T0305700ZY	0	+	0	0	2649	0.0000000
zheyou73v0_A01	28881021	28886437	BnaA01T0305800ZY	0	+	0	0	5416	0.0000000
zheyou73v0_A01	28891544	28892753	BnaA01T0305900ZY	0	-	0	0	1209	0.0000000
zheyou73v0_A01	28895490	28898711	BnaA01T0306000ZY	0	+	0	0	3221	0.0000000
zheyou73v0_A01	28895490	28898711	BnaA01T0306000ZY.1	0	+	0	0	3221	0.0000000
zheyou73v0_A01	28895490	28898711	BnaA01T0306000ZY.2	0	+	0	0	3221	0.0000000
zheyou73v0_A01	28898745	28899382	BnaA01T0306100ZY	0	-	0	0	637	0.0000000
zheyou73v0_A01	28899847	28901440	BnaA01T0306200ZY	0	-	0	0	1593	0.0000000
zheyou73v0_A01	28908671	28911054	BnaA01T0306300ZY	0	+	0	0	2383	0.0000000
zheyou73v0_A01	28908671	28911054	BnaA01T0306300ZY.1	0	+	0	0	2383	0.0000000
zheyou73v0_A01	28911163	28917669	BnaA01T0306400ZY	0	-	0	0	6506	0.0000000
zheyou73v0_A01	28918038	28920679	BnaA01T0306500ZY	0	-	0	0	2641	0.0000000
zheyou73v0_A01	28918038	28920679	BnaA01T0306500ZY.1	0	-	0	0	2641	0.0000000
zheyou73v0_A01	28923872	28926513	BnaA01T0306600ZY	0	+	0	0	2641	0.0000000
zheyou73v0_A01	28923872	28926513	BnaA01T0306600ZY.1	0	+	0	0	2641	0.0000000
zheyou73v0_A01	28926154	28928121	BnaA01T0306700ZY	0	-	0	0	1967	0.0000000
zheyou73v0_A01	28928355	28931112	BnaA01T0306800ZY	0	+	0	0	2757	0.0000000
zheyou73v0_A01	28928355	28931112	BnaA01T0306800ZY.1	0	+	0	0	2757	0.0000000
zheyou73v0_A01	28931670	28934230	BnaA01T0306900ZY	0	-	0	0	2560	0.0000000
zheyou73v0_A01	28957871	28960874	BnaA01T0307000ZY	0	+	0	0	3003	0.0000000
zheyou73v0_A01	28960747	28963565	BnaA01T0307100ZY	0	-	0	0	2818	0.0000000
zheyou73v0_A01	28960747	28963565	BnaA01T0307100ZY.1	0	-	0	0	2818	0.0000000
zheyou73v0_A01	28963893	28964403	BnaA01T0307200ZY	0	+	0	0	510	0.0000000
zheyou73v0_A01	28975434	28975632	BnaA01T0307300ZY	0	-	0	0	198	0.0000000
zheyou73v0_A01	28978640	28979495	BnaA01T0307400ZY	0	-	0	0	855	0.0000000
zheyou73v0_A01	28989291	28991087	BnaA01T0307500ZY	0	+	0	0	1796	0.0000000
zheyou73v0_A01	28989291	28991087	BnaA01T0307500ZY.1	0	+	0	0	1796	0.0000000
zheyou73v0_A01	28991387	28992288	BnaA01T0307600ZY	0	-	0	0	901	0.0000000
zheyou73v0_A01	28993223	28993739	BnaA01T0307700ZY	0	-	0	0	516	0.0000000
zheyou73v0_A01	29001257	29002128	BnaA01T0307800ZY	0	-	0	0	871	0.0000000
zheyou73v0_A01	29021396	29023402	BnaA01T0307900ZY	0	+	0	0	2006	0.0000000
zheyou73v0_A01	29034529	29034724	BnaA01T0308000ZY	0	+	0	0	195	0.0000000
zheyou73v0_A01	29034787	29037875	BnaA01T0308100ZY	0	-	0	0	3088	0.0000000
zheyou73v0_A01	29041636	29044311	BnaA01T0308200ZY	0	-	0	0	2675	0.0000000
zheyou73v0_A01	29072842	29073317	BnaA01T0308300ZY	0	+	0	0	475	0.0000000
zheyou73v0_A01	29073435	29073630	BnaA01T0308400ZY	0	+	0	0	195	0.0000000
zheyou73v0_A01	29074290	29074488	BnaA01T0308500ZY	0	+	0	0	198	0.0000000
zheyou73v0_A01	29080393	29081746	BnaA01T0308600ZY	0	-	0	0	1353	0.0000000
zheyou73v0_A01	29089011	29091133	BnaA01T0308700ZY	0	+	0	0	2122	0.0000000
zheyou73v0_A01	29094344	29099672	BnaA01T0308800ZY	0	+	0	0	5328	0.0000000
zheyou73v0_A01	29108052	29108211	BnaA01T0308900ZY	0	+	0	0	159	0.0000000
zheyou73v0_A01	29109806	29110894	BnaA01T0309000ZY	0	-	0	0	1088	0.0000000
zheyou73v0_A01	29113865	29121854	BnaA01T0309100ZY	0	+	0	0	7989	0.0000000
zheyou73v0_A01	29128796	29129375	BnaA01T0309200ZY	0	+	0	0	579	0.0000000
zheyou73v0_A01	29133987	29135095	BnaA01T0309300ZY	0	-	0	0	1108	0.0000000
zheyou73v0_A01	29146967	29148754	BnaA01T0309400ZY	0	-	0	0	1787	0.0000000
zheyou73v0_A01	29148762	29156372	BnaA01T0309500ZY	0	-	0	0	7610	0.0000000
zheyou73v0_A01	29157482	29169407	BnaA01T0309600ZY	0	+	0	0	11925	0.0000000
zheyou73v0_A01	29171978	29173292	BnaA01T0309700ZY	0	+	0	0	1314	0.0000000
zheyou73v0_A01	29173522	29174344	BnaA01T0309800ZY	0	-	0	0	822	0.0000000
zheyou73v0_A01	29178098	29180564	BnaA01T0309900ZY	0	+	0	0	2466	0.0000000
zheyou73v0_A01	29178098	29180564	BnaA01T0309900ZY.1	0	+	0	0	2466	0.0000000
zheyou73v0_A01	29178098	29180564	BnaA01T0309900ZY.2	0	+	0	0	2466	0.0000000
zheyou73v0_A01	29199895	29202530	BnaA01T0310000ZY	0	+	0	0	2635	0.0000000
zheyou73v0_A01	29214141	29214900	BnaA01T0310100ZY	0	-	0	0	759	0.0000000
zheyou73v0_A01	29219366	29222629	BnaA01T0310200ZY	0	+	0	0	3263	0.0000000
zheyou73v0_A01	29222960	29223638	BnaA01T0310300ZY	0	+	0	0	678	0.0000000
zheyou73v0_A01	29224744	29225377	BnaA01T0310400ZY	0	-	0	0	633	0.0000000
zheyou73v0_A01	29232605	29234177	BnaA01T0310500ZY	0	-	0	0	1572	0.0000000
zheyou73v0_A01	29259248	29261129	BnaA01T0310600ZY	0	+	0	0	1881	0.0000000
zheyou73v0_A01	29263454	29266409	BnaA01T0310700ZY	0	+	0	0	2955	0.0000000
zheyou73v0_A01	29266876	29268931	BnaA01T0310800ZY	0	-	0	0	2055	0.0000000
zheyou73v0_A01	29269661	29271509	BnaA01T0310900ZY	0	-	0	0	1848	0.0000000
zheyou73v0_A01	29288641	29289187	BnaA01T0311000ZY	0	+	0	0	546	0.0000000
zheyou73v0_A01	29290367	29292537	BnaA01T0311100ZY	0	+	0	0	2170	0.0000000
zheyou73v0_A01	29292616	29294336	BnaA01T0311200ZY	0	+	0	0	1720	0.0000000
zheyou73v0_A01	29295028	29296743	BnaA01T0311300ZY	0	+	0	0	1715	0.0000000
zheyou73v0_A01	29300499	29302989	BnaA01T0311400ZY	0	+	0	0	2490	0.0000000
zheyou73v0_A01	29303713	29307466	BnaA01T0311500ZY	0	+	0	0	3753	0.0000000
zheyou73v0_A01	29308120	29309158	BnaA01T0311600ZY	0	-	0	0	1038	0.0000000
zheyou73v0_A01	29335118	29335567	BnaA01T0311700ZY	0	-	0	0	449	0.0000000
zheyou73v0_A01	29422156	29425015	BnaA01T0311800ZY	0	-	0	0	2859	0.0000000
zheyou73v0_A01	29434462	29435812	BnaA01T0311900ZY	0	+	0	0	1350	0.0000000
zheyou73v0_A01	29435028	29435812	BnaA01T0311900ZY.1	0	+	0	0	784	0.0000000
zheyou73v0_A01	29436686	29448316	BnaA01T0312000ZY	0	+	0	0	11630	0.0000000
zheyou73v0_A01	29448635	29449012	BnaA01T0312100ZY	0	+	0	0	377	0.0000000
zheyou73v0_A01	29450243	29458370	BnaA01T0312200ZY	0	-	0	0	8127	0.0000000
zheyou73v0_A01	29464396	29467284	BnaA01T0312300ZY	0	-	0	0	2888	0.0000000
zheyou73v0_A01	29475633	29477848	BnaA01T0312400ZY	0	-	0	0	2215	0.0000000
zheyou73v0_A01	29479328	29480041	BnaA01T0312500ZY	0	-	0	0	713	0.0000000
zheyou73v0_A01	29480759	29483819	BnaA01T0312600ZY	0	-	0	0	3060	0.0000000
zheyou73v0_A01	29484930	29487253	BnaA01T0312700ZY	0	-	0	0	2323	0.0000000
zheyou73v0_A01	29490481	29492588	BnaA01T0312800ZY	0	-	0	0	2107	0.0000000
zheyou73v0_A01	29505167	29507277	BnaA01T0312900ZY	0	-	0	0	2110	0.0000000
zheyou73v0_A01	29511814	29512072	BnaA01T0313000ZY	0	-	0	0	258	0.0000000
zheyou73v0_A01	29537521	29539620	BnaA01T0313100ZY	0	+	0	0	2099	0.0000000
zheyou73v0_A01	29569482	29572461	BnaA01T0313200ZY	0	-	0	0	2979	0.0000000
zheyou73v0_A01	29574874	29576764	BnaA01T0313300ZY	0	+	0	0	1890	0.0000000
zheyou73v0_A01	29580265	29583150	BnaA01T0313400ZY	0	+	0	0	2885	0.0000000
zheyou73v0_A01	29585650	29589656	BnaA01T0313500ZY	0	-	0	0	4006	0.0000000
zheyou73v0_A01	29591349	29593402	BnaA01T0313600ZY	0	-	0	0	2053	0.0000000
zheyou73v0_A01	29593985	29595533	BnaA01T0313700ZY	0	-	0	0	1548	0.0000000
zheyou73v0_A01	29596083	29596278	BnaA01T0313800ZY	0	+	0	0	195	0.0000000
zheyou73v0_A01	29603943	29606890	BnaA01T0313900ZY	0	+	0	0	2947	0.0000000
zheyou73v0_A01	29609781	29612666	BnaA01T0314000ZY	0	+	0	0	2885	0.0000000
zheyou73v0_A01	29620814	29622276	BnaA01T0314100ZY	0	-	0	0	1462	0.0000000
zheyou73v0_A01	29622656	29625202	BnaA01T0314200ZY	0	-	0	0	2546	0.0000000
zheyou73v0_A01	29622656	29625202	BnaA01T0314200ZY.1	0	-	0	0	2546	0.0000000
zheyou73v0_A01	29625428	29632346	BnaA01T0314300ZY	0	+	0	0	6918	0.0000000
zheyou73v0_A01	29632706	29637510	BnaA01T0314400ZY	0	+	0	0	4804	0.0000000
zheyou73v0_A01	29663937	29666940	BnaA01T0314500ZY	0	-	0	0	3003	0.0000000
zheyou73v0_A01	29668391	29669792	BnaA01T0314600ZY	0	-	0	0	1401	0.0000000
zheyou73v0_A01	29673068	29673470	BnaA01T0314700ZY	0	+	0	0	402	0.0000000
zheyou73v0_A01	29687411	29687612	BnaA01T0314800ZY	0	+	0	0	201	0.0000000
zheyou73v0_A01	29693279	29695537	BnaA01T0314900ZY	0	-	0	0	2258	0.0000000
zheyou73v0_A01	29698205	29698656	BnaA01T0315000ZY	0	+	0	0	451	0.0000000
zheyou73v0_A01	29700561	29701500	BnaA01T0315100ZY	0	+	0	0	939	0.0000000
zheyou73v0_A01	29701586	29704274	BnaA01T0315200ZY	0	-	0	0	2688	0.0000000
zheyou73v0_A01	29707754	29709108	BnaA01T0315300ZY	0	+	0	0	1354	0.0000000
zheyou73v0_A01	29711253	29714571	BnaA01T0315400ZY	0	-	0	0	3318	0.0000000
zheyou73v0_A01	29711253	29714571	BnaA01T0315400ZY.1	0	-	0	0	3318	0.0000000
zheyou73v0_A01	29716141	29718500	BnaA01T0315500ZY	0	+	0	0	2359	0.0000000
zheyou73v0_A01	29728533	29729338	BnaA01T0315600ZY	0	+	0	0	805	0.0000000
zheyou73v0_A01	29737606	29744991	BnaA01T0315700ZY	0	+	0	0	7385	0.0000000
zheyou73v0_A01	29749792	29750848	BnaA01T0315800ZY	0	+	0	0	1056	0.0000000
zheyou73v0_A01	29750899	29752105	BnaA01T0315900ZY	0	+	0	0	1206	0.0000000
zheyou73v0_A01	29752474	29753141	BnaA01T0316000ZY	0	+	0	0	667	0.0000000
zheyou73v0_A01	29753176	29754057	BnaA01T0316100ZY	0	+	0	0	881	0.0000000
zheyou73v0_A01	29764009	29764213	BnaA01T0316200ZY	0	+	0	0	204	0.0000000
zheyou73v0_A01	29767938	29769729	BnaA01T0316300ZY	0	-	0	0	1791	0.0000000
zheyou73v0_A01	29780091	29780958	BnaA01T0316400ZY	0	-	0	0	867	0.0000000
zheyou73v0_A01	29781794	29785356	BnaA01T0316500ZY	0	+	0	0	3562	0.0000000
zheyou73v0_A01	29785555	29785876	BnaA01T0316600ZY	0	+	0	0	321	0.0000000
zheyou73v0_A01	29787359	29788977	BnaA01T0316700ZY	0	+	0	0	1618	0.0000000
zheyou73v0_A01	29798654	29800856	BnaA01T0316800ZY	0	+	0	0	2202	0.0000000
zheyou73v0_A01	29802284	29805836	BnaA01T0316900ZY	0	-	0	0	3552	0.0000000
zheyou73v0_A01	29807606	29809715	BnaA01T0317000ZY	0	-	0	0	2109	0.0000000
zheyou73v0_A01	29819908	29821072	BnaA01T0317100ZY	0	-	0	0	1164	0.0000000
zheyou73v0_A01	29827466	29829350	BnaA01T0317200ZY	0	-	0	0	1884	0.0000000
zheyou73v0_A01	29850812	29852511	BnaA01T0317300ZY	0	+	0	0	1699	0.0000000
zheyou73v0_A01	29853155	29854705	BnaA01T0317400ZY	0	-	0	0	1550	0.0000000
zheyou73v0_A01	29869795	29871605	BnaA01T0317500ZY	0	-	0	0	1810	0.0000000
zheyou73v0_A01	29895394	29896406	BnaA01T0317600ZY	0	+	0	0	1012	0.0000000
zheyou73v0_A01	29897196	29898547	BnaA01T0317700ZY	0	-	0	0	1351	0.0000000
zheyou73v0_A01	29902445	29908399	BnaA01T0317800ZY	0	+	0	0	5954	0.0000000
zheyou73v0_A01	29908596	29910025	BnaA01T0317900ZY	0	+	0	0	1429	0.0000000
zheyou73v0_A01	29911083	29912536	BnaA01T0318000ZY	0	+	0	0	1453	0.0000000
zheyou73v0_A01	29913211	29915838	BnaA01T0318100ZY	0	+	0	0	2627	0.0000000
zheyou73v0_A01	29913211	29915838	BnaA01T0318100ZY.1	0	+	0	0	2627	0.0000000
zheyou73v0_A01	29918199	29921689	BnaA01T0318200ZY	0	-	0	0	3490	0.0000000
zheyou73v0_A01	29948613	29957177	BnaA01T0318300ZY	0	+	0	0	8564	0.0000000
zheyou73v0_A01	29959636	29960211	BnaA01T0318400ZY	0	+	0	0	575	0.0000000
zheyou73v0_A01	29967068	29969744	BnaA01T0318500ZY	0	+	0	0	2676	0.0000000
zheyou73v0_A01	29984828	29987922	BnaA01T0318600ZY	0	+	0	0	3094	0.0000000
zheyou73v0_A01	29991177	29992999	BnaA01T0318700ZY	0	-	0	0	1822	0.0000000
zheyou73v0_A01	30017029	30017329	BnaA01T0318800ZY	0	-	0	0	300	0.0000000
zheyou73v0_A01	30017454	30019760	BnaA01T0318900ZY	0	+	0	0	2306	0.0000000
zheyou73v0_A01	30020470	30026193	BnaA01T0319000ZY	0	-	0	0	5723	0.0000000
zheyou73v0_A01	30026755	30027534	BnaA01T0319100ZY	0	-	0	0	779	0.0000000
zheyou73v0_A01	30029847	30031582	BnaA01T0319200ZY	0	-	0	0	1735	0.0000000
zheyou73v0_A01	30045957	30046873	BnaA01T0319300ZY	0	+	0	0	916	0.0000000
zheyou73v0_A01	30088567	30091846	BnaA01T0319400ZY	0	+	0	0	3279	0.0000000
zheyou73v0_A01	30120092	30122511	BnaA01T0319500ZY	0	-	0	0	2419	0.0000000
zheyou73v0_A01	30124261	30127703	BnaA01T0319600ZY	0	+	0	0	3442	0.0000000
zheyou73v0_A01	30128333	30129118	BnaA01T0319700ZY	0	-	0	0	785	0.0000000
zheyou73v0_A01	30131040	30133268	BnaA01T0319800ZY	0	-	0	0	2228	0.0000000
zheyou73v0_A01	30137150	30137825	BnaA01T0319900ZY	0	-	0	0	675	0.0000000
zheyou73v0_A01	30140547	30141257	BnaA01T0320000ZY	0	-	0	0	710	0.0000000
zheyou73v0_A01	30150843	30156287	BnaA01T0320100ZY	0	-	0	0	5444	0.0000000
zheyou73v0_A01	30159751	30161677	BnaA01T0320200ZY	0	+	0	0	1926	0.0000000
zheyou73v0_A01	30163308	30165751	BnaA01T0320300ZY	0	+	0	0	2443	0.0000000
zheyou73v0_A01	30166024	30166747	BnaA01T0320400ZY	0	-	0	0	723	0.0000000
zheyou73v0_A01	30177376	30177658	BnaA01T0320500ZY	0	-	0	0	282	0.0000000
zheyou73v0_A01	30212180	30212979	BnaA01T0320600ZY	0	+	0	0	799	0.0000000
zheyou73v0_A01	30248640	30252518	BnaA01T0320700ZY	0	+	0	0	3878	0.0000000
zheyou73v0_A01	30253348	30259371	BnaA01T0320800ZY	0	+	0	0	6023	0.0000000
zheyou73v0_A01	30261133	30263636	BnaA01T0320900ZY	0	-	0	0	2503	0.0000000
zheyou73v0_A01	30280568	30282505	BnaA01T0321000ZY	0	-	0	0	1937	0.0000000
zheyou73v0_A01	30300160	30302290	BnaA01T0321100ZY	0	-	0	0	2130	0.0000000
zheyou73v0_A01	30304305	30306134	BnaA01T0321200ZY	0	-	0	0	1829	0.0000000
zheyou73v0_A01	30306722	30308162	BnaA01T0321300ZY	0	-	0	0	1440	0.0000000
zheyou73v0_A01	30316844	30317246	BnaA01T0321400ZY	0	+	0	0	402	0.0000000
zheyou73v0_A01	30317881	30318493	BnaA01T0321500ZY	0	-	0	0	612	0.0000000
zheyou73v0_A01	30319723	30321885	BnaA01T0321600ZY	0	+	0	0	2162	0.0000000
zheyou73v0_A01	30329760	30330897	BnaA01T0321700ZY	0	+	0	0	1137	0.0000000
zheyou73v0_A01	30346977	30348716	BnaA01T0321800ZY	0	-	0	0	1739	0.0000000
zheyou73v0_A01	30346977	30348716	BnaA01T0321800ZY.1	0	-	0	0	1739	0.0000000
zheyou73v0_A01	30346977	30348716	BnaA01T0321800ZY.2	0	-	0	0	1739	0.0000000
zheyou73v0_A01	30346977	30348716	BnaA01T0321800ZY.3	0	-	0	0	1739	0.0000000
zheyou73v0_A01	30346977	30348716	BnaA01T0321800ZY.4	0	-	0	0	1739	0.0000000
zheyou73v0_A01	30346977	30348716	BnaA01T0321800ZY.5	0	-	0	0	1739	0.0000000
zheyou73v0_A01	30355657	30356175	BnaA01T0321900ZY	0	+	0	0	518	0.0000000
zheyou73v0_A01	30356233	30357055	BnaA01T0322000ZY	0	-	0	0	822	0.0000000
zheyou73v0_A01	30356233	30357055	BnaA01T0322000ZY.1	0	-	0	0	822	0.0000000
zheyou73v0_A01	30357300	30358879	BnaA01T0322100ZY	0	-	0	0	1579	0.0000000
zheyou73v0_A01	30357300	30358879	BnaA01T0322100ZY.1	0	-	0	0	1579	0.0000000
zheyou73v0_A01	30359368	30362083	BnaA01T0322200ZY	0	-	0	0	2715	0.0000000
zheyou73v0_A01	30365852	30366062	BnaA01T0322300ZY	0	+	0	0	210	0.0000000
zheyou73v0_A01	30368277	30370457	BnaA01T0322400ZY	0	+	0	0	2180	0.0000000
zheyou73v0_A01	30372779	30372962	BnaA01T0322500ZY	0	+	0	0	183	0.0000000
zheyou73v0_A01	30373003	30373420	BnaA01T0322600ZY	0	+	0	0	417	0.0000000
zheyou73v0_A01	30394663	30395746	BnaA01T0322700ZY	0	-	0	0	1083	0.0000000
zheyou73v0_A01	30401968	30403995	BnaA01T0322800ZY	0	-	0	0	2027	0.0000000
zheyou73v0_A01	30404105	30405912	BnaA01T0322900ZY	0	-	0	0	1807	0.0000000
zheyou73v0_A01	30406156	30406853	BnaA01T0323000ZY	0	-	0	0	697	0.0000000
zheyou73v0_A01	30407951	30408615	BnaA01T0323100ZY	0	+	0	0	664	0.0000000
zheyou73v0_A01	30413026	30413275	BnaA01T0323200ZY	0	-	0	0	249	0.0000000
zheyou73v0_A01	30420223	30423894	BnaA01T0323300ZY	0	-	0	0	3671	0.0000000
zheyou73v0_A01	30425319	30426791	BnaA01T0323400ZY	0	+	0	0	1472	0.0000000
zheyou73v0_A01	30441942	30495380	BnaA01T0323500ZY	0	+	0	0	53438	0.0000000
zheyou73v0_A01	30496180	30496931	BnaA01T0323600ZY	0	+	0	0	751	0.0000000
zheyou73v0_A01	30501033	30503142	BnaA01T0323700ZY	0	+	0	0	2109	0.0000000
zheyou73v0_A01	30503823	30506246	BnaA01T0323800ZY	0	-	0	0	2423	0.0000000
zheyou73v0_A01	30510985	30513824	BnaA01T0323900ZY	0	+	0	0	2839	0.0000000
zheyou73v0_A01	30514368	30515084	BnaA01T0324000ZY	0	-	0	0	716	0.0000000
zheyou73v0_A01	30519912	30520671	BnaA01T0324100ZY	0	+	0	0	759	0.0000000
zheyou73v0_A01	30521597	30524213	BnaA01T0324200ZY	0	-	0	0	2616	0.0000000
zheyou73v0_A01	30531594	30532971	BnaA01T0324300ZY	0	+	0	0	1377	0.0000000
zheyou73v0_A01	30534755	30549988	BnaA01T0324400ZY	0	+	0	0	15233	0.0000000
zheyou73v0_A01	30550798	30551827	BnaA01T0324500ZY	0	-	0	0	1029	0.0000000
zheyou73v0_A01	30569537	30570518	BnaA01T0324600ZY	0	-	0	0	981	0.0000000
zheyou73v0_A01	30575228	30576777	BnaA01T0324700ZY	0	+	0	0	1549	0.0000000
zheyou73v0_A01	30585147	30586992	BnaA01T0324800ZY	0	+	0	0	1845	0.0000000
zheyou73v0_A01	30587927	30588452	BnaA01T0324900ZY	0	+	0	0	525	0.0000000
zheyou73v0_A01	30588748	30589303	BnaA01T0325000ZY	0	-	0	0	555	0.0000000
zheyou73v0_A01	30597454	30597727	BnaA01T0325100ZY	0	+	0	0	273	0.0000000
zheyou73v0_A01	30602034	30605913	BnaA01T0325200ZY	0	-	0	0	3879	0.0000000
zheyou73v0_A01	30624716	30631457	BnaA01T0325300ZY	0	+	0	0	6741	0.0000000
zheyou73v0_A01	30632004	30633070	BnaA01T0325400ZY	0	+	0	0	1066	0.0000000
zheyou73v0_A01	30633450	30634021	BnaA01T0325500ZY	0	-	0	0	571	0.0000000
zheyou73v0_A01	30641378	30642905	BnaA01T0325600ZY	0	+	0	0	1527	0.0000000
zheyou73v0_A01	30643984	30644678	BnaA01T0325700ZY	0	-	0	0	694	0.0000000
zheyou73v0_A01	30654283	30654466	BnaA01T0325800ZY	0	-	0	0	183	0.0000000
zheyou73v0_A01	30655635	30656336	BnaA01T0325900ZY	0	+	0	0	701	0.0000000
zheyou73v0_A01	30657124	30657753	BnaA01T0326000ZY	0	+	0	0	629	0.0000000
zheyou73v0_A01	30659530	30661585	BnaA01T0326100ZY	0	-	0	0	2055	0.0000000
zheyou73v0_A01	30664046	30666957	BnaA01T0326200ZY	0	+	0	0	2911	0.0000000
zheyou73v0_A01	30685711	30687013	BnaA01T0326300ZY	0	+	0	0	1302	0.0000000
zheyou73v0_A01	30702800	30703325	BnaA01T0326400ZY	0	-	0	0	525	0.0000000
zheyou73v0_A01	30706053	30707037	BnaA01T0326500ZY	0	+	0	0	984	0.0000000
zheyou73v0_A01	30712919	30714252	BnaA01T0326600ZY	0	-	0	0	1333	0.0000000
zheyou73v0_A01	30716765	30718568	BnaA01T0326700ZY	0	-	0	0	1803	0.0000000
zheyou73v0_A01	30721089	30721429	BnaA01T0326800ZY	0	-	0	0	340	0.0000000
zheyou73v0_A01	30729813	30730150	BnaA01T0326900ZY	0	-	0	0	337	0.0000000
zheyou73v0_A01	30738200	30738740	BnaA01T0327000ZY	0	+	0	0	540	0.0000000
zheyou73v0_A01	30745108	30746337	BnaA01T0327100ZY	0	-	0	0	1229	0.0000000
zheyou73v0_A01	30751302	30754161	BnaA01T0327200ZY	0	+	0	0	2859	0.0000000
zheyou73v0_A01	30754865	30755851	BnaA01T0327300ZY	0	+	0	0	986	0.0000000
zheyou73v0_A01	30756268	30758722	BnaA01T0327400ZY	0	-	0	0	2454	0.0000000
zheyou73v0_A01	30769433	30770551	BnaA01T0327500ZY	0	+	0	0	1118	0.0000000
zheyou73v0_A01	30776985	30777426	BnaA01T0327600ZY	0	+	0	0	441	0.0000000
zheyou73v0_A01	30778614	30779088	BnaA01T0327700ZY	0	+	0	0	474	0.0000000
zheyou73v0_A01	30779722	30780471	BnaA01T0327800ZY	0	-	0	0	749	0.0000000
zheyou73v0_A01	30781222	30783672	BnaA01T0327900ZY	0	+	0	0	2450	0.0000000
zheyou73v0_A01	30785076	30785934	BnaA01T0328000ZY	0	+	0	0	858	0.0000000
zheyou73v0_A01	30788497	30791202	BnaA01T0328100ZY	0	+	0	0	2705	0.0000000
zheyou73v0_A01	30792359	30792894	BnaA01T0328200ZY	0	-	0	0	535	0.0000000
zheyou73v0_A01	30803103	30807743	BnaA01T0328300ZY	0	+	0	0	4640	0.0000000
zheyou73v0_A01	30811429	30812422	BnaA01T0328400ZY	0	+	0	0	993	0.0000000
zheyou73v0_A01	30820953	30826511	BnaA01T0328500ZY	0	-	0	0	5558	0.0000000
zheyou73v0_A01	30829242	30831459	BnaA01T0328600ZY	0	-	0	0	2217	0.0000000
zheyou73v0_A01	30839699	30841193	BnaA01T0328700ZY	0	-	0	0	1494	0.0000000
zheyou73v0_A01	30847306	30847672	BnaA01T0328800ZY	0	-	0	0	366	0.0000000
zheyou73v0_A01	30864402	30864698	BnaA01T0328900ZY	0	-	0	0	296	0.0000000
zheyou73v0_A01	30866398	30866683	BnaA01T0329000ZY	0	-	0	0	285	0.0000000
zheyou73v0_A01	30871756	30871963	BnaA01T0329100ZY	0	+	0	0	207	0.0000000
zheyou73v0_A01	30874631	30875925	BnaA01T0329200ZY	0	-	0	0	1294	0.0000000
zheyou73v0_A01	30876867	30878697	BnaA01T0329300ZY	0	-	0	0	1830	0.0000000
zheyou73v0_A01	30892357	30895378	BnaA01T0329400ZY	0	+	0	0	3021	0.0000000
zheyou73v0_A01	30897327	30898083	BnaA01T0329500ZY	0	-	0	0	756	0.0000000
zheyou73v0_A01	30899784	30900540	BnaA01T0329600ZY	0	-	0	0	756	0.0000000
zheyou73v0_A01	30905284	30906225	BnaA01T0329700ZY	0	-	0	0	941	0.0000000
zheyou73v0_A01	30908850	30911041	BnaA01T0329800ZY	0	-	0	0	2191	0.0000000
zheyou73v0_A01	30911700	30913128	BnaA01T0329900ZY	0	-	0	0	1428	0.0000000
zheyou73v0_A01	30914674	30916328	BnaA01T0330000ZY	0	+	0	0	1654	0.0000000
zheyou73v0_A01	30918983	30920206	BnaA01T0330100ZY	0	-	0	0	1223	0.0000000
zheyou73v0_A01	30922493	30926016	BnaA01T0330200ZY	0	-	0	0	3523	0.0000000
zheyou73v0_A01	30938490	30940028	BnaA01T0330300ZY	0	+	0	0	1538	0.0000000
zheyou73v0_A01	30941653	30948860	BnaA01T0330400ZY	0	+	0	0	7207	0.0000000
zheyou73v0_A01	30949390	30951358	BnaA01T0330500ZY	0	+	0	0	1968	0.0000000
zheyou73v0_A01	30951743	30953860	BnaA01T0330600ZY	0	+	0	0	2117	0.0000000
zheyou73v0_A01	30968562	30970504	BnaA01T0330700ZY	0	+	0	0	1942	0.0000000
zheyou73v0_A01	30990376	30992035	BnaA01T0330800ZY	0	+	0	0	1659	0.0000000
zheyou73v0_A01	30994701	30995095	BnaA01T0330900ZY	0	-	0	0	394	0.0000000
zheyou73v0_A01	31003383	31006288	BnaA01T0331000ZY	0	+	0	0	2905	0.0000000
zheyou73v0_A01	31007137	31008852	BnaA01T0331100ZY	0	-	0	0	1715	0.0000000
zheyou73v0_A01	31011963	31015025	BnaA01T0331200ZY	0	-	0	0	3062	0.0000000
zheyou73v0_A01	31016534	31020005	BnaA01T0331300ZY	0	-	0	0	3471	0.0000000
zheyou73v0_A01	31028918	31030600	BnaA01T0331400ZY	0	-	0	0	1682	0.0000000
zheyou73v0_A01	31033444	31035429	BnaA01T0331500ZY	0	-	0	0	1985	0.0000000
zheyou73v0_A01	31042816	31043896	BnaA01T0331600ZY	0	-	0	0	1080	0.0000000
zheyou73v0_A01	31059414	31066660	BnaA01T0331700ZY	0	-	0	0	7246	0.0000000
zheyou73v0_A01	31073131	31073832	BnaA01T0331800ZY	0	-	0	0	701	0.0000000
zheyou73v0_A01	31074417	31075951	BnaA01T0331900ZY	0	+	0	0	1534	0.0000000
zheyou73v0_A01	31077757	31079118	BnaA01T0332000ZY	0	-	0	0	1361	0.0000000
zheyou73v0_A01	31089097	31097202	BnaA01T0332100ZY	0	-	0	0	8105	0.0000000
zheyou73v0_A01	31097992	31100876	BnaA01T0332200ZY	0	+	0	0	2884	0.0000000
zheyou73v0_A01	31110237	31113630	BnaA01T0332300ZY	0	+	0	0	3393	0.0000000
zheyou73v0_A01	31113621	31114590	BnaA01T0332400ZY	0	-	0	0	969	0.0000000
zheyou73v0_A01	31114828	31118516	BnaA01T0332500ZY	0	-	0	0	3688	0.0000000
zheyou73v0_A01	31114828	31118516	BnaA01T0332500ZY.1	0	-	0	0	3688	0.0000000
zheyou73v0_A01	31118840	31119885	BnaA01T0332600ZY	0	-	0	0	1045	0.0000000
zheyou73v0_A01	31118840	31120194	BnaA01T0332600ZY.1	0	-	0	0	1354	0.0000000
zheyou73v0_A01	31122234	31123838	BnaA01T0332700ZY	0	+	0	0	1604	0.0000000
zheyou73v0_A01	31123822	31125303	BnaA01T0332800ZY	0	-	0	0	1481	0.0000000
zheyou73v0_A01	31133024	31134050	BnaA01T0332900ZY	0	+	0	0	1026	0.0000000
zheyou73v0_A01	31133937	31135523	BnaA01T0333000ZY	0	-	0	0	1586	0.0000000
zheyou73v0_A01	31135842	31136244	BnaA01T0333100ZY	0	-	0	0	402	0.0000000
zheyou73v0_A01	31142945	31145713	BnaA01T0333200ZY	0	-	0	0	2768	0.0000000
zheyou73v0_A01	31155598	31159227	BnaA01T0333300ZY	0	-	0	0	3629	0.0000000
zheyou73v0_A01	31160486	31161401	BnaA01T0333400ZY	0	+	0	0	915	0.0000000
zheyou73v0_A01	31170477	31171823	BnaA01T0333500ZY	0	-	0	0	1346	0.0000000
zheyou73v0_A01	31173915	31176156	BnaA01T0333600ZY	0	+	0	0	2241	0.0000000
zheyou73v0_A01	31176290	31180349	BnaA01T0333700ZY	0	-	0	0	4059	0.0000000
zheyou73v0_A01	31176290	31180269	BnaA01T0333700ZY.1	0	-	0	0	3979	0.0000000
zheyou73v0_A01	31206624	31213187	BnaA01T0333800ZY	0	+	0	0	6563	0.0000000
zheyou73v0_A01	31206624	31213187	BnaA01T0333800ZY.1	0	+	0	0	6563	0.0000000
zheyou73v0_A01	31218376	31221834	BnaA01T0333900ZY	0	+	0	0	3458	0.0000000
zheyou73v0_A01	31223851	31228667	BnaA01T0334000ZY	0	+	0	0	4816	0.0000000
zheyou73v0_A01	31229310	31230009	BnaA01T0334100ZY	0	+	0	0	699	0.0000000
zheyou73v0_A01	31230176	31232609	BnaA01T0334200ZY	0	-	0	0	2433	0.0000000
zheyou73v0_A01	31232979	31236375	BnaA01T0334300ZY	0	+	0	0	3396	0.0000000
zheyou73v0_A01	31236601	31238087	BnaA01T0334400ZY	0	+	0	0	1486	0.0000000
zheyou73v0_A01	31244584	31245395	BnaA01T0334500ZY	0	+	0	0	811	0.0000000
zheyou73v0_A01	31245595	31250665	BnaA01T0334600ZY	0	+	0	0	5070	0.0000000
zheyou73v0_A01	31251127	31251628	BnaA01T0334700ZY	0	+	0	0	501	0.0000000
zheyou73v0_A01	31256633	31258085	BnaA01T0334800ZY	0	+	0	0	1452	0.0000000
zheyou73v0_A01	31258503	31260626	BnaA01T0334900ZY	0	-	0	0	2123	0.0000000
zheyou73v0_A01	31265036	31266642	BnaA01T0335000ZY	0	-	0	0	1606	0.0000000
zheyou73v0_A01	31267600	31269850	BnaA01T0335100ZY	0	-	0	0	2250	0.0000000
zheyou73v0_A01	31270305	31271700	BnaA01T0335200ZY	0	-	0	0	1395	0.0000000
zheyou73v0_A01	31272344	31273250	BnaA01T0335300ZY	0	-	0	0	906	0.0000000
zheyou73v0_A01	31273978	31274842	BnaA01T0335400ZY	0	-	0	0	864	0.0000000
zheyou73v0_A01	31275598	31279431	BnaA01T0335500ZY	0	-	0	0	3833	0.0000000
zheyou73v0_A01	31286946	31288355	BnaA01T0335600ZY	0	+	0	0	1409	0.0000000
zheyou73v0_A01	31289337	31289532	BnaA01T0335700ZY	0	+	0	0	195	0.0000000
zheyou73v0_A01	31289831	31292107	BnaA01T0335800ZY	0	-	0	0	2276	0.0000000
zheyou73v0_A01	31293283	31294819	BnaA01T0335900ZY	0	-	0	0	1536	0.0000000
zheyou73v0_A01	31299173	31299943	BnaA01T0336000ZY	0	+	0	0	770	0.0000000
zheyou73v0_A01	31301365	31302595	BnaA01T0336100ZY	0	+	0	0	1230	0.0000000
zheyou73v0_A01	31302549	31304524	BnaA01T0336200ZY	0	-	0	0	1975	0.0000000
zheyou73v0_A01	31310487	31312525	BnaA01T0336300ZY	0	-	0	0	2038	0.0000000
zheyou73v0_A01	31313525	31314566	BnaA01T0336400ZY	0	-	0	0	1041	0.0000000
zheyou73v0_A01	31318742	31321512	BnaA01T0336500ZY	0	+	0	0	2770	0.0000000
zheyou73v0_A01	31323359	31324031	BnaA01T0336600ZY	0	+	0	0	672	0.0000000
zheyou73v0_A01	31327247	31330046	BnaA01T0336700ZY	0	-	0	0	2799	0.0000000
zheyou73v0_A01	31331052	31331442	BnaA01T0336800ZY	0	-	0	0	390	0.0000000
zheyou73v0_A01	31370383	31373179	BnaA01T0336900ZY	0	+	0	0	2796	0.0000000
zheyou73v0_A01	31377543	31379509	BnaA01T0337000ZY	0	-	0	0	1966	0.0000000
zheyou73v0_A01	31377543	31379509	BnaA01T0337000ZY.1	0	-	0	0	1966	0.0000000
zheyou73v0_A01	31403507	31404963	BnaA01T0337100ZY	0	-	0	0	1456	0.0000000
zheyou73v0_A01	31421259	31422321	BnaA01T0337200ZY	0	-	0	0	1062	0.0000000
zheyou73v0_A01	31424935	31426836	BnaA01T0337300ZY	0	+	0	0	1901	0.0000000
zheyou73v0_A01	31426694	31427856	BnaA01T0337400ZY	0	-	0	0	1162	0.0000000
zheyou73v0_A01	31430034	31437378	BnaA01T0337500ZY	0	-	0	0	7344	0.0000000
zheyou73v0_A01	31438375	31439806	BnaA01T0337600ZY	0	-	0	0	1431	0.0000000
zheyou73v0_A01	31440916	31443677	BnaA01T0337700ZY	0	+	0	0	2761	0.0000000
zheyou73v0_A01	31440916	31443548	BnaA01T0337700ZY.1	0	+	0	0	2632	0.0000000
zheyou73v0_A01	31448080	31450167	BnaA01T0337800ZY	0	-	0	0	2087	0.0000000
zheyou73v0_A01	31450465	31450741	BnaA01T0337900ZY	0	+	0	0	276	0.0000000
zheyou73v0_A01	31452165	31455045	BnaA01T0338000ZY	0	-	0	0	2880	0.0000000
zheyou73v0_A01	31456503	31456740	BnaA01T0338100ZY	0	-	0	0	237	0.0000000
zheyou73v0_A01	31457921	31458871	BnaA01T0338200ZY	0	-	0	0	950	0.0000000
zheyou73v0_A01	31459361	31460054	BnaA01T0338300ZY	0	-	0	0	693	0.0000000
zheyou73v0_A01	31461047	31462066	BnaA01T0338400ZY	0	+	0	0	1019	0.0000000
zheyou73v0_A01	31463449	31467163	BnaA01T0338500ZY	0	+	0	0	3714	0.0000000
zheyou73v0_A01	31470329	31473115	BnaA01T0338600ZY	0	-	0	0	2786	0.0000000
zheyou73v0_A01	31475491	31476074	BnaA01T0338700ZY	0	+	0	0	583	0.0000000
zheyou73v0_A01	31479035	31479899	BnaA01T0338800ZY	0	-	0	0	864	0.0000000
zheyou73v0_A01	31487653	31488569	BnaA01T0338900ZY	0	+	0	0	916	0.0000000
zheyou73v0_A01	31490544	31491263	BnaA01T0339000ZY	0	+	0	0	719	0.0000000
zheyou73v0_A01	31494181	31494998	BnaA01T0339100ZY	0	+	0	0	817	0.0000000
zheyou73v0_A01	31496348	31496751	BnaA01T0339200ZY	0	-	0	0	403	0.0000000
zheyou73v0_A01	31498749	31499157	BnaA01T0339300ZY	0	-	0	0	408	0.0000000
zheyou73v0_A01	31520487	31521340	BnaA01T0339400ZY	0	-	0	0	853	0.0000000
zheyou73v0_A01	31523326	31525102	BnaA01T0339500ZY	0	-	0	0	1776	0.0000000
zheyou73v0_A01	31527781	31529168	BnaA01T0339600ZY	0	+	0	0	1387	0.0000000
zheyou73v0_A01	31532826	31534125	BnaA01T0339700ZY	0	+	0	0	1299	0.0000000
zheyou73v0_A01	31537327	31538626	BnaA01T0339800ZY	0	+	0	0	1299	0.0000000
zheyou73v0_A01	31539780	31540662	BnaA01T0339900ZY	0	-	0	0	882	0.0000000
zheyou73v0_A01	31541573	31542538	BnaA01T0340000ZY	0	+	0	0	965	0.0000000
zheyou73v0_A01	31543214	31543877	BnaA01T0340100ZY	0	+	0	0	663	0.0000000
zheyou73v0_A01	31545772	31547072	BnaA01T0340200ZY	0	-	0	0	1300	0.0000000
zheyou73v0_A01	31558463	31561448	BnaA01T0340300ZY	0	+	0	0	2985	0.0000000
zheyou73v0_A01	31558463	31561448	BnaA01T0340300ZY.1	0	+	0	0	2985	0.0000000
zheyou73v0_A01	31565307	31567430	BnaA01T0340400ZY	0	-	0	0	2123	0.0000000
zheyou73v0_A01	31568610	31569001	BnaA01T0340500ZY	0	+	0	0	391	0.0000000
zheyou73v0_A01	31571656	31572132	BnaA01T0340600ZY	0	+	0	0	476	0.0000000
zheyou73v0_A01	31574726	31575119	BnaA01T0340700ZY	0	+	0	0	393	0.0000000
zheyou73v0_A01	31576309	31587477	BnaA01T0340800ZY	0	-	0	0	11168	0.0000000
zheyou73v0_A01	31593578	31595064	BnaA01T0340900ZY	0	-	0	0	1486	0.0000000
zheyou73v0_A01	31600589	31602749	BnaA01T0341000ZY	0	-	0	0	2160	0.0000000
zheyou73v0_A01	31608040	31610099	BnaA01T0341100ZY	0	+	0	0	2059	0.0000000
zheyou73v0_A01	31608040	31610099	BnaA01T0341100ZY.1	0	+	0	0	2059	0.0000000
zheyou73v0_A01	31610196	31610899	BnaA01T0341200ZY	0	-	0	0	703	0.0000000
zheyou73v0_A01	31612396	31613147	BnaA01T0341300ZY	0	+	0	0	751	0.0000000
zheyou73v0_A01	31614614	31616552	BnaA01T0341400ZY	0	+	0	0	1938	0.0000000
zheyou73v0_A01	31616974	31619888	BnaA01T0341500ZY	0	-	0	0	2914	0.0000000
zheyou73v0_A01	31616974	31619888	BnaA01T0341500ZY.1	0	-	0	0	2914	0.0000000
zheyou73v0_A01	31616974	31619888	BnaA01T0341500ZY.2	0	-	0	0	2914	0.0000000
zheyou73v0_A01	31635395	31635630	BnaA01T0341600ZY	0	-	0	0	235	0.0000000
zheyou73v0_A01	31636022	31639258	BnaA01T0341700ZY	0	+	0	0	3236	0.0000000
zheyou73v0_A01	31639729	31640480	BnaA01T0341800ZY	0	-	0	0	751	0.0000000
zheyou73v0_A01	31642593	31647868	BnaA01T0341900ZY	0	-	0	0	5275	0.0000000
zheyou73v0_A01	31654048	31656815	BnaA01T0342000ZY	0	+	0	0	2767	0.0000000
zheyou73v0_A01	31659081	31661599	BnaA01T0342100ZY	0	-	0	0	2518	0.0000000
zheyou73v0_A01	31678129	31679929	BnaA01T0342200ZY	0	+	0	0	1800	0.0000000
zheyou73v0_A01	31694081	31694621	BnaA01T0342300ZY	0	+	0	0	540	0.0000000
zheyou73v0_A01	31700504	31703556	BnaA01T0342400ZY	0	+	0	0	3052	0.0000000
zheyou73v0_A01	31732083	31732895	BnaA01T0342500ZY	0	-	0	0	812	0.0000000
zheyou73v0_A01	31735518	31739803	BnaA01T0342600ZY	0	+	0	0	4285	0.0000000
zheyou73v0_A01	31740161	31742599	BnaA01T0342700ZY	0	+	0	0	2438	0.0000000
zheyou73v0_A01	31749137	31753579	BnaA01T0342800ZY	0	+	0	0	4442	0.0000000
zheyou73v0_A01	31762586	31775040	BnaA01T0342900ZY	0	+	0	0	12454	0.0000000
zheyou73v0_A01	31781301	31782561	BnaA01T0343000ZY	0	+	0	0	1260	0.0000000
zheyou73v0_A01	31781301	31782561	BnaA01T0343000ZY.1	0	+	0	0	1260	0.0000000
zheyou73v0_A01	31782366	31788600	BnaA01T0343100ZY	0	-	0	0	6234	0.0000000
zheyou73v0_A01	31791804	31792621	BnaA01T0343200ZY	0	-	0	0	817	0.0000000
zheyou73v0_A01	31806652	31807433	BnaA01T0343300ZY	0	+	0	0	781	0.0000000
zheyou73v0_A01	31812204	31814330	BnaA01T0343400ZY	0	+	0	0	2126	0.0000000
zheyou73v0_A01	31812204	31814330	BnaA01T0343400ZY.1	0	+	0	0	2126	0.0000000
zheyou73v0_A01	31814898	31816504	BnaA01T0343500ZY	0	-	0	0	1606	0.0000000
zheyou73v0_A01	31825487	31829869	BnaA01T0343600ZY	0	+	0	0	4382	0.0000000
zheyou73v0_A01	31832767	31836040	BnaA01T0343700ZY	0	+	0	0	3273	0.0000000
zheyou73v0_A01	31838627	31838862	BnaA01T0343800ZY	0	+	0	0	235	0.0000000
zheyou73v0_A01	31839854	31840525	BnaA01T0343900ZY	0	-	0	0	671	0.0000000
zheyou73v0_A01	31841800	31842637	BnaA01T0344000ZY	0	+	0	0	837	0.0000000
zheyou73v0_A01	31848010	31848931	BnaA01T0344100ZY	0	+	0	0	921	0.0000000
zheyou73v0_A01	31849714	31861440	BnaA01T0344200ZY	0	+	0	0	11726	0.0000000
zheyou73v0_A01	31852863	31854057	BnaA01T0344300ZY	0	+	0	0	1194	0.0000000
zheyou73v0_A01	31855329	31855635	BnaA01T0344400ZY	0	+	0	0	306	0.0000000
zheyou73v0_A01	31857501	31858715	BnaA01T0344500ZY	0	+	0	0	1214	0.0000000
zheyou73v0_A01	31861378	31868227	BnaA01T0344600ZY	0	-	0	0	6849	0.0000000
zheyou73v0_A01	31869780	31870924	BnaA01T0344700ZY	0	-	0	0	1144	0.0000000
zheyou73v0_A01	31874939	31877610	BnaA01T0344800ZY	0	+	0	0	2671	0.0000000
zheyou73v0_A01	31875231	31877610	BnaA01T0344800ZY.1	0	+	0	0	2379	0.0000000
zheyou73v0_A01	31883200	31887797	BnaA01T0344900ZY	0	-	0	0	4597	0.0000000
zheyou73v0_A01	31888501	31890814	BnaA01T0345000ZY	0	-	0	0	2313	0.0000000
zheyou73v0_A01	31899556	31899748	BnaA01T0345100ZY	0	-	0	0	192	0.0000000
zheyou73v0_A01	31902831	31904147	BnaA01T0345200ZY	0	+	0	0	1316	0.0000000
zheyou73v0_A01	31908805	31910039	BnaA01T0345300ZY	0	+	0	0	1234	0.0000000
zheyou73v0_A01	31919972	31924842	BnaA01T0345400ZY	0	-	0	0	4870	0.0000000
zheyou73v0_A01	31934685	31937190	BnaA01T0345500ZY	0	-	0	0	2505	0.0000000
zheyou73v0_A01	31937529	31939852	BnaA01T0345600ZY	0	+	0	0	2323	0.0000000
zheyou73v0_A01	31944651	31944960	BnaA01T0345700ZY	0	+	0	0	309	0.0000000
zheyou73v0_A01	31964545	31965823	BnaA01T0345800ZY	0	+	0	0	1278	0.0000000
zheyou73v0_A01	31968371	31970603	BnaA01T0345900ZY	0	-	0	0	2232	0.0000000
zheyou73v0_A01	31979014	31980067	BnaA01T0346000ZY	0	-	0	0	1053	0.0000000
zheyou73v0_A01	31999091	32002334	BnaA01T0346100ZY	0	-	0	0	3243	0.0000000
zheyou73v0_A01	31999091	32002334	BnaA01T0346100ZY.1	0	-	0	0	3243	0.0000000
zheyou73v0_A01	32005698	32005872	BnaA01T0346200ZY	0	+	0	0	174	0.0000000
zheyou73v0_A01	32012061	32015147	BnaA01T0346300ZY	0	+	0	0	3086	0.0000000
zheyou73v0_A01	32012061	32014424	BnaA01T0346300ZY.1	0	+	0	0	2363	0.0000000
zheyou73v0_A01	32019748	32024060	BnaA01T0346400ZY	0	-	0	0	4312	0.0000000
zheyou73v0_A01	32036368	32039804	BnaA01T0346500ZY	0	+	0	0	3436	0.0000000
zheyou73v0_A01	32040834	32041813	BnaA01T0346600ZY	0	+	0	0	979	0.0000000
zheyou73v0_A01	32043155	32043854	BnaA01T0346700ZY	0	+	0	0	699	0.0000000
zheyou73v0_A01	32046621	32047441	BnaA01T0346800ZY	0	+	0	0	820	0.0000000
zheyou73v0_A01	32049120	32053060	BnaA01T0346900ZY	0	-	0	0	3940	0.0000000
zheyou73v0_A01	32049120	32053561	BnaA01T0346900ZY.1	0	-	0	0	4441	0.0000000
zheyou73v0_A01	32049120	32052974	BnaA01T0346900ZY.2	0	-	0	0	3854	0.0000000
zheyou73v0_A01	32049120	32053060	BnaA01T0346900ZY.3	0	-	0	0	3940	0.0000000
zheyou73v0_A01	32059196	32061827	BnaA01T0347000ZY	0	+	0	0	2631	0.0000000
zheyou73v0_A01	32065503	32066238	BnaA01T0347100ZY	0	-	0	0	735	0.0000000
zheyou73v0_A01	32066289	32068027	BnaA01T0347200ZY	0	-	0	0	1738	0.0000000
zheyou73v0_A01	32068406	32072775	BnaA01T0347300ZY	0	-	0	0	4369	0.0000000
zheyou73v0_A01	32077988	32078794	BnaA01T0347400ZY	0	-	0	0	806	0.0000000
zheyou73v0_A01	32084001	32084591	BnaA01T0347500ZY	0	-	0	0	590	0.0000000
zheyou73v0_A01	32088966	32089667	BnaA01T0347600ZY	0	-	0	0	701	0.0000000
zheyou73v0_A01	32092827	32095825	BnaA01T0347700ZY	0	+	0	0	2998	0.0000000
zheyou73v0_A01	32108576	32110365	BnaA01T0347800ZY	0	-	0	0	1789	0.0000000
zheyou73v0_A01	32108576	32110365	BnaA01T0347800ZY.1	0	-	0	0	1789	0.0000000
zheyou73v0_A01	32111669	32114379	BnaA01T0347900ZY	0	-	0	0	2710	0.0000000
zheyou73v0_A01	32135057	32139152	BnaA01T0348000ZY	0	-	0	0	4095	0.0000000
zheyou73v0_A01	32152771	32155430	BnaA01T0348100ZY	0	+	0	0	2659	0.0000000
zheyou73v0_A01	32157959	32159247	BnaA01T0348200ZY	0	-	0	0	1288	0.0000000
zheyou73v0_A01	32161567	32166656	BnaA01T0348300ZY	0	+	0	0	5089	0.0000000
zheyou73v0_A01	32167853	32168042	BnaA01T0348400ZY	0	-	0	0	189	0.0000000
zheyou73v0_A01	32168078	32170949	BnaA01T0348500ZY	0	+	0	0	2871	0.0000000
zheyou73v0_A01	32173536	32174882	BnaA01T0348600ZY	0	+	0	0	1346	0.0000000
zheyou73v0_A01	32175978	32179545	BnaA01T0348700ZY	0	+	0	0	3567	0.0000000
zheyou73v0_A01	32179721	32181013	BnaA01T0348800ZY	0	-	0	0	1292	0.0000000
zheyou73v0_A01	32222653	32224952	BnaA01T0348900ZY	0	+	0	0	2299	0.0000000
zheyou73v0_A01	32227879	32228173	BnaA01T0349000ZY	0	+	0	0	294	0.0000000
zheyou73v0_A01	32229042	32231675	BnaA01T0349100ZY	0	-	0	0	2633	0.0000000
zheyou73v0_A01	32233469	32235837	BnaA01T0349200ZY	0	+	0	0	2368	0.0000000
zheyou73v0_A01	32236872	32238651	BnaA01T0349300ZY	0	+	0	0	1779	0.0000000
zheyou73v0_A01	32236872	32238651	BnaA01T0349300ZY.1	0	+	0	0	1779	0.0000000
zheyou73v0_A01	32240080	32243096	BnaA01T0349400ZY	0	-	0	0	3016	0.0000000
zheyou73v0_A01	32246132	32247056	BnaA01T0349500ZY	0	+	0	0	924	0.0000000
zheyou73v0_A01	32250015	32254202	BnaA01T0349600ZY	0	+	0	0	4187	0.0000000
zheyou73v0_A01	32254461	32256200	BnaA01T0349700ZY	0	+	0	0	1739	0.0000000
zheyou73v0_A01	32258186	32262407	BnaA01T0349800ZY	0	+	0	0	4221	0.0000000
zheyou73v0_A01	32264415	32266107	BnaA01T0349900ZY	0	-	0	0	1692	0.0000000
zheyou73v0_A01	32269072	32270563	BnaA01T0350000ZY	0	-	0	0	1491	0.0000000
zheyou73v0_A01	32272398	32275568	BnaA01T0350100ZY	0	+	0	0	3170	0.0000000
zheyou73v0_A01	32275865	32278910	BnaA01T0350200ZY	0	+	0	0	3045	0.0000000
zheyou73v0_A01	32279024	32280847	BnaA01T0350300ZY	0	-	0	0	1823	0.0000000
zheyou73v0_A01	32281162	32284298	BnaA01T0350400ZY	0	+	0	0	3136	0.0000000
zheyou73v0_A01	32284998	32285585	BnaA01T0350500ZY	0	+	0	0	587	0.0000000
zheyou73v0_A01	32288619	32291320	BnaA01T0350600ZY	0	+	0	0	2701	0.0000000
zheyou73v0_A01	32291624	32292809	BnaA01T0350700ZY	0	+	0	0	1185	0.0000000
zheyou73v0_A01	32293278	32294782	BnaA01T0350800ZY	0	+	0	0	1504	0.0000000
zheyou73v0_A01	32295505	32296247	BnaA01T0350900ZY	0	+	0	0	742	0.0000000
zheyou73v0_A01	32298319	32299792	BnaA01T0351000ZY	0	+	0	0	1473	0.0000000
zheyou73v0_A01	32300397	32305569	BnaA01T0351100ZY	0	+	0	0	5172	0.0000000
zheyou73v0_A01	32306206	32311207	BnaA01T0351200ZY	0	+	0	0	5001	0.0000000
zheyou73v0_A01	32311539	32314685	BnaA01T0351300ZY	0	-	0	0	3146	0.0000000
zheyou73v0_A01	32314979	32317336	BnaA01T0351400ZY	0	-	0	0	2357	0.0000000
zheyou73v0_A01	32314979	32316568	BnaA01T0351400ZY.1	0	-	0	0	1589	0.0000000
zheyou73v0_A01	32319924	32323388	BnaA01T0351500ZY	0	-	0	0	3464	0.0000000
zheyou73v0_A01	32319924	32322969	BnaA01T0351500ZY.1	0	-	0	0	3045	0.0000000
zheyou73v0_A01	32323744	32325979	BnaA01T0351600ZY	0	-	0	0	2235	0.0000000
zheyou73v0_A01	32328663	32331484	BnaA01T0351700ZY	0	+	0	0	2821	0.0000000
zheyou73v0_A01	32332047	32332646	BnaA01T0351800ZY	0	+	0	0	599	0.0000000
zheyou73v0_A01	32334946	32336194	BnaA01T0351900ZY	0	-	0	0	1248	0.0000000
zheyou73v0_A01	32340712	32343352	BnaA01T0352000ZY	0	+	0	0	2640	0.0000000
zheyou73v0_A01	32345234	32352955	BnaA01T0352100ZY	0	-	0	0	7721	0.0000000
zheyou73v0_A01	32359068	32359693	BnaA01T0352200ZY	0	-	0	0	625	0.0000000
zheyou73v0_A01	32361804	32362425	BnaA01T0352300ZY	0	-	0	0	621	0.0000000
zheyou73v0_A01	32362536	32363228	BnaA01T0352400ZY	0	+	0	0	692	0.0000000
zheyou73v0_A01	32363945	32367106	BnaA01T0352500ZY	0	+	0	0	3161	0.0000000
zheyou73v0_A01	32367311	32369171	BnaA01T0352600ZY	0	-	0	0	1860	0.0000000
zheyou73v0_A01	32377335	32378487	BnaA01T0352700ZY	0	+	0	0	1152	0.0000000
zheyou73v0_A01	32390316	32392111	BnaA01T0352800ZY	0	-	0	0	1795	0.0000000
zheyou73v0_A01	32396457	32398195	BnaA01T0352900ZY	0	-	0	0	1738	0.0000000
zheyou73v0_A01	32407863	32408904	BnaA01T0353000ZY	0	-	0	0	1041	0.0000000
zheyou73v0_A01	32413586	32413913	BnaA01T0353100ZY	0	-	0	0	327	0.0000000
zheyou73v0_A01	32419450	32425211	BnaA01T0353200ZY	0	-	0	0	5761	0.0000000
zheyou73v0_A01	32428373	32429147	BnaA01T0353300ZY	0	+	0	0	774	0.0000000
zheyou73v0_A01	32434698	32435388	BnaA01T0353400ZY	0	+	0	0	690	0.0000000
zheyou73v0_A01	32444607	32446175	BnaA01T0353500ZY	0	+	0	0	1568	0.0000000
zheyou73v0_A01	32446461	32446716	BnaA01T0353600ZY	0	+	0	0	255	0.0000000
zheyou73v0_A01	32447385	32448111	BnaA01T0353700ZY	0	-	0	0	726	0.0000000
zheyou73v0_A01	32450731	32453171	BnaA01T0353800ZY	0	-	0	0	2440	0.0000000
zheyou73v0_A01	32454696	32457241	BnaA01T0353900ZY	0	+	0	0	2545	0.0000000
zheyou73v0_A01	32454696	32457241	BnaA01T0353900ZY.1	0	+	0	0	2545	0.0000000
zheyou73v0_A01	32457560	32459416	BnaA01T0354000ZY	0	-	0	0	1856	0.0000000
zheyou73v0_A01	32460375	32462108	BnaA01T0354100ZY	0	+	0	0	1733	0.0000000
zheyou73v0_A01	32517630	32519362	BnaA01T0354200ZY	0	+	0	0	1732	0.0000000
zheyou73v0_A01	32520106	32522449	BnaA01T0354300ZY	0	-	0	0	2343	0.0000000
zheyou73v0_A01	32533271	32536048	BnaA01T0354400ZY	0	+	0	0	2777	0.0000000
zheyou73v0_A01	32533271	32536048	BnaA01T0354400ZY.1	0	+	0	0	2777	0.0000000
zheyou73v0_A01	32548857	32550695	BnaA01T0354500ZY	0	+	0	0	1838	0.0000000
zheyou73v0_A01	32552975	32556690	BnaA01T0354600ZY	0	+	0	0	3715	0.0000000
zheyou73v0_A01	32557821	32559005	BnaA01T0354700ZY	0	-	0	0	1184	0.0000000
zheyou73v0_A01	32559701	32562764	BnaA01T0354800ZY	0	-	0	0	3063	0.0000000
zheyou73v0_A01	32564118	32564589	BnaA01T0354900ZY	0	-	0	0	471	0.0000000
zheyou73v0_A01	32565924	32568236	BnaA01T0355000ZY	0	+	0	0	2312	0.0000000
zheyou73v0_A01	32569479	32570888	BnaA01T0355100ZY	0	+	0	0	1409	0.0000000
zheyou73v0_A01	32570977	32572482	BnaA01T0355200ZY	0	-	0	0	1505	0.0000000
zheyou73v0_A01	32570977	32571920	BnaA01T0355200ZY.1	0	-	0	0	943	0.0000000
zheyou73v0_A01	32574516	32581909	BnaA01T0355300ZY	0	+	0	0	7393	0.0000000
zheyou73v0_A01	32583808	32586716	BnaA01T0355400ZY	0	+	0	0	2908	0.0000000
zheyou73v0_A01	32586758	32588849	BnaA01T0355500ZY	0	-	0	0	2091	0.0000000
zheyou73v0_A01	32592585	32595681	BnaA01T0355600ZY	0	+	0	0	3096	0.0000000
zheyou73v0_A01	32598394	32599126	BnaA01T0355700ZY	0	-	0	0	732	0.0000000
zheyou73v0_A01	32601665	32602394	BnaA01T0355800ZY	0	+	0	0	729	0.0000000
zheyou73v0_A01	32604700	32606137	BnaA01T0355900ZY	0	+	0	0	1437	0.0000000
zheyou73v0_A01	32607725	32608723	BnaA01T0356000ZY	0	+	0	0	998	0.0000000
zheyou73v0_A01	32608949	32610754	BnaA01T0356100ZY	0	-	0	0	1805	0.0000000
zheyou73v0_A01	32613551	32614202	BnaA01T0356200ZY	0	+	0	0	651	0.0000000
zheyou73v0_A01	32615447	32616237	BnaA01T0356300ZY	0	+	0	0	790	0.0000000
zheyou73v0_A01	32637618	32638293	BnaA01T0356400ZY	0	+	0	0	675	0.0000000
zheyou73v0_A01	32638720	32640048	BnaA01T0356500ZY	0	-	0	0	1328	0.0000000
zheyou73v0_A01	32641039	32641549	BnaA01T0356600ZY	0	+	0	0	510	0.0000000
zheyou73v0_A01	32642225	32645169	BnaA01T0356700ZY	0	-	0	0	2944	0.0000000
zheyou73v0_A01	32663233	32663443	BnaA01T0356800ZY	0	+	0	0	210	0.0000000
zheyou73v0_A01	32665447	32670047	BnaA01T0356900ZY	0	+	0	0	4600	0.0000000
zheyou73v0_A01	32670744	32672721	BnaA01T0357000ZY	0	+	0	0	1977	0.0000000
zheyou73v0_A01	32672511	32674817	BnaA01T0357100ZY	0	-	0	0	2306	0.0000000
zheyou73v0_A01	32697452	32700406	BnaA01T0357200ZY	0	+	0	0	2954	0.0000000
zheyou73v0_A01	32700762	32702088	BnaA01T0357300ZY	0	-	0	0	1326	0.0000000
zheyou73v0_A01	32702450	32704088	BnaA01T0357400ZY	0	-	0	0	1638	0.0000000
zheyou73v0_A01	32704972	32706169	BnaA01T0357500ZY	0	+	0	0	1197	0.0000000
zheyou73v0_A01	32707607	32708962	BnaA01T0357600ZY	0	+	0	0	1355	0.0000000
zheyou73v0_A01	32723467	32725430	BnaA01T0357700ZY	0	+	0	0	1963	0.0000000
zheyou73v0_A01	32728017	32730232	BnaA01T0357800ZY	0	+	0	0	2215	0.0000000
zheyou73v0_A01	32731224	32736081	BnaA01T0357900ZY	0	+	0	0	4857	0.0000000
zheyou73v0_A01	32743120	32744347	BnaA01T0358000ZY	0	+	0	0	1227	0.0000000
zheyou73v0_A01	32746843	32747668	BnaA01T0358100ZY	0	-	0	0	825	0.0000000
zheyou73v0_A01	32748415	32749003	BnaA01T0358200ZY	0	-	0	0	588	0.0000000
zheyou73v0_A01	32753775	32753995	BnaA01T0358300ZY	0	+	0	0	220	0.0000000
zheyou73v0_A01	32754274	32756468	BnaA01T0358400ZY	0	-	0	0	2194	0.0000000
zheyou73v0_A01	32771422	32772010	BnaA01T0358500ZY	0	+	0	0	588	0.0000000
zheyou73v0_A01	32775033	32779256	BnaA01T0358600ZY	0	-	0	0	4223	0.0000000
zheyou73v0_A01	32780175	32780586	BnaA01T0358700ZY	0	-	0	0	411	0.0000000
zheyou73v0_A01	32782637	32788414	BnaA01T0358800ZY	0	-	0	0	5777	0.0000000
zheyou73v0_A01	32792637	32795219	BnaA01T0358900ZY	0	-	0	0	2582	0.0000000
zheyou73v0_A01	32796299	32808879	BnaA01T0359000ZY	0	+	0	0	12580	0.0000000
zheyou73v0_A01	32810079	32811783	BnaA01T0359100ZY	0	+	0	0	1704	0.0000000
zheyou73v0_A01	32812207	32813359	BnaA01T0359200ZY	0	-	0	0	1152	0.0000000
zheyou73v0_A01	32819610	32820864	BnaA01T0359300ZY	0	-	0	0	1254	0.0000000
zheyou73v0_A01	32827824	32831324	BnaA01T0359400ZY	0	-	0	0	3500	0.0000000
zheyou73v0_A01	32833020	32841516	BnaA01T0359500ZY	0	+	0	0	8496	0.0000000
zheyou73v0_A01	32833020	32842378	BnaA01T0359500ZY.1	0	+	0	0	9358	0.0000000
zheyou73v0_A01	32841927	32844309	BnaA01T0359600ZY	0	+	0	0	2382	0.0000000
zheyou73v0_A01	32847127	32848805	BnaA01T0359700ZY	0	+	0	0	1678	0.0000000
zheyou73v0_A01	32848715	32852720	BnaA01T0359800ZY	0	-	0	0	4005	0.0000000
zheyou73v0_A01	32854133	32855558	BnaA01T0359900ZY	0	+	0	0	1425	0.0000000
zheyou73v0_A01	32856036	32856639	BnaA01T0360000ZY	0	+	0	0	603	0.0000000
zheyou73v0_A01	32856848	32860606	BnaA01T0360100ZY	0	-	0	0	3758	0.0000000
zheyou73v0_A01	32864553	32865623	BnaA01T0360200ZY	0	+	0	0	1070	0.0000000
zheyou73v0_A01	32865814	32866655	BnaA01T0360300ZY	0	-	0	0	841	0.0000000
zheyou73v0_A01	32867868	32874896	BnaA01T0360400ZY	0	+	0	0	7028	0.0000000
zheyou73v0_A01	32875576	32878931	BnaA01T0360500ZY	0	+	0	0	3355	0.0000000
zheyou73v0_A01	32881478	32884105	BnaA01T0360600ZY	0	-	0	0	2627	0.0000000
zheyou73v0_A01	32886526	32887727	BnaA01T0360700ZY	0	-	0	0	1201	0.0000000
zheyou73v0_A01	32943857	32946195	BnaA01T0360800ZY	0	+	0	0	2338	0.0000000
zheyou73v0_A01	32953663	32954604	BnaA01T0360900ZY	0	+	0	0	941	0.0000000
zheyou73v0_A01	32962667	32963333	BnaA01T0361000ZY	0	+	0	0	666	0.0000000
zheyou73v0_A01	32964199	32964893	BnaA01T0361100ZY	0	-	0	0	694	0.0000000
zheyou73v0_A01	32966648	32973989	BnaA01T0361200ZY	0	-	0	0	7341	0.0000000
zheyou73v0_A01	32975766	32976419	BnaA01T0361300ZY	0	-	0	0	653	0.0000000
zheyou73v0_A01	32980942	32981427	BnaA01T0361400ZY	0	+	0	0	485	0.0000000
zheyou73v0_A01	33002534	33005023	BnaA01T0361500ZY	0	+	0	0	2489	0.0000000
zheyou73v0_A01	33002534	33005023	BnaA01T0361500ZY.1	0	+	0	0	2489	0.0000000
zheyou73v0_A01	33010375	33011178	BnaA01T0361600ZY	0	-	0	0	803	0.0000000
zheyou73v0_A01	33018331	33020080	BnaA01T0361700ZY	0	+	0	0	1749	0.0000000
zheyou73v0_A01	33020722	33022152	BnaA01T0361800ZY	0	+	0	0	1430	0.0000000
zheyou73v0_A01	33022898	33023923	BnaA01T0361900ZY	0	+	0	0	1025	0.0000000
zheyou73v0_A01	33028993	33031059	BnaA01T0362000ZY	0	+	0	0	2066	0.0000000
zheyou73v0_A01	33031080	33031614	BnaA01T0362100ZY	0	+	0	0	534	0.0000000
zheyou73v0_A01	33031794	33034152	BnaA01T0362200ZY	0	-	0	0	2358	0.0000000
zheyou73v0_A01	33041273	33043146	BnaA01T0362300ZY	0	-	0	0	1873	0.0000000
zheyou73v0_A01	33044440	33046609	BnaA01T0362400ZY	0	-	0	0	2169	0.0000000
zheyou73v0_A01	33057069	33058637	BnaA01T0362500ZY	0	+	0	0	1568	0.0000000
zheyou73v0_A01	33061330	33063359	BnaA01T0362600ZY	0	-	0	0	2029	0.0000000
zheyou73v0_A01	33064869	33068094	BnaA01T0362700ZY	0	+	0	0	3225	0.0000000
zheyou73v0_A01	33068488	33073891	BnaA01T0362800ZY	0	+	0	0	5403	0.0000000
zheyou73v0_A01	33075414	33077058	BnaA01T0362900ZY	0	+	0	0	1644	0.0000000
zheyou73v0_A01	33078967	33083137	BnaA01T0363000ZY	0	-	0	0	4170	0.0000000
zheyou73v0_A01	33083810	33085119	BnaA01T0363100ZY	0	-	0	0	1309	0.0000000
zheyou73v0_A01	33087532	33089649	BnaA01T0363200ZY	0	+	0	0	2117	0.0000000
zheyou73v0_A01	33090041	33092259	BnaA01T0363300ZY	0	+	0	0	2218	0.0000000
zheyou73v0_A01	33093842	33096724	BnaA01T0363400ZY.1	0	-	0	0	2882	0.0000000
zheyou73v0_A01	33094168	33096724	BnaA01T0363400ZY	0	-	0	0	2556	0.0000000
zheyou73v0_A01	33100154	33101209	BnaA01T0363500ZY	0	-	0	0	1055	0.0000000
zheyou73v0_A01	33103783	33105637	BnaA01T0363600ZY	0	+	0	0	1854	0.0000000
zheyou73v0_A01	33113106	33122021	BnaA01T0363700ZY	0	+	0	0	8915	0.0000000
zheyou73v0_A01	33123704	33125177	BnaA01T0363800ZY	0	+	0	0	1473	0.0000000
zheyou73v0_A01	33126261	33128445	BnaA01T0363900ZY	0	-	0	0	2184	0.0000000
zheyou73v0_A01	33130472	33133578	BnaA01T0364000ZY	0	-	0	0	3106	0.0000000
zheyou73v0_A01	33134347	33135220	BnaA01T0364100ZY	0	-	0	0	873	0.0000000
zheyou73v0_A01	33156123	33157611	BnaA01T0364200ZY	0	-	0	0	1488	0.0000000
zheyou73v0_A01	33156123	33157429	BnaA01T0364200ZY.1	0	-	0	0	1306	0.0000000
zheyou73v0_A01	33158267	33160430	BnaA01T0364300ZY	0	-	0	0	2163	0.0000000
zheyou73v0_A01	33165229	33165595	BnaA01T0364400ZY	0	+	0	0	366	0.0000000
zheyou73v0_A01	33167973	33169630	BnaA01T0364500ZY	0	-	0	0	1657	0.0000000
zheyou73v0_A01	33167973	33169630	BnaA01T0364500ZY.1	0	-	0	0	1657	0.0000000
zheyou73v0_A01	33170834	33172787	BnaA01T0364600ZY	0	+	0	0	1953	0.0000000
zheyou73v0_A01	33170834	33172787	BnaA01T0364600ZY.1	0	+	0	0	1953	0.0000000
zheyou73v0_A01	33175517	33178164	BnaA01T0364700ZY	0	-	0	0	2647	0.0000000
zheyou73v0_A01	33195430	33197220	BnaA01T0364800ZY	0	+	0	0	1790	0.0000000
zheyou73v0_A01	33206582	33206873	BnaA01T0364900ZY	0	+	0	0	291	0.0000000
zheyou73v0_A01	33207996	33208599	BnaA01T0365000ZY	0	-	0	0	603	0.0000000
zheyou73v0_A01	33210181	33211604	BnaA01T0365100ZY	0	-	0	0	1423	0.0000000
zheyou73v0_A01	33212080	33213620	BnaA01T0365200ZY	0	+	0	0	1540	0.0000000
zheyou73v0_A01	33216420	33217467	BnaA01T0365300ZY	0	+	0	0	1047	0.0000000
zheyou73v0_A01	33219412	33221495	BnaA01T0365400ZY	0	+	0	0	2083	0.0000000
zheyou73v0_A01	33226715	33227789	BnaA01T0365500ZY	0	+	0	0	1074	0.0000000
zheyou73v0_A01	33228522	33229242	BnaA01T0365600ZY	0	-	0	0	720	0.0000000
zheyou73v0_A01	33230208	33232738	BnaA01T0365700ZY	0	+	0	0	2530	0.0000000
zheyou73v0_A01	33232324	33234898	BnaA01T0365800ZY	0	-	0	0	2574	0.0000000
zheyou73v0_A01	33236430	33237544	BnaA01T0365900ZY	0	-	0	0	1114	0.0000000
zheyou73v0_A01	33238830	33240683	BnaA01T0366000ZY.1	0	+	0	0	1853	0.0000000
zheyou73v0_A01	33238841	33240683	BnaA01T0366000ZY	0	+	0	0	1842	0.0000000
zheyou73v0_A01	33242007	33243281	BnaA01T0366100ZY	0	-	0	0	1274	0.0000000
zheyou73v0_A01	33248874	33253563	BnaA01T0366200ZY.1	0	+	0	0	4689	0.0000000
zheyou73v0_A01	33249601	33253563	BnaA01T0366200ZY	0	+	0	0	3962	0.0000000
zheyou73v0_A01	33254836	33258365	BnaA01T0366300ZY	0	+	0	0	3529	0.0000000
zheyou73v0_A01	33260920	33261937	BnaA01T0366400ZY	0	-	0	0	1017	0.0000000
zheyou73v0_A01	33262923	33263457	BnaA01T0366500ZY	0	-	0	0	534	0.0000000
zheyou73v0_A01	33266791	33268237	BnaA01T0366600ZY	0	-	0	0	1446	0.0000000
zheyou73v0_A01	33270395	33274787	BnaA01T0366700ZY	0	+	0	0	4392	0.0000000
zheyou73v0_A01	33276817	33278570	BnaA01T0366800ZY	0	+	0	0	1753	0.0000000
zheyou73v0_A01	33279283	33279571	BnaA01T0366900ZY	0	-	0	0	288	0.0000000
zheyou73v0_A01	33284107	33285346	BnaA01T0367000ZY	0	-	0	0	1239	0.0000000
zheyou73v0_A01	33292679	33295993	BnaA01T0367100ZY	0	-	0	0	3314	0.0000000
zheyou73v0_A01	33329276	33332515	BnaA01T0367200ZY	0	-	0	0	3239	0.0000000
zheyou73v0_A01	33329561	33332515	BnaA01T0367200ZY.1	0	-	0	0	2954	0.0000000
zheyou73v0_A01	33335263	33340261	BnaA01T0367300ZY	0	+	0	0	4998	0.0000000
zheyou73v0_A01	33340594	33343371	BnaA01T0367400ZY	0	-	0	0	2777	0.0000000
zheyou73v0_A01	33347042	33349771	BnaA01T0367500ZY	0	-	0	0	2729	0.0000000
zheyou73v0_A01	33347042	33349771	BnaA01T0367500ZY.1	0	-	0	0	2729	0.0000000
zheyou73v0_A01	33357679	33358413	BnaA01T0367600ZY	0	+	0	0	734	0.0000000
zheyou73v0_A01	33363426	33366864	BnaA01T0367700ZY	0	-	0	0	3438	0.0000000
zheyou73v0_A01	33368264	33370646	BnaA01T0367800ZY	0	-	0	0	2382	0.0000000
zheyou73v0_A01	33371649	33376898	BnaA01T0367900ZY	0	-	0	0	5249	0.0000000
zheyou73v0_A01	33379654	33380809	BnaA01T0368000ZY	0	-	0	0	1155	0.0000000
zheyou73v0_A01	33383993	33385810	BnaA01T0368100ZY	0	-	0	0	1817	0.0000000
zheyou73v0_A01	33386205	33388889	BnaA01T0368200ZY	0	-	0	0	2684	0.0000000
zheyou73v0_A01	33389594	33390773	BnaA01T0368300ZY	0	+	0	0	1179	0.0000000
zheyou73v0_A01	33400185	33400994	BnaA01T0368400ZY	0	+	0	0	809	0.0000000
zheyou73v0_A01	33407244	33407580	BnaA01T0368500ZY	0	+	0	0	336	0.0000000
zheyou73v0_A01	33408183	33409377	BnaA01T0368600ZY	0	+	0	0	1194	0.0000000
zheyou73v0_A01	33410417	33413742	BnaA01T0368700ZY	0	+	0	0	3325	0.0000000
zheyou73v0_A01	33414270	33428065	BnaA01T0368800ZY	0	+	0	0	13795	0.0000000
zheyou73v0_A01	33428121	33431877	BnaA01T0368900ZY	0	-	0	0	3756	0.0000000
zheyou73v0_A01	33434732	33437098	BnaA01T0369000ZY	0	-	0	0	2366	0.0000000
zheyou73v0_A01	33444794	33446150	BnaA01T0369100ZY	0	-	0	0	1356	0.0000000
zheyou73v0_A01	33447532	33459591	BnaA01T0369200ZY	0	+	0	0	12059	0.0000000
zheyou73v0_A01	33447532	33459591	BnaA01T0369200ZY.1	0	+	0	0	12059	0.0000000
zheyou73v0_A01	33460807	33463400	BnaA01T0369300ZY	0	+	0	0	2593	0.0000000
zheyou73v0_A01	33469757	33470957	BnaA01T0369400ZY	0	+	0	0	1200	0.0000000
zheyou73v0_A01	33477900	33479189	BnaA01T0369500ZY	0	+	0	0	1289	0.0000000
zheyou73v0_A01	33480363	33481623	BnaA01T0369600ZY	0	-	0	0	1260	0.0000000
zheyou73v0_A01	33482249	33482729	BnaA01T0369700ZY	0	+	0	0	480	0.0000000
zheyou73v0_A01	33487859	33488311	BnaA01T0369800ZY	0	+	0	0	452	0.0000000
zheyou73v0_A01	33493992	33494862	BnaA01T0369900ZY	0	-	0	0	870	0.0000000
zheyou73v0_A01	33493992	33494862	BnaA01T0369900ZY.1	0	-	0	0	870	0.0000000
zheyou73v0_A01	33498824	33502819	BnaA01T0370000ZY	0	+	0	0	3995	0.0000000
zheyou73v0_A01	33506948	33508002	BnaA01T0370100ZY	0	-	0	0	1054	0.0000000
zheyou73v0_A01	33519282	33520171	BnaA01T0370200ZY	0	+	0	0	889	0.0000000
zheyou73v0_A01	33521539	33523754	BnaA01T0370300ZY	0	+	0	0	2215	0.0000000
zheyou73v0_A01	33524922	33529096	BnaA01T0370400ZY	0	+	0	0	4174	0.0000000
zheyou73v0_A01	33533568	33535125	BnaA01T0370500ZY	0	+	0	0	1557	0.0000000
zheyou73v0_A01	33536570	33539898	BnaA01T0370600ZY	0	-	0	0	3328	0.0000000
zheyou73v0_A01	33540692	33542913	BnaA01T0370700ZY	0	-	0	0	2221	0.0000000
zheyou73v0_A01	33546518	33548935	BnaA01T0370800ZY	0	-	0	0	2417	0.0000000
zheyou73v0_A01	33549659	33551248	BnaA01T0370900ZY	0	+	0	0	1589	0.0000000
zheyou73v0_A01	33554550	33555912	BnaA01T0371000ZY	0	+	0	0	1362	0.0000000
zheyou73v0_A01	33555556	33558168	BnaA01T0371100ZY	0	-	0	0	2612	0.0000000
zheyou73v0_A01	33558792	33559887	BnaA01T0371200ZY	0	+	0	0	1095	0.0000000
zheyou73v0_A01	33560046	33561871	BnaA01T0371300ZY	0	-	0	0	1825	0.0000000
zheyou73v0_A01	33562543	33565450	BnaA01T0371400ZY	0	+	0	0	2907	0.0000000
zheyou73v0_A01	33566423	33571602	BnaA01T0371500ZY	0	+	0	0	5179	0.0000000
zheyou73v0_A01	33572929	33577030	BnaA01T0371600ZY	0	+	0	0	4101	0.0000000
zheyou73v0_A01	33577461	33579643	BnaA01T0371700ZY	0	-	0	0	2182	0.0000000
zheyou73v0_A01	33579683	33581406	BnaA01T0371800ZY	0	+	0	0	1723	0.0000000
zheyou73v0_A01	33581935	33588266	BnaA01T0371900ZY	0	-	0	0	6331	0.0000000
zheyou73v0_A01	33588724	33590803	BnaA01T0372000ZY	0	-	0	0	2079	0.0000000
zheyou73v0_A01	33591665	33592006	BnaA01T0372100ZY	0	+	0	0	341	0.0000000
zheyou73v0_A01	33593526	33595402	BnaA01T0372200ZY	0	-	0	0	1876	0.0000000
zheyou73v0_A01	33598645	33602349	BnaA01T0372300ZY	0	+	0	0	3704	0.0000000
zheyou73v0_A01	33606023	33607913	BnaA01T0372400ZY	0	-	0	0	1890	0.0000000
zheyou73v0_A01	33621940	33622853	BnaA01T0372500ZY	0	-	0	0	913	0.0000000
zheyou73v0_A01	33624339	33627931	BnaA01T0372600ZY	0	+	0	0	3592	0.0000000
zheyou73v0_A01	33628462	33630358	BnaA01T0372700ZY	0	+	0	0	1896	0.0000000
zheyou73v0_A01	33630784	33633073	BnaA01T0372800ZY	0	-	0	0	2289	0.0000000
zheyou73v0_A01	33668199	33668745	BnaA01T0372900ZY	0	-	0	0	546	0.0000000
zheyou73v0_A01	33669243	33670233	BnaA01T0373000ZY	0	+	0	0	990	0.0000000
zheyou73v0_A01	33672417	33673422	BnaA01T0373100ZY	0	+	0	0	1005	0.0000000
zheyou73v0_A01	33673557	33673938	BnaA01T0373200ZY	0	-	0	0	381	0.0000000
zheyou73v0_A01	33675660	33678128	BnaA01T0373300ZY	0	-	0	0	2468	0.0000000
zheyou73v0_A01	33675660	33678128	BnaA01T0373300ZY.1	0	-	0	0	2468	0.0000000
zheyou73v0_A01	33678743	33679528	BnaA01T0373400ZY	0	-	0	0	785	0.0000000
zheyou73v0_A01	33685291	33685678	BnaA01T0373500ZY	0	-	0	0	387	0.0000000
zheyou73v0_A01	33685767	33690561	BnaA01T0373600ZY	0	-	0	0	4794	0.0000000
zheyou73v0_A01	33695229	33696542	BnaA01T0373700ZY	0	+	0	0	1313	0.0000000
zheyou73v0_A01	33696781	33697553	BnaA01T0373800ZY	0	+	0	0	772	0.0000000
zheyou73v0_A01	33699555	33700596	BnaA01T0373900ZY	0	+	0	0	1041	0.0000000
zheyou73v0_A01	33733294	33734014	BnaA01T0374000ZY	0	+	0	0	720	0.0000000
zheyou73v0_A01	33735923	33736726	BnaA01T0374100ZY	0	-	0	0	803	0.0000000
zheyou73v0_A01	33739978	33741149	BnaA01T0374200ZY	0	+	0	0	1171	0.0000000
zheyou73v0_A01	33743128	33743818	BnaA01T0374300ZY	0	-	0	0	690	0.0000000
zheyou73v0_A01	33744445	33746141	BnaA01T0374400ZY	0	+	0	0	1696	0.0000000
zheyou73v0_A01	33747041	33747737	BnaA01T0374500ZY	0	-	0	0	696	0.0000000
zheyou73v0_A01	33750456	33752236	BnaA01T0374600ZY	0	-	0	0	1780	0.0000000
zheyou73v0_A01	33758547	33759759	BnaA01T0374700ZY	0	-	0	0	1212	0.0000000
zheyou73v0_A01	33767365	33769065	BnaA01T0374800ZY	0	+	0	0	1700	0.0000000
zheyou73v0_A01	33772414	33775319	BnaA01T0374900ZY	0	+	0	0	2905	0.0000000
zheyou73v0_A01	33775530	33778086	BnaA01T0375000ZY	0	+	0	0	2556	0.0000000
zheyou73v0_A01	33778309	33781543	BnaA01T0375100ZY	0	+	0	0	3234	0.0000000
zheyou73v0_A01	33778309	33781543	BnaA01T0375100ZY.1	0	+	0	0	3234	0.0000000
zheyou73v0_A01	33778801	33781543	BnaA01T0375100ZY.2	0	+	0	0	2742	0.0000000
zheyou73v0_A01	33780976	33784700	BnaA01T0375200ZY	0	-	0	0	3724	0.0000000
zheyou73v0_A01	33798602	33800051	BnaA01T0375300ZY	0	+	0	0	1449	0.0000000
zheyou73v0_A01	33801286	33802472	BnaA01T0375400ZY	0	+	0	0	1186	0.0000000
zheyou73v0_A01	33802860	33803609	BnaA01T0375500ZY	0	-	0	0	749	0.0000000
zheyou73v0_A01	33805421	33816969	BnaA01T0375600ZY	0	+	0	0	11548	0.0000000
zheyou73v0_A01	33818309	33821037	BnaA01T0375700ZY	0	+	0	0	2728	0.0000000
zheyou73v0_A01	33821135	33822231	BnaA01T0375800ZY	0	-	0	0	1096	0.0000000
zheyou73v0_A01	33830096	33830668	BnaA01T0375900ZY	0	+	0	0	572	0.0000000
zheyou73v0_A01	33830857	33832321	BnaA01T0376000ZY	0	-	0	0	1464	0.0000000
zheyou73v0_A01	33833094	33833719	BnaA01T0376100ZY	0	-	0	0	625	0.0000000
zheyou73v0_A01	33833727	33834526	BnaA01T0376200ZY	0	-	0	0	799	0.0000000
zheyou73v0_A01	33856954	33859326	BnaA01T0376300ZY	0	+	0	0	2372	0.0000000
zheyou73v0_A01	33860289	33861402	BnaA01T0376400ZY	0	-	0	0	1113	0.0000000
zheyou73v0_A01	33862598	33863778	BnaA01T0376500ZY	0	+	0	0	1180	0.0000000
zheyou73v0_A01	33865923	33866302	BnaA01T0376600ZY	0	-	0	0	379	0.0000000
zheyou73v0_A01	33867834	33868219	BnaA01T0376700ZY	0	-	0	0	385	0.0000000
zheyou73v0_A01	33868828	33869646	BnaA01T0376800ZY	0	-	0	0	818	0.0000000
zheyou73v0_A01	33871338	33873902	BnaA01T0376900ZY	0	-	0	0	2564	0.0000000
zheyou73v0_A01	33877456	33880075	BnaA01T0377000ZY	0	+	0	0	2619	0.0000000
zheyou73v0_A01	33877456	33880075	BnaA01T0377000ZY.1	0	+	0	0	2619	0.0000000
zheyou73v0_A01	33877456	33880075	BnaA01T0377000ZY.2	0	+	0	0	2619	0.0000000
zheyou73v0_A01	33886588	33889863	BnaA01T0377100ZY	0	+	0	0	3275	0.0000000
zheyou73v0_A01	33890089	33895718	BnaA01T0377200ZY	0	-	0	0	5629	0.0000000
zheyou73v0_A01	33899682	33902131	BnaA01T0377300ZY	0	+	0	0	2449	0.0000000
zheyou73v0_A01	33902407	33904220	BnaA01T0377400ZY	0	-	0	0	1813	0.0000000
zheyou73v0_A01	33905863	33907502	BnaA01T0377500ZY	0	+	0	0	1639	0.0000000
zheyou73v0_A01	33905863	33907502	BnaA01T0377500ZY.1	0	+	0	0	1639	0.0000000
zheyou73v0_A01	33908444	33909586	BnaA01T0377600ZY	0	+	0	0	1142	0.0000000
zheyou73v0_A01	33910045	33911863	BnaA01T0377700ZY	0	-	0	0	1818	0.0000000
zheyou73v0_A01	33913303	33916666	BnaA01T0377800ZY	0	-	0	0	3363	0.0000000
zheyou73v0_A01	33917258	33917759	BnaA01T0377900ZY	0	-	0	0	501	0.0000000
zheyou73v0_A01	33918492	33919285	BnaA01T0378000ZY	0	-	0	0	793	0.0000000
zheyou73v0_A01	33920050	33922484	BnaA01T0378100ZY	0	-	0	0	2434	0.0000000
zheyou73v0_A01	33926163	33929525	BnaA01T0378200ZY	0	-	0	0	3362	0.0000000
zheyou73v0_A01	33930109	33930610	BnaA01T0378300ZY	0	-	0	0	501	0.0000000
zheyou73v0_A01	33931201	33931990	BnaA01T0378400ZY	0	-	0	0	789	0.0000000
zheyou73v0_A01	33932287	33935383	BnaA01T0378500ZY	0	-	0	0	3096	0.0000000
zheyou73v0_A01	33938677	33939062	BnaA01T0378600ZY	0	+	0	0	385	0.0000000
zheyou73v0_A01	33993076	33995143	BnaA01T0378700ZY	0	+	0	0	2067	0.0000000
zheyou73v0_A01	33995882	33996791	BnaA01T0378800ZY	0	-	0	0	909	0.0000000
zheyou73v0_A01	33998728	34000795	BnaA01T0378900ZY	0	+	0	0	2067	0.0000000
zheyou73v0_A01	34003756	34003975	BnaA01T0379000ZY	0	+	0	0	219	0.0000000
zheyou73v0_A01	34006602	34009716	BnaA01T0379100ZY	0	-	0	0	3114	0.0000000
zheyou73v0_A01	34012326	34014439	BnaA01T0379200ZY	0	+	0	0	2113	0.0000000
zheyou73v0_A01	34015988	34017708	BnaA01T0379300ZY	0	+	0	0	1720	0.0000000
zheyou73v0_A01	34019255	34021193	BnaA01T0379400ZY	0	+	0	0	1938	0.0000000
zheyou73v0_A01	34021546	34022268	BnaA01T0379500ZY	0	-	0	0	722	0.0000000
zheyou73v0_A01	34027982	34029118	BnaA01T0379600ZY	0	-	0	0	1136	0.0000000
zheyou73v0_A01	34029906	34031173	BnaA01T0379700ZY	0	-	0	0	1267	0.0000000
zheyou73v0_A01	34031254	34035989	BnaA01T0379800ZY	0	-	0	0	4735	0.0000000
zheyou73v0_A01	34052356	34054335	BnaA01T0379900ZY	0	+	0	0	1979	0.0000000
zheyou73v0_A01	34055083	34055976	BnaA01T0380000ZY	0	-	0	0	893	0.0000000
zheyou73v0_A01	34057966	34060154	BnaA01T0380100ZY	0	+	0	0	2188	0.0000000
zheyou73v0_A01	34064016	34064418	BnaA01T0380200ZY	0	+	0	0	402	0.0000000
zheyou73v0_A01	34065404	34068661	BnaA01T0380300ZY	0	-	0	0	3257	0.0000000
zheyou73v0_A01	34071288	34073464	BnaA01T0380400ZY	0	+	0	0	2176	0.0000000
zheyou73v0_A01	34074942	34079925	BnaA01T0380500ZY	0	+	0	0	4983	0.0000000
zheyou73v0_A01	34081795	34082522	BnaA01T0380600ZY	0	-	0	0	727	0.0000000
zheyou73v0_A01	34089244	34090724	BnaA01T0380700ZY	0	-	0	0	1480	0.0000000
zheyou73v0_A01	34089244	34090861	BnaA01T0380700ZY.1	0	-	0	0	1617	0.0000000
zheyou73v0_A01	34120325	34121309	BnaA01T0380800ZY	0	+	0	0	984	0.0000000
zheyou73v0_A01	34136206	34137052	BnaA01T0380900ZY	0	+	0	0	846	0.0000000
zheyou73v0_A01	34137362	34141004	BnaA01T0381000ZY	0	+	0	0	3642	0.0000000
zheyou73v0_A01	34143298	34144805	BnaA01T0381100ZY	0	-	0	0	1507	0.0000000
zheyou73v0_A01	34145411	34146419	BnaA01T0381200ZY	0	+	0	0	1008	0.0000000
zheyou73v0_A01	34146918	34149970	BnaA01T0381300ZY	0	-	0	0	3052	0.0000000
zheyou73v0_A01	34152558	34155370	BnaA01T0381400ZY	0	+	0	0	2812	0.0000000
zheyou73v0_A01	34156003	34157533	BnaA01T0381500ZY	0	+	0	0	1530	0.0000000
zheyou73v0_A01	34160207	34163079	BnaA01T0381600ZY	0	-	0	0	2872	0.0000000
zheyou73v0_A01	34163538	34164683	BnaA01T0381700ZY	0	+	0	0	1145	0.0000000
zheyou73v0_A01	34168643	34172028	BnaA01T0381800ZY	0	+	0	0	3385	0.0000000
zheyou73v0_A01	34172629	34174481	BnaA01T0381900ZY	0	-	0	0	1852	0.0000000
zheyou73v0_A01	34180846	34183594	BnaA01T0382000ZY	0	+	0	0	2748	0.0000000
zheyou73v0_A01	34186499	34189272	BnaA01T0382100ZY	0	-	0	0	2773	0.0000000
zheyou73v0_A01	34215791	34218991	BnaA01T0382200ZY	0	-	0	0	3200	0.0000000
zheyou73v0_A01	34222180	34225014	BnaA01T0382300ZY	0	+	0	0	2834	0.0000000
zheyou73v0_A01	34228035	34229542	BnaA01T0382400ZY	0	-	0	0	1507	0.0000000
zheyou73v0_A01	34230133	34231098	BnaA01T0382500ZY	0	+	0	0	965	0.0000000
zheyou73v0_A01	34231597	34234657	BnaA01T0382600ZY	0	-	0	0	3060	0.0000000
zheyou73v0_A01	34236729	34239572	BnaA01T0382700ZY	0	+	0	0	2843	0.0000000
zheyou73v0_A01	34240198	34242270	BnaA01T0382800ZY	0	+	0	0	2072	0.0000000
zheyou73v0_A01	34243984	34245601	BnaA01T0382900ZY	0	-	0	0	1617	0.0000000
zheyou73v0_A01	34247167	34248312	BnaA01T0383000ZY	0	+	0	0	1145	0.0000000
zheyou73v0_A01	34251916	34255423	BnaA01T0383100ZY	0	+	0	0	3507	0.0000000
zheyou73v0_A01	34255903	34257716	BnaA01T0383200ZY	0	-	0	0	1813	0.0000000
zheyou73v0_A01	34260336	34263752	BnaA01T0383300ZY	0	+	0	0	3416	0.0000000
zheyou73v0_A01	34267887	34268765	BnaA01T0383400ZY	0	-	0	0	878	0.0000000
zheyou73v0_A01	34270183	34272951	BnaA01T0383500ZY	0	-	0	0	2768	0.0000000
zheyou73v0_A01	34319868	34322195	BnaA01T0383600ZY	0	-	0	0	2327	0.0000000
zheyou73v0_A01	34323040	34325623	BnaA01T0383700ZY	0	-	0	0	2583	0.0000000
zheyou73v0_A01	34323040	34325623	BnaA01T0383700ZY.1	0	-	0	0	2583	0.0000000
zheyou73v0_A01	34326776	34327560	BnaA01T0383800ZY	0	+	0	0	784	0.0000000
zheyou73v0_A01	34332330	34332955	BnaA01T0383900ZY	0	+	0	0	625	0.0000000
zheyou73v0_A01	34335393	34337974	BnaA01T0384000ZY	0	+	0	0	2581	0.0000000
zheyou73v0_A01	34338602	34339931	BnaA01T0384100ZY	0	-	0	0	1329	0.0000000
zheyou73v0_A01	34341528	34343253	BnaA01T0384200ZY	0	+	0	0	1725	0.0000000
zheyou73v0_A01	34346303	34347849	BnaA01T0384300ZY	0	+	0	0	1546	0.0000000
zheyou73v0_A01	34350134	34351694	BnaA01T0384400ZY	0	+	0	0	1560	0.0000000
zheyou73v0_A01	34352618	34354259	BnaA01T0384500ZY	0	+	0	0	1641	0.0000000
zheyou73v0_A01	34355866	34357755	BnaA01T0384600ZY	0	-	0	0	1889	0.0000000
zheyou73v0_A01	34359492	34360544	BnaA01T0384700ZY	0	+	0	0	1052	0.0000000
zheyou73v0_A01	34361224	34362765	BnaA01T0384800ZY	0	-	0	0	1541	0.0000000
zheyou73v0_A01	34367827	34372183	BnaA01T0384900ZY	0	-	0	0	4356	0.0000000
zheyou73v0_A01	34372949	34374345	BnaA01T0385000ZY	0	-	0	0	1396	0.0000000
zheyou73v0_A01	34378620	34380014	BnaA01T0385100ZY	0	-	0	0	1394	0.0000000
zheyou73v0_A01	34385766	34386916	BnaA01T0385200ZY	0	-	0	0	1150	0.0000000
zheyou73v0_A01	34387279	34390413	BnaA01T0385300ZY	0	-	0	0	3134	0.0000000
zheyou73v0_A01	34392099	34396636	BnaA01T0385400ZY	0	+	0	0	4537	0.0000000
zheyou73v0_A01	34397774	34399328	BnaA01T0385500ZY	0	-	0	0	1554	0.0000000
zheyou73v0_A01	34405154	34408736	BnaA01T0385600ZY	0	+	0	0	3582	0.0000000
zheyou73v0_A01	34409112	34409758	BnaA01T0385700ZY	0	-	0	0	646	0.0000000
zheyou73v0_A01	34411759	34415891	BnaA01T0385800ZY	0	+	0	0	4132	0.0000000
zheyou73v0_A01	34416355	34418479	BnaA01T0385900ZY	0	+	0	0	2124	0.0000000
zheyou73v0_A01	34419704	34421429	BnaA01T0386000ZY	0	-	0	0	1725	0.0000000
zheyou73v0_A01	34421819	34423089	BnaA01T0386100ZY	0	+	0	0	1270	0.0000000
zheyou73v0_A01	34492629	34494554	BnaA01T0386200ZY	0	-	0	0	1925	0.0000000
zheyou73v0_A01	34496287	34496967	BnaA01T0386300ZY	0	+	0	0	680	0.0000000
zheyou73v0_A01	34501793	34502416	BnaA01T0386400ZY	0	+	0	0	623	0.0000000
zheyou73v0_A01	34507945	34510282	BnaA01T0386500ZY	0	+	0	0	2337	0.0000000
zheyou73v0_A01	34510928	34512221	BnaA01T0386600ZY	0	-	0	0	1293	0.0000000
zheyou73v0_A01	34513561	34515100	BnaA01T0386700ZY	0	+	0	0	1539	0.0000000
zheyou73v0_A01	34518159	34519701	BnaA01T0386800ZY	0	+	0	0	1542	0.0000000
zheyou73v0_A01	34521968	34523528	BnaA01T0386900ZY	0	+	0	0	1560	0.0000000
zheyou73v0_A01	34524452	34526093	BnaA01T0387000ZY	0	+	0	0	1641	0.0000000
zheyou73v0_A01	34527700	34529618	BnaA01T0387100ZY	0	-	0	0	1918	0.0000000
zheyou73v0_A01	34531159	34532253	BnaA01T0387200ZY	0	+	0	0	1094	0.0000000
zheyou73v0_A01	34532826	34534314	BnaA01T0387300ZY	0	-	0	0	1488	0.0000000
zheyou73v0_A01	34539196	34544438	BnaA01T0387400ZY	0	-	0	0	5242	0.0000000
zheyou73v0_A01	34545460	34546604	BnaA01T0387500ZY	0	-	0	0	1144	0.0000000
zheyou73v0_A01	34549831	34551271	BnaA01T0387600ZY	0	-	0	0	1440	0.0000000
zheyou73v0_A01	34554419	34555562	BnaA01T0387700ZY	0	-	0	0	1143	0.0000000
zheyou73v0_A01	34556201	34559094	BnaA01T0387800ZY	0	-	0	0	2893	0.0000000
zheyou73v0_A01	34560324	34564892	BnaA01T0387900ZY	0	+	0	0	4568	0.0000000
zheyou73v0_A01	34566038	34567550	BnaA01T0388000ZY	0	-	0	0	1512	0.0000000
zheyou73v0_A01	34572872	34576469	BnaA01T0388100ZY	0	+	0	0	3597	0.0000000
zheyou73v0_A01	34576726	34577376	BnaA01T0388200ZY	0	-	0	0	650	0.0000000
zheyou73v0_A01	34579383	34581323	BnaA01T0388300ZY	0	+	0	0	1940	0.0000000
zheyou73v0_A01	34582818	34584451	BnaA01T0388400ZY	0	+	0	0	1633	0.0000000
zheyou73v0_A01	34586331	34587966	BnaA01T0388500ZY	0	-	0	0	1635	0.0000000
zheyou73v0_A02	31835	34755	BnaA02T0000100ZY	0	+	1	128	2920	0.0438356
zheyou73v0_A02	90659	91349	BnaA02T0000200ZY	0	+	108	543	690	0.7869565
zheyou73v0_A02	94276	99310	BnaA02T0000300ZY	0	+	1423	4587	5034	0.9112038
zheyou73v0_A02	94276	99310	BnaA02T0000300ZY.1	0	+	1423	4587	5034	0.9112038
zheyou73v0_A02	94276	99310	BnaA02T0000300ZY.2	0	+	1423	4587	5034	0.9112038
zheyou73v0_A02	94276	99310	BnaA02T0000300ZY.3	0	+	1423	4587	5034	0.9112038
zheyou73v0_A02	94276	99310	BnaA02T0000300ZY.4	0	+	1423	4587	5034	0.9112038
zheyou73v0_A02	94276	99310	BnaA02T0000300ZY.5	0	+	1423	4587	5034	0.9112038
zheyou73v0_A02	94276	99310	BnaA02T0000300ZY.6	0	+	1423	4587	5034	0.9112038
zheyou73v0_A02	94276	99310	BnaA02T0000300ZY.7	0	+	1423	4587	5034	0.9112038
zheyou73v0_A02	104182	105359	BnaA02T0000400ZY	0	+	815	835	1177	0.7094308
zheyou73v0_A02	119900	123061	BnaA02T0000500ZY	0	+	348	2318	3161	0.7333122
zheyou73v0_A02	124006	127586	BnaA02T0000600ZY	0	+	989	2725	3580	0.7611732
zheyou73v0_A02	130396	131052	BnaA02T0000700ZY	0	-	231	606	656	0.9237805
zheyou73v0_A02	133472	134180	BnaA02T0000800ZY	0	-	61	165	708	0.2330509
zheyou73v0_A02	136059	137708	BnaA02T0000900ZY	0	-	223	1525	1649	0.9248029
zheyou73v0_A02	165943	166914	BnaA02T0001000ZY	0	-	206	713	971	0.7342945
zheyou73v0_A02	180043	181983	BnaA02T0001100ZY	0	+	198	1507	1940	0.7768041
zheyou73v0_A02	185965	187483	BnaA02T0001200ZY	0	-	95	523	1518	0.3445323
zheyou73v0_A02	189178	190513	BnaA02T0001300ZY	0	-	478	1157	1335	0.8666667
zheyou73v0_A02	204515	205250	BnaA02T0001400ZY	0	-	61	391	735	0.5319728
zheyou73v0_A02	212965	216987	BnaA02T0001500ZY	0	+	1381	3760	4022	0.9348583
zheyou73v0_A02	218677	220894	BnaA02T0001600ZY	0	+	819	2213	2217	0.9981958
zheyou73v0_A02	223226	224261	BnaA02T0001700ZY	0	-	259	977	1035	0.9439614
zheyou73v0_A02	224707	228803	BnaA02T0001800ZY	0	-	1330	3552	4096	0.8671875
zheyou73v0_A02	229112	230714	BnaA02T0001900ZY	0	-	543	1522	1602	0.9500624
zheyou73v0_A02	230975	232363	BnaA02T0002000ZY.1	0	+	693	1320	1388	0.9510086
zheyou73v0_A02	230975	232363	BnaA02T0002000ZY.2	0	+	693	1320	1388	0.9510086
zheyou73v0_A02	230975	232363	BnaA02T0002000ZY.3	0	+	693	1320	1388	0.9510086
zheyou73v0_A02	230975	232363	BnaA02T0002000ZY.4	0	+	693	1320	1388	0.9510086
zheyou73v0_A02	230975	232363	BnaA02T0002000ZY.5	0	+	693	1320	1388	0.9510086
zheyou73v0_A02	231061	232363	BnaA02T0002000ZY	0	+	600	1234	1302	0.9477727
zheyou73v0_A02	232948	234025	BnaA02T0002100ZY	0	+	635	1077	1077	1.0000000
zheyou73v0_A02	235310	236537	BnaA02T0002200ZY	0	+	369	1157	1227	0.9429503
zheyou73v0_A02	237149	245454	BnaA02T0002300ZY	0	+	1446	5664	8305	0.6819988
zheyou73v0_A02	247037	248687	BnaA02T0002400ZY	0	+	344	1165	1650	0.7060606
zheyou73v0_A02	250021	251860	BnaA02T0002500ZY	0	-	222	1445	1839	0.7857531
zheyou73v0_A02	255768	257611	BnaA02T0002600ZY	0	+	273	1456	1843	0.7900163
zheyou73v0_A02	262086	264184	BnaA02T0002700ZY	0	+	138	1479	2098	0.7049571
zheyou73v0_A02	265348	266073	BnaA02T0002800ZY	0	-	6	21	725	0.0289655
zheyou73v0_A02	271747	274063	BnaA02T0002900ZY	0	+	48	560	2316	0.2417962
zheyou73v0_A02	274591	276614	BnaA02T0003000ZY	0	-	78	1216	2023	0.6010875
zheyou73v0_A02	285881	287443	BnaA02T0003100ZY	0	-	865	1545	1562	0.9891165
zheyou73v0_A02	290198	292361	BnaA02T0003200ZY	0	-	489	1950	2163	0.9015257
zheyou73v0_A02	290198	293144	BnaA02T0003200ZY.1	0	-	787	2376	2946	0.8065173
zheyou73v0_A02	294759	295738	BnaA02T0003300ZY	0	+	823	931	979	0.9509704
zheyou73v0_A02	296032	296869	BnaA02T0003400ZY	0	-	1008	837	837	1.0000000
zheyou73v0_A02	303956	306397	BnaA02T0003500ZY	0	+	839	2404	2441	0.9848423
zheyou73v0_A02	307270	308732	BnaA02T0003600ZY	0	-	207	1233	1462	0.8433653
zheyou73v0_A02	311886	312339	BnaA02T0003700ZY	0	+	10	306	453	0.6754967
zheyou73v0_A02	316631	319437	BnaA02T0003800ZY	0	+	67	960	2806	0.3421240
zheyou73v0_A02	329095	332596	BnaA02T0003900ZY	0	+	880	2790	3501	0.7969152
zheyou73v0_A02	336339	338409	BnaA02T0004000ZY	0	+	618	1879	2070	0.9077294
zheyou73v0_A02	336559	338409	BnaA02T0004000ZY.1	0	+	533	1659	1850	0.8967568
zheyou73v0_A02	340285	341964	BnaA02T0004100ZY	0	+	76	265	1679	0.1578320
zheyou73v0_A02	343193	343679	BnaA02T0004200ZY	0	-	248	486	486	1.0000000
zheyou73v0_A02	349871	351268	BnaA02T0004300ZY	0	+	147	1114	1397	0.7974231
zheyou73v0_A02	357774	359440	BnaA02T0004400ZY	0	+	328	1243	1666	0.7460985
zheyou73v0_A02	361309	363613	BnaA02T0004500ZY	0	-	429	1393	2304	0.6046007
zheyou73v0_A02	365005	373562	BnaA02T0004600ZY	0	+	1126	5050	8557	0.5901601
zheyou73v0_A02	373695	374462	BnaA02T0004700ZY	0	-	666	767	767	1.0000000
zheyou73v0_A02	377690	380949	BnaA02T0004800ZY	0	+	482	2418	3259	0.7419454
zheyou73v0_A02	382092	383508	BnaA02T0004900ZY	0	+	132	1104	1416	0.7796610
zheyou73v0_A02	383601	385887	BnaA02T0005000ZY	0	+	1328	2182	2286	0.9545057
zheyou73v0_A02	397558	399775	BnaA02T0005100ZY	0	+	1556	2201	2217	0.9927831
zheyou73v0_A02	397558	399775	BnaA02T0005100ZY.1	0	+	1556	2201	2217	0.9927831
zheyou73v0_A02	397558	399775	BnaA02T0005100ZY.2	0	+	1556	2201	2217	0.9927831
zheyou73v0_A02	403094	403676	BnaA02T0005200ZY	0	-	3	208	582	0.3573883
zheyou73v0_A02	406055	407094	BnaA02T0005300ZY	0	+	485	992	1039	0.9547642
zheyou73v0_A02	407751	408232	BnaA02T0005400ZY	0	-	442	481	481	1.0000000
zheyou73v0_A02	409563	409860	BnaA02T0005500ZY	0	-	206	297	297	1.0000000
zheyou73v0_A02	410418	411764	BnaA02T0005600ZY	0	-	362	1001	1346	0.7436850
zheyou73v0_A02	411985	413382	BnaA02T0005700ZY	0	+	784	1387	1397	0.9928418
zheyou73v0_A02	414112	416047	BnaA02T0005800ZY	0	+	515	1403	1935	0.7250646
zheyou73v0_A02	419665	421143	BnaA02T0005900ZY	0	+	133	1219	1478	0.8247632
zheyou73v0_A02	422164	423583	BnaA02T0006000ZY	0	-	1347	1285	1419	0.9055673
zheyou73v0_A02	424442	428563	BnaA02T0006100ZY	0	+	2425	3955	4121	0.9597185
zheyou73v0_A02	429137	430994	BnaA02T0006200ZY	0	-	552	1622	1857	0.8734518
zheyou73v0_A02	431297	434467	BnaA02T0006300ZY	0	-	870	2641	3170	0.8331230
zheyou73v0_A02	445326	451399	BnaA02T0006400ZY	0	+	2625	5318	6073	0.8756793
zheyou73v0_A02	452836	454357	BnaA02T0006500ZY	0	-	1980	1521	1521	1.0000000
zheyou73v0_A02	455630	456022	BnaA02T0006600ZY	0	+	532	392	392	1.0000000
zheyou73v0_A02	457075	458683	BnaA02T0006700ZY	0	-	1158	1558	1608	0.9689054
zheyou73v0_A02	460457	462069	BnaA02T0006800ZY	0	+	919	1612	1612	1.0000000
zheyou73v0_A02	462272	463183	BnaA02T0006900ZY	0	-	334	911	911	1.0000000
zheyou73v0_A02	463579	464685	BnaA02T0007000ZY	0	-	170	995	1106	0.8996384
zheyou73v0_A02	465023	467797	BnaA02T0007100ZY	0	-	943	2680	2774	0.9661139
zheyou73v0_A02	465023	467797	BnaA02T0007100ZY.1	0	-	943	2680	2774	0.9661139
zheyou73v0_A02	467936	470475	BnaA02T0007200ZY	0	-	1182	2452	2539	0.9657345
zheyou73v0_A02	467936	470606	BnaA02T0007200ZY.1	0	-	1193	2583	2670	0.9674158
zheyou73v0_A02	469250	470606	BnaA02T0007200ZY.2	0	-	462	1269	1356	0.9358407
zheyou73v0_A02	469250	470475	BnaA02T0007200ZY.3	0	-	451	1138	1225	0.9289796
zheyou73v0_A02	470725	473682	BnaA02T0007300ZY	0	-	757	2835	2957	0.9587420
zheyou73v0_A02	473952	474920	BnaA02T0007400ZY	0	+	166	829	968	0.8564050
zheyou73v0_A02	486285	487476	BnaA02T0007500ZY	0	+	259	942	1191	0.7909320
zheyou73v0_A02	489804	491045	BnaA02T0007600ZY	0	+	7	131	1241	0.1055600
zheyou73v0_A02	489804	491045	BnaA02T0007600ZY.1	0	+	7	131	1241	0.1055600
zheyou73v0_A02	494063	494954	BnaA02T0007700ZY	0	-	204	706	891	0.7923681
zheyou73v0_A02	495740	497866	BnaA02T0007800ZY	0	-	455	1422	2126	0.6688617
zheyou73v0_A02	495740	497866	BnaA02T0007800ZY.1	0	-	455	1422	2126	0.6688617
zheyou73v0_A02	501112	502990	BnaA02T0007900ZY	0	-	707	1878	1878	1.0000000
zheyou73v0_A02	501112	502990	BnaA02T0007900ZY.1	0	-	707	1878	1878	1.0000000
zheyou73v0_A02	504994	506995	BnaA02T0008000ZY	0	-	1422	1869	2001	0.9340330
zheyou73v0_A02	507059	509318	BnaA02T0008100ZY	0	-	835	2002	2259	0.8862329
zheyou73v0_A02	512351	517761	BnaA02T0008200ZY	0	+	1765	4616	5410	0.8532348
zheyou73v0_A02	518699	519288	BnaA02T0008300ZY	0	-	991	589	589	1.0000000
zheyou73v0_A02	524656	526846	BnaA02T0008400ZY	0	+	3467	2190	2190	1.0000000
zheyou73v0_A02	535314	537997	BnaA02T0008500ZY	0	+	3783	2683	2683	1.0000000
zheyou73v0_A02	535314	537997	BnaA02T0008500ZY.1	0	+	3783	2683	2683	1.0000000
zheyou73v0_A02	535314	537997	BnaA02T0008500ZY.2	0	+	3783	2683	2683	1.0000000
zheyou73v0_A02	535314	537997	BnaA02T0008500ZY.3	0	+	3783	2683	2683	1.0000000
zheyou73v0_A02	539219	541249	BnaA02T0008600ZY	0	+	3097	2002	2030	0.9862069
zheyou73v0_A02	540408	541224	BnaA02T0008700ZY	0	-	1317	816	816	1.0000000
zheyou73v0_A02	542256	543535	BnaA02T0008800ZY	0	+	930	1244	1279	0.9726349
zheyou73v0_A02	549229	551503	BnaA02T0008900ZY	0	-	176	1594	2274	0.7009674
zheyou73v0_A02	553288	556881	BnaA02T0009000ZY	0	-	4194	3593	3593	1.0000000
zheyou73v0_A02	553288	556596	BnaA02T0009000ZY.1	0	-	3894	3308	3308	1.0000000
zheyou73v0_A02	557739	561033	BnaA02T0009100ZY	0	-	1826	3144	3294	0.9544626
zheyou73v0_A02	561442	562481	BnaA02T0009200ZY	0	+	1083	1039	1039	1.0000000
zheyou73v0_A02	561442	562481	BnaA02T0009200ZY.1	0	+	1083	1039	1039	1.0000000
zheyou73v0_A02	563148	565249	BnaA02T0009300ZY	0	+	321	1728	2101	0.8224655
zheyou73v0_A02	567635	568810	BnaA02T0009400ZY	0	+	567	1175	1175	1.0000000
zheyou73v0_A02	571423	572814	BnaA02T0009500ZY	0	-	3	219	1391	0.1574407
zheyou73v0_A02	573358	574394	BnaA02T0009600ZY	0	+	438	855	1036	0.8252895
zheyou73v0_A02	575599	580879	BnaA02T0009700ZY	0	+	84	377	5280	0.0714015
zheyou73v0_A02	582129	582753	BnaA02T0009800ZY	0	-	1	4	624	0.0064103
zheyou73v0_A02	584478	587156	BnaA02T0009900ZY	0	+	49	357	2678	0.1333084
zheyou73v0_A02	584478	587156	BnaA02T0009900ZY.1	0	+	49	357	2678	0.1333084
zheyou73v0_A02	588134	595333	BnaA02T0010000ZY	0	+	269	2961	7199	0.4113071
zheyou73v0_A02	608270	611082	BnaA02T0010100ZY	0	+	441	2246	2812	0.7987198
zheyou73v0_A02	624597	632255	BnaA02T0010200ZY	0	+	185	2679	7658	0.3498302
zheyou73v0_A02	624597	632255	BnaA02T0010200ZY.1	0	+	185	2679	7658	0.3498302
zheyou73v0_A02	632596	634314	BnaA02T0010300ZY	0	-	72	287	1718	0.1670547
zheyou73v0_A02	680028	681514	BnaA02T0010400ZY	0	+	496	1171	1486	0.7880215
zheyou73v0_A02	681837	684728	BnaA02T0010500ZY	0	-	491	2478	2891	0.8571429
zheyou73v0_A02	685283	686908	BnaA02T0010600ZY	0	-	1162	1536	1625	0.9452308
zheyou73v0_A02	689707	690827	BnaA02T0010700ZY	0	-	294	878	1120	0.7839286
zheyou73v0_A02	693819	697339	BnaA02T0010800ZY	0	-	1387	2793	3520	0.7934659
zheyou73v0_A02	698072	699369	BnaA02T0010900ZY	0	-	304	1212	1297	0.9344642
zheyou73v0_A02	702311	704955	BnaA02T0011000ZY	0	+	1427	2491	2644	0.9421331
zheyou73v0_A02	705783	706662	BnaA02T0011100ZY	0	+	896	803	879	0.9135381
zheyou73v0_A02	707047	709942	BnaA02T0011200ZY	0	-	973	2562	2895	0.8849741
zheyou73v0_A02	715328	716913	BnaA02T0011300ZY	0	-	42	447	1585	0.2820189
zheyou73v0_A02	720627	724303	BnaA02T0011400ZY	0	+	763	2167	3676	0.5894995
zheyou73v0_A02	726028	726623	BnaA02T0011500ZY	0	+	671	595	595	1.0000000
zheyou73v0_A02	726028	726623	BnaA02T0011500ZY.1	0	+	671	595	595	1.0000000
zheyou73v0_A02	736850	738879	BnaA02T0011600ZY	0	+	1613	1964	2029	0.9679645
zheyou73v0_A02	745487	745709	BnaA02T0011700ZY	0	+	0	0	222	0.0000000
zheyou73v0_A02	765262	772922	BnaA02T0011800ZY	0	-	5511	7296	7660	0.9524804
zheyou73v0_A02	774309	775419	BnaA02T0011900ZY	0	+	962	1110	1110	1.0000000
zheyou73v0_A02	776051	777357	BnaA02T0012000ZY	0	+	191	851	1306	0.6516080
zheyou73v0_A02	778749	779957	BnaA02T0012100ZY	0	+	400	1047	1208	0.8667219
zheyou73v0_A02	793981	794533	BnaA02T0012200ZY	0	+	335	552	552	1.0000000
zheyou73v0_A02	794850	795363	BnaA02T0012300ZY	0	+	29	180	513	0.3508772
zheyou73v0_A02	798030	799094	BnaA02T0012400ZY	0	+	534	811	1064	0.7622181
zheyou73v0_A02	800233	800623	BnaA02T0012500ZY	0	+	28	321	390	0.8230769
zheyou73v0_A02	801359	803491	BnaA02T0012600ZY	0	+	699	1822	2132	0.8545966
zheyou73v0_A02	803734	806587	BnaA02T0012700ZY	0	-	769	2597	2853	0.9102699
zheyou73v0_A02	817017	817604	BnaA02T0012800ZY	0	-	45	420	587	0.7155026
zheyou73v0_A02	824310	826976	BnaA02T0012900ZY	0	+	967	2511	2666	0.9418604
zheyou73v0_A02	828485	830108	BnaA02T0013000ZY	0	-	366	1403	1623	0.8644485
zheyou73v0_A02	831877	837099	BnaA02T0013100ZY	0	-	1937	4329	5222	0.8289927
zheyou73v0_A02	837674	841045	BnaA02T0013200ZY	0	-	1537	3346	3371	0.9925838
zheyou73v0_A02	837674	841045	BnaA02T0013200ZY.1	0	-	1537	3346	3371	0.9925838
zheyou73v0_A02	842339	844124	BnaA02T0013300ZY	0	+	1111	1785	1785	1.0000000
zheyou73v0_A02	847393	849398	BnaA02T0013400ZY	0	-	291	1948	2005	0.9715711
zheyou73v0_A02	851593	854081	BnaA02T0013500ZY	0	-	1675	2212	2488	0.8890675
zheyou73v0_A02	854818	855859	BnaA02T0013600ZY	0	-	588	1041	1041	1.0000000
zheyou73v0_A02	860335	860569	BnaA02T0013700ZY	0	+	330	234	234	1.0000000
zheyou73v0_A02	861131	861978	BnaA02T0013800ZY	0	+	514	847	847	1.0000000
zheyou73v0_A02	865691	870015	BnaA02T0013900ZY	0	+	1300	3590	4324	0.8302498
zheyou73v0_A02	870213	870531	BnaA02T0014000ZY	0	-	132	318	318	1.0000000
zheyou73v0_A02	870728	873052	BnaA02T0014100ZY	0	-	335	1615	2324	0.6949226
zheyou73v0_A02	874329	876446	BnaA02T0014200ZY	0	-	579	1826	2117	0.8625413
zheyou73v0_A02	878042	881399	BnaA02T0014300ZY	0	+	1804	3319	3357	0.9886804
zheyou73v0_A02	881997	887269	BnaA02T0014400ZY	0	+	2785	3821	5272	0.7247724
zheyou73v0_A02	883734	884009	BnaA02T0014500ZY	0	+	0	0	275	0.0000000
zheyou73v0_A02	884956	885642	BnaA02T0014600ZY	0	-	889	686	686	1.0000000
zheyou73v0_A02	889801	891921	BnaA02T0014700ZY	0	+	447	2005	2120	0.9457547
zheyou73v0_A02	895428	896493	BnaA02T0014800ZY	0	+	403	539	1065	0.5061033
zheyou73v0_A02	896549	897932	BnaA02T0014900ZY	0	+	1677	1383	1383	1.0000000
zheyou73v0_A02	898499	903501	BnaA02T0015000ZY	0	-	326	3389	5002	0.6775290
zheyou73v0_A02	904345	905587	BnaA02T0015100ZY	0	+	191	1096	1242	0.8824477
zheyou73v0_A02	905694	906012	BnaA02T0015200ZY	0	+	565	318	318	1.0000000
zheyou73v0_A02	906234	908957	BnaA02T0015300ZY	0	-	1767	2565	2723	0.9419758
zheyou73v0_A02	910553	919794	BnaA02T0015400ZY	0	-	4497	7792	9241	0.8431988
zheyou73v0_A02	923701	925019	BnaA02T0015500ZY	0	+	643	1318	1318	1.0000000
zheyou73v0_A02	925270	926624	BnaA02T0015600ZY	0	-	712	1267	1354	0.9357460
zheyou73v0_A02	926919	928976	BnaA02T0015700ZY	0	-	101	1190	2057	0.5785124
zheyou73v0_A02	939581	941820	BnaA02T0015800ZY	0	+	55	1257	2239	0.5614113
zheyou73v0_A02	942973	944802	BnaA02T0015900ZY	0	+	862	1829	1829	1.0000000
zheyou73v0_A02	945905	946499	BnaA02T0016000ZY	0	+	814	594	594	1.0000000
zheyou73v0_A02	947625	951147	BnaA02T0016100ZY	0	+	2313	3495	3522	0.9923339
zheyou73v0_A02	947625	951147	BnaA02T0016100ZY.1	0	+	2313	3495	3522	0.9923339
zheyou73v0_A02	947625	950656	BnaA02T0016100ZY.2	0	+	1989	3004	3031	0.9910920
zheyou73v0_A02	951801	952365	BnaA02T0016200ZY	0	+	562	564	564	1.0000000
zheyou73v0_A02	952830	953948	BnaA02T0016300ZY	0	-	298	1061	1118	0.9490161
zheyou73v0_A02	954366	967239	BnaA02T0016400ZY	0	+	4541	11789	12873	0.9157928
zheyou73v0_A02	967948	969414	BnaA02T0016500ZY	0	+	589	1466	1466	1.0000000
zheyou73v0_A02	969865	976419	BnaA02T0016600ZY	0	+	1908	6063	6554	0.9250839
zheyou73v0_A02	977445	979386	BnaA02T0016700ZY	0	+	159	1590	1941	0.8191653
zheyou73v0_A02	980074	980953	BnaA02T0016800ZY	0	-	87	721	879	0.8202503
zheyou73v0_A02	987821	990552	BnaA02T0016900ZY	0	+	727	2261	2731	0.8279018
zheyou73v0_A02	992315	995988	BnaA02T0017000ZY	0	-	1271	3267	3673	0.8894637
zheyou73v0_A02	1006325	1007051	BnaA02T0017100ZY	0	+	148	520	726	0.7162535
zheyou73v0_A02	1008214	1010495	BnaA02T0017200ZY	0	+	186	1605	2281	0.7036387
zheyou73v0_A02	1010725	1011163	BnaA02T0017300ZY	0	-	105	238	438	0.5433790
zheyou73v0_A02	1012108	1012735	BnaA02T0017400ZY	0	+	298	627	627	1.0000000
zheyou73v0_A02	1013823	1025510	BnaA02T0017500ZY	0	-	1735	8937	11687	0.7646958
zheyou73v0_A02	1026067	1027605	BnaA02T0017600ZY	0	+	757	1451	1538	0.9434330
zheyou73v0_A02	1028042	1029651	BnaA02T0017700ZY	0	-	1216	1609	1609	1.0000000
zheyou73v0_A02	1029809	1038934	BnaA02T0017800ZY	0	+	4076	7797	9125	0.8544658
zheyou73v0_A02	1029809	1038934	BnaA02T0017800ZY.1	0	+	4076	7797	9125	0.8544658
zheyou73v0_A02	1038944	1040806	BnaA02T0017900ZY	0	-	1452	1862	1862	1.0000000
zheyou73v0_A02	1038944	1040806	BnaA02T0017900ZY.1	0	-	1452	1862	1862	1.0000000
zheyou73v0_A02	1046155	1048185	BnaA02T0018000ZY	0	-	204	1837	2030	0.9049261
zheyou73v0_A02	1048419	1050329	BnaA02T0018100ZY	0	-	988	1910	1910	1.0000000
zheyou73v0_A02	1051033	1055253	BnaA02T0018200ZY	0	-	1608	4116	4220	0.9753554
zheyou73v0_A02	1051033	1055253	BnaA02T0018200ZY.1	0	-	1608	4116	4220	0.9753554
zheyou73v0_A02	1055561	1056589	BnaA02T0018300ZY	0	+	1156	1028	1028	1.0000000
zheyou73v0_A02	1056464	1058752	BnaA02T0018400ZY	0	-	1183	2258	2288	0.9868881
zheyou73v0_A02	1070355	1070978	BnaA02T0018500ZY	0	+	208	422	623	0.6773676
zheyou73v0_A02	1080010	1083665	BnaA02T0018600ZY	0	-	824	3227	3655	0.8829001
zheyou73v0_A02	1086872	1088583	BnaA02T0018700ZY	0	+	1438	1711	1711	1.0000000
zheyou73v0_A02	1089772	1090345	BnaA02T0018800ZY	0	+	307	573	573	1.0000000
zheyou73v0_A02	1093240	1093468	BnaA02T0018900ZY	0	-	49	154	228	0.6754386
zheyou73v0_A02	1094529	1095541	BnaA02T0019000ZY	0	-	1009	1012	1012	1.0000000
zheyou73v0_A02	1096244	1096838	BnaA02T0019100ZY	0	-	88	512	594	0.8619528
zheyou73v0_A02	1100643	1101427	BnaA02T0019200ZY	0	+	17	463	784	0.5905612
zheyou73v0_A02	1102524	1107364	BnaA02T0019300ZY	0	-	2330	4770	4840	0.9855372
zheyou73v0_A02	1111991	1114116	BnaA02T0019400ZY	0	-	1585	2125	2125	1.0000000
zheyou73v0_A02	1114444	1123245	BnaA02T0019500ZY	0	-	2658	7537	8801	0.8563800
zheyou73v0_A02	1114444	1123245	BnaA02T0019500ZY.1	0	-	2658	7537	8801	0.8563800
zheyou73v0_A02	1124088	1126201	BnaA02T0019600ZY	0	+	931	2113	2113	1.0000000
zheyou73v0_A02	1126603	1127218	BnaA02T0019700ZY	0	-	45	403	615	0.6552845
zheyou73v0_A02	1128919	1129661	BnaA02T0019800ZY	0	+	241	634	742	0.8544474
zheyou73v0_A02	1131402	1138035	BnaA02T0019900ZY	0	-	2050	5653	6633	0.8522539
zheyou73v0_A02	1139222	1142288	BnaA02T0020000ZY	0	+	648	2791	3066	0.9103066
zheyou73v0_A02	1143629	1145858	BnaA02T0020100ZY	0	+	675	2211	2229	0.9919246
zheyou73v0_A02	1146245	1148416	BnaA02T0020200ZY	0	-	836	2171	2171	1.0000000
zheyou73v0_A02	1158116	1160725	BnaA02T0020300ZY	0	+	716	2072	2609	0.7941740
zheyou73v0_A02	1161739	1163627	BnaA02T0020400ZY	0	+	1315	1888	1888	1.0000000
zheyou73v0_A02	1164410	1165171	BnaA02T0020500ZY	0	-	616	761	761	1.0000000
zheyou73v0_A02	1165687	1167230	BnaA02T0020600ZY	0	-	970	1543	1543	1.0000000
zheyou73v0_A02	1169257	1171542	BnaA02T0020700ZY	0	-	1069	2221	2285	0.9719912
zheyou73v0_A02	1172443	1175014	BnaA02T0020800ZY	0	+	1095	2476	2571	0.9630494
zheyou73v0_A02	1175665	1176588	BnaA02T0020900ZY	0	+	184	622	923	0.6738895
zheyou73v0_A02	1176986	1178418	BnaA02T0021000ZY	0	-	898	1432	1432	1.0000000
zheyou73v0_A02	1183670	1185238	BnaA02T0021100ZY	0	-	1156	1508	1568	0.9617347
zheyou73v0_A02	1185908	1187228	BnaA02T0021200ZY	0	-	106	927	1320	0.7022727
zheyou73v0_A02	1187463	1194212	BnaA02T0021300ZY	0	+	2280	5201	6749	0.7706327
zheyou73v0_A02	1194943	1196635	BnaA02T0021400ZY	0	+	243	1428	1692	0.8439716
zheyou73v0_A02	1194943	1196635	BnaA02T0021400ZY.1	0	+	243	1428	1692	0.8439716
zheyou73v0_A02	1194943	1196052	BnaA02T0021400ZY.2	0	+	161	845	1109	0.7619477
zheyou73v0_A02	1201701	1203310	BnaA02T0021500ZY	0	-	1027	1602	1609	0.9956495
zheyou73v0_A02	1216078	1220585	BnaA02T0021600ZY	0	+	1606	3513	4507	0.7794542
zheyou73v0_A02	1221390	1223036	BnaA02T0021700ZY	0	-	257	1297	1646	0.7879708
zheyou73v0_A02	1239113	1242214	BnaA02T0021800ZY	0	+	3211	2985	3101	0.9625927
zheyou73v0_A02	1244831	1250851	BnaA02T0021900ZY	0	-	3221	5841	6020	0.9702658
zheyou73v0_A02	1252792	1257143	BnaA02T0022000ZY	0	+	1238	4058	4351	0.9326591
zheyou73v0_A02	1257572	1259576	BnaA02T0022100ZY	0	+	482	1647	2004	0.8218563
zheyou73v0_A02	1260725	1262386	BnaA02T0022200ZY	0	+	106	1286	1661	0.7742324
zheyou73v0_A02	1264155	1266747	BnaA02T0022300ZY	0	+	594	2480	2592	0.9567901
zheyou73v0_A02	1269225	1271278	BnaA02T0022400ZY	0	+	302	1614	2053	0.7861666
zheyou73v0_A02	1272788	1273791	BnaA02T0022500ZY	0	-	75	701	1003	0.6989033
zheyou73v0_A02	1288602	1289595	BnaA02T0022600ZY	0	-	1082	933	993	0.9395770
zheyou73v0_A02	1291025	1292163	BnaA02T0022700ZY	0	-	771	958	1138	0.8418278
zheyou73v0_A02	1293910	1294583	BnaA02T0022800ZY	0	+	566	673	673	1.0000000
zheyou73v0_A02	1295764	1302309	BnaA02T0022900ZY	0	+	4245	6545	6545	1.0000000
zheyou73v0_A02	1306253	1312146	BnaA02T0023000ZY	0	+	3261	5677	5893	0.9633464
zheyou73v0_A02	1312590	1314516	BnaA02T0023100ZY	0	+	965	1889	1926	0.9807892
zheyou73v0_A02	1317921	1319525	BnaA02T0023200ZY	0	+	614	1526	1604	0.9513716
zheyou73v0_A02	1322423	1330168	BnaA02T0023300ZY	0	-	4101	7391	7745	0.9542931
zheyou73v0_A02	1331150	1333847	BnaA02T0023400ZY	0	-	355	1878	2697	0.6963292
zheyou73v0_A02	1343058	1344599	BnaA02T0023500ZY	0	+	176	1363	1541	0.8844906
zheyou73v0_A02	1344759	1346232	BnaA02T0023600ZY	0	+	1581	1473	1473	1.0000000
zheyou73v0_A02	1346333	1348421	BnaA02T0023700ZY	0	-	375	1653	2088	0.7916667
zheyou73v0_A02	1348859	1352724	BnaA02T0023800ZY	0	-	1062	3401	3865	0.8799483
zheyou73v0_A02	1348859	1352724	BnaA02T0023800ZY.1	0	-	1062	3401	3865	0.8799483
zheyou73v0_A02	1348859	1352724	BnaA02T0023800ZY.2	0	-	1062	3401	3865	0.8799483
zheyou73v0_A02	1356907	1358281	BnaA02T0023900ZY	0	+	794	1374	1374	1.0000000
zheyou73v0_A02	1366749	1367082	BnaA02T0024000ZY	0	-	197	333	333	1.0000000
zheyou73v0_A02	1368380	1369886	BnaA02T0024100ZY	0	+	1615	1506	1506	1.0000000
zheyou73v0_A02	1369879	1370787	BnaA02T0024200ZY	0	-	925	908	908	1.0000000
zheyou73v0_A02	1371010	1372605	BnaA02T0024300ZY	0	+	1116	1595	1595	1.0000000
zheyou73v0_A02	1374674	1377605	BnaA02T0024400ZY	0	+	2985	2917	2931	0.9952235
zheyou73v0_A02	1377856	1381026	BnaA02T0024500ZY	0	-	2757	2733	3170	0.8621451
zheyou73v0_A02	1384357	1386687	BnaA02T0024600ZY	0	-	1195	2262	2330	0.9708155
zheyou73v0_A02	1387402	1389166	BnaA02T0024700ZY	0	-	2241	1764	1764	1.0000000
zheyou73v0_A02	1390082	1392024	BnaA02T0024800ZY	0	+	1597	1942	1942	1.0000000
zheyou73v0_A02	1394180	1396084	BnaA02T0024900ZY	0	+	1328	1904	1904	1.0000000
zheyou73v0_A02	1396020	1398548	BnaA02T0025000ZY	0	-	357	2179	2528	0.8619462
zheyou73v0_A02	1401190	1403413	BnaA02T0025100ZY	0	+	1098	2214	2223	0.9959514
zheyou73v0_A02	1403959	1404226	BnaA02T0025200ZY	0	-	421	267	267	1.0000000
zheyou73v0_A02	1404248	1404599	BnaA02T0025300ZY	0	-	563	351	351	1.0000000
zheyou73v0_A02	1405275	1405697	BnaA02T0025400ZY	0	-	270	422	422	1.0000000
zheyou73v0_A02	1408437	1409923	BnaA02T0025500ZY	0	+	703	1486	1486	1.0000000
zheyou73v0_A02	1410932	1412077	BnaA02T0025600ZY	0	+	355	1125	1145	0.9825327
zheyou73v0_A02	1412828	1415081	BnaA02T0025700ZY	0	-	1013	1918	2253	0.8513094
zheyou73v0_A02	1412828	1415081	BnaA02T0025700ZY.1	0	-	1013	1918	2253	0.8513094
zheyou73v0_A02	1416463	1418738	BnaA02T0025800ZY	0	-	802	2067	2275	0.9085714
zheyou73v0_A02	1421995	1423827	BnaA02T0025900ZY	0	-	1186	1755	1832	0.9579694
zheyou73v0_A02	1424083	1426733	BnaA02T0026000ZY	0	-	1199	2462	2650	0.9290566
zheyou73v0_A02	1427693	1430123	BnaA02T0026100ZY	0	+	2243	2430	2430	1.0000000
zheyou73v0_A02	1430615	1433554	BnaA02T0026200ZY	0	+	1131	2757	2939	0.9380742
zheyou73v0_A02	1435139	1436729	BnaA02T0026300ZY	0	-	712	1451	1590	0.9125786
zheyou73v0_A02	1438374	1441062	BnaA02T0026400ZY	0	+	1185	2688	2688	1.0000000
zheyou73v0_A02	1441269	1445827	BnaA02T0026500ZY	0	+	1619	4454	4558	0.9771830
zheyou73v0_A02	1446325	1449409	BnaA02T0026600ZY	0	+	522	2777	3084	0.9004540
zheyou73v0_A02	1449499	1454249	BnaA02T0026700ZY	0	-	3385	4674	4750	0.9840000
zheyou73v0_A02	1455963	1459599	BnaA02T0026800ZY	0	+	2350	3636	3636	1.0000000
zheyou73v0_A02	1459603	1462284	BnaA02T0026900ZY	0	-	657	2477	2681	0.9239090
zheyou73v0_A02	1465185	1467822	BnaA02T0027000ZY	0	+	1124	2434	2637	0.9230186
zheyou73v0_A02	1468062	1476369	BnaA02T0027100ZY	0	-	3341	6491	8307	0.7813892
zheyou73v0_A02	1477205	1478636	BnaA02T0027200ZY	0	-	380	1346	1431	0.9406010
zheyou73v0_A02	1481687	1483043	BnaA02T0027300ZY	0	-	448	1356	1356	1.0000000
zheyou73v0_A02	1486068	1486748	BnaA02T0027400ZY	0	-	597	680	680	1.0000000
zheyou73v0_A02	1487303	1488981	BnaA02T0027500ZY	0	+	308	1678	1678	1.0000000
zheyou73v0_A02	1489269	1490353	BnaA02T0027600ZY	0	-	682	1084	1084	1.0000000
zheyou73v0_A02	1489269	1490353	BnaA02T0027600ZY.1	0	-	682	1084	1084	1.0000000
zheyou73v0_A02	1490628	1491603	BnaA02T0027700ZY	0	+	470	975	975	1.0000000
zheyou73v0_A02	1492193	1493858	BnaA02T0027800ZY	0	-	613	1665	1665	1.0000000
zheyou73v0_A02	1499034	1500383	BnaA02T0027900ZY	0	-	609	1313	1349	0.9733136
zheyou73v0_A02	1503304	1506214	BnaA02T0028000ZY	0	+	1468	2910	2910	1.0000000
zheyou73v0_A02	1507999	1509175	BnaA02T0028100ZY	0	+	610	1175	1176	0.9991497
zheyou73v0_A02	1511338	1511972	BnaA02T0028200ZY	0	-	1	102	634	0.1608833
zheyou73v0_A02	1514248	1515367	BnaA02T0028300ZY	0	+	865	1119	1119	1.0000000
zheyou73v0_A02	1521115	1521686	BnaA02T0028400ZY	0	+	486	571	571	1.0000000
zheyou73v0_A02	1521874	1524030	BnaA02T0028500ZY	0	+	345	1811	2156	0.8399814
zheyou73v0_A02	1569901	1576558	BnaA02T0028600ZY	0	+	1881	5733	6657	0.8611987
zheyou73v0_A02	1576637	1578949	BnaA02T0028700ZY	0	+	1903	2312	2312	1.0000000
zheyou73v0_A02	1579021	1582833	BnaA02T0028800ZY	0	+	2540	3795	3812	0.9955404
zheyou73v0_A02	1599976	1600884	BnaA02T0028900ZY	0	-	349	908	908	1.0000000
zheyou73v0_A02	1601208	1603659	BnaA02T0029000ZY	0	-	1249	2433	2451	0.9926561
zheyou73v0_A02	1601208	1603659	BnaA02T0029000ZY.1	0	-	1249	2433	2451	0.9926561
zheyou73v0_A02	1601208	1603659	BnaA02T0029000ZY.2	0	-	1249	2433	2451	0.9926561
zheyou73v0_A02	1603863	1606725	BnaA02T0029100ZY	0	-	2498	2862	2862	1.0000000
zheyou73v0_A02	1603863	1606672	BnaA02T0029100ZY.1	0	-	2440	2809	2809	1.0000000
zheyou73v0_A02	1606854	1608182	BnaA02T0029200ZY	0	-	1140	1328	1328	1.0000000
zheyou73v0_A02	1606854	1608182	BnaA02T0029200ZY.1	0	-	1140	1328	1328	1.0000000
zheyou73v0_A02	1608887	1611308	BnaA02T0029300ZY	0	-	1521	2419	2421	0.9991739
zheyou73v0_A02	1614261	1615088	BnaA02T0029400ZY	0	-	53	735	827	0.8887545
zheyou73v0_A02	1624254	1626899	BnaA02T0029500ZY	0	+	759	2392	2645	0.9043478
zheyou73v0_A02	1628318	1630509	BnaA02T0029600ZY	0	-	831	2132	2191	0.9730716
zheyou73v0_A02	1632447	1632786	BnaA02T0029700ZY	0	+	58	301	339	0.8879056
zheyou73v0_A02	1635333	1637252	BnaA02T0029800ZY	0	-	167	1185	1919	0.6175091
zheyou73v0_A02	1643165	1643333	BnaA02T0029900ZY	0	+	233	168	168	1.0000000
zheyou73v0_A02	1653182	1655486	BnaA02T0030000ZY	0	+	519	2135	2304	0.9266493
zheyou73v0_A02	1655948	1658413	BnaA02T0030100ZY	0	-	28	851	2465	0.3452333
zheyou73v0_A02	1660658	1664540	BnaA02T0030200ZY	0	+	2314	3882	3882	1.0000000
zheyou73v0_A02	1660658	1664540	BnaA02T0030200ZY.1	0	+	2314	3882	3882	1.0000000
zheyou73v0_A02	1665068	1668322	BnaA02T0030300ZY	0	-	1396	3163	3254	0.9720344
zheyou73v0_A02	1668926	1671524	BnaA02T0030400ZY	0	-	1270	2598	2598	1.0000000
zheyou73v0_A02	1674223	1674694	BnaA02T0030500ZY	0	+	500	471	471	1.0000000
zheyou73v0_A02	1675211	1676595	BnaA02T0030600ZY	0	+	1852	1384	1384	1.0000000
zheyou73v0_A02	1677333	1677948	BnaA02T0030700ZY	0	+	84	528	615	0.8585366
zheyou73v0_A02	1678613	1679916	BnaA02T0030800ZY	0	+	537	1251	1303	0.9600921
zheyou73v0_A02	1683454	1689734	BnaA02T0030900ZY	0	+	4494	6261	6280	0.9969745
zheyou73v0_A02	1689751	1691969	BnaA02T0031000ZY	0	-	1124	2060	2218	0.9287646
zheyou73v0_A02	1697947	1699324	BnaA02T0031100ZY	0	+	1811	1377	1377	1.0000000
zheyou73v0_A02	1699906	1706315	BnaA02T0031200ZY	0	-	4529	6297	6409	0.9825246
zheyou73v0_A02	1708007	1709375	BnaA02T0031300ZY	0	+	269	1186	1368	0.8669590
zheyou73v0_A02	1709763	1710751	BnaA02T0031400ZY	0	-	222	924	988	0.9352227
zheyou73v0_A02	1712702	1716276	BnaA02T0031500ZY	0	-	3141	3510	3574	0.9820929
zheyou73v0_A02	1718079	1719901	BnaA02T0031600ZY	0	-	498	1777	1822	0.9753019
zheyou73v0_A02	1721882	1723480	BnaA02T0031700ZY	0	+	855	1406	1598	0.8798498
zheyou73v0_A02	1723787	1726994	BnaA02T0031800ZY	0	-	638	2755	3207	0.8590583
zheyou73v0_A02	1737436	1739936	BnaA02T0031900ZY	0	+	1066	2036	2500	0.8144000
zheyou73v0_A02	1748472	1749997	BnaA02T0032000ZY	0	+	589	1502	1525	0.9849181
zheyou73v0_A02	1750764	1754547	BnaA02T0032100ZY	0	-	860	3455	3783	0.9132963
zheyou73v0_A02	1756426	1757210	BnaA02T0032200ZY	0	-	383	784	784	1.0000000
zheyou73v0_A02	1758446	1759968	BnaA02T0032300ZY	0	-	596	1370	1522	0.9001314
zheyou73v0_A02	1758446	1759968	BnaA02T0032300ZY.1	0	-	596	1370	1522	0.9001314
zheyou73v0_A02	1761780	1764223	BnaA02T0032400ZY	0	-	1998	2337	2443	0.9566107
zheyou73v0_A02	1767973	1772139	BnaA02T0032500ZY	0	-	1918	2179	4166	0.5230437
zheyou73v0_A02	1773715	1774521	BnaA02T0032600ZY	0	-	136	629	806	0.7803970
zheyou73v0_A02	1775594	1777317	BnaA02T0032700ZY	0	-	1204	1723	1723	1.0000000
zheyou73v0_A02	1778017	1779771	BnaA02T0032800ZY	0	+	666	1754	1754	1.0000000
zheyou73v0_A02	1789179	1792810	BnaA02T0032900ZY	0	+	635	3514	3631	0.9677775
zheyou73v0_A02	1792357	1795308	BnaA02T0033000ZY	0	-	1138	2827	2951	0.9579803
zheyou73v0_A02	1792357	1795308	BnaA02T0033000ZY.1	0	-	1138	2827	2951	0.9579803
zheyou73v0_A02	1797024	1797915	BnaA02T0033100ZY	0	-	39	584	891	0.6554433
zheyou73v0_A02	1798113	1798665	BnaA02T0033200ZY	0	-	167	536	552	0.9710145
zheyou73v0_A02	1798720	1798999	BnaA02T0033300ZY	0	-	256	279	279	1.0000000
zheyou73v0_A02	1800261	1804096	BnaA02T0033400ZY	0	+	3044	3835	3835	1.0000000
zheyou73v0_A02	1807431	1808966	BnaA02T0033500ZY	0	+	781	1370	1535	0.8925081
zheyou73v0_A02	1809790	1813892	BnaA02T0033600ZY	0	+	3366	3999	4102	0.9748903
zheyou73v0_A02	1814356	1815927	BnaA02T0033700ZY	0	-	1395	1571	1571	1.0000000
zheyou73v0_A02	1817532	1818654	BnaA02T0033800ZY	0	+	1435	1122	1122	1.0000000
zheyou73v0_A02	1818061	1821782	BnaA02T0033900ZY	0	-	2076	3218	3721	0.8648213
zheyou73v0_A02	1832966	1835267	BnaA02T0034000ZY	0	+	0	0	2301	0.0000000
zheyou73v0_A02	1835498	1842136	BnaA02T0034100ZY	0	-	336	1670	6638	0.2515818
zheyou73v0_A02	1843034	1844825	BnaA02T0034200ZY	0	-	187	489	1791	0.2730318
zheyou73v0_A02	1850947	1852479	BnaA02T0034300ZY	0	+	4	451	1532	0.2943864
zheyou73v0_A02	1852717	1855068	BnaA02T0034400ZY	0	+	0	0	2351	0.0000000
zheyou73v0_A02	1855331	1865862	BnaA02T0034500ZY	0	-	1	87	10531	0.0082613
zheyou73v0_A02	1866830	1868345	BnaA02T0034600ZY	0	-	3	299	1515	0.1973597
zheyou73v0_A02	1869098	1870320	BnaA02T0034700ZY	0	-	4	161	1222	0.1317512
zheyou73v0_A02	1871136	1876841	BnaA02T0034800ZY	0	-	8	648	5705	0.1135846
zheyou73v0_A02	1878392	1878899	BnaA02T0034900ZY	0	+	2	110	507	0.2169625
zheyou73v0_A02	1880683	1881912	BnaA02T0035000ZY	0	-	0	0	1229	0.0000000
zheyou73v0_A02	1884098	1884807	BnaA02T0035100ZY	0	+	0	0	709	0.0000000
zheyou73v0_A02	1888859	1891182	BnaA02T0035200ZY	0	+	4	168	2323	0.0723203
zheyou73v0_A02	1905043	1906046	BnaA02T0035300ZY	0	-	11	562	1003	0.5603191
zheyou73v0_A02	1914490	1915063	BnaA02T0035400ZY	0	+	0	0	573	0.0000000
zheyou73v0_A02	1920904	1924018	BnaA02T0035500ZY	0	+	4	493	3114	0.1583173
zheyou73v0_A02	1924915	1927371	BnaA02T0035600ZY	0	+	0	0	2456	0.0000000
zheyou73v0_A02	1928290	1929400	BnaA02T0035700ZY	0	-	0	0	1110	0.0000000
zheyou73v0_A02	1937583	1940596	BnaA02T0035800ZY	0	+	0	0	3013	0.0000000
zheyou73v0_A02	1940979	1944632	BnaA02T0035900ZY	0	-	0	0	3653	0.0000000
zheyou73v0_A02	1945558	1947129	BnaA02T0036000ZY	0	-	0	0	1571	0.0000000
zheyou73v0_A02	1948149	1951397	BnaA02T0036100ZY	0	+	2	105	3248	0.0323276
zheyou73v0_A02	1951768	1952663	BnaA02T0036200ZY	0	-	0	0	895	0.0000000
zheyou73v0_A02	1956177	1958257	BnaA02T0036300ZY	0	-	4	278	2080	0.1336538
zheyou73v0_A02	1964159	1965867	BnaA02T0036400ZY	0	+	0	0	1708	0.0000000
zheyou73v0_A02	1966343	1967966	BnaA02T0036500ZY	0	-	0	0	1623	0.0000000
zheyou73v0_A02	1982010	1982285	BnaA02T0036600ZY	0	-	40	275	275	1.0000000
zheyou73v0_A02	1994891	1998120	BnaA02T0036700ZY	0	+	0	0	3229	0.0000000
zheyou73v0_A02	1998351	2000152	BnaA02T0036800ZY	0	-	4	426	1801	0.2365353
zheyou73v0_A02	2000933	2002322	BnaA02T0036900ZY	0	+	49	354	1389	0.2548596
zheyou73v0_A02	2002711	2004620	BnaA02T0037000ZY	0	-	538	1712	1909	0.8968046
zheyou73v0_A02	2006189	2007758	BnaA02T0037100ZY	0	-	43	495	1569	0.3154876
zheyou73v0_A02	2013930	2015469	BnaA02T0037200ZY	0	+	758	1536	1539	0.9980507
zheyou73v0_A02	2015707	2018051	BnaA02T0037300ZY	0	+	891	2293	2344	0.9782423
zheyou73v0_A02	2018316	2029542	BnaA02T0037400ZY	0	-	4831	9182	11226	0.8179227
zheyou73v0_A02	2030540	2032052	BnaA02T0037500ZY	0	-	550	1477	1512	0.9768519
zheyou73v0_A02	2032818	2034046	BnaA02T0037600ZY	0	-	751	1228	1228	1.0000000
zheyou73v0_A02	2034881	2038033	BnaA02T0037700ZY	0	-	467	1741	3152	0.5523477
zheyou73v0_A02	2045455	2046321	BnaA02T0037800ZY	0	-	306	715	866	0.8256351
zheyou73v0_A02	2047734	2048175	BnaA02T0037900ZY	0	+	214	441	441	1.0000000
zheyou73v0_A02	2049784	2050815	BnaA02T0038000ZY	0	-	131	703	1031	0.6818623
zheyou73v0_A02	2060967	2064076	BnaA02T0038100ZY	0	+	706	1802	3109	0.5796076
zheyou73v0_A02	2068284	2069411	BnaA02T0038200ZY	0	-	1015	1127	1127	1.0000000
zheyou73v0_A02	2071991	2073624	BnaA02T0038300ZY	0	+	975	1633	1633	1.0000000
zheyou73v0_A02	2085115	2088431	BnaA02T0038400ZY	0	+	1437	3316	3316	1.0000000
zheyou73v0_A02	2091020	2094019	BnaA02T0038500ZY	0	+	1506	2796	2999	0.9323108
zheyou73v0_A02	2094588	2096174	BnaA02T0038600ZY	0	-	102	765	1586	0.4823455
zheyou73v0_A02	2102930	2105943	BnaA02T0038700ZY	0	+	140	429	3013	0.1423830
zheyou73v0_A02	2106326	2110220	BnaA02T0038800ZY	0	-	1337	3576	3894	0.9183359
zheyou73v0_A02	2111143	2112752	BnaA02T0038900ZY	0	-	719	1599	1609	0.9937850
zheyou73v0_A02	2113717	2116461	BnaA02T0039000ZY	0	+	2799	2744	2744	1.0000000
zheyou73v0_A02	2117271	2118211	BnaA02T0039100ZY	0	-	216	828	940	0.8808511
zheyou73v0_A02	2125507	2127588	BnaA02T0039200ZY	0	-	979	1431	2081	0.6876501
zheyou73v0_A02	2134105	2134902	BnaA02T0039300ZY	0	+	151	756	797	0.9485571
zheyou73v0_A02	2135246	2136992	BnaA02T0039400ZY	0	-	25	553	1746	0.3167239
zheyou73v0_A02	2150822	2151429	BnaA02T0039500ZY	0	-	305	607	607	1.0000000
zheyou73v0_A02	2152535	2154924	BnaA02T0039600ZY	0	-	70	552	2389	0.2310590
zheyou73v0_A02	2172858	2174343	BnaA02T0039700ZY	0	+	0	0	1485	0.0000000
zheyou73v0_A02	2176574	2177441	BnaA02T0039800ZY	0	-	315	707	867	0.8154556
zheyou73v0_A02	2206444	2211091	BnaA02T0039900ZY	0	+	589	2066	4647	0.4445879
zheyou73v0_A02	2216731	2219185	BnaA02T0040000ZY	0	-	242	1878	2454	0.7652812
zheyou73v0_A02	2222169	2223281	BnaA02T0040100ZY	0	-	138	907	1112	0.8156475
zheyou73v0_A02	2223815	2227974	BnaA02T0040200ZY	0	-	2780	4159	4159	1.0000000
zheyou73v0_A02	2228917	2231172	BnaA02T0040300ZY	0	+	1536	2020	2255	0.8957871
zheyou73v0_A02	2234652	2235185	BnaA02T0040400ZY	0	-	0	0	533	0.0000000
zheyou73v0_A02	2236884	2237589	BnaA02T0040500ZY	0	-	411	705	705	1.0000000
zheyou73v0_A02	2243523	2245009	BnaA02T0040600ZY	0	-	332	1303	1486	0.8768506
zheyou73v0_A02	2243523	2245009	BnaA02T0040600ZY.1	0	-	332	1303	1486	0.8768506
zheyou73v0_A02	2246441	2247280	BnaA02T0040700ZY	0	+	523	839	839	1.0000000
zheyou73v0_A02	2248075	2250017	BnaA02T0040800ZY	0	+	1030	1942	1942	1.0000000
zheyou73v0_A02	2251909	2255726	BnaA02T0040900ZY	0	+	1253	3631	3817	0.9512706
zheyou73v0_A02	2256095	2259643	BnaA02T0041000ZY	0	+	1811	3548	3548	1.0000000
zheyou73v0_A02	2259778	2261440	BnaA02T0041100ZY	0	-	912	1662	1662	1.0000000
zheyou73v0_A02	2269013	2270735	BnaA02T0041200ZY	0	+	831	1722	1722	1.0000000
zheyou73v0_A02	2269013	2269983	BnaA02T0041200ZY.1	0	+	602	970	970	1.0000000
zheyou73v0_A02	2270979	2272279	BnaA02T0041300ZY	0	+	925	1300	1300	1.0000000
zheyou73v0_A02	2272287	2274089	BnaA02T0041400ZY	0	-	1279	1802	1802	1.0000000
zheyou73v0_A02	2277889	2281344	BnaA02T0041500ZY	0	+	484	2589	3455	0.7493488
zheyou73v0_A02	2286389	2287178	BnaA02T0041600ZY	0	-	223	602	789	0.7629911
zheyou73v0_A02	2287918	2288425	BnaA02T0041700ZY	0	-	34	199	507	0.3925049
zheyou73v0_A02	2288800	2293942	BnaA02T0041800ZY	0	-	587	4297	5142	0.8356671
zheyou73v0_A02	2288800	2293942	BnaA02T0041800ZY.1	0	-	587	4297	5142	0.8356671
zheyou73v0_A02	2288800	2293942	BnaA02T0041800ZY.2	0	-	587	4297	5142	0.8356671
zheyou73v0_A02	2296043	2299109	BnaA02T0041900ZY	0	+	1061	2838	3066	0.9256360
zheyou73v0_A02	2300035	2303273	BnaA02T0042000ZY	0	+	237	2369	3238	0.7316245
zheyou73v0_A02	2303430	2309321	BnaA02T0042100ZY	0	-	3760	5622	5891	0.9543371
zheyou73v0_A02	2310508	2311912	BnaA02T0042200ZY	0	+	740	1375	1404	0.9793447
zheyou73v0_A02	2313896	2317480	BnaA02T0042300ZY	0	-	2229	3409	3584	0.9511719
zheyou73v0_A02	2323298	2326878	BnaA02T0042400ZY	0	-	2622	3580	3580	1.0000000
zheyou73v0_A02	2323298	2326878	BnaA02T0042400ZY.1	0	-	2622	3580	3580	1.0000000
zheyou73v0_A02	2328098	2328380	BnaA02T0042500ZY	0	+	1	122	282	0.4326241
zheyou73v0_A02	2332222	2332815	BnaA02T0042600ZY	0	-	342	536	593	0.9038786
zheyou73v0_A02	2333258	2336063	BnaA02T0042700ZY	0	-	344	2250	2805	0.8021390
zheyou73v0_A02	2333258	2336063	BnaA02T0042700ZY.1	0	-	344	2250	2805	0.8021390
zheyou73v0_A02	2342458	2343159	BnaA02T0042800ZY	0	-	490	701	701	1.0000000
zheyou73v0_A02	2345502	2346748	BnaA02T0042900ZY	0	+	662	1246	1246	1.0000000
zheyou73v0_A02	2350730	2353749	BnaA02T0043000ZY	0	-	854	2910	3019	0.9638953
zheyou73v0_A02	2356490	2357091	BnaA02T0043100ZY	0	-	42	601	601	1.0000000
zheyou73v0_A02	2358060	2360328	BnaA02T0043200ZY	0	-	1452	2268	2268	1.0000000
zheyou73v0_A02	2361267	2364018	BnaA02T0043300ZY	0	+	625	2636	2751	0.9581970
zheyou73v0_A02	2364122	2364941	BnaA02T0043400ZY	0	-	730	819	819	1.0000000
zheyou73v0_A02	2365918	2369855	BnaA02T0043500ZY	0	+	1005	2930	3937	0.7442215
zheyou73v0_A02	2370406	2371584	BnaA02T0043600ZY	0	+	118	1054	1178	0.8947368
zheyou73v0_A02	2372383	2372782	BnaA02T0043700ZY	0	+	55	353	399	0.8847118
zheyou73v0_A02	2375259	2377937	BnaA02T0043800ZY	0	-	968	2197	2678	0.8203884
zheyou73v0_A02	2379819	2380092	BnaA02T0043900ZY	0	+	464	273	273	1.0000000
zheyou73v0_A02	2382115	2384474	BnaA02T0044000ZY	0	-	1410	2359	2359	1.0000000
zheyou73v0_A02	2385055	2389019	BnaA02T0044100ZY	0	-	2062	3964	3964	1.0000000
zheyou73v0_A02	2396377	2400300	BnaA02T0044200ZY	0	-	1530	3540	3923	0.9023706
zheyou73v0_A02	2406036	2406761	BnaA02T0044300ZY	0	-	63	652	725	0.8993104
zheyou73v0_A02	2408207	2412870	BnaA02T0044400ZY	0	+	901	3988	4663	0.8552434
zheyou73v0_A02	2413474	2414335	BnaA02T0044500ZY	0	-	470	861	861	1.0000000
zheyou73v0_A02	2415234	2421689	BnaA02T0044600ZY	0	+	1644	5646	6455	0.8746708
zheyou73v0_A02	2423188	2426173	BnaA02T0044700ZY	0	-	967	2590	2985	0.8676717
zheyou73v0_A02	2428726	2430525	BnaA02T0044800ZY	0	-	1656	1799	1799	1.0000000
zheyou73v0_A02	2428726	2430525	BnaA02T0044800ZY.1	0	-	1656	1799	1799	1.0000000
zheyou73v0_A02	2435162	2438200	BnaA02T0044900ZY	0	+	985	2840	3038	0.9348255
zheyou73v0_A02	2440456	2442667	BnaA02T0045000ZY	0	-	1503	2076	2211	0.9389417
zheyou73v0_A02	2445827	2448009	BnaA02T0045100ZY	0	-	905	2156	2182	0.9880843
zheyou73v0_A02	2449572	2451541	BnaA02T0045200ZY	0	-	1054	1840	1969	0.9344845
zheyou73v0_A02	2454230	2455616	BnaA02T0045300ZY	0	+	786	1289	1386	0.9300144
zheyou73v0_A02	2459129	2463940	BnaA02T0045400ZY	0	+	2676	4807	4811	0.9991686
zheyou73v0_A02	2464287	2464770	BnaA02T0045500ZY	0	-	283	483	483	1.0000000
zheyou73v0_A02	2465346	2475546	BnaA02T0045600ZY	0	-	3426	9830	10200	0.9637255
zheyou73v0_A02	2478470	2484871	BnaA02T0045700ZY	0	+	825	4754	6401	0.7426965
zheyou73v0_A02	2485602	2490455	BnaA02T0045800ZY	0	-	3306	4778	4853	0.9845456
zheyou73v0_A02	2491850	2495839	BnaA02T0045900ZY	0	+	1167	3144	3989	0.7881675
zheyou73v0_A02	2491850	2495839	BnaA02T0045900ZY.1	0	+	1167	3144	3989	0.7881675
zheyou73v0_A02	2497608	2499098	BnaA02T0046000ZY.1	0	+	467	1454	1490	0.9758389
zheyou73v0_A02	2497680	2499098	BnaA02T0046000ZY	0	+	466	1382	1418	0.9746121
zheyou73v0_A02	2500867	2502906	BnaA02T0046100ZY	0	+	1454	2039	2039	1.0000000
zheyou73v0_A02	2503151	2504648	BnaA02T0046200ZY	0	-	639	1497	1497	1.0000000
zheyou73v0_A02	2505952	2508763	BnaA02T0046300ZY	0	+	1269	2774	2811	0.9868374
zheyou73v0_A02	2509945	2511468	BnaA02T0046400ZY	0	-	420	1400	1523	0.9192383
zheyou73v0_A02	2525525	2526432	BnaA02T0046500ZY	0	+	63	541	907	0.5964719
zheyou73v0_A02	2535905	2537014	BnaA02T0046600ZY	0	-	828	1109	1109	1.0000000
zheyou73v0_A02	2537849	2539648	BnaA02T0046700ZY	0	+	606	1549	1799	0.8610339
zheyou73v0_A02	2542159	2544441	BnaA02T0046800ZY.1	0	+	608	2090	2282	0.9158633
zheyou73v0_A02	2542247	2544441	BnaA02T0046800ZY	0	+	546	2002	2194	0.9124886
zheyou73v0_A02	2551541	2558370	BnaA02T0046900ZY	0	+	3625	6283	6829	0.9200469
zheyou73v0_A02	2559994	2563102	BnaA02T0047000ZY	0	+	1138	3006	3108	0.9671814
zheyou73v0_A02	2563322	2565169	BnaA02T0047100ZY	0	-	614	1812	1847	0.9810504
zheyou73v0_A02	2569803	2575535	BnaA02T0047200ZY	0	+	2344	5047	5732	0.8804955
zheyou73v0_A02	2589062	2593041	BnaA02T0047300ZY	0	+	678	2793	3979	0.7019352
zheyou73v0_A02	2592664	2595519	BnaA02T0047400ZY	0	-	946	2787	2855	0.9761822
zheyou73v0_A02	2596186	2597877	BnaA02T0047500ZY	0	-	2224	1691	1691	1.0000000
zheyou73v0_A02	2606728	2608939	BnaA02T0047600ZY	0	-	1161	2211	2211	1.0000000
zheyou73v0_A02	2609289	2611242	BnaA02T0047700ZY	0	-	1742	1953	1953	1.0000000
zheyou73v0_A02	2612424	2614003	BnaA02T0047800ZY	0	-	1188	1579	1579	1.0000000
zheyou73v0_A02	2614195	2615782	BnaA02T0047900ZY	0	-	699	1444	1587	0.9098929
zheyou73v0_A02	2617891	2619719	BnaA02T0048000ZY	0	+	610	1686	1828	0.9223195
zheyou73v0_A02	2620160	2621411	BnaA02T0048100ZY	0	+	919	1251	1251	1.0000000
zheyou73v0_A02	2621447	2625832	BnaA02T0048200ZY	0	-	1489	4212	4385	0.9605473
zheyou73v0_A02	2626251	2630578	BnaA02T0048300ZY	0	+	3226	4302	4327	0.9942223
zheyou73v0_A02	2630849	2634560	BnaA02T0048400ZY	0	-	2091	3658	3711	0.9857181
zheyou73v0_A02	2631107	2631773	BnaA02T0048500ZY	0	+	230	666	666	1.0000000
zheyou73v0_A02	2635835	2640096	BnaA02T0048600ZY	0	-	1619	4226	4261	0.9917859
zheyou73v0_A02	2641499	2644228	BnaA02T0048700ZY	0	+	1327	2726	2729	0.9989007
zheyou73v0_A02	2641499	2644228	BnaA02T0048700ZY.1	0	+	1327	2726	2729	0.9989007
zheyou73v0_A02	2641499	2644228	BnaA02T0048700ZY.2	0	+	1327	2726	2729	0.9989007
zheyou73v0_A02	2646059	2650018	BnaA02T0048800ZY	0	-	636	3510	3959	0.8865875
zheyou73v0_A02	2651485	2653658	BnaA02T0048900ZY	0	+	1218	1995	2173	0.9180856
zheyou73v0_A02	2654048	2656732	BnaA02T0049000ZY	0	-	183	1142	2684	0.4254844
zheyou73v0_A02	2662307	2663662	BnaA02T0049100ZY	0	-	635	1228	1355	0.9062731
zheyou73v0_A02	2665756	2670090	BnaA02T0049200ZY	0	+	2967	4334	4334	1.0000000
zheyou73v0_A02	2666955	2670090	BnaA02T0049200ZY.1	0	+	2133	3135	3135	1.0000000
zheyou73v0_A02	2666955	2670090	BnaA02T0049200ZY.2	0	+	2133	3135	3135	1.0000000
zheyou73v0_A02	2670610	2678560	BnaA02T0049300ZY	0	+	2859	7059	7950	0.8879246
zheyou73v0_A02	2676913	2679757	BnaA02T0049400ZY	0	-	348	2425	2844	0.8526723
zheyou73v0_A02	2681106	2685292	BnaA02T0049500ZY	0	+	1513	3864	4186	0.9230769
zheyou73v0_A02	2685445	2688555	BnaA02T0049600ZY	0	-	1640	3048	3110	0.9800643
zheyou73v0_A02	2689604	2690872	BnaA02T0049700ZY	0	+	778	1159	1268	0.9140379
zheyou73v0_A02	2690981	2693073	BnaA02T0049800ZY	0	-	1279	1825	2092	0.8723710
zheyou73v0_A02	2695727	2702954	BnaA02T0049900ZY	0	+	5351	7207	7227	0.9972326
zheyou73v0_A02	2703278	2706113	BnaA02T0050000ZY	0	+	595	1452	2835	0.5121693
zheyou73v0_A02	2706895	2710509	BnaA02T0050100ZY	0	-	1259	3174	3614	0.8782513
zheyou73v0_A02	2706944	2708786	BnaA02T0050200ZY	0	+	625	1510	1842	0.8197612
zheyou73v0_A02	2711251	2713351	BnaA02T0050300ZY	0	-	1517	2036	2100	0.9695238
zheyou73v0_A02	2720831	2723337	BnaA02T0050400ZY	0	+	2206	2440	2506	0.9736632
zheyou73v0_A02	2724125	2725123	BnaA02T0050500ZY	0	-	296	889	998	0.8907816
zheyou73v0_A02	2726970	2728391	BnaA02T0050600ZY	0	-	656	1340	1421	0.9429979
zheyou73v0_A02	2728717	2730505	BnaA02T0050700ZY	0	-	704	1771	1788	0.9904922
zheyou73v0_A02	2735750	2740121	BnaA02T0050800ZY	0	-	525	3353	4371	0.7671013
zheyou73v0_A02	2743849	2744152	BnaA02T0050900ZY	0	-	573	303	303	1.0000000
zheyou73v0_A02	2746089	2746599	BnaA02T0051000ZY	0	+	359	510	510	1.0000000
zheyou73v0_A02	2747440	2748918	BnaA02T0051100ZY	0	+	1184	1473	1478	0.9966171
zheyou73v0_A02	2749589	2749865	BnaA02T0051200ZY	0	-	286	276	276	1.0000000
zheyou73v0_A02	2750061	2750950	BnaA02T0051300ZY	0	-	395	889	889	1.0000000
zheyou73v0_A02	2751768	2753344	BnaA02T0051400ZY	0	+	990	1540	1576	0.9771574
zheyou73v0_A02	2756914	2757563	BnaA02T0051500ZY	0	+	314	596	649	0.9183359
zheyou73v0_A02	2760293	2762463	BnaA02T0051600ZY	0	-	840	2145	2170	0.9884793
zheyou73v0_A02	2766321	2768494	BnaA02T0051700ZY	0	+	1472	2173	2173	1.0000000
zheyou73v0_A02	2766321	2768494	BnaA02T0051700ZY.1	0	+	1472	2173	2173	1.0000000
zheyou73v0_A02	2771751	2772279	BnaA02T0051800ZY	0	-	753	528	528	1.0000000
zheyou73v0_A02	2772484	2778231	BnaA02T0051900ZY	0	+	4500	5747	5747	1.0000000
zheyou73v0_A02	2780384	2780869	BnaA02T0052000ZY	0	-	599	485	485	1.0000000
zheyou73v0_A02	2782223	2782457	BnaA02T0052100ZY	0	-	80	234	234	1.0000000
zheyou73v0_A02	2784536	2785093	BnaA02T0052200ZY	0	-	172	522	557	0.9371634
zheyou73v0_A02	2787303	2788301	BnaA02T0052300ZY	0	+	20	134	998	0.1342685
zheyou73v0_A02	2788792	2790295	BnaA02T0052400ZY	0	-	731	1479	1503	0.9840319
zheyou73v0_A02	2792039	2793724	BnaA02T0052500ZY	0	-	516	1685	1685	1.0000000
zheyou73v0_A02	2803543	2806870	BnaA02T0052600ZY	0	+	599	2557	3327	0.7685603
zheyou73v0_A02	2807217	2809891	BnaA02T0052700ZY	0	-	414	1992	2674	0.7449514
zheyou73v0_A02	2812462	2813934	BnaA02T0052800ZY	0	-	337	1463	1472	0.9938859
zheyou73v0_A02	2818966	2820911	BnaA02T0052900ZY	0	+	1038	1722	1945	0.8853471
zheyou73v0_A02	2825210	2826432	BnaA02T0053000ZY	0	+	243	1148	1222	0.9394435
zheyou73v0_A02	2826493	2826718	BnaA02T0053100ZY	0	-	15	225	225	1.0000000
zheyou73v0_A02	2827463	2829631	BnaA02T0053200ZY	0	+	1187	2005	2168	0.9248155
zheyou73v0_A02	2830564	2831436	BnaA02T0053300ZY	0	+	2	249	872	0.2855504
zheyou73v0_A02	2831795	2832095	BnaA02T0053400ZY	0	+	30	254	300	0.8466667
zheyou73v0_A02	2834012	2839041	BnaA02T0053500ZY	0	-	3302	5017	5029	0.9976138
zheyou73v0_A02	2841460	2843701	BnaA02T0053600ZY	0	-	1468	2241	2241	1.0000000
zheyou73v0_A02	2845433	2847783	BnaA02T0053700ZY	0	-	2001	2350	2350	1.0000000
zheyou73v0_A02	2845433	2847439	BnaA02T0053700ZY.1	0	-	1710	2006	2006	1.0000000
zheyou73v0_A02	2848350	2850344	BnaA02T0053800ZY	0	-	936	1802	1994	0.9037111
zheyou73v0_A02	2851398	2856795	BnaA02T0053900ZY	0	+	1655	4612	5397	0.8545488
zheyou73v0_A02	2857868	2860969	BnaA02T0054000ZY	0	-	1488	2614	3101	0.8429539
zheyou73v0_A02	2864184	2866171	BnaA02T0054100ZY	0	-	3904	1987	1987	1.0000000
zheyou73v0_A02	2864184	2866171	BnaA02T0054100ZY.1	0	-	3904	1987	1987	1.0000000
zheyou73v0_A02	2875489	2879273	BnaA02T0054200ZY	0	-	1530	2900	3784	0.7663848
zheyou73v0_A02	2882093	2883358	BnaA02T0054300ZY	0	+	1544	1265	1265	1.0000000
zheyou73v0_A02	2882093	2883358	BnaA02T0054300ZY.1	0	+	1544	1265	1265	1.0000000
zheyou73v0_A02	2883600	2887770	BnaA02T0054400ZY	0	-	1893	3502	4170	0.8398082
zheyou73v0_A02	2893035	2893993	BnaA02T0054500ZY	0	+	814	958	958	1.0000000
zheyou73v0_A02	2896014	2899773	BnaA02T0054600ZY	0	+	2126	3631	3759	0.9659484
zheyou73v0_A02	2896014	2900637	BnaA02T0054600ZY.1	0	+	2375	4395	4623	0.9506814
zheyou73v0_A02	2902948	2908208	BnaA02T0054700ZY	0	-	3498	4648	5260	0.8836502
zheyou73v0_A02	2913600	2915305	BnaA02T0054800ZY	0	+	400	1538	1705	0.9020528
zheyou73v0_A02	2915274	2918262	BnaA02T0054900ZY	0	-	1991	2705	2988	0.9052878
zheyou73v0_A02	2921157	2925607	BnaA02T0055000ZY	0	+	443	3242	4450	0.7285393
zheyou73v0_A02	2925815	2928229	BnaA02T0055100ZY	0	+	199	1383	2414	0.5729080
zheyou73v0_A02	2929246	2930125	BnaA02T0055200ZY	0	+	99	637	879	0.7246872
zheyou73v0_A02	2930915	2932093	BnaA02T0055300ZY	0	+	846	1178	1178	1.0000000
zheyou73v0_A02	2932087	2933227	BnaA02T0055400ZY	0	-	278	877	1140	0.7692983
zheyou73v0_A02	2933605	2948449	BnaA02T0055500ZY	0	-	5102	11486	14844	0.7737806
zheyou73v0_A02	2949634	2952071	BnaA02T0055600ZY	0	+	516	2070	2437	0.8494050
zheyou73v0_A02	2949634	2952071	BnaA02T0055600ZY.1	0	+	516	2070	2437	0.8494050
zheyou73v0_A02	2952325	2954559	BnaA02T0055700ZY	0	+	601	2057	2234	0.9207699
zheyou73v0_A02	2952325	2954559	BnaA02T0055700ZY.1	0	+	601	2057	2234	0.9207699
zheyou73v0_A02	2954753	2956021	BnaA02T0055800ZY	0	+	204	1183	1268	0.9329653
zheyou73v0_A02	2956138	2959082	BnaA02T0055900ZY	0	+	1296	2763	2944	0.9385190
zheyou73v0_A02	2961065	2962869	BnaA02T0056000ZY	0	+	1137	1804	1804	1.0000000
zheyou73v0_A02	2961896	2969665	BnaA02T0056100ZY	0	-	5583	7636	7769	0.9828807
zheyou73v0_A02	2970717	2973136	BnaA02T0056200ZY	0	-	763	2118	2419	0.8755684
zheyou73v0_A02	2974707	2978574	BnaA02T0056300ZY	0	-	2025	3181	3867	0.8226015
zheyou73v0_A02	2980926	2983191	BnaA02T0056400ZY	0	+	729	2157	2265	0.9523179
zheyou73v0_A02	2989742	2992000	BnaA02T0056500ZY	0	+	1975	2258	2258	1.0000000
zheyou73v0_A02	2992427	2992960	BnaA02T0056600ZY	0	+	487	533	533	1.0000000
zheyou73v0_A02	2998349	3002340	BnaA02T0056700ZY	0	-	943	3543	3991	0.8877474
zheyou73v0_A02	3008318	3009519	BnaA02T0056800ZY	0	-	231	1132	1201	0.9425479
zheyou73v0_A02	3013612	3015385	BnaA02T0056900ZY	0	+	988	1476	1773	0.8324873
zheyou73v0_A02	3015698	3016385	BnaA02T0057000ZY	0	-	170	642	687	0.9344978
zheyou73v0_A02	3017690	3018974	BnaA02T0057100ZY	0	-	498	1234	1284	0.9610592
zheyou73v0_A02	3019768	3020644	BnaA02T0057200ZY	0	-	830	876	876	1.0000000
zheyou73v0_A02	3023504	3024528	BnaA02T0057300ZY	0	+	286	943	1024	0.9208984
zheyou73v0_A02	3027528	3030393	BnaA02T0057400ZY	0	+	1199	2399	2865	0.8373473
zheyou73v0_A02	3027528	3030393	BnaA02T0057400ZY.1	0	+	1199	2399	2865	0.8373473
zheyou73v0_A02	3031047	3034783	BnaA02T0057500ZY	0	+	2079	3720	3736	0.9957173
zheyou73v0_A02	3038307	3040123	BnaA02T0057600ZY	0	+	1055	1815	1816	0.9994493
zheyou73v0_A02	3040700	3045608	BnaA02T0057700ZY	0	-	1349	3391	4908	0.6909128
zheyou73v0_A02	3046623	3047877	BnaA02T0057800ZY	0	+	518	1254	1254	1.0000000
zheyou73v0_A02	3048621	3052989	BnaA02T0057900ZY	0	-	2760	4368	4368	1.0000000
zheyou73v0_A02	3048621	3052989	BnaA02T0057900ZY.1	0	-	2760	4368	4368	1.0000000
zheyou73v0_A02	3053405	3057638	BnaA02T0058000ZY	0	-	2402	3964	4233	0.9364517
zheyou73v0_A02	3053405	3057638	BnaA02T0058000ZY.1	0	-	2402	3964	4233	0.9364517
zheyou73v0_A02	3058200	3061147	BnaA02T0058100ZY	0	-	832	2857	2947	0.9694605
zheyou73v0_A02	3058200	3061227	BnaA02T0058100ZY.1	0	-	834	2937	3027	0.9702676
zheyou73v0_A02	3064064	3066705	BnaA02T0058200ZY	0	+	1400	2641	2641	1.0000000
zheyou73v0_A02	3066985	3076695	BnaA02T0058300ZY	0	-	2096	5574	9710	0.5740474
zheyou73v0_A02	3080718	3082055	BnaA02T0058400ZY	0	+	939	1295	1337	0.9685864
zheyou73v0_A02	3080718	3082055	BnaA02T0058400ZY.1	0	+	939	1295	1337	0.9685864
zheyou73v0_A02	3082599	3085723	BnaA02T0058500ZY	0	-	1010	3085	3124	0.9875160
zheyou73v0_A02	3082599	3085688	BnaA02T0058500ZY.1	0	-	999	3050	3089	0.9873745
zheyou73v0_A02	3086673	3087807	BnaA02T0058600ZY	0	+	408	1099	1134	0.9691358
zheyou73v0_A02	3086727	3091782	BnaA02T0058700ZY	0	-	1657	4472	5055	0.8846686
zheyou73v0_A02	3098962	3099837	BnaA02T0058800ZY	0	+	350	875	875	1.0000000
zheyou73v0_A02	3103523	3105803	BnaA02T0058900ZY	0	+	815	2270	2280	0.9956141
zheyou73v0_A02	3110905	3112168	BnaA02T0059000ZY	0	+	187	796	1263	0.6302454
zheyou73v0_A02	3113182	3122680	BnaA02T0059100ZY	0	-	1282	7032	9498	0.7403664
zheyou73v0_A02	3123419	3128971	BnaA02T0059200ZY	0	-	1425	4327	5552	0.7793588
zheyou73v0_A02	3123419	3128971	BnaA02T0059200ZY.1	0	-	1425	4327	5552	0.7793588
zheyou73v0_A02	3129520	3131105	BnaA02T0059300ZY	0	-	65	1125	1585	0.7097792
zheyou73v0_A02	3133847	3134327	BnaA02T0059400ZY	0	-	1	35	480	0.0729167
zheyou73v0_A02	3134707	3135943	BnaA02T0059500ZY	0	-	0	0	1236	0.0000000
zheyou73v0_A02	3137124	3137515	BnaA02T0059600ZY	0	+	0	0	391	0.0000000
zheyou73v0_A02	3137832	3138990	BnaA02T0059700ZY	0	+	144	648	1158	0.5595855
zheyou73v0_A02	3150091	3151066	BnaA02T0059800ZY	0	+	69	610	975	0.6256410
zheyou73v0_A02	3153383	3154432	BnaA02T0059900ZY	0	-	16	474	1049	0.4518589
zheyou73v0_A02	3155353	3158782	BnaA02T0060000ZY	0	-	206	1124	3429	0.3277923
zheyou73v0_A02	3163653	3165919	BnaA02T0060100ZY	0	-	0	0	2266	0.0000000
zheyou73v0_A02	3166987	3169695	BnaA02T0060200ZY	0	-	0	0	2708	0.0000000
zheyou73v0_A02	3173987	3176018	BnaA02T0060300ZY	0	+	0	0	2031	0.0000000
zheyou73v0_A02	3176085	3178648	BnaA02T0060400ZY	0	+	0	0	2563	0.0000000
zheyou73v0_A02	3179024	3180985	BnaA02T0060500ZY	0	+	0	0	1961	0.0000000
zheyou73v0_A02	3182165	3182906	BnaA02T0060600ZY	0	+	2	210	741	0.2834008
zheyou73v0_A02	3183657	3184572	BnaA02T0060700ZY	0	+	0	0	915	0.0000000
zheyou73v0_A02	3184694	3185525	BnaA02T0060800ZY	0	+	0	0	831	0.0000000
zheyou73v0_A02	3186562	3186715	BnaA02T0060900ZY	0	-	0	0	153	0.0000000
zheyou73v0_A02	3191855	3194898	BnaA02T0061000ZY	0	+	226	1024	3043	0.3365100
zheyou73v0_A02	3191855	3195098	BnaA02T0061000ZY.1	0	+	233	1154	3243	0.3558434
zheyou73v0_A02	3195117	3196373	BnaA02T0061100ZY	0	+	172	979	1256	0.7794586
zheyou73v0_A02	3196571	3196817	BnaA02T0061200ZY	0	+	1	150	246	0.6097561
zheyou73v0_A02	3197858	3199889	BnaA02T0061300ZY	0	-	260	1457	2031	0.7173806
zheyou73v0_A02	3197858	3199889	BnaA02T0061300ZY.1	0	-	260	1457	2031	0.7173806
zheyou73v0_A02	3200275	3201681	BnaA02T0061400ZY	0	-	1620	1406	1406	1.0000000
zheyou73v0_A02	3202225	3204274	BnaA02T0061500ZY	0	+	628	1801	2049	0.8789654
zheyou73v0_A02	3202225	3204274	BnaA02T0061500ZY.2	0	+	628	1801	2049	0.8789654
zheyou73v0_A02	3202330	3204274	BnaA02T0061500ZY.1	0	+	587	1696	1944	0.8724280
zheyou73v0_A02	3202330	3204274	BnaA02T0061500ZY.3	0	+	587	1696	1944	0.8724280
zheyou73v0_A02	3206644	3207923	BnaA02T0061600ZY	0	+	612	1252	1279	0.9788898
zheyou73v0_A02	3207790	3208529	BnaA02T0061700ZY	0	-	428	739	739	1.0000000
zheyou73v0_A02	3209401	3215490	BnaA02T0061800ZY	0	+	1610	5191	6089	0.8525209
zheyou73v0_A02	3215639	3221616	BnaA02T0061900ZY	0	-	1498	4632	5977	0.7749707
zheyou73v0_A02	3223338	3224031	BnaA02T0062000ZY	0	-	433	693	693	1.0000000
zheyou73v0_A02	3225334	3230743	BnaA02T0062100ZY	0	+	2435	5400	5409	0.9983361
zheyou73v0_A02	3233164	3237275	BnaA02T0062200ZY	0	+	2484	4111	4111	1.0000000
zheyou73v0_A02	3246345	3247904	BnaA02T0062300ZY	0	-	548	1521	1559	0.9756254
zheyou73v0_A02	3249432	3251616	BnaA02T0062400ZY	0	-	1648	2184	2184	1.0000000
zheyou73v0_A02	3252814	3253864	BnaA02T0062500ZY	0	-	755	1050	1050	1.0000000
zheyou73v0_A02	3254669	3262511	BnaA02T0062600ZY	0	-	2110	7454	7842	0.9505228
zheyou73v0_A02	3269789	3270291	BnaA02T0062700ZY	0	-	550	502	502	1.0000000
zheyou73v0_A02	3272065	3274697	BnaA02T0062800ZY	0	-	599	2510	2632	0.9536474
zheyou73v0_A02	3276919	3277492	BnaA02T0062900ZY	0	+	833	573	573	1.0000000
zheyou73v0_A02	3278295	3279402	BnaA02T0063000ZY	0	+	419	1072	1107	0.9683830
zheyou73v0_A02	3278295	3279402	BnaA02T0063000ZY.1	0	+	419	1072	1107	0.9683830
zheyou73v0_A02	3279500	3280820	BnaA02T0063100ZY	0	-	616	1308	1320	0.9909091
zheyou73v0_A02	3281532	3287767	BnaA02T0063200ZY	0	-	1213	1033	6235	0.1656776
zheyou73v0_A02	3286757	3287767	BnaA02T0063200ZY.1	0	-	586	443	1010	0.4386139
zheyou73v0_A02	3291141	3292114	BnaA02T0063300ZY	0	-	3	199	973	0.2045221
zheyou73v0_A02	3293136	3293463	BnaA02T0063400ZY	0	+	625	327	327	1.0000000
zheyou73v0_A02	3294610	3296255	BnaA02T0063500ZY	0	+	840	1615	1645	0.9817629
zheyou73v0_A02	3296353	3300348	BnaA02T0063600ZY	0	-	1741	3713	3995	0.9294118
zheyou73v0_A02	3308177	3311057	BnaA02T0063700ZY	0	-	1799	2795	2880	0.9704861
zheyou73v0_A02	3318093	3318501	BnaA02T0063800ZY	0	+	75	408	408	1.0000000
zheyou73v0_A02	3318701	3320021	BnaA02T0063900ZY	0	+	107	1063	1320	0.8053030
zheyou73v0_A02	3328618	3330636	BnaA02T0064000ZY	0	+	715	1979	2018	0.9806739
zheyou73v0_A02	3336652	3340033	BnaA02T0064100ZY	0	+	2433	3376	3381	0.9985211
zheyou73v0_A02	3340295	3344639	BnaA02T0064200ZY	0	+	2781	4323	4344	0.9951658
zheyou73v0_A02	3345735	3348004	BnaA02T0064300ZY	0	+	485	1795	2269	0.7910974
zheyou73v0_A02	3353934	3354911	BnaA02T0064400ZY	0	+	4	152	977	0.1555783
zheyou73v0_A02	3360257	3362140	BnaA02T0064500ZY	0	+	661	1791	1883	0.9511418
zheyou73v0_A02	3365061	3365586	BnaA02T0064600ZY	0	+	242	525	525	1.0000000
zheyou73v0_A02	3368118	3370154	BnaA02T0064700ZY	0	-	179	1400	2036	0.6876228
zheyou73v0_A02	3373466	3378000	BnaA02T0064800ZY	0	-	1058	3974	4534	0.8764887
zheyou73v0_A02	3378743	3379724	BnaA02T0064900ZY	0	+	876	981	981	1.0000000
zheyou73v0_A02	3382012	3382359	BnaA02T0065000ZY	0	+	239	347	347	1.0000000
zheyou73v0_A02	3382524	3385355	BnaA02T0065100ZY	0	-	1086	2440	2831	0.8618863
zheyou73v0_A02	3385660	3387465	BnaA02T0065200ZY	0	+	1426	1805	1805	1.0000000
zheyou73v0_A02	3385660	3389453	BnaA02T0065300ZY	0	-	2486	3793	3793	1.0000000
zheyou73v0_A02	3389656	3391908	BnaA02T0065400ZY	0	+	1295	2138	2252	0.9493783
zheyou73v0_A02	3389656	3392007	BnaA02T0065400ZY.1	0	+	1345	2237	2351	0.9515100
zheyou73v0_A02	3389656	3392007	BnaA02T0065400ZY.2	0	+	1345	2237	2351	0.9515100
zheyou73v0_A02	3392738	3395547	BnaA02T0065500ZY	0	+	993	2621	2809	0.9330723
zheyou73v0_A02	3396257	3398947	BnaA02T0065600ZY	0	+	1356	2366	2690	0.8795539
zheyou73v0_A02	3396257	3398947	BnaA02T0065600ZY.1	0	+	1356	2366	2690	0.8795539
zheyou73v0_A02	3401921	3407705	BnaA02T0065700ZY	0	+	1178	4745	5784	0.8203665
zheyou73v0_A02	3408536	3408986	BnaA02T0065800ZY	0	+	64	191	450	0.4244444
zheyou73v0_A02	3409006	3409351	BnaA02T0065900ZY	0	+	44	232	345	0.6724638
zheyou73v0_A02	3410139	3411306	BnaA02T0066000ZY	0	+	387	1118	1167	0.9580120
zheyou73v0_A02	3411427	3413276	BnaA02T0066100ZY	0	+	175	1498	1849	0.8101677
zheyou73v0_A02	3413490	3414811	BnaA02T0066200ZY	0	-	377	1288	1321	0.9750189
zheyou73v0_A02	3415813	3419721	BnaA02T0066300ZY	0	-	1243	2973	3908	0.7607472
zheyou73v0_A02	3421394	3427160	BnaA02T0066400ZY	0	+	1842	3946	5766	0.6843566
zheyou73v0_A02	3427197	3428856	BnaA02T0066500ZY	0	+	576	1659	1659	1.0000000
zheyou73v0_A02	3429174	3430729	BnaA02T0066600ZY	0	-	319	1387	1555	0.8919614
zheyou73v0_A02	3433395	3436011	BnaA02T0066700ZY	0	-	653	2603	2616	0.9950306
zheyou73v0_A02	3438452	3439838	BnaA02T0066800ZY	0	-	400	1268	1386	0.9148629
zheyou73v0_A02	3440147	3441094	BnaA02T0066900ZY	0	-	207	819	947	0.8648363
zheyou73v0_A02	3441718	3443473	BnaA02T0067000ZY	0	+	436	1543	1755	0.8792023
zheyou73v0_A02	3444011	3446083	BnaA02T0067100ZY	0	-	575	1745	2072	0.8421814
zheyou73v0_A02	3452133	3454927	BnaA02T0067200ZY	0	+	1035	2730	2794	0.9770938
zheyou73v0_A02	3455267	3456077	BnaA02T0067300ZY	0	+	279	810	810	1.0000000
zheyou73v0_A02	3457631	3459745	BnaA02T0067400ZY	0	-	1051	2108	2114	0.9971618
zheyou73v0_A02	3461076	3469105	BnaA02T0067500ZY	0	+	2275	7460	8029	0.9291319
zheyou73v0_A02	3469387	3472156	BnaA02T0067600ZY	0	-	440	2215	2769	0.7999278
zheyou73v0_A02	3472741	3473104	BnaA02T0067700ZY	0	+	15	251	363	0.6914601
zheyou73v0_A02	3476956	3479050	BnaA02T0067800ZY	0	+	512	1941	2094	0.9269341
zheyou73v0_A02	3479413	3481304	BnaA02T0067900ZY	0	+	189	1537	1891	0.8127975
zheyou73v0_A02	3483916	3486833	BnaA02T0068000ZY	0	-	912	2917	2917	1.0000000
zheyou73v0_A02	3483938	3484367	BnaA02T0068100ZY	0	+	73	429	429	1.0000000
zheyou73v0_A02	3487431	3490031	BnaA02T0068200ZY	0	-	1091	2475	2600	0.9519231
zheyou73v0_A02	3491869	3496277	BnaA02T0068300ZY	0	-	310	1823	4408	0.4135662
zheyou73v0_A02	3502166	3503303	BnaA02T0068400ZY	0	+	190	988	1137	0.8689534
zheyou73v0_A02	3503731	3505716	BnaA02T0068500ZY	0	+	461	1476	1985	0.7435768
zheyou73v0_A02	3505757	3506435	BnaA02T0068600ZY	0	-	167	474	678	0.6991150
zheyou73v0_A02	3509008	3510202	BnaA02T0068700ZY	0	+	122	1122	1194	0.9396985
zheyou73v0_A02	3511090	3513660	BnaA02T0068800ZY	0	-	906	2559	2570	0.9957199
zheyou73v0_A02	3514551	3516375	BnaA02T0068900ZY	0	-	804	1722	1824	0.9440789
zheyou73v0_A02	3514551	3516375	BnaA02T0068900ZY.1	0	-	804	1722	1824	0.9440789
zheyou73v0_A02	3516895	3521912	BnaA02T0069000ZY	0	-	683	3479	5017	0.6934423
zheyou73v0_A02	3516895	3521912	BnaA02T0069000ZY.1	0	-	683	3479	5017	0.6934423
zheyou73v0_A02	3522850	3525903	BnaA02T0069100ZY	0	-	1350	2809	3053	0.9200786
zheyou73v0_A02	3534385	3537561	BnaA02T0069200ZY	0	+	2858	3150	3176	0.9918136
zheyou73v0_A02	3534385	3537561	BnaA02T0069200ZY.1	0	+	2858	3150	3176	0.9918136
zheyou73v0_A02	3539014	3540662	BnaA02T0069300ZY	0	+	950	1629	1648	0.9884709
zheyou73v0_A02	3541383	3543363	BnaA02T0069400ZY	0	-	1652	1980	1980	1.0000000
zheyou73v0_A02	3541383	3543363	BnaA02T0069400ZY.1	0	-	1652	1980	1980	1.0000000
zheyou73v0_A02	3545076	3545316	BnaA02T0069500ZY	0	+	112	220	240	0.9166667
zheyou73v0_A02	3545970	3549281	BnaA02T0069600ZY	0	-	3182	3311	3311	1.0000000
zheyou73v0_A02	3549510	3553651	BnaA02T0069700ZY	0	+	2300	3730	4141	0.9007486
zheyou73v0_A02	3549510	3553651	BnaA02T0069700ZY.1	0	+	2300	3730	4141	0.9007486
zheyou73v0_A02	3558950	3565599	BnaA02T0069800ZY	0	+	3	210	6649	0.0315837
zheyou73v0_A02	3565695	3565970	BnaA02T0069900ZY	0	-	21	242	275	0.8800000
zheyou73v0_A02	3568649	3569654	BnaA02T0070000ZY	0	+	239	1005	1005	1.0000000
zheyou73v0_A02	3570656	3571938	BnaA02T0070100ZY	0	+	0	0	1282	0.0000000
zheyou73v0_A02	3574984	3576082	BnaA02T0070200ZY	0	+	14	135	1098	0.1229508
zheyou73v0_A02	3585565	3586830	BnaA02T0070300ZY	0	+	12	348	1265	0.2750988
zheyou73v0_A02	3594271	3594995	BnaA02T0070400ZY	0	-	246	724	724	1.0000000
zheyou73v0_A02	3596251	3597283	BnaA02T0070500ZY	0	+	1335	939	1032	0.9098837
zheyou73v0_A02	3596924	3599849	BnaA02T0070600ZY	0	-	1653	2769	2925	0.9466667
zheyou73v0_A02	3600473	3603995	BnaA02T0070700ZY	0	+	3706	3522	3522	1.0000000
zheyou73v0_A02	3602344	3609864	BnaA02T0070800ZY	0	-	6782	7514	7520	0.9992021
zheyou73v0_A02	3617235	3620011	BnaA02T0070900ZY	0	-	609	1896	2776	0.6829971
zheyou73v0_A02	3628301	3629857	BnaA02T0071000ZY	0	-	286	1487	1556	0.9556555
zheyou73v0_A02	3633008	3635166	BnaA02T0071100ZY	0	-	133	584	2158	0.2706209
zheyou73v0_A02	3637689	3639850	BnaA02T0071200ZY	0	-	0	0	2161	0.0000000
zheyou73v0_A02	3667210	3668984	BnaA02T0071300ZY	0	+	0	0	1774	0.0000000
zheyou73v0_A02	3674562	3676116	BnaA02T0071400ZY	0	-	0	0	1554	0.0000000
zheyou73v0_A02	3682400	3682754	BnaA02T0071500ZY	0	+	12	271	354	0.7655367
zheyou73v0_A02	3682911	3684567	BnaA02T0071600ZY	0	+	384	1098	1656	0.6630435
zheyou73v0_A02	3688602	3690462	BnaA02T0071700ZY	0	-	159	980	1860	0.5268817
zheyou73v0_A02	3702970	3706971	BnaA02T0071800ZY	0	-	87	463	4001	0.1157211
zheyou73v0_A02	3732002	3732642	BnaA02T0071900ZY	0	+	36	481	640	0.7515625
zheyou73v0_A02	3765237	3765570	BnaA02T0072000ZY	0	-	0	0	333	0.0000000
zheyou73v0_A02	3766175	3767308	BnaA02T0072100ZY	0	-	0	0	1133	0.0000000
zheyou73v0_A02	3775551	3775859	BnaA02T0072200ZY	0	-	15	194	308	0.6298701
zheyou73v0_A02	3800047	3801647	BnaA02T0072300ZY	0	+	0	0	1600	0.0000000
zheyou73v0_A02	3800163	3801647	BnaA02T0072300ZY.1	0	+	0	0	1484	0.0000000
zheyou73v0_A02	3811161	3812906	BnaA02T0072400ZY	0	-	873	1745	1745	1.0000000
zheyou73v0_A02	3817766	3819478	BnaA02T0072500ZY	0	-	186	1629	1712	0.9515187
zheyou73v0_A02	3820505	3822309	BnaA02T0072600ZY	0	+	1311	1804	1804	1.0000000
zheyou73v0_A02	3824029	3824338	BnaA02T0072700ZY	0	-	21	309	309	1.0000000
zheyou73v0_A02	3826308	3831178	BnaA02T0072800ZY	0	+	185	2001	4870	0.4108829
zheyou73v0_A02	3833513	3833972	BnaA02T0072900ZY	0	-	63	459	459	1.0000000
zheyou73v0_A02	3854416	3856999	BnaA02T0073000ZY	0	+	653	2564	2583	0.9926442
zheyou73v0_A02	3892660	3893319	BnaA02T0073100ZY	0	-	256	659	659	1.0000000
zheyou73v0_A02	3893693	3897830	BnaA02T0073200ZY	0	+	493	3836	4137	0.9272420
zheyou73v0_A02	3899611	3901966	BnaA02T0073300ZY	0	+	372	1362	2355	0.5783439
zheyou73v0_A02	3911314	3912120	BnaA02T0073400ZY	0	-	52	640	806	0.7940447
zheyou73v0_A02	3912441	3913410	BnaA02T0073500ZY	0	+	1	47	969	0.0485036
zheyou73v0_A02	3916447	3919314	BnaA02T0073600ZY	0	+	153	2354	2867	0.8210673
zheyou73v0_A02	3916447	3919314	BnaA02T0073600ZY.1	0	+	153	2354	2867	0.8210673
zheyou73v0_A02	3921373	3925657	BnaA02T0073700ZY	0	+	705	3048	4284	0.7114846
zheyou73v0_A02	3926075	3927972	BnaA02T0073800ZY	0	+	1866	1897	1897	1.0000000
zheyou73v0_A02	3928377	3929978	BnaA02T0073900ZY	0	-	406	1415	1601	0.8838226
zheyou73v0_A02	3930281	3933255	BnaA02T0074000ZY	0	-	871	2877	2974	0.9673840
zheyou73v0_A02	3935302	3936560	BnaA02T0074100ZY	0	-	169	819	1258	0.6510334
zheyou73v0_A02	3943115	3946837	BnaA02T0074200ZY	0	+	975	3528	3722	0.9478775
zheyou73v0_A02	3950884	3952422	BnaA02T0074300ZY	0	-	470	1451	1538	0.9434330
zheyou73v0_A02	3972270	3974743	BnaA02T0074400ZY	0	+	350	2144	2473	0.8669632
zheyou73v0_A02	3972270	3974743	BnaA02T0074400ZY.1	0	+	350	2144	2473	0.8669632
zheyou73v0_A02	3972270	3974743	BnaA02T0074400ZY.2	0	+	350	2144	2473	0.8669632
zheyou73v0_A02	3991463	3992280	BnaA02T0074500ZY	0	-	1	132	817	0.1615667
zheyou73v0_A02	3994052	3995270	BnaA02T0074600ZY	0	+	987	1218	1218	1.0000000
zheyou73v0_A02	4010051	4011404	BnaA02T0074700ZY	0	-	1264	1353	1353	1.0000000
zheyou73v0_A02	4019635	4022135	BnaA02T0074800ZY	0	+	695	2389	2500	0.9556000
zheyou73v0_A02	4019635	4022135	BnaA02T0074800ZY.1	0	+	695	2389	2500	0.9556000
zheyou73v0_A02	4019635	4022135	BnaA02T0074800ZY.2	0	+	695	2389	2500	0.9556000
zheyou73v0_A02	4022468	4024391	BnaA02T0074900ZY	0	-	294	1680	1923	0.8736349
zheyou73v0_A02	4022468	4024391	BnaA02T0074900ZY.1	0	-	294	1680	1923	0.8736349
zheyou73v0_A02	4024627	4025261	BnaA02T0075000ZY	0	+	126	624	634	0.9842271
zheyou73v0_A02	4031957	4032662	BnaA02T0075100ZY	0	+	200	705	705	1.0000000
zheyou73v0_A02	4034642	4035575	BnaA02T0075200ZY	0	+	590	933	933	1.0000000
zheyou73v0_A02	4038871	4040968	BnaA02T0075300ZY	0	+	1065	2097	2097	1.0000000
zheyou73v0_A02	4041135	4043913	BnaA02T0075400ZY	0	-	1067	2706	2778	0.9740821
zheyou73v0_A02	4044870	4045606	BnaA02T0075500ZY	0	+	476	736	736	1.0000000
zheyou73v0_A02	4046305	4047473	BnaA02T0075600ZY	0	+	600	1122	1168	0.9606164
zheyou73v0_A02	4056304	4057616	BnaA02T0075700ZY	0	-	95	883	1312	0.6730183
zheyou73v0_A02	4063113	4066690	BnaA02T0075800ZY	0	+	929	2947	3577	0.8238748
zheyou73v0_A02	4093888	4094219	BnaA02T0075900ZY	0	-	0	0	331	0.0000000
zheyou73v0_A02	4094327	4095282	BnaA02T0076000ZY	0	-	0	0	955	0.0000000
zheyou73v0_A02	4096621	4098546	BnaA02T0076100ZY	0	+	22	561	1925	0.2914286
zheyou73v0_A02	4098074	4098554	BnaA02T0076200ZY	0	-	0	0	480	0.0000000
zheyou73v0_A02	4098934	4100170	BnaA02T0076300ZY	0	-	0	0	1236	0.0000000
zheyou73v0_A02	4101351	4101742	BnaA02T0076400ZY	0	+	0	0	391	0.0000000
zheyou73v0_A02	4102059	4103217	BnaA02T0076500ZY	0	+	255	833	1158	0.7193437
zheyou73v0_A02	4120802	4121777	BnaA02T0076600ZY	0	+	148	716	975	0.7343590
zheyou73v0_A02	4124029	4125105	BnaA02T0076700ZY	0	-	403	1000	1076	0.9293680
zheyou73v0_A02	4126244	4129004	BnaA02T0076800ZY	0	-	1328	2699	2760	0.9778985
zheyou73v0_A02	4129741	4132009	BnaA02T0076900ZY	0	-	675	1936	2268	0.8536155
zheyou73v0_A02	4133090	4137497	BnaA02T0077000ZY	0	-	1147	4257	4407	0.9659632
zheyou73v0_A02	4137392	4139432	BnaA02T0077100ZY	0	+	475	709	2040	0.3475490
zheyou73v0_A02	4137392	4139432	BnaA02T0077100ZY.1	0	+	475	709	2040	0.3475490
zheyou73v0_A02	4139499	4142062	BnaA02T0077200ZY	0	+	0	0	2563	0.0000000
zheyou73v0_A02	4142438	4144399	BnaA02T0077300ZY	0	+	0	0	1961	0.0000000
zheyou73v0_A02	4145579	4146320	BnaA02T0077400ZY	0	+	28	258	741	0.3481781
zheyou73v0_A02	4147069	4147984	BnaA02T0077500ZY	0	+	0	0	915	0.0000000
zheyou73v0_A02	4148106	4148937	BnaA02T0077600ZY	0	+	0	0	831	0.0000000
zheyou73v0_A02	4149974	4150127	BnaA02T0077700ZY	0	-	0	0	153	0.0000000
zheyou73v0_A02	4155266	4158308	BnaA02T0077800ZY	0	+	6	354	3042	0.1163708
zheyou73v0_A02	4155266	4158507	BnaA02T0077800ZY.1	0	+	6	354	3241	0.1092255
zheyou73v0_A02	4158526	4159779	BnaA02T0077900ZY	0	+	0	0	1253	0.0000000
zheyou73v0_A02	4161270	4163299	BnaA02T0078000ZY	0	-	2	278	2029	0.1370133
zheyou73v0_A02	4161270	4163299	BnaA02T0078000ZY.1	0	-	2	278	2029	0.1370133
zheyou73v0_A02	4189455	4191612	BnaA02T0078100ZY	0	-	0	0	2157	0.0000000
zheyou73v0_A02	4194135	4196296	BnaA02T0078200ZY	0	-	0	0	2161	0.0000000
zheyou73v0_A02	4205538	4207463	BnaA02T0078300ZY	0	+	2	157	1925	0.0815584
zheyou73v0_A02	4209835	4210950	BnaA02T0078400ZY	0	-	0	0	1115	0.0000000
zheyou73v0_A02	4218223	4219777	BnaA02T0078500ZY	0	-	0	0	1554	0.0000000
zheyou73v0_A02	4226057	4226659	BnaA02T0078600ZY	0	+	0	0	602	0.0000000
zheyou73v0_A02	4232721	4236239	BnaA02T0078700ZY	0	+	4	238	3518	0.0676521
zheyou73v0_A02	4236342	4240343	BnaA02T0078800ZY	0	-	1	3	4001	0.0007498
zheyou73v0_A02	4277397	4278037	BnaA02T0078900ZY	0	+	0	0	640	0.0000000
zheyou73v0_A02	4295127	4297745	BnaA02T0079000ZY	0	+	0	0	2618	0.0000000
zheyou73v0_A02	4325026	4328108	BnaA02T0079100ZY	0	+	0	0	3082	0.0000000
zheyou73v0_A02	4330091	4330379	BnaA02T0079200ZY	0	-	0	0	288	0.0000000
zheyou73v0_A02	4331249	4331763	BnaA02T0079300ZY	0	+	0	0	514	0.0000000
zheyou73v0_A02	4345327	4345660	BnaA02T0079400ZY	0	-	0	0	333	0.0000000
zheyou73v0_A02	4346265	4348545	BnaA02T0079500ZY	0	-	0	0	2280	0.0000000
zheyou73v0_A02	4348698	4351879	BnaA02T0079600ZY	0	-	0	0	3181	0.0000000
zheyou73v0_A02	4354450	4355943	BnaA02T0079700ZY	0	-	0	0	1493	0.0000000
zheyou73v0_A02	4355953	4357102	BnaA02T0079800ZY	0	-	0	0	1149	0.0000000
zheyou73v0_A02	4387726	4389254	BnaA02T0079900ZY	0	+	381	1378	1528	0.9018325
zheyou73v0_A02	4389644	4389973	BnaA02T0080000ZY	0	-	117	251	329	0.7629179
zheyou73v0_A02	4390715	4391670	BnaA02T0080100ZY	0	-	379	955	955	1.0000000
zheyou73v0_A02	4392502	4395663	BnaA02T0080200ZY	0	-	333	2798	3161	0.8851629
zheyou73v0_A02	4397917	4398750	BnaA02T0080300ZY	0	-	93	353	833	0.4237695
zheyou73v0_A02	4399376	4401231	BnaA02T0080400ZY	0	-	1031	1855	1855	1.0000000
zheyou73v0_A02	4401719	4406550	BnaA02T0080500ZY	0	-	101	562	4831	0.1163320
zheyou73v0_A02	4416931	4418534	BnaA02T0080600ZY	0	+	4	175	1603	0.1091703
zheyou73v0_A02	4417047	4418534	BnaA02T0080600ZY.1	0	+	4	175	1487	0.1176866
zheyou73v0_A02	4420702	4421061	BnaA02T0080700ZY	0	-	0	0	359	0.0000000
zheyou73v0_A02	4422382	4422970	BnaA02T0080800ZY	0	-	0	0	588	0.0000000
zheyou73v0_A02	4430279	4431974	BnaA02T0080900ZY	0	-	24	737	1695	0.4348083
zheyou73v0_A02	4439169	4440518	BnaA02T0081000ZY	0	+	85	649	1349	0.4810971
zheyou73v0_A02	4446561	4446867	BnaA02T0081100ZY	0	-	5	235	306	0.7679738
zheyou73v0_A02	4448924	4454488	BnaA02T0081200ZY	0	+	77	1413	5564	0.2539540
zheyou73v0_A02	4454817	4457953	BnaA02T0081300ZY	0	-	143	1780	3136	0.5676020
zheyou73v0_A02	4469353	4471627	BnaA02T0081400ZY	0	+	0	0	2274	0.0000000
zheyou73v0_A02	4475646	4478232	BnaA02T0081500ZY	0	+	211	2037	2586	0.7877030
zheyou73v0_A02	4498003	4499002	BnaA02T0081600ZY	0	-	0	0	999	0.0000000
zheyou73v0_A02	4528558	4531662	BnaA02T0081700ZY	0	+	0	0	3104	0.0000000
zheyou73v0_A02	4531788	4532327	BnaA02T0081800ZY	0	+	0	0	539	0.0000000
zheyou73v0_A02	4550389	4551047	BnaA02T0081900ZY	0	-	9	378	658	0.5744681
zheyou73v0_A02	4554846	4555612	BnaA02T0082000ZY	0	+	47	154	766	0.2010444
zheyou73v0_A02	4555791	4556602	BnaA02T0082100ZY	0	+	239	811	811	1.0000000
zheyou73v0_A02	4557566	4559945	BnaA02T0082200ZY	0	+	120	1281	2379	0.5384616
zheyou73v0_A02	4570969	4571946	BnaA02T0082300ZY	0	+	0	0	977	0.0000000
zheyou73v0_A02	4574984	4577848	BnaA02T0082400ZY	0	+	12	572	2864	0.1997207
zheyou73v0_A02	4583156	4584518	BnaA02T0082500ZY	0	+	331	880	1362	0.6461087
zheyou73v0_A02	4586026	4586379	BnaA02T0082600ZY	0	+	345	353	353	1.0000000
zheyou73v0_A02	4587244	4587926	BnaA02T0082700ZY	0	+	846	682	682	1.0000000
zheyou73v0_A02	4601267	4603231	BnaA02T0082800ZY	0	-	1852	1964	1964	1.0000000
zheyou73v0_A02	4603455	4606739	BnaA02T0082900ZY	0	-	3859	3284	3284	1.0000000
zheyou73v0_A02	4609873	4614816	BnaA02T0083000ZY	0	+	5715	4943	4943	1.0000000
zheyou73v0_A02	4623037	4627978	BnaA02T0083100ZY	0	+	4725	4941	4941	1.0000000
zheyou73v0_A02	4623037	4627978	BnaA02T0083100ZY.1	0	+	4725	4941	4941	1.0000000
zheyou73v0_A02	4630753	4631358	BnaA02T0083200ZY	0	-	554	605	605	1.0000000
zheyou73v0_A02	4636503	4639110	BnaA02T0083300ZY	0	-	1066	2586	2607	0.9919448
zheyou73v0_A02	4639116	4643041	BnaA02T0083400ZY	0	-	388	2653	3925	0.6759236
zheyou73v0_A02	4644182	4648811	BnaA02T0083500ZY	0	-	2920	4470	4629	0.9656513
zheyou73v0_A02	4649848	4652400	BnaA02T0083600ZY	0	+	2068	2536	2552	0.9937304
zheyou73v0_A02	4652549	4653864	BnaA02T0083700ZY	0	-	906	1315	1315	1.0000000
zheyou73v0_A02	4657808	4659924	BnaA02T0083800ZY	0	+	1973	2116	2116	1.0000000
zheyou73v0_A02	4661341	4663424	BnaA02T0083900ZY	0	-	1686	2083	2083	1.0000000
zheyou73v0_A02	4661341	4663424	BnaA02T0083900ZY.1	0	-	1686	2083	2083	1.0000000
zheyou73v0_A02	4661341	4663424	BnaA02T0083900ZY.2	0	-	1686	2083	2083	1.0000000
zheyou73v0_A02	4669390	4672162	BnaA02T0084000ZY	0	+	1651	2772	2772	1.0000000
zheyou73v0_A02	4672815	4675925	BnaA02T0084100ZY	0	+	1325	2905	3110	0.9340836
zheyou73v0_A02	4680536	4683305	BnaA02T0084200ZY	0	+	253	2004	2769	0.7237270
zheyou73v0_A02	4684047	4684825	BnaA02T0084300ZY	0	+	342	726	778	0.9331620
zheyou73v0_A02	4685204	4687443	BnaA02T0084400ZY	0	-	122	1463	2239	0.6534167
zheyou73v0_A02	4688191	4689311	BnaA02T0084500ZY	0	-	279	1120	1120	1.0000000
zheyou73v0_A02	4690005	4697383	BnaA02T0084600ZY	0	-	1921	5874	7378	0.7961507
zheyou73v0_A02	4690005	4695580	BnaA02T0084600ZY.1	0	-	1010	4087	5575	0.7330942
zheyou73v0_A02	4690005	4695076	BnaA02T0084600ZY.2	0	-	897	3603	5071	0.7105107
zheyou73v0_A02	4690005	4697383	BnaA02T0084600ZY.3	0	-	1921	5874	7378	0.7961507
zheyou73v0_A02	4698440	4698914	BnaA02T0084700ZY	0	-	608	474	474	1.0000000
zheyou73v0_A02	4702083	4702554	BnaA02T0084800ZY	0	-	431	471	471	1.0000000
zheyou73v0_A02	4704401	4705128	BnaA02T0084900ZY	0	-	913	727	727	1.0000000
zheyou73v0_A02	4706170	4706335	BnaA02T0085000ZY	0	+	260	165	165	1.0000000
zheyou73v0_A02	4707085	4707887	BnaA02T0085100ZY	0	+	262	802	802	1.0000000
zheyou73v0_A02	4709823	4711208	BnaA02T0085200ZY	0	+	1244	1385	1385	1.0000000
zheyou73v0_A02	4715632	4717159	BnaA02T0085300ZY	0	+	2236	1527	1527	1.0000000
zheyou73v0_A02	4718005	4720808	BnaA02T0085400ZY	0	-	2302	2803	2803	1.0000000
zheyou73v0_A02	4725641	4728360	BnaA02T0085500ZY	0	+	1310	2409	2719	0.8859875
zheyou73v0_A02	4729175	4731607	BnaA02T0085600ZY	0	-	1197	2417	2432	0.9938322
zheyou73v0_A02	4732144	4734173	BnaA02T0085700ZY	0	-	95	1389	2029	0.6845737
zheyou73v0_A02	4738247	4739922	BnaA02T0085800ZY	0	+	29	917	1675	0.5474627
zheyou73v0_A02	4740236	4740992	BnaA02T0085900ZY	0	-	109	490	756	0.6481481
zheyou73v0_A02	4741425	4741809	BnaA02T0086000ZY	0	+	121	384	384	1.0000000
zheyou73v0_A02	4742122	4748580	BnaA02T0086100ZY	0	-	1701	6321	6458	0.9787860
zheyou73v0_A02	4750586	4755557	BnaA02T0086200ZY	0	-	1124	4636	4971	0.9326091
zheyou73v0_A02	4757531	4761136	BnaA02T0086300ZY	0	-	2838	3605	3605	1.0000000
zheyou73v0_A02	4763045	4764290	BnaA02T0086400ZY	0	+	399	1069	1245	0.8586345
zheyou73v0_A02	4764780	4765374	BnaA02T0086500ZY	0	-	103	291	594	0.4898990
zheyou73v0_A02	4768069	4769898	BnaA02T0086600ZY	0	-	784	1671	1829	0.9136140
zheyou73v0_A02	4770849	4772651	BnaA02T0086700ZY	0	-	518	1607	1802	0.8917869
zheyou73v0_A02	4777066	4778699	BnaA02T0086800ZY	0	-	1662	1633	1633	1.0000000
zheyou73v0_A02	4779769	4781495	BnaA02T0086900ZY	0	-	1673	1726	1726	1.0000000
zheyou73v0_A02	4779769	4781495	BnaA02T0086900ZY.1	0	-	1673	1726	1726	1.0000000
zheyou73v0_A02	4779769	4781495	BnaA02T0086900ZY.2	0	-	1673	1726	1726	1.0000000
zheyou73v0_A02	4782171	4785283	BnaA02T0087000ZY	0	-	2729	3112	3112	1.0000000
zheyou73v0_A02	4792490	4794856	BnaA02T0087100ZY	0	+	2244	2366	2366	1.0000000
zheyou73v0_A02	4796298	4797575	BnaA02T0087200ZY	0	+	91	890	1277	0.6969460
zheyou73v0_A02	4799283	4800417	BnaA02T0087300ZY	0	-	761	1134	1134	1.0000000
zheyou73v0_A02	4801201	4806141	BnaA02T0087400ZY	0	+	2823	4769	4940	0.9653846
zheyou73v0_A02	4806286	4807961	BnaA02T0087500ZY	0	-	1272	1675	1675	1.0000000
zheyou73v0_A02	4808976	4812430	BnaA02T0087600ZY	0	-	3261	3082	3454	0.8922988
zheyou73v0_A02	4812827	4813082	BnaA02T0087700ZY	0	-	377	255	255	1.0000000
zheyou73v0_A02	4815858	4819664	BnaA02T0087800ZY	0	+	1532	3410	3806	0.8959538
zheyou73v0_A02	4819973	4821609	BnaA02T0087900ZY	0	+	1330	1636	1636	1.0000000
zheyou73v0_A02	4822028	4822875	BnaA02T0088000ZY	0	-	936	847	847	1.0000000
zheyou73v0_A02	4823889	4826085	BnaA02T0088100ZY	0	-	476	1749	2196	0.7964481
zheyou73v0_A02	4827870	4829510	BnaA02T0088200ZY	0	+	1873	1640	1640	1.0000000
zheyou73v0_A02	4827870	4829510	BnaA02T0088200ZY.1	0	+	1873	1640	1640	1.0000000
zheyou73v0_A02	4827870	4829510	BnaA02T0088200ZY.2	0	+	1873	1640	1640	1.0000000
zheyou73v0_A02	4829733	4831355	BnaA02T0088300ZY	0	+	1486	1579	1622	0.9734895
zheyou73v0_A02	4833023	4834215	BnaA02T0088400ZY	0	+	141	974	1192	0.8171141
zheyou73v0_A02	4834371	4835298	BnaA02T0088500ZY	0	+	445	927	927	1.0000000
zheyou73v0_A02	4837872	4839170	BnaA02T0088600ZY	0	+	206	778	1298	0.5993837
zheyou73v0_A02	4837872	4839170	BnaA02T0088600ZY.1	0	+	206	778	1298	0.5993837
zheyou73v0_A02	4843820	4848835	BnaA02T0088700ZY	0	+	798	2887	5015	0.5756730
zheyou73v0_A02	4849389	4850508	BnaA02T0088800ZY	0	+	55	747	1119	0.6675603
zheyou73v0_A02	4852046	4854449	BnaA02T0088900ZY	0	+	31	663	2403	0.2759051
zheyou73v0_A02	4856342	4859704	BnaA02T0089000ZY	0	+	259	1887	3362	0.5612730
zheyou73v0_A02	4858468	4860815	BnaA02T0089100ZY	0	-	390	1426	2347	0.6075842
zheyou73v0_A02	4867179	4872865	BnaA02T0089200ZY	0	-	2491	5438	5686	0.9563841
zheyou73v0_A02	4876175	4877550	BnaA02T0089300ZY	0	-	1084	1375	1375	1.0000000
zheyou73v0_A02	4880288	4880927	BnaA02T0089400ZY	0	-	20	184	639	0.2879499
zheyou73v0_A02	4884066	4884602	BnaA02T0089500ZY	0	+	64	380	536	0.7089552
zheyou73v0_A02	4884799	4885186	BnaA02T0089600ZY	0	+	447	387	387	1.0000000
zheyou73v0_A02	4885901	4888449	BnaA02T0089700ZY	0	+	2430	2548	2548	1.0000000
zheyou73v0_A02	4888460	4889169	BnaA02T0089800ZY	0	+	220	358	709	0.5049365
zheyou73v0_A02	4891783	4892275	BnaA02T0089900ZY	0	-	316	492	492	1.0000000
zheyou73v0_A02	4892643	4897018	BnaA02T0090000ZY	0	-	4837	4375	4375	1.0000000
zheyou73v0_A02	4900969	4903526	BnaA02T0090100ZY	0	+	1743	2447	2557	0.9569808
zheyou73v0_A02	4905413	4907723	BnaA02T0090200ZY	0	+	1035	2156	2310	0.9333333
zheyou73v0_A02	4908262	4917435	BnaA02T0090300ZY	0	-	3829	8775	9173	0.9566118
zheyou73v0_A02	4918387	4919392	BnaA02T0090400ZY	0	+	968	1005	1005	1.0000000
zheyou73v0_A02	4919654	4921378	BnaA02T0090500ZY	0	-	1513	1724	1724	1.0000000
zheyou73v0_A02	4924204	4927042	BnaA02T0090600ZY	0	-	2439	2835	2838	0.9989429
zheyou73v0_A02	4928535	4933834	BnaA02T0090700ZY	0	+	3391	5270	5299	0.9945273
zheyou73v0_A02	4934620	4935643	BnaA02T0090800ZY	0	+	391	799	1023	0.7810361
zheyou73v0_A02	4936468	4937777	BnaA02T0090900ZY	0	-	510	1307	1309	0.9984721
zheyou73v0_A02	4939432	4942728	BnaA02T0091000ZY	0	+	1072	2773	3296	0.8413228
zheyou73v0_A02	4942947	4943768	BnaA02T0091100ZY	0	-	143	554	821	0.6747869
zheyou73v0_A02	4945735	4946395	BnaA02T0091200ZY	0	-	48	406	660	0.6151515
zheyou73v0_A02	4950068	4951035	BnaA02T0091300ZY	0	+	111	606	967	0.6266804
zheyou73v0_A02	4951647	4952561	BnaA02T0091400ZY	0	-	122	600	914	0.6564552
zheyou73v0_A02	4957078	4957393	BnaA02T0091500ZY	0	+	87	279	315	0.8857143
zheyou73v0_A02	4959301	4959484	BnaA02T0091600ZY	0	-	98	183	183	1.0000000
zheyou73v0_A02	4961148	4962427	BnaA02T0091700ZY	0	+	718	1278	1279	0.9992182
zheyou73v0_A02	4969092	4973212	BnaA02T0091800ZY	0	-	758	1718	4120	0.4169903
zheyou73v0_A02	4977808	4980938	BnaA02T0091900ZY	0	+	2	174	3130	0.0555911
zheyou73v0_A02	4977808	4980938	BnaA02T0091900ZY.1	0	+	2	174	3130	0.0555911
zheyou73v0_A02	4977808	4980938	BnaA02T0091900ZY.2	0	+	2	174	3130	0.0555911
zheyou73v0_A02	4977808	4980938	BnaA02T0091900ZY.3	0	+	2	174	3130	0.0555911
zheyou73v0_A02	4982164	4984506	BnaA02T0092000ZY	0	+	4	373	2342	0.1592656
zheyou73v0_A02	4995265	4995954	BnaA02T0092100ZY	0	-	2	67	689	0.0972424
zheyou73v0_A02	4996304	4997613	BnaA02T0092200ZY	0	-	8	468	1309	0.3575248
zheyou73v0_A02	4998494	5004097	BnaA02T0092300ZY	0	+	8	833	5603	0.1486704
zheyou73v0_A02	5004724	5009700	BnaA02T0092400ZY	0	-	0	0	4976	0.0000000
zheyou73v0_A02	5017367	5018380	BnaA02T0092500ZY	0	-	0	0	1013	0.0000000
zheyou73v0_A02	5022367	5023381	BnaA02T0092600ZY	0	+	0	0	1014	0.0000000
zheyou73v0_A02	5025163	5025550	BnaA02T0092700ZY	0	-	0	0	387	0.0000000
zheyou73v0_A02	5029723	5035194	BnaA02T0092800ZY	0	-	0	0	5471	0.0000000
zheyou73v0_A02	5038894	5039395	BnaA02T0092900ZY	0	+	0	0	501	0.0000000
zheyou73v0_A02	5040287	5042591	BnaA02T0093000ZY	0	-	14	678	2304	0.2942708
zheyou73v0_A02	5050202	5051824	BnaA02T0093100ZY	0	-	0	0	1622	0.0000000
zheyou73v0_A02	5052859	5053625	BnaA02T0093200ZY	0	-	0	0	766	0.0000000
zheyou73v0_A02	5055505	5057917	BnaA02T0093300ZY	0	-	20	7	2412	0.0029022
zheyou73v0_A02	5058769	5060559	BnaA02T0093400ZY	0	+	0	0	1790	0.0000000
zheyou73v0_A02	5060862	5063387	BnaA02T0093500ZY	0	-	16	193	2525	0.0764356
zheyou73v0_A02	5064098	5068823	BnaA02T0093600ZY	0	+	13	170	4725	0.0359788
zheyou73v0_A02	5069059	5069527	BnaA02T0093700ZY	0	+	20	21	468	0.0448718
zheyou73v0_A02	5069718	5073142	BnaA02T0093800ZY	0	-	3	82	3424	0.0239486
zheyou73v0_A02	5078788	5086709	BnaA02T0093900ZY	0	+	13	514	7921	0.0648908
zheyou73v0_A02	5086961	5087717	BnaA02T0094000ZY	0	+	0	0	756	0.0000000
zheyou73v0_A02	5088366	5090773	BnaA02T0094100ZY	0	+	0	0	2407	0.0000000
zheyou73v0_A02	5089355	5090773	BnaA02T0094100ZY.1	0	+	0	0	1418	0.0000000
zheyou73v0_A02	5091759	5092143	BnaA02T0094200ZY	0	-	106	384	384	1.0000000
zheyou73v0_A02	5093598	5095382	BnaA02T0094300ZY	0	+	877	1719	1784	0.9635651
zheyou73v0_A02	5104526	5110033	BnaA02T0094400ZY	0	-	897	3962	5507	0.7194480
zheyou73v0_A02	5111776	5114603	BnaA02T0094500ZY	0	+	2439	2827	2827	1.0000000
zheyou73v0_A02	5115320	5116177	BnaA02T0094600ZY	0	-	660	857	857	1.0000000
zheyou73v0_A02	5120323	5121495	BnaA02T0094700ZY	0	+	74	709	1172	0.6049488
zheyou73v0_A02	5128412	5130988	BnaA02T0094800ZY	0	+	726	2379	2576	0.9235249
zheyou73v0_A02	5132854	5136493	BnaA02T0094900ZY	0	+	1822	3367	3639	0.9252542
zheyou73v0_A02	5143342	5145028	BnaA02T0095000ZY	0	+	109	1136	1686	0.6737841
zheyou73v0_A02	5145631	5146534	BnaA02T0095100ZY	0	+	63	524	903	0.5802879
zheyou73v0_A02	5148707	5149589	BnaA02T0095200ZY	0	+	159	450	882	0.5102041
zheyou73v0_A02	5149997	5151811	BnaA02T0095300ZY	0	-	326	1536	1814	0.8467475
zheyou73v0_A02	5152571	5154366	BnaA02T0095400ZY	0	-	1575	1795	1795	1.0000000
zheyou73v0_A02	5155015	5156383	BnaA02T0095500ZY	0	+	324	492	1368	0.3596491
zheyou73v0_A02	5158831	5161160	BnaA02T0095600ZY	0	-	2	266	2329	0.1142121
zheyou73v0_A02	5162279	5167887	BnaA02T0095700ZY	0	+	1392	4778	5608	0.8519971
zheyou73v0_A02	5170215	5174447	BnaA02T0095800ZY	0	-	5332	4204	4232	0.9933838
zheyou73v0_A02	5179726	5180188	BnaA02T0095900ZY	0	+	583	462	462	1.0000000
zheyou73v0_A02	5180829	5181267	BnaA02T0096000ZY	0	-	621	438	438	1.0000000
zheyou73v0_A02	5191132	5195416	BnaA02T0096100ZY	0	-	1349	3672	4284	0.8571429
zheyou73v0_A02	5198630	5201220	BnaA02T0096200ZY	0	+	1595	2507	2590	0.9679537
zheyou73v0_A02	5202523	5206227	BnaA02T0096300ZY	0	+	1322	3547	3704	0.9576134
zheyou73v0_A02	5215780	5219386	BnaA02T0096400ZY	0	+	1369	3002	3606	0.8325014
zheyou73v0_A02	5215780	5219386	BnaA02T0096400ZY.1	0	+	1369	3002	3606	0.8325014
zheyou73v0_A02	5225397	5226820	BnaA02T0096500ZY	0	-	876	1423	1423	1.0000000
zheyou73v0_A02	5228410	5229827	BnaA02T0096600ZY	0	-	1676	1417	1417	1.0000000
zheyou73v0_A02	5230605	5233687	BnaA02T0096700ZY	0	-	2499	3025	3082	0.9815055
zheyou73v0_A02	5235783	5236437	BnaA02T0096800ZY	0	-	21	268	654	0.4097859
zheyou73v0_A02	5246011	5247452	BnaA02T0096900ZY	0	-	541	1409	1441	0.9777932
zheyou73v0_A02	5262504	5263587	BnaA02T0097000ZY	0	+	225	1052	1083	0.9713758
zheyou73v0_A02	5263620	5263985	BnaA02T0097100ZY	0	+	353	365	365	1.0000000
zheyou73v0_A02	5264813	5267510	BnaA02T0097200ZY	0	+	1494	2621	2697	0.9718205
zheyou73v0_A02	5267766	5274502	BnaA02T0097300ZY	0	-	2344	6225	6736	0.9241390
zheyou73v0_A02	5275152	5275581	BnaA02T0097400ZY	0	-	411	429	429	1.0000000
zheyou73v0_A02	5275676	5277637	BnaA02T0097500ZY	0	-	758	1776	1961	0.9056604
zheyou73v0_A02	5278725	5281411	BnaA02T0097600ZY	0	-	1718	2686	2686	1.0000000
zheyou73v0_A02	5278725	5281411	BnaA02T0097600ZY.1	0	-	1718	2686	2686	1.0000000
zheyou73v0_A02	5284324	5286321	BnaA02T0097700ZY	0	-	348	1690	1997	0.8462694
zheyou73v0_A02	5309002	5312876	BnaA02T0097800ZY	0	-	1109	3735	3874	0.9641198
zheyou73v0_A02	5316205	5317009	BnaA02T0097900ZY	0	+	886	796	804	0.9900498
zheyou73v0_A02	5318084	5320352	BnaA02T0098000ZY	0	-	355	1941	2268	0.8558201
zheyou73v0_A02	5326571	5328258	BnaA02T0098100ZY	0	-	265	1604	1687	0.9508002
zheyou73v0_A02	5329505	5330351	BnaA02T0098200ZY	0	+	375	782	846	0.9243499
zheyou73v0_A02	5333559	5334167	BnaA02T0098300ZY	0	+	271	542	608	0.8914474
zheyou73v0_A02	5334683	5335941	BnaA02T0098400ZY	0	-	511	1258	1258	1.0000000
zheyou73v0_A02	5340944	5341490	BnaA02T0098500ZY	0	-	21	240	546	0.4395604
zheyou73v0_A02	5340944	5341501	BnaA02T0098500ZY.1	0	-	21	251	557	0.4506284
zheyou73v0_A02	5347156	5348576	BnaA02T0098600ZY	0	-	539	1378	1420	0.9704225
zheyou73v0_A02	5350064	5351718	BnaA02T0098700ZY	0	-	122	1062	1654	0.6420798
zheyou73v0_A02	5352473	5354007	BnaA02T0098800ZY	0	+	1168	1534	1534	1.0000000
zheyou73v0_A02	5355283	5356635	BnaA02T0098900ZY	0	-	116	925	1352	0.6841716
zheyou73v0_A02	5367219	5369161	BnaA02T0099000ZY	0	+	276	1511	1942	0.7780638
zheyou73v0_A02	5372766	5375815	BnaA02T0099100ZY	0	-	783	2513	3049	0.8242047
zheyou73v0_A02	5372766	5375815	BnaA02T0099100ZY.1	0	-	783	2513	3049	0.8242047
zheyou73v0_A02	5372766	5375815	BnaA02T0099100ZY.2	0	-	783	2513	3049	0.8242047
zheyou73v0_A02	5394598	5396713	BnaA02T0099200ZY	0	-	194	894	2115	0.4226950
zheyou73v0_A02	5394598	5396713	BnaA02T0099200ZY.1	0	-	194	894	2115	0.4226950
zheyou73v0_A02	5398370	5399628	BnaA02T0099300ZY	0	+	1831	1258	1258	1.0000000
zheyou73v0_A02	5401766	5402867	BnaA02T0099400ZY	0	+	80	865	1101	0.7856494
zheyou73v0_A02	5403304	5406978	BnaA02T0099500ZY	0	-	2060	3647	3674	0.9926510
zheyou73v0_A02	5419116	5422571	BnaA02T0099600ZY	0	+	1820	3441	3455	0.9959479
zheyou73v0_A02	5435145	5436327	BnaA02T0099700ZY	0	-	488	791	1182	0.6692047
zheyou73v0_A02	5439141	5439370	BnaA02T0099800ZY	0	+	155	229	229	1.0000000
zheyou73v0_A02	5440964	5442390	BnaA02T0099900ZY	0	-	209	998	1426	0.6998597
zheyou73v0_A02	5450860	5451435	BnaA02T0100000ZY	0	+	70	337	575	0.5860869
zheyou73v0_A02	5451837	5454285	BnaA02T0100100ZY	0	+	1013	2448	2448	1.0000000
zheyou73v0_A02	5454489	5456671	BnaA02T0100200ZY	0	-	1323	2180	2182	0.9990834
zheyou73v0_A02	5460828	5462447	BnaA02T0100300ZY	0	+	332	1479	1619	0.9135269
zheyou73v0_A02	5469384	5472391	BnaA02T0100400ZY	0	+	1238	2801	3007	0.9314932
zheyou73v0_A02	5473560	5475317	BnaA02T0100500ZY	0	-	963	1757	1757	1.0000000
zheyou73v0_A02	5484013	5487650	BnaA02T0100600ZY	0	+	575	3335	3637	0.9169645
zheyou73v0_A02	5488080	5490078	BnaA02T0100700ZY	0	+	219	1923	1998	0.9624625
zheyou73v0_A02	5495347	5497658	BnaA02T0100800ZY	0	+	796	2242	2311	0.9701428
zheyou73v0_A02	5498310	5498676	BnaA02T0100900ZY	0	+	462	366	366	1.0000000
zheyou73v0_A02	5498738	5501409	BnaA02T0101000ZY	0	+	2112	2494	2671	0.9337327
zheyou73v0_A02	5502065	5503529	BnaA02T0101100ZY	0	-	1158	1464	1464	1.0000000
zheyou73v0_A02	5505734	5506643	BnaA02T0101200ZY	0	-	146	865	909	0.9515952
zheyou73v0_A02	5506702	5507153	BnaA02T0101300ZY	0	-	243	451	451	1.0000000
zheyou73v0_A02	5508292	5512638	BnaA02T0101400ZY	0	-	848	3719	4346	0.8557294
zheyou73v0_A02	5531384	5531819	BnaA02T0101500ZY	0	+	16	265	435	0.6091954
zheyou73v0_A02	5531838	5543879	BnaA02T0101600ZY	0	+	65	1111	12041	0.0922681
zheyou73v0_A02	5551092	5555570	BnaA02T0101700ZY	0	-	0	0	4478	0.0000000
zheyou73v0_A02	5560141	5562014	BnaA02T0101800ZY	0	+	0	0	1873	0.0000000
zheyou73v0_A02	5562115	5565034	BnaA02T0101900ZY	0	-	2	217	2919	0.0743405
zheyou73v0_A02	5565425	5567457	BnaA02T0102000ZY	0	-	123	1361	2032	0.6697835
zheyou73v0_A02	5568476	5570685	BnaA02T0102100ZY	0	-	30	1578	2209	0.7143504
zheyou73v0_A02	5602032	5602785	BnaA02T0102200ZY	0	-	212	532	753	0.7065073
zheyou73v0_A02	5603754	5604046	BnaA02T0102300ZY	0	+	363	292	292	1.0000000
zheyou73v0_A02	5604585	5605695	BnaA02T0102400ZY	0	-	290	1009	1110	0.9090090
zheyou73v0_A02	5609066	5610149	BnaA02T0102500ZY	0	-	38	432	1083	0.3988920
zheyou73v0_A02	5613354	5615149	BnaA02T0102600ZY	0	+	125	1102	1795	0.6139276
zheyou73v0_A02	5615195	5616119	BnaA02T0102700ZY	0	+	17	488	924	0.5281385
zheyou73v0_A02	5617819	5619085	BnaA02T0102800ZY	0	+	1	131	1266	0.1034755
zheyou73v0_A02	5623162	5625851	BnaA02T0102900ZY	0	+	35	376	2689	0.1398289
zheyou73v0_A02	5629368	5630787	BnaA02T0103000ZY	0	+	0	0	1419	0.0000000
zheyou73v0_A02	5632820	5633924	BnaA02T0103100ZY	0	+	132	953	1104	0.8632246
zheyou73v0_A02	5641175	5643284	BnaA02T0103200ZY	0	-	57	678	2109	0.3214794
zheyou73v0_A02	5646997	5648062	BnaA02T0103300ZY	0	-	657	842	1065	0.7906103
zheyou73v0_A02	5648376	5650555	BnaA02T0103400ZY	0	-	932	2148	2179	0.9857733
zheyou73v0_A02	5657623	5659732	BnaA02T0103500ZY	0	-	1105	2015	2109	0.9554291
zheyou73v0_A02	5660817	5662942	BnaA02T0103600ZY	0	-	936	2116	2125	0.9957647
zheyou73v0_A02	5668459	5671732	BnaA02T0103700ZY	0	+	618	3071	3273	0.9382829
zheyou73v0_A02	5671848	5672133	BnaA02T0103800ZY	0	+	36	285	285	1.0000000
zheyou73v0_A02	5677632	5681912	BnaA02T0103900ZY	0	+	406	2578	4280	0.6023365
zheyou73v0_A02	5682094	5682827	BnaA02T0104000ZY	0	-	68	733	733	1.0000000
zheyou73v0_A02	5682957	5686175	BnaA02T0104100ZY	0	-	96	1603	3218	0.4981355
zheyou73v0_A02	5715845	5716436	BnaA02T0104200ZY	0	-	220	591	591	1.0000000
zheyou73v0_A02	5723608	5725424	BnaA02T0104300ZY	0	+	179	349	1816	0.1921806
zheyou73v0_A02	5733031	5733656	BnaA02T0104400ZY	0	+	1	43	625	0.0688000
zheyou73v0_A02	5736763	5737042	BnaA02T0104500ZY	0	+	22	201	279	0.7204301
zheyou73v0_A02	5749640	5751297	BnaA02T0104600ZY	0	+	162	1109	1657	0.6692818
zheyou73v0_A02	5752922	5756310	BnaA02T0104700ZY	0	+	1871	3388	3388	1.0000000
zheyou73v0_A02	5756494	5758917	BnaA02T0104800ZY	0	-	1319	2387	2423	0.9851424
zheyou73v0_A02	5765085	5771824	BnaA02T0104900ZY	0	-	2098	5853	6739	0.8685265
zheyou73v0_A02	5765085	5771824	BnaA02T0104900ZY.1	0	-	2098	5853	6739	0.8685265
zheyou73v0_A02	5765085	5768091	BnaA02T0104900ZY.2	0	-	1656	3006	3006	1.0000000
zheyou73v0_A02	5765085	5767548	BnaA02T0104900ZY.3	0	-	1383	2463	2463	1.0000000
zheyou73v0_A02	5770239	5770880	BnaA02T0105000ZY	0	-	5	123	641	0.1918877
zheyou73v0_A02	5771932	5773385	BnaA02T0105100ZY	0	+	241	1222	1453	0.8410186
zheyou73v0_A02	5781274	5781916	BnaA02T0105200ZY	0	-	23	234	642	0.3644860
zheyou73v0_A02	5788966	5789581	BnaA02T0105300ZY	0	-	144	611	615	0.9934959
zheyou73v0_A02	5819299	5819479	BnaA02T0105400ZY	0	+	146	180	180	1.0000000
zheyou73v0_A02	5823944	5824401	BnaA02T0105500ZY	0	+	0	0	457	0.0000000
zheyou73v0_A02	5824855	5825271	BnaA02T0105600ZY	0	+	0	0	416	0.0000000
zheyou73v0_A02	5828108	5828645	BnaA02T0105700ZY	0	-	132	532	537	0.9906890
zheyou73v0_A02	5828847	5832871	BnaA02T0105800ZY	0	-	980	3503	4024	0.8705269
zheyou73v0_A02	5836210	5836892	BnaA02T0105900ZY	0	+	0	0	682	0.0000000
zheyou73v0_A02	5837010	5837769	BnaA02T0106000ZY	0	-	0	0	759	0.0000000
zheyou73v0_A02	5842844	5843245	BnaA02T0106100ZY	0	+	0	0	401	0.0000000
zheyou73v0_A02	5843547	5844396	BnaA02T0106200ZY	0	-	0	0	849	0.0000000
zheyou73v0_A02	5846252	5848201	BnaA02T0106300ZY	0	-	146	883	1949	0.4530528
zheyou73v0_A02	5852356	5854966	BnaA02T0106400ZY	0	-	398	2053	2610	0.7865900
zheyou73v0_A02	5863075	5863528	BnaA02T0106500ZY	0	+	0	0	453	0.0000000
zheyou73v0_A02	5874383	5876657	BnaA02T0106600ZY	0	+	92	1375	2274	0.6046614
zheyou73v0_A02	5878027	5879316	BnaA02T0106700ZY	0	-	2	83	1289	0.0643910
zheyou73v0_A02	5891047	5892353	BnaA02T0106800ZY	0	+	56	775	1306	0.5934150
zheyou73v0_A02	5891047	5892353	BnaA02T0106800ZY.1	0	+	56	775	1306	0.5934150
zheyou73v0_A02	5892580	5895301	BnaA02T0106900ZY	0	-	334	2361	2721	0.8676957
zheyou73v0_A02	5897986	5899644	BnaA02T0107000ZY	0	+	0	0	1658	0.0000000
zheyou73v0_A02	5900111	5901880	BnaA02T0107100ZY	0	+	64	1059	1769	0.5986433
zheyou73v0_A02	5903114	5905122	BnaA02T0107200ZY	0	+	345	1879	2008	0.9357570
zheyou73v0_A02	5907751	5909245	BnaA02T0107300ZY	0	+	121	1254	1494	0.8393574
zheyou73v0_A02	5909450	5917603	BnaA02T0107400ZY	0	-	108	2089	8153	0.2562247
zheyou73v0_A02	5917991	5918909	BnaA02T0107500ZY	0	+	273	832	918	0.9063181
zheyou73v0_A02	5919715	5921110	BnaA02T0107600ZY	0	-	43	848	1395	0.6078853
zheyou73v0_A02	5921416	5921816	BnaA02T0107700ZY	0	-	5	278	400	0.6950000
zheyou73v0_A02	5926388	5930502	BnaA02T0107800ZY	0	-	12	566	4114	0.1375790
zheyou73v0_A02	5947958	5950033	BnaA02T0107900ZY	0	+	3	271	2075	0.1306024
zheyou73v0_A02	5951140	5953888	BnaA02T0108000ZY	0	-	96	1608	2748	0.5851529
zheyou73v0_A02	5951140	5953888	BnaA02T0108000ZY.1	0	-	96	1608	2748	0.5851529
zheyou73v0_A02	5954226	5954545	BnaA02T0108100ZY	0	-	101	319	319	1.0000000
zheyou73v0_A02	5958206	5958482	BnaA02T0108200ZY	0	+	0	0	276	0.0000000
zheyou73v0_A02	5975566	5976276	BnaA02T0108300ZY	0	+	2	149	710	0.2098591
zheyou73v0_A02	5976634	5977711	BnaA02T0108400ZY	0	-	7	161	1077	0.1494893
zheyou73v0_A02	5978039	5979123	BnaA02T0108500ZY	0	+	129	682	1084	0.6291513
zheyou73v0_A02	5978039	5979123	BnaA02T0108500ZY.1	0	+	129	682	1084	0.6291513
zheyou73v0_A02	5978039	5979123	BnaA02T0108500ZY.2	0	+	129	682	1084	0.6291513
zheyou73v0_A02	5978039	5979123	BnaA02T0108500ZY.3	0	+	129	682	1084	0.6291513
zheyou73v0_A02	5979194	5979784	BnaA02T0108600ZY	0	-	70	417	590	0.7067797
zheyou73v0_A02	5983470	5984061	BnaA02T0108700ZY	0	-	0	0	591	0.0000000
zheyou73v0_A02	5994713	5997781	BnaA02T0108800ZY	0	+	29	572	3068	0.1864407
zheyou73v0_A02	5998971	5999967	BnaA02T0108900ZY	0	+	179	827	996	0.8303213
zheyou73v0_A02	6001235	6003445	BnaA02T0109000ZY	0	-	74	1563	2210	0.7072398
zheyou73v0_A02	6016328	6016621	BnaA02T0109100ZY	0	-	0	0	293	0.0000000
zheyou73v0_A02	6018754	6021667	BnaA02T0109200ZY	0	-	85	1079	2913	0.3704085
zheyou73v0_A02	6021864	6023052	BnaA02T0109300ZY	0	+	51	617	1188	0.5193602
zheyou73v0_A02	6024269	6025895	BnaA02T0109400ZY	0	+	207	1404	1626	0.8634686
zheyou73v0_A02	6031339	6032242	BnaA02T0109500ZY	0	+	0	0	903	0.0000000
zheyou73v0_A02	6033830	6036013	BnaA02T0109600ZY	0	-	112	1347	2183	0.6170408
zheyou73v0_A02	6036449	6038426	BnaA02T0109700ZY	0	+	82	785	1977	0.3970663
zheyou73v0_A02	6038808	6041558	BnaA02T0109800ZY	0	+	55	1031	2750	0.3749091
zheyou73v0_A02	6045363	6047342	BnaA02T0109900ZY	0	+	46	1252	1979	0.6326427
zheyou73v0_A02	6048843	6049302	BnaA02T0110000ZY	0	-	3	242	459	0.5272331
zheyou73v0_A02	6050067	6054117	BnaA02T0110100ZY	0	-	337	3030	4050	0.7481481
zheyou73v0_A02	6054792	6055334	BnaA02T0110200ZY	0	-	99	542	542	1.0000000
zheyou73v0_A02	6109551	6110395	BnaA02T0110300ZY	0	+	64	583	844	0.6907583
zheyou73v0_A02	6110560	6111607	BnaA02T0110400ZY	0	-	24	209	1047	0.1996180
zheyou73v0_A02	6113981	6114317	BnaA02T0110500ZY	0	-	77	336	336	1.0000000
zheyou73v0_A02	6115050	6116869	BnaA02T0110600ZY	0	-	174	1636	1819	0.8993953
zheyou73v0_A02	6118849	6125119	BnaA02T0110700ZY	0	+	153	1243	6270	0.1982456
zheyou73v0_A02	6126854	6128134	BnaA02T0110800ZY	0	+	34	789	1280	0.6164063
zheyou73v0_A02	6128989	6130402	BnaA02T0110900ZY	0	+	101	1174	1413	0.8308563
zheyou73v0_A02	6137343	6139208	BnaA02T0111000ZY	0	+	147	1323	1865	0.7093834
zheyou73v0_A02	6139990	6140635	BnaA02T0111100ZY	0	-	256	645	645	1.0000000
zheyou73v0_A02	6144238	6145973	BnaA02T0111200ZY	0	+	266	1024	1735	0.5902017
zheyou73v0_A02	6144238	6145973	BnaA02T0111200ZY.1	0	+	266	1024	1735	0.5902017
zheyou73v0_A02	6146310	6153210	BnaA02T0111300ZY	0	-	3	261	6900	0.0378261
zheyou73v0_A02	6154169	6155637	BnaA02T0111400ZY	0	+	239	957	1468	0.6519074
zheyou73v0_A02	6159505	6160268	BnaA02T0111500ZY	0	-	2	151	763	0.1979030
zheyou73v0_A02	6159505	6160279	BnaA02T0111500ZY.1	0	-	2	151	774	0.1950904
zheyou73v0_A02	6166114	6168235	BnaA02T0111600ZY	0	-	152	1403	2121	0.6614804
zheyou73v0_A02	6169762	6171412	BnaA02T0111700ZY	0	-	68	766	1650	0.4642424
zheyou73v0_A02	6171856	6172645	BnaA02T0111800ZY	0	-	55	361	789	0.4575412
zheyou73v0_A02	6175856	6178009	BnaA02T0111900ZY	0	+	61	844	2153	0.3920111
zheyou73v0_A02	6185093	6188155	BnaA02T0112000ZY	0	-	327	2271	3062	0.7416721
zheyou73v0_A02	6185093	6188155	BnaA02T0112000ZY.1	0	-	327	2271	3062	0.7416721
zheyou73v0_A02	6200153	6201028	BnaA02T0112100ZY	0	-	0	0	875	0.0000000
zheyou73v0_A02	6219250	6221167	BnaA02T0112200ZY	0	-	3	94	1917	0.0490349
zheyou73v0_A02	6223660	6229700	BnaA02T0112300ZY	0	+	133	887	6040	0.1468543
zheyou73v0_A02	6235051	6235759	BnaA02T0112400ZY	0	-	0	0	708	0.0000000
zheyou73v0_A02	6237176	6240015	BnaA02T0112500ZY	0	+	0	0	2839	0.0000000
zheyou73v0_A02	6247105	6247969	BnaA02T0112600ZY	0	-	6	488	864	0.5648148
zheyou73v0_A02	6253650	6279070	BnaA02T0112700ZY	0	-	62	1023	25420	0.0402439
zheyou73v0_A02	6283815	6285688	BnaA02T0112800ZY	0	+	56	325	1873	0.1735184
zheyou73v0_A02	6286076	6288708	BnaA02T0112900ZY	0	-	0	0	2632	0.0000000
zheyou73v0_A02	6289103	6289918	BnaA02T0113000ZY	0	-	40	495	815	0.6073620
zheyou73v0_A02	6289947	6291138	BnaA02T0113100ZY	0	-	7	123	1191	0.1032746
zheyou73v0_A02	6292512	6292835	BnaA02T0113200ZY	0	-	0	0	323	0.0000000
zheyou73v0_A02	6293929	6294959	BnaA02T0113300ZY	0	-	16	359	1030	0.3485437
zheyou73v0_A02	6295559	6297271	BnaA02T0113400ZY	0	-	0	0	1712	0.0000000
zheyou73v0_A02	6298844	6301053	BnaA02T0113500ZY	0	-	108	1292	2209	0.5848801
zheyou73v0_A02	6307645	6310275	BnaA02T0113600ZY	0	-	0	0	2630	0.0000000
zheyou73v0_A02	6315271	6317143	BnaA02T0113700ZY	0	-	0	0	1872	0.0000000
zheyou73v0_A02	6323752	6325018	BnaA02T0113800ZY	0	+	40	520	1266	0.4107425
zheyou73v0_A02	6326641	6329346	BnaA02T0113900ZY	0	+	6	286	2705	0.1057301
zheyou73v0_A02	6332860	6334279	BnaA02T0114000ZY	0	+	0	0	1419	0.0000000
zheyou73v0_A02	6336516	6337209	BnaA02T0114100ZY	0	+	85	672	693	0.9696970
zheyou73v0_A02	6350803	6354450	BnaA02T0114200ZY	0	+	159	1767	3647	0.4845078
zheyou73v0_A02	6359947	6364228	BnaA02T0114300ZY	0	+	178	2290	4281	0.5349218
zheyou73v0_A02	6364407	6368488	BnaA02T0114400ZY	0	-	275	2219	4081	0.5437393
zheyou73v0_A02	6374161	6376742	BnaA02T0114500ZY	0	-	141	1855	2581	0.7187137
zheyou73v0_A02	6380441	6382597	BnaA02T0114600ZY	0	-	0	0	2156	0.0000000
zheyou73v0_A02	6386275	6386676	BnaA02T0114700ZY	0	+	0	0	401	0.0000000
zheyou73v0_A02	6386978	6388586	BnaA02T0114800ZY	0	-	87	671	1608	0.4172886
zheyou73v0_A02	6390350	6392339	BnaA02T0114900ZY	0	-	665	1883	1989	0.9467069
zheyou73v0_A02	6392986	6395516	BnaA02T0115000ZY	0	-	755	2399	2530	0.9482213
zheyou73v0_A02	6403617	6404070	BnaA02T0115100ZY	0	+	0	0	453	0.0000000
zheyou73v0_A02	6411110	6415051	BnaA02T0115200ZY	0	+	1170	3501	3941	0.8883532
zheyou73v0_A02	6416382	6417324	BnaA02T0115300ZY	0	-	48	209	942	0.2218684
zheyou73v0_A02	6430537	6432020	BnaA02T0115400ZY	0	+	594	1483	1483	1.0000000
zheyou73v0_A02	6432322	6434569	BnaA02T0115500ZY	0	-	595	2247	2247	1.0000000
zheyou73v0_A02	6437558	6439216	BnaA02T0115600ZY	0	+	4	148	1658	0.0892642
zheyou73v0_A02	6439683	6441449	BnaA02T0115700ZY	0	+	109	1430	1766	0.8097395
zheyou73v0_A02	6442644	6444626	BnaA02T0115800ZY	0	+	1028	1982	1982	1.0000000
zheyou73v0_A02	6446792	6457015	BnaA02T0115900ZY	0	-	830	6295	10223	0.6157684
zheyou73v0_A02	6447172	6448648	BnaA02T0116000ZY	0	+	164	1069	1476	0.7242547
zheyou73v0_A02	6457438	6458351	BnaA02T0116100ZY	0	+	386	913	913	1.0000000
zheyou73v0_A02	6461121	6462523	BnaA02T0116200ZY	0	-	212	1318	1402	0.9400856
zheyou73v0_A02	6462829	6463228	BnaA02T0116300ZY	0	-	26	399	399	1.0000000
zheyou73v0_A02	6467796	6471910	BnaA02T0116400ZY	0	-	347	1710	4114	0.4156539
zheyou73v0_A02	6493155	6495218	BnaA02T0116500ZY	0	+	192	1135	2063	0.5501696
zheyou73v0_A02	6496323	6499085	BnaA02T0116600ZY	0	-	526	2401	2762	0.8692976
zheyou73v0_A02	6499465	6500525	BnaA02T0116700ZY	0	-	774	1060	1060	1.0000000
zheyou73v0_A02	6503294	6505199	BnaA02T0116800ZY	0	-	56	459	1905	0.2409449
zheyou73v0_A02	6520347	6521060	BnaA02T0116900ZY	0	+	259	712	713	0.9985975
zheyou73v0_A02	6521446	6522523	BnaA02T0117000ZY	0	-	93	785	1077	0.7288765
zheyou73v0_A02	6522851	6523966	BnaA02T0117100ZY	0	+	488	1115	1115	1.0000000
zheyou73v0_A02	6522851	6523966	BnaA02T0117100ZY.1	0	+	488	1115	1115	1.0000000
zheyou73v0_A02	6522851	6523966	BnaA02T0117100ZY.2	0	+	488	1115	1115	1.0000000
zheyou73v0_A02	6522851	6523966	BnaA02T0117100ZY.3	0	+	488	1115	1115	1.0000000
zheyou73v0_A02	6523990	6524586	BnaA02T0117200ZY	0	-	173	575	596	0.9647651
zheyou73v0_A02	6528614	6530469	BnaA02T0117300ZY	0	-	533	1855	1855	1.0000000
zheyou73v0_A02	6540475	6543542	BnaA02T0117400ZY	0	+	105	1612	3067	0.5255951
zheyou73v0_A02	6544715	6545712	BnaA02T0117500ZY	0	+	620	997	997	1.0000000
zheyou73v0_A02	6547007	6549217	BnaA02T0117600ZY	0	-	605	2092	2210	0.9466063
zheyou73v0_A02	6561150	6561924	BnaA02T0117700ZY	0	-	584	774	774	1.0000000
zheyou73v0_A02	6565021	6566418	BnaA02T0117800ZY	0	+	110	879	1397	0.6292055
zheyou73v0_A02	6567528	6569454	BnaA02T0117900ZY	0	+	979	1926	1926	1.0000000
zheyou73v0_A02	6569511	6569914	BnaA02T0118000ZY	0	+	537	403	403	1.0000000
zheyou73v0_A02	6573670	6574576	BnaA02T0118100ZY	0	+	141	810	906	0.8940398
zheyou73v0_A02	6575319	6582232	BnaA02T0118200ZY	0	-	1153	6137	6913	0.8877477
zheyou73v0_A02	6582685	6585443	BnaA02T0118300ZY	0	+	918	2509	2758	0.9097172
zheyou73v0_A02	6591413	6591614	BnaA02T0118400ZY	0	-	0	0	201	0.0000000
zheyou73v0_A02	6593478	6595500	BnaA02T0118500ZY	0	+	256	1563	2022	0.7729970
zheyou73v0_A02	6596229	6596903	BnaA02T0118600ZY	0	-	36	333	674	0.4940653
zheyou73v0_A02	6598653	6601430	BnaA02T0118700ZY	0	-	4	372	2777	0.1339575
zheyou73v0_A02	6618733	6621930	BnaA02T0118800ZY	0	-	105	1127	3197	0.3525180
zheyou73v0_A02	6623646	6624836	BnaA02T0118900ZY	0	-	0	0	1190	0.0000000
zheyou73v0_A02	6637520	6638586	BnaA02T0119000ZY	0	+	0	0	1066	0.0000000
zheyou73v0_A02	6642973	6644221	BnaA02T0119100ZY	0	-	0	0	1248	0.0000000
zheyou73v0_A02	6645572	6645747	BnaA02T0119200ZY	0	-	41	175	175	1.0000000
zheyou73v0_A02	6680958	6681412	BnaA02T0119300ZY	0	-	0	0	454	0.0000000
zheyou73v0_A02	6693577	6694424	BnaA02T0119400ZY	0	+	388	846	847	0.9988194
zheyou73v0_A02	6694589	6695636	BnaA02T0119500ZY	0	-	132	552	1047	0.5272206
zheyou73v0_A02	6700259	6702056	BnaA02T0119600ZY	0	-	1055	1797	1797	1.0000000
zheyou73v0_A02	6702961	6705022	BnaA02T0119700ZY	0	+	320	1716	2061	0.8326055
zheyou73v0_A02	6712055	6713326	BnaA02T0119800ZY	0	+	157	977	1271	0.7686861
zheyou73v0_A02	6714180	6715583	BnaA02T0119900ZY	0	+	40	587	1403	0.4183892
zheyou73v0_A02	6720308	6726810	BnaA02T0120000ZY	0	+	321	1241	6502	0.1908644
zheyou73v0_A02	6727594	6728244	BnaA02T0120100ZY	0	-	119	569	650	0.8753846
zheyou73v0_A02	6728723	6733637	BnaA02T0120200ZY	0	-	507	2704	4914	0.5502645
zheyou73v0_A02	6735673	6737557	BnaA02T0120300ZY	0	-	0	0	1884	0.0000000
zheyou73v0_A02	6738703	6740442	BnaA02T0120400ZY	0	+	316	1461	1739	0.8401380
zheyou73v0_A02	6738703	6740442	BnaA02T0120400ZY.1	0	+	316	1461	1739	0.8401380
zheyou73v0_A02	6741327	6742432	BnaA02T0120500ZY	0	-	37	589	1105	0.5330317
zheyou73v0_A02	6743260	6744749	BnaA02T0120600ZY	0	+	334	1078	1489	0.7239758
zheyou73v0_A02	6751137	6755134	BnaA02T0120700ZY	0	-	1379	3472	3997	0.8686515
zheyou73v0_A02	6767387	6768931	BnaA02T0120800ZY	0	-	378	1163	1544	0.7532383
zheyou73v0_A02	6777792	6779265	BnaA02T0120900ZY	0	+	131	746	1473	0.5064494
zheyou73v0_A02	6793477	6795006	BnaA02T0121000ZY.1	0	+	433	1410	1529	0.9221714
zheyou73v0_A02	6793564	6795006	BnaA02T0121000ZY	0	+	392	1323	1442	0.9174757
zheyou73v0_A02	6800420	6801222	BnaA02T0121100ZY	0	+	49	652	802	0.8129676
zheyou73v0_A02	6806119	6806920	BnaA02T0121200ZY	0	+	274	789	801	0.9850187
zheyou73v0_A02	6808670	6809471	BnaA02T0121300ZY	0	+	161	801	801	1.0000000
zheyou73v0_A02	6812154	6813087	BnaA02T0121400ZY	0	-	66	479	933	0.5133976
zheyou73v0_A02	6815438	6817403	BnaA02T0121500ZY	0	+	66	904	1965	0.4600509
zheyou73v0_A02	6819992	6823142	BnaA02T0121600ZY	0	-	601	2802	3150	0.8895238
zheyou73v0_A02	6824884	6827327	BnaA02T0121700ZY	0	+	378	1594	2443	0.6524765
zheyou73v0_A02	6829862	6830558	BnaA02T0121800ZY	0	-	427	696	696	1.0000000
zheyou73v0_A02	6831703	6842940	BnaA02T0121900ZY	0	-	4791	9805	11237	0.8725638
zheyou73v0_A02	6848272	6850316	BnaA02T0122000ZY	0	+	908	1836	2044	0.8982387
zheyou73v0_A02	6851663	6853518	BnaA02T0122100ZY	0	+	1010	1855	1855	1.0000000
zheyou73v0_A02	6862155	6864243	BnaA02T0122200ZY	0	-	538	1288	2088	0.6168582
zheyou73v0_A02	6865885	6866770	BnaA02T0122300ZY	0	-	665	885	885	1.0000000
zheyou73v0_A02	6874630	6877216	BnaA02T0122400ZY	0	+	1201	2586	2586	1.0000000
zheyou73v0_A02	6880391	6883153	BnaA02T0122500ZY	0	+	654	2444	2762	0.8848661
zheyou73v0_A02	6883268	6884450	BnaA02T0122600ZY	0	-	551	1182	1182	1.0000000
zheyou73v0_A02	6885176	6887510	BnaA02T0122700ZY	0	+	1355	2210	2334	0.9468723
zheyou73v0_A02	6885176	6887510	BnaA02T0122700ZY.1	0	+	1355	2210	2334	0.9468723
zheyou73v0_A02	6885488	6887510	BnaA02T0122700ZY.2	0	+	1157	1898	2022	0.9386746
zheyou73v0_A02	6889366	6891312	BnaA02T0122800ZY	0	+	378	1832	1946	0.9414183
zheyou73v0_A02	6891590	6892686	BnaA02T0122900ZY	0	-	390	1088	1096	0.9927008
zheyou73v0_A02	6896768	6899790	BnaA02T0123000ZY	0	+	432	2573	3022	0.8514229
zheyou73v0_A02	6900859	6902406	BnaA02T0123100ZY	0	-	170	1008	1547	0.6515837
zheyou73v0_A02	6904333	6929629	BnaA02T0123200ZY	0	-	5064	21263	25296	0.8405677
zheyou73v0_A02	6933748	6934954	BnaA02T0123300ZY	0	+	130	695	1206	0.5762852
zheyou73v0_A02	6936956	6941087	BnaA02T0123400ZY	0	+	846	3134	4131	0.7586541
zheyou73v0_A02	6941106	6942936	BnaA02T0123500ZY	0	-	529	1620	1830	0.8852459
zheyou73v0_A02	6944268	6947288	BnaA02T0123600ZY	0	+	1558	2971	3020	0.9837748
zheyou73v0_A02	6950127	6950776	BnaA02T0123700ZY	0	-	649	649	649	1.0000000
zheyou73v0_A02	6955137	6958282	BnaA02T0123800ZY	0	+	666	2614	3145	0.8311605
zheyou73v0_A02	6958408	6959242	BnaA02T0123900ZY	0	-	944	834	834	1.0000000
zheyou73v0_A02	6960670	6963850	BnaA02T0124000ZY	0	+	823	2744	3180	0.8628931
zheyou73v0_A02	6965456	6966678	BnaA02T0124100ZY	0	+	199	983	1222	0.8044190
zheyou73v0_A02	6967180	6970394	BnaA02T0124200ZY	0	+	912	2636	3214	0.8201618
zheyou73v0_A02	6976640	6979364	BnaA02T0124300ZY	0	-	1367	2430	2724	0.8920705
zheyou73v0_A02	6981359	6981623	BnaA02T0124400ZY	0	+	340	264	264	1.0000000
zheyou73v0_A02	6984003	6984528	BnaA02T0124500ZY	0	-	36	410	525	0.7809524
zheyou73v0_A02	6998871	6999787	BnaA02T0124600ZY	0	+	32	141	916	0.1539301
zheyou73v0_A02	7001689	7003664	BnaA02T0124700ZY	0	+	1925	1948	1975	0.9863291
zheyou73v0_A02	7006138	7009620	BnaA02T0124800ZY	0	+	282	1320	3482	0.3790925
zheyou73v0_A02	7010519	7011767	BnaA02T0124900ZY	0	+	332	1248	1248	1.0000000
zheyou73v0_A02	7011822	7012296	BnaA02T0125000ZY	0	+	52	396	474	0.8354430
zheyou73v0_A02	7012883	7014419	BnaA02T0125100ZY	0	-	554	1478	1536	0.9622396
zheyou73v0_A02	7020714	7022432	BnaA02T0125200ZY	0	+	759	1661	1718	0.9668219
zheyou73v0_A02	7023839	7025762	BnaA02T0125300ZY	0	+	1259	1923	1923	1.0000000
zheyou73v0_A02	7026487	7026784	BnaA02T0125400ZY	0	+	247	297	297	1.0000000
zheyou73v0_A02	7027293	7027446	BnaA02T0125500ZY	0	+	130	153	153	1.0000000
zheyou73v0_A02	7027481	7031367	BnaA02T0125600ZY	0	-	1265	3051	3886	0.7851261
zheyou73v0_A02	7027481	7031367	BnaA02T0125600ZY.1	0	-	1265	3051	3886	0.7851261
zheyou73v0_A02	7031376	7031703	BnaA02T0125700ZY	0	-	468	327	327	1.0000000
zheyou73v0_A02	7031908	7032103	BnaA02T0125800ZY	0	-	276	195	195	1.0000000
zheyou73v0_A02	7032503	7034228	BnaA02T0125900ZY	0	+	1164	1725	1725	1.0000000
zheyou73v0_A02	7035065	7036799	BnaA02T0126000ZY	0	-	441	1397	1734	0.8056517
zheyou73v0_A02	7038602	7040071	BnaA02T0126100ZY	0	+	250	1141	1469	0.7767189
zheyou73v0_A02	7039822	7042815	BnaA02T0126200ZY	0	-	426	2351	2993	0.7854995
zheyou73v0_A02	7043478	7045702	BnaA02T0126300ZY	0	-	444	2006	2224	0.9019784
zheyou73v0_A02	7048095	7050311	BnaA02T0126400ZY	0	-	1212	2216	2216	1.0000000
zheyou73v0_A02	7052175	7053927	BnaA02T0126500ZY	0	+	567	1563	1752	0.8921233
zheyou73v0_A02	7052175	7053927	BnaA02T0126500ZY.1	0	+	567	1563	1752	0.8921233
zheyou73v0_A02	7054390	7056396	BnaA02T0126600ZY	0	-	1608	2006	2006	1.0000000
zheyou73v0_A02	7060378	7061589	BnaA02T0126700ZY	0	-	13	376	1211	0.3104872
zheyou73v0_A02	7061597	7063148	BnaA02T0126800ZY	0	-	384	1248	1551	0.8046421
zheyou73v0_A02	7064875	7066065	BnaA02T0126900ZY	0	-	20	550	1190	0.4621849
zheyou73v0_A02	7070569	7076622	BnaA02T0127000ZY	0	-	418	3552	6053	0.5868164
zheyou73v0_A02	7077967	7082782	BnaA02T0127100ZY	0	-	922	1562	4815	0.3244029
zheyou73v0_A02	7088217	7093791	BnaA02T0127200ZY	0	-	2391	5452	5574	0.9781126
zheyou73v0_A02	7088217	7093067	BnaA02T0127200ZY.1	0	-	1878	4728	4850	0.9748453
zheyou73v0_A02	7088217	7092967	BnaA02T0127200ZY.2	0	-	1861	4628	4750	0.9743158
zheyou73v0_A02	7095790	7098963	BnaA02T0127300ZY	0	+	1521	3101	3173	0.9773085
zheyou73v0_A02	7100536	7100861	BnaA02T0127400ZY	0	+	155	325	325	1.0000000
zheyou73v0_A02	7100883	7103090	BnaA02T0127500ZY	0	+	219	1037	2207	0.4698686
zheyou73v0_A02	7106842	7108900	BnaA02T0127600ZY	0	+	224	980	2058	0.4761905
zheyou73v0_A02	7106842	7112690	BnaA02T0127600ZY.1	0	+	732	3239	5848	0.5538646
zheyou73v0_A02	7112633	7114579	BnaA02T0127700ZY	0	-	1486	1946	1946	1.0000000
zheyou73v0_A02	7115644	7118661	BnaA02T0127800ZY	0	+	217	2042	3017	0.6768313
zheyou73v0_A02	7119748	7135544	BnaA02T0127900ZY	0	+	1376	7717	15796	0.4885414
zheyou73v0_A02	7136032	7138472	BnaA02T0128000ZY	0	-	1958	2440	2440	1.0000000
zheyou73v0_A02	7143331	7146792	BnaA02T0128100ZY	0	+	1972	3253	3461	0.9399018
zheyou73v0_A02	7147214	7150464	BnaA02T0128200ZY	0	+	1943	3008	3250	0.9255385
zheyou73v0_A02	7150437	7154288	BnaA02T0128300ZY	0	-	1605	3809	3851	0.9890937
zheyou73v0_A02	7155944	7157980	BnaA02T0128400ZY	0	-	502	1677	2036	0.8236738
zheyou73v0_A02	7164246	7166470	BnaA02T0128500ZY	0	+	1485	2217	2224	0.9968525
zheyou73v0_A02	7166293	7166551	BnaA02T0128600ZY	0	-	383	258	258	1.0000000
zheyou73v0_A02	7166946	7169228	BnaA02T0128700ZY	0	-	1302	2282	2282	1.0000000
zheyou73v0_A02	7169939	7173980	BnaA02T0128800ZY	0	-	1051	3497	4041	0.8653799
zheyou73v0_A02	7174450	7175203	BnaA02T0128900ZY	0	-	399	591	753	0.7848606
zheyou73v0_A02	7175711	7176961	BnaA02T0129000ZY	0	+	1046	1250	1250	1.0000000
zheyou73v0_A02	7177214	7178245	BnaA02T0129100ZY	0	-	816	1031	1031	1.0000000
zheyou73v0_A02	7183422	7184901	BnaA02T0129200ZY	0	+	501	1196	1479	0.8086545
zheyou73v0_A02	7189141	7192535	BnaA02T0129300ZY	0	-	1184	3162	3394	0.9316441
zheyou73v0_A02	7213388	7216258	BnaA02T0129400ZY	0	+	693	2501	2870	0.8714285
zheyou73v0_A02	7213388	7216258	BnaA02T0129400ZY.1	0	+	693	2501	2870	0.8714285
zheyou73v0_A02	7213388	7216258	BnaA02T0129400ZY.2	0	+	693	2501	2870	0.8714285
zheyou73v0_A02	7213388	7216258	BnaA02T0129400ZY.3	0	+	693	2501	2870	0.8714285
zheyou73v0_A02	7225368	7227127	BnaA02T0129500ZY	0	+	833	1759	1759	1.0000000
zheyou73v0_A02	7229194	7229816	BnaA02T0129600ZY	0	+	493	622	622	1.0000000
zheyou73v0_A02	7231016	7233040	BnaA02T0129700ZY	0	-	728	1956	2024	0.9664032
zheyou73v0_A02	7233042	7233317	BnaA02T0129800ZY	0	+	193	275	275	1.0000000
zheyou73v0_A02	7233402	7234050	BnaA02T0129900ZY	0	-	109	634	648	0.9783950
zheyou73v0_A02	7256448	7257421	BnaA02T0130000ZY	0	+	75	399	973	0.4100719
zheyou73v0_A02	7284192	7284766	BnaA02T0130100ZY	0	+	8	272	574	0.4738676
zheyou73v0_A02	7285932	7286390	BnaA02T0130200ZY	0	+	62	458	458	1.0000000
zheyou73v0_A02	7301046	7302721	BnaA02T0130300ZY	0	-	74	1015	1675	0.6059701
zheyou73v0_A02	7305237	7307962	BnaA02T0130400ZY	0	-	887	2485	2725	0.9119266
zheyou73v0_A02	7307970	7309190	BnaA02T0130500ZY	0	-	469	1202	1220	0.9852459
zheyou73v0_A02	7310274	7311483	BnaA02T0130600ZY	0	-	0	0	1209	0.0000000
zheyou73v0_A02	7312721	7314519	BnaA02T0130700ZY	0	-	0	0	1798	0.0000000
zheyou73v0_A02	7330057	7332324	BnaA02T0130800ZY	0	+	192	1619	2267	0.7141597
zheyou73v0_A02	7335026	7338218	BnaA02T0130900ZY	0	+	369	2094	3192	0.6560150
zheyou73v0_A02	7335026	7338218	BnaA02T0130900ZY.1	0	+	369	2094	3192	0.6560150
zheyou73v0_A02	7340977	7341799	BnaA02T0131000ZY	0	-	135	602	822	0.7323601
zheyou73v0_A02	7344070	7344790	BnaA02T0131100ZY	0	+	182	720	720	1.0000000
zheyou73v0_A02	7344805	7345459	BnaA02T0131200ZY	0	+	130	653	654	0.9984710
zheyou73v0_A02	7368531	7369539	BnaA02T0131300ZY	0	-	13	565	1008	0.5605159
zheyou73v0_A02	7383809	7384483	BnaA02T0131400ZY	0	+	39	226	674	0.3353116
zheyou73v0_A02	7401819	7402778	BnaA02T0131500ZY	0	-	10	336	959	0.3503650
zheyou73v0_A02	7405087	7406141	BnaA02T0131600ZY	0	+	90	800	1054	0.7590133
zheyou73v0_A02	7415444	7416312	BnaA02T0131700ZY	0	+	85	331	868	0.3813364
zheyou73v0_A02	7422911	7426092	BnaA02T0131800ZY	0	+	173	2038	3181	0.6406791
zheyou73v0_A02	7433479	7436103	BnaA02T0131900ZY	0	+	9	477	2624	0.1817835
zheyou73v0_A02	7435869	7437603	BnaA02T0132000ZY	0	-	0	0	1734	0.0000000
zheyou73v0_A02	7440889	7445750	BnaA02T0132100ZY	0	+	44	902	4861	0.1855585
zheyou73v0_A02	7446435	7447838	BnaA02T0132200ZY	0	+	3	201	1403	0.1432644
zheyou73v0_A02	7447963	7449407	BnaA02T0132300ZY	0	-	0	0	1444	0.0000000
zheyou73v0_A02	7466373	7468496	BnaA02T0132400ZY	0	-	1686	2123	2123	1.0000000
zheyou73v0_A02	7466373	7468496	BnaA02T0132400ZY.1	0	-	1686	2123	2123	1.0000000
zheyou73v0_A02	7471738	7474004	BnaA02T0132500ZY	0	-	884	1871	2266	0.8256840
zheyou73v0_A02	7474438	7475365	BnaA02T0132600ZY	0	+	702	927	927	1.0000000
zheyou73v0_A02	7475403	7476805	BnaA02T0132700ZY	0	+	1089	1402	1402	1.0000000
zheyou73v0_A02	7477368	7478142	BnaA02T0132800ZY	0	+	557	723	774	0.9341086
zheyou73v0_A02	7478342	7481302	BnaA02T0132900ZY	0	-	2531	2960	2960	1.0000000
zheyou73v0_A02	7483481	7484516	BnaA02T0133000ZY	0	-	871	1035	1035	1.0000000
zheyou73v0_A02	7488267	7490050	BnaA02T0133100ZY	0	-	177	861	1783	0.4828940
zheyou73v0_A02	7511967	7514758	BnaA02T0133200ZY	0	-	67	790	2791	0.2830527
zheyou73v0_A02	7516287	7519265	BnaA02T0133300ZY	0	-	1251	2779	2978	0.9331766
zheyou73v0_A02	7516287	7519265	BnaA02T0133300ZY.1	0	-	1251	2779	2978	0.9331766
zheyou73v0_A02	7516287	7519265	BnaA02T0133300ZY.2	0	-	1251	2779	2978	0.9331766
zheyou73v0_A02	7525690	7527050	BnaA02T0133400ZY	0	+	568	910	1360	0.6691176
zheyou73v0_A02	7527587	7535761	BnaA02T0133500ZY	0	-	81	1071	8174	0.1310252
zheyou73v0_A02	7536603	7543643	BnaA02T0133600ZY	0	-	768	4250	7040	0.6036932
zheyou73v0_A02	7591186	7591374	BnaA02T0133700ZY	0	+	65	188	188	1.0000000
zheyou73v0_A02	7609079	7609656	BnaA02T0133800ZY	0	+	99	373	577	0.6464471
zheyou73v0_A02	7617178	7618855	BnaA02T0133900ZY	0	-	167	1080	1677	0.6440071
zheyou73v0_A02	7620565	7623298	BnaA02T0134000ZY	0	-	452	2159	2733	0.7899744
zheyou73v0_A02	7623322	7624526	BnaA02T0134100ZY	0	-	185	896	1204	0.7441860
zheyou73v0_A02	7625610	7626819	BnaA02T0134200ZY	0	-	0	0	1209	0.0000000
zheyou73v0_A02	7628057	7629855	BnaA02T0134300ZY	0	-	0	0	1798	0.0000000
zheyou73v0_A02	7639782	7642085	BnaA02T0134400ZY	0	+	103	1735	2303	0.7533652
zheyou73v0_A02	7644524	7647227	BnaA02T0134500ZY	0	+	255	1952	2703	0.7221606
zheyou73v0_A02	7648963	7650395	BnaA02T0134600ZY	0	+	2792	1432	1432	1.0000000
zheyou73v0_A02	7655229	7655787	BnaA02T0134700ZY	0	-	370	558	558	1.0000000
zheyou73v0_A02	7655791	7656510	BnaA02T0134800ZY	0	-	65	528	719	0.7343532
zheyou73v0_A02	7658327	7659512	BnaA02T0134900ZY	0	+	77	846	1185	0.7139241
zheyou73v0_A02	7668907	7672461	BnaA02T0135000ZY	0	+	261	2548	3554	0.7169387
zheyou73v0_A02	7672520	7673295	BnaA02T0135100ZY	0	+	7	77	775	0.0993548
zheyou73v0_A02	7676589	7676877	BnaA02T0135200ZY	0	+	32	191	288	0.6631944
zheyou73v0_A02	7683700	7689461	BnaA02T0135300ZY	0	-	2577	5126	5761	0.8897761
zheyou73v0_A02	7691515	7692152	BnaA02T0135400ZY	0	-	43	333	637	0.5227630
zheyou73v0_A02	7710510	7711184	BnaA02T0135500ZY	0	+	98	263	674	0.3902077
zheyou73v0_A02	7716788	7717739	BnaA02T0135600ZY	0	-	189	951	951	1.0000000
zheyou73v0_A02	7726686	7727277	BnaA02T0135700ZY	0	+	1100	591	591	1.0000000
zheyou73v0_A02	7735093	7736144	BnaA02T0135800ZY	0	+	213	842	1051	0.8011418
zheyou73v0_A02	7751394	7754311	BnaA02T0135900ZY	0	+	844	2917	2917	1.0000000
zheyou73v0_A02	7762019	7764571	BnaA02T0136000ZY	0	+	4	183	2552	0.0717085
zheyou73v0_A02	7764337	7766070	BnaA02T0136100ZY	0	-	2	275	1733	0.1586844
zheyou73v0_A02	7769355	7774216	BnaA02T0136200ZY	0	+	99	1506	4861	0.3098128
zheyou73v0_A02	7774916	7776008	BnaA02T0136300ZY	0	+	0	0	1092	0.0000000
zheyou73v0_A02	7776494	7779039	BnaA02T0136400ZY	0	-	47	407	2545	0.1599214
zheyou73v0_A02	7790319	7794026	BnaA02T0136500ZY	0	-	209	1988	3707	0.5362827
zheyou73v0_A02	7796574	7798347	BnaA02T0136600ZY	0	-	73	750	1773	0.4230118
zheyou73v0_A02	7807559	7809982	BnaA02T0136700ZY	0	-	184	1440	2423	0.5943046
zheyou73v0_A02	7810826	7817849	BnaA02T0136800ZY	0	-	774	4738	7023	0.6746405
zheyou73v0_A02	7823387	7826366	BnaA02T0136900ZY	0	+	0	0	2979	0.0000000
zheyou73v0_A02	7849864	7852842	BnaA02T0137000ZY	0	-	6	411	2978	0.1380121
zheyou73v0_A02	7856361	7859340	BnaA02T0137100ZY	0	-	6	274	2979	0.0919772
zheyou73v0_A02	7887321	7889822	BnaA02T0137200ZY	0	+	1507	2501	2501	1.0000000
zheyou73v0_A02	7912323	7919720	BnaA02T0137300ZY	0	+	2679	6660	7397	0.9003650
zheyou73v0_A02	7921599	7925047	BnaA02T0137400ZY	0	-	668	2512	3448	0.7285383
zheyou73v0_A02	7928135	7928861	BnaA02T0137500ZY	0	-	395	726	726	1.0000000
zheyou73v0_A02	7928979	7929732	BnaA02T0137600ZY	0	-	195	668	753	0.8871182
zheyou73v0_A02	7935389	7938637	BnaA02T0137700ZY	0	-	1656	3179	3248	0.9787561
zheyou73v0_A02	7939730	7941132	BnaA02T0137800ZY	0	-	292	1176	1402	0.8388017
zheyou73v0_A02	7942306	7942779	BnaA02T0137900ZY	0	+	391	473	473	1.0000000
zheyou73v0_A02	7969751	7970739	BnaA02T0138000ZY	0	+	426	988	988	1.0000000
zheyou73v0_A02	7977300	7978410	BnaA02T0138100ZY	0	+	27	569	1110	0.5126126
zheyou73v0_A02	7997732	8000827	BnaA02T0138200ZY	0	+	274	1907	3095	0.6161551
zheyou73v0_A02	8017612	8020894	BnaA02T0138300ZY	0	+	125	1416	3282	0.4314442
zheyou73v0_A02	8025678	8027019	BnaA02T0138400ZY	0	-	71	604	1341	0.4504101
zheyou73v0_A02	8025678	8027019	BnaA02T0138400ZY.1	0	-	71	604	1341	0.4504101
zheyou73v0_A02	8027632	8028761	BnaA02T0138500ZY	0	+	573	1074	1129	0.9512843
zheyou73v0_A02	8028950	8029533	BnaA02T0138600ZY	0	+	78	583	583	1.0000000
zheyou73v0_A02	8034058	8044613	BnaA02T0138700ZY	0	+	1952	5730	10555	0.5428707
zheyou73v0_A02	8044816	8049635	BnaA02T0138800ZY	0	-	4	230	4819	0.0477277
zheyou73v0_A02	8053724	8054757	BnaA02T0138900ZY	0	-	0	0	1033	0.0000000
zheyou73v0_A02	8055144	8058247	BnaA02T0139000ZY	0	-	1946	2021	3103	0.6513052
zheyou73v0_A02	8087927	8089294	BnaA02T0139100ZY	0	-	4	329	1367	0.2406730
zheyou73v0_A02	8093500	8094569	BnaA02T0139200ZY	0	-	1120	1069	1069	1.0000000
zheyou73v0_A02	8095800	8097283	BnaA02T0139300ZY	0	-	470	1452	1483	0.9790964
zheyou73v0_A02	8098167	8098813	BnaA02T0139400ZY	0	-	1156	646	646	1.0000000
zheyou73v0_A02	8100590	8101615	BnaA02T0139500ZY	0	-	1302	1025	1025	1.0000000
zheyou73v0_A02	8104819	8105964	BnaA02T0139600ZY	0	+	282	1145	1145	1.0000000
zheyou73v0_A02	8106789	8107234	BnaA02T0139700ZY	0	+	354	445	445	1.0000000
zheyou73v0_A02	8109623	8111970	BnaA02T0139800ZY	0	+	2191	2347	2347	1.0000000
zheyou73v0_A02	8114776	8117423	BnaA02T0139900ZY	0	-	1065	2623	2647	0.9909331
zheyou73v0_A02	8125526	8127077	BnaA02T0140000ZY	0	-	904	1551	1551	1.0000000
zheyou73v0_A02	8139155	8140317	BnaA02T0140100ZY	0	-	961	1162	1162	1.0000000
zheyou73v0_A02	8144861	8146016	BnaA02T0140200ZY	0	+	679	1155	1155	1.0000000
zheyou73v0_A02	8148198	8148605	BnaA02T0140300ZY	0	-	243	407	407	1.0000000
zheyou73v0_A02	8153186	8154846	BnaA02T0140400ZY	0	-	901	1660	1660	1.0000000
zheyou73v0_A02	8165959	8169491	BnaA02T0140500ZY	0	-	1259	3532	3532	1.0000000
zheyou73v0_A02	8177353	8180543	BnaA02T0140600ZY	0	-	677	2145	3190	0.6724138
zheyou73v0_A02	8183060	8185220	BnaA02T0140700ZY	0	-	724	1981	2160	0.9171296
zheyou73v0_A02	8194433	8194901	BnaA02T0140800ZY	0	+	680	468	468	1.0000000
zheyou73v0_A02	8196142	8196706	BnaA02T0140900ZY	0	+	169	428	564	0.7588652
zheyou73v0_A02	8196739	8197469	BnaA02T0141000ZY	0	+	423	730	730	1.0000000
zheyou73v0_A02	8198764	8200039	BnaA02T0141100ZY	0	+	1049	1268	1275	0.9945098
zheyou73v0_A02	8201938	8205568	BnaA02T0141200ZY	0	+	756	3172	3630	0.8738292
zheyou73v0_A02	8205962	8207337	BnaA02T0141300ZY	0	-	309	1094	1375	0.7956364
zheyou73v0_A02	8210399	8211771	BnaA02T0141400ZY	0	+	660	1372	1372	1.0000000
zheyou73v0_A02	8216840	8217996	BnaA02T0141500ZY	0	+	580	1156	1156	1.0000000
zheyou73v0_A02	8219728	8220776	BnaA02T0141600ZY	0	+	138	605	1048	0.5772901
zheyou73v0_A02	8225639	8226225	BnaA02T0141700ZY	0	+	42	113	586	0.1928328
zheyou73v0_A02	8231729	8233409	BnaA02T0141800ZY	0	+	146	1293	1680	0.7696428
zheyou73v0_A02	8250883	8252216	BnaA02T0141900ZY	0	-	120	831	1333	0.6234059
zheyou73v0_A02	8262538	8262817	BnaA02T0142000ZY	0	+	446	279	279	1.0000000
zheyou73v0_A02	8264960	8265666	BnaA02T0142100ZY	0	+	151	389	706	0.5509915
zheyou73v0_A02	8276852	8279238	BnaA02T0142200ZY	0	+	2332	2386	2386	1.0000000
zheyou73v0_A02	8279903	8281125	BnaA02T0142300ZY	0	+	1315	1222	1222	1.0000000
zheyou73v0_A02	8294016	8296899	BnaA02T0142400ZY	0	+	1618	2658	2883	0.9219563
zheyou73v0_A02	8299227	8300762	BnaA02T0142500ZY	0	-	694	1535	1535	1.0000000
zheyou73v0_A02	8306718	8308405	BnaA02T0142600ZY	0	-	454	1452	1687	0.8606995
zheyou73v0_A02	8312098	8314736	BnaA02T0142700ZY	0	+	349	2142	2638	0.8119788
zheyou73v0_A02	8315876	8319847	BnaA02T0142800ZY	0	-	2484	3775	3971	0.9506422
zheyou73v0_A02	8321490	8323137	BnaA02T0142900ZY	0	-	275	1536	1647	0.9326047
zheyou73v0_A02	8324890	8325441	BnaA02T0143000ZY	0	-	1050	551	551	1.0000000
zheyou73v0_A02	8329115	8330162	BnaA02T0143100ZY	0	+	13	224	1047	0.2139446
zheyou73v0_A02	8337942	8340877	BnaA02T0143200ZY	0	+	613	1495	2935	0.5093697
zheyou73v0_A02	8341844	8345155	BnaA02T0143300ZY	0	-	1837	3228	3311	0.9749320
zheyou73v0_A02	8352679	8356356	BnaA02T0143400ZY	0	+	479	3146	3677	0.8555888
zheyou73v0_A02	8353119	8356356	BnaA02T0143400ZY.1	0	+	386	2706	3237	0.8359592
zheyou73v0_A02	8357402	8358078	BnaA02T0143500ZY	0	-	411	676	676	1.0000000
zheyou73v0_A02	8359075	8362538	BnaA02T0143600ZY	0	+	2073	2781	3463	0.8030609
zheyou73v0_A02	8361784	8364042	BnaA02T0143700ZY	0	-	97	709	2258	0.3139947
zheyou73v0_A02	8367835	8369068	BnaA02T0143800ZY	0	+	478	1122	1233	0.9099756
zheyou73v0_A02	8369078	8369831	BnaA02T0143900ZY	0	+	161	650	753	0.8632138
zheyou73v0_A02	8371012	8372622	BnaA02T0144000ZY	0	-	1513	1591	1610	0.9881988
zheyou73v0_A02	8380756	8382474	BnaA02T0144100ZY	0	-	1643	1651	1718	0.9610012
zheyou73v0_A02	8383503	8383947	BnaA02T0144200ZY	0	+	381	444	444	1.0000000
zheyou73v0_A02	8385343	8387621	BnaA02T0144300ZY	0	+	968	2278	2278	1.0000000
zheyou73v0_A02	8388048	8389725	BnaA02T0144400ZY	0	-	270	1120	1677	0.6678593
zheyou73v0_A02	8390489	8391125	BnaA02T0144500ZY	0	+	57	567	636	0.8915094
zheyou73v0_A02	8391398	8393869	BnaA02T0144600ZY	0	-	1176	2407	2471	0.9740996
zheyou73v0_A02	8398059	8398757	BnaA02T0144700ZY	0	+	234	698	698	1.0000000
zheyou73v0_A02	8398905	8400683	BnaA02T0144800ZY	0	+	220	1687	1778	0.9488189
zheyou73v0_A02	8398905	8400683	BnaA02T0144800ZY.1	0	+	220	1687	1778	0.9488189
zheyou73v0_A02	8401138	8407377	BnaA02T0144900ZY	0	-	2122	5109	6239	0.8188812
zheyou73v0_A02	8401138	8405559	BnaA02T0144900ZY.1	0	-	917	3291	4421	0.7444017
zheyou73v0_A02	8401138	8404927	BnaA02T0144900ZY.2	0	-	466	2659	3789	0.7017683
zheyou73v0_A02	8408042	8409908	BnaA02T0145000ZY	0	-	1562	1866	1866	1.0000000
zheyou73v0_A02	8408042	8409908	BnaA02T0145000ZY.1	0	-	1562	1866	1866	1.0000000
zheyou73v0_A02	8411102	8413138	BnaA02T0145100ZY	0	-	555	1813	2036	0.8904715
zheyou73v0_A02	8414752	8416638	BnaA02T0145200ZY	0	+	604	1823	1886	0.9665959
zheyou73v0_A02	8414752	8416638	BnaA02T0145200ZY.1	0	+	604	1823	1886	0.9665959
zheyou73v0_A02	8421668	8423088	BnaA02T0145300ZY	0	+	540	1403	1420	0.9880282
zheyou73v0_A02	8421668	8423088	BnaA02T0145300ZY.1	0	+	540	1403	1420	0.9880282
zheyou73v0_A02	8424493	8427947	BnaA02T0145400ZY	0	+	213	1362	3454	0.3943254
zheyou73v0_A02	8429140	8430270	BnaA02T0145500ZY	0	+	2	239	1130	0.2115044
zheyou73v0_A02	8441116	8448915	BnaA02T0145600ZY	0	+	4	135	7799	0.0173099
zheyou73v0_A02	8450317	8451349	BnaA02T0145700ZY	0	+	22	224	1032	0.2170543
zheyou73v0_A02	8453039	8455152	BnaA02T0145800ZY	0	+	372	1370	2113	0.6483672
zheyou73v0_A02	8456510	8457527	BnaA02T0145900ZY	0	+	59	654	1017	0.6430678
zheyou73v0_A02	8460315	8462550	BnaA02T0146000ZY	0	+	109	1539	2235	0.6885906
zheyou73v0_A02	8466667	8475825	BnaA02T0146100ZY	0	+	1004	6199	9158	0.6768945
zheyou73v0_A02	8476619	8477453	BnaA02T0146200ZY	0	+	481	806	834	0.9664268
zheyou73v0_A02	8477917	8479629	BnaA02T0146300ZY	0	+	779	1699	1712	0.9924065
zheyou73v0_A02	8480662	8484004	BnaA02T0146400ZY	0	-	831	3164	3342	0.9467385
zheyou73v0_A02	8485973	8488539	BnaA02T0146500ZY	0	-	166	1248	2566	0.4863601
zheyou73v0_A02	8491693	8493365	BnaA02T0146600ZY	0	+	258	1638	1672	0.9796651
zheyou73v0_A02	8495525	8497417	BnaA02T0146700ZY	0	-	155	1266	1892	0.6691332
zheyou73v0_A02	8498026	8499803	BnaA02T0146800ZY	0	+	0	0	1777	0.0000000
zheyou73v0_A02	8505593	8506696	BnaA02T0146900ZY	0	+	435	1103	1103	1.0000000
zheyou73v0_A02	8506752	8507868	BnaA02T0147000ZY	0	+	236	1052	1116	0.9426523
zheyou73v0_A02	8508425	8508863	BnaA02T0147100ZY	0	-	227	438	438	1.0000000
zheyou73v0_A02	8510252	8510673	BnaA02T0147200ZY	0	-	34	325	421	0.7719715
zheyou73v0_A02	8512205	8526141	BnaA02T0147300ZY	0	+	567	4133	13936	0.2965700
zheyou73v0_A02	8526544	8526778	BnaA02T0147400ZY	0	-	147	234	234	1.0000000
zheyou73v0_A02	8528274	8534334	BnaA02T0147500ZY	0	-	1159	4139	6060	0.6830033
zheyou73v0_A02	8538942	8543116	BnaA02T0147600ZY	0	+	371	2661	4174	0.6375180
zheyou73v0_A02	8546742	8548104	BnaA02T0147700ZY	0	+	284	1252	1362	0.9192364
zheyou73v0_A02	8551104	8553960	BnaA02T0147800ZY	0	-	126	882	2856	0.3088235
zheyou73v0_A02	8554922	8556295	BnaA02T0147900ZY	0	-	294	1121	1373	0.8164603
zheyou73v0_A02	8558008	8560625	BnaA02T0148000ZY	0	-	41	673	2617	0.2571647
zheyou73v0_A02	8571956	8573765	BnaA02T0148100ZY	0	+	552	1809	1809	1.0000000
zheyou73v0_A02	8574751	8575456	BnaA02T0148200ZY	0	-	310	705	705	1.0000000
zheyou73v0_A02	8579611	8582448	BnaA02T0148300ZY	0	-	132	1563	2837	0.5509341
zheyou73v0_A02	8589935	8591601	BnaA02T0148400ZY	0	-	202	1486	1666	0.8919568
zheyou73v0_A02	8592334	8596139	BnaA02T0148500ZY	0	-	41	964	3805	0.2533509
zheyou73v0_A02	8613371	8616104	BnaA02T0148600ZY	0	-	0	0	2733	0.0000000
zheyou73v0_A02	8643624	8644138	BnaA02T0148700ZY	0	-	1	107	514	0.2081712
zheyou73v0_A02	8647319	8648822	BnaA02T0148800ZY	0	+	99	1038	1503	0.6906188
zheyou73v0_A02	8672724	8675727	BnaA02T0148900ZY	0	+	134	1206	3003	0.4015984
zheyou73v0_A02	8682010	8684056	BnaA02T0149000ZY	0	+	139	1771	2046	0.8655914
zheyou73v0_A02	8690568	8693619	BnaA02T0149100ZY	0	+	72	1154	3051	0.3782367
zheyou73v0_A02	8698114	8699441	BnaA02T0149200ZY	0	-	655	1253	1327	0.9442351
zheyou73v0_A02	8699746	8702227	BnaA02T0149300ZY	0	+	517	2130	2481	0.8585248
zheyou73v0_A02	8705299	8705737	BnaA02T0149400ZY	0	-	0	0	438	0.0000000
zheyou73v0_A02	8714134	8718944	BnaA02T0149500ZY	0	+	1249	3969	4810	0.8251559
zheyou73v0_A02	8719501	8722616	BnaA02T0149600ZY	0	-	0	0	3115	0.0000000
zheyou73v0_A02	8739421	8742388	BnaA02T0149700ZY	0	-	0	0	2967	0.0000000
zheyou73v0_A02	8803009	8804376	BnaA02T0149800ZY	0	-	29	708	1367	0.5179225
zheyou73v0_A02	8815190	8818329	BnaA02T0149900ZY	0	+	755	2422	3139	0.7715833
zheyou73v0_A02	8819724	8820853	BnaA02T0150000ZY	0	+	0	0	1129	0.0000000
zheyou73v0_A02	8832985	8841131	BnaA02T0150100ZY	0	+	0	0	8146	0.0000000
zheyou73v0_A02	8842193	8843228	BnaA02T0150200ZY	0	+	60	544	1035	0.5256039
zheyou73v0_A02	8844834	8845869	BnaA02T0150300ZY	0	+	52	707	1035	0.6830918
zheyou73v0_A02	8846780	8847632	BnaA02T0150400ZY	0	+	30	271	852	0.3180751
zheyou73v0_A02	8848940	8849474	BnaA02T0150500ZY	0	+	15	190	534	0.3558052
zheyou73v0_A02	8850847	8851864	BnaA02T0150600ZY	0	+	96	798	1017	0.7846608
zheyou73v0_A02	8854478	8856878	BnaA02T0150700ZY	0	+	308	1779	2400	0.7412500
zheyou73v0_A02	8864113	8864686	BnaA02T0150800ZY	0	+	2	213	573	0.3717277
zheyou73v0_A02	8866947	8867897	BnaA02T0150900ZY	0	-	2	85	950	0.0894737
zheyou73v0_A02	8869548	8878721	BnaA02T0151000ZY	0	+	1353	6571	9173	0.7163414
zheyou73v0_A02	8879379	8880209	BnaA02T0151100ZY	0	+	194	693	830	0.8349398
zheyou73v0_A02	8880672	8882367	BnaA02T0151200ZY	0	+	277	1290	1695	0.7610620
zheyou73v0_A02	8883188	8885762	BnaA02T0151300ZY	0	-	204	1706	2574	0.6627817
zheyou73v0_A02	8893871	8896726	BnaA02T0151400ZY	0	-	637	2476	2855	0.8672504
zheyou73v0_A02	8899897	8901493	BnaA02T0151500ZY	0	+	307	1566	1596	0.9812030
zheyou73v0_A02	8902635	8905083	BnaA02T0151600ZY	0	-	220	1649	2448	0.6736111
zheyou73v0_A02	8902635	8905083	BnaA02T0151600ZY.1	0	-	220	1649	2448	0.6736111
zheyou73v0_A02	8902635	8905083	BnaA02T0151600ZY.2	0	-	220	1649	2448	0.6736111
zheyou73v0_A02	8902635	8905083	BnaA02T0151600ZY.3	0	-	220	1649	2448	0.6736111
zheyou73v0_A02	8906987	8909554	BnaA02T0151700ZY	0	+	341	1795	2567	0.6992598
zheyou73v0_A02	8909837	8910953	BnaA02T0151800ZY	0	+	34	493	1116	0.4417563
zheyou73v0_A02	8911231	8912315	BnaA02T0151900ZY	0	-	454	1050	1084	0.9686347
zheyou73v0_A02	8913251	8913668	BnaA02T0152000ZY	0	-	72	355	417	0.8513190
zheyou73v0_A02	8914610	8917108	BnaA02T0152100ZY	0	+	632	2365	2498	0.9467574
zheyou73v0_A02	8917400	8917634	BnaA02T0152200ZY	0	-	33	185	234	0.7905983
zheyou73v0_A02	8918592	8923890	BnaA02T0152300ZY	0	-	622	3485	5298	0.6577954
zheyou73v0_A02	8927768	8931860	BnaA02T0152400ZY	0	+	935	3145	4092	0.7685728
zheyou73v0_A02	8927768	8931860	BnaA02T0152400ZY.1	0	+	935	3145	4092	0.7685728
zheyou73v0_A02	8927768	8931860	BnaA02T0152400ZY.2	0	+	935	3145	4092	0.7685728
zheyou73v0_A02	8927768	8931860	BnaA02T0152400ZY.3	0	+	935	3145	4092	0.7685728
zheyou73v0_A02	8936110	8937448	BnaA02T0152500ZY	0	+	125	959	1338	0.7167414
zheyou73v0_A02	8940065	8943202	BnaA02T0152600ZY	0	-	426	1472	3137	0.4692381
zheyou73v0_A02	8944690	8946159	BnaA02T0152700ZY	0	-	408	1390	1469	0.9462219
zheyou73v0_A02	8947245	8949883	BnaA02T0152800ZY	0	-	139	1466	2638	0.5557240
zheyou73v0_A02	8955827	8957635	BnaA02T0152900ZY	0	+	187	1023	1808	0.5658186
zheyou73v0_A02	8958571	8964764	BnaA02T0153000ZY	0	-	96	1494	6193	0.2412401
zheyou73v0_A02	8968260	8969539	BnaA02T0153100ZY	0	+	400	1232	1279	0.9632525
zheyou73v0_A02	8970451	8973842	BnaA02T0153200ZY	0	-	116	1303	3391	0.3842524
zheyou73v0_A02	8974435	8976253	BnaA02T0153300ZY	0	-	578	1756	1818	0.9658966
zheyou73v0_A02	8974435	8976253	BnaA02T0153300ZY.1	0	-	578	1756	1818	0.9658966
zheyou73v0_A02	8976982	8980786	BnaA02T0153400ZY	0	-	3	94	3804	0.0247108
zheyou73v0_A02	8983278	8983694	BnaA02T0153500ZY	0	-	0	0	416	0.0000000
zheyou73v0_A02	8984148	8984844	BnaA02T0153600ZY	0	-	0	0	696	0.0000000
zheyou73v0_A02	9001918	9005420	BnaA02T0153700ZY	0	-	181	1321	3502	0.3772130
zheyou73v0_A02	9001918	9005420	BnaA02T0153700ZY.1	0	-	181	1321	3502	0.3772130
zheyou73v0_A02	9052759	9055414	BnaA02T0153800ZY	0	-	738	2552	2655	0.9612052
zheyou73v0_A02	9065512	9067467	BnaA02T0153900ZY	0	+	1447	1955	1955	1.0000000
zheyou73v0_A02	9071569	9075406	BnaA02T0154000ZY	0	+	982	3724	3837	0.9705499
zheyou73v0_A02	9074910	9076930	BnaA02T0154100ZY	0	-	278	1714	2020	0.8485149
zheyou73v0_A02	9082302	9085666	BnaA02T0154200ZY	0	+	394	2902	3364	0.8626635
zheyou73v0_A02	9087502	9088155	BnaA02T0154300ZY	0	-	67	335	653	0.5130168
zheyou73v0_A02	9089258	9091334	BnaA02T0154400ZY	0	+	425	1871	2076	0.9012524
zheyou73v0_A02	9091508	9093719	BnaA02T0154500ZY	0	-	531	1943	2211	0.8787879
zheyou73v0_A02	9097291	9102389	BnaA02T0154600ZY	0	-	1255	5010	5098	0.9827383
zheyou73v0_A02	9097291	9102389	BnaA02T0154600ZY.1	0	-	1255	5010	5098	0.9827383
zheyou73v0_A02	9108477	9109671	BnaA02T0154700ZY	0	-	190	894	1194	0.7487437
zheyou73v0_A02	9119287	9121478	BnaA02T0154800ZY	0	+	410	1663	2191	0.7590141
zheyou73v0_A02	9122857	9124496	BnaA02T0154900ZY	0	-	303	1255	1639	0.7657108
zheyou73v0_A02	9126348	9128506	BnaA02T0155000ZY	0	-	2250	2158	2158	1.0000000
zheyou73v0_A02	9138692	9139220	BnaA02T0155100ZY	0	+	0	0	528	0.0000000
zheyou73v0_A02	9153912	9156147	BnaA02T0155200ZY	0	-	2	203	2235	0.0908277
zheyou73v0_A02	9161291	9162453	BnaA02T0155300ZY	0	+	288	1048	1162	0.9018933
zheyou73v0_A02	9173447	9176150	BnaA02T0155400ZY	0	+	260	1634	2703	0.6045135
zheyou73v0_A02	9176667	9178910	BnaA02T0155500ZY	0	-	396	1524	2243	0.6794472
zheyou73v0_A02	9184542	9187661	BnaA02T0155600ZY	0	+	595	2796	3119	0.8964412
zheyou73v0_A02	9189495	9190014	BnaA02T0155700ZY	0	-	0	0	519	0.0000000
zheyou73v0_A02	9200667	9203878	BnaA02T0155800ZY	0	+	72	1212	3211	0.3774525
zheyou73v0_A02	9204021	9208860	BnaA02T0155900ZY	0	-	297	2831	4839	0.5850382
zheyou73v0_A02	9211487	9216591	BnaA02T0156000ZY	0	-	371	3200	5104	0.6269593
zheyou73v0_A02	9211487	9216591	BnaA02T0156000ZY.1	0	-	371	3200	5104	0.6269593
zheyou73v0_A02	9225064	9226282	BnaA02T0156100ZY	0	-	38	506	1218	0.4154351
zheyou73v0_A02	9234617	9236783	BnaA02T0156200ZY	0	+	69	967	2166	0.4464450
zheyou73v0_A02	9238164	9239843	BnaA02T0156300ZY	0	-	315	1416	1679	0.8433591
zheyou73v0_A02	9240993	9241314	BnaA02T0156400ZY	0	-	45	321	321	1.0000000
zheyou73v0_A02	9249373	9249901	BnaA02T0156500ZY	0	+	441	528	528	1.0000000
zheyou73v0_A02	9259022	9260672	BnaA02T0156600ZY	0	-	424	1543	1650	0.9351515
zheyou73v0_A02	9279841	9281482	BnaA02T0156700ZY	0	-	184	755	1641	0.4600853
zheyou73v0_A02	9305231	9307646	BnaA02T0156800ZY	0	+	54	743	2415	0.3076605
zheyou73v0_A02	9332204	9333279	BnaA02T0156900ZY	0	+	68	715	1075	0.6651163
zheyou73v0_A02	9338380	9339789	BnaA02T0157000ZY	0	-	263	1006	1409	0.7139816
zheyou73v0_A02	9340942	9348859	BnaA02T0157100ZY	0	+	1923	6509	7917	0.8221549
zheyou73v0_A02	9340942	9348400	BnaA02T0157100ZY.1	0	+	1690	6050	7458	0.8112094
zheyou73v0_A02	9356501	9357662	BnaA02T0157200ZY	0	-	41	654	1161	0.5633075
zheyou73v0_A02	9374622	9376476	BnaA02T0157300ZY	0	-	312	1608	1854	0.8673139
zheyou73v0_A02	9381965	9384022	BnaA02T0157400ZY	0	+	634	1933	2057	0.9397180
zheyou73v0_A02	9381965	9384022	BnaA02T0157400ZY.1	0	+	634	1933	2057	0.9397180
zheyou73v0_A02	9385130	9387365	BnaA02T0157500ZY	0	+	1082	2069	2235	0.9257271
zheyou73v0_A02	9393302	9394522	BnaA02T0157600ZY	0	-	93	411	1220	0.3368852
zheyou73v0_A02	9397837	9399691	BnaA02T0157700ZY	0	-	123	1569	1854	0.8462783
zheyou73v0_A02	9408635	9411490	BnaA02T0157800ZY	0	-	900	1853	2855	0.6490368
zheyou73v0_A02	9423944	9430185	BnaA02T0157900ZY	0	+	830	4598	6241	0.7367409
zheyou73v0_A02	9424420	9430185	BnaA02T0157900ZY.1	0	+	772	4162	5765	0.7219428
zheyou73v0_A02	9424420	9430185	BnaA02T0157900ZY.2	0	+	772	4162	5765	0.7219428
zheyou73v0_A02	9430245	9430841	BnaA02T0158000ZY	0	-	166	596	596	1.0000000
zheyou73v0_A02	9456707	9457142	BnaA02T0158100ZY	0	+	269	435	435	1.0000000
zheyou73v0_A02	9463733	9464036	BnaA02T0158200ZY	0	-	2	210	303	0.6930693
zheyou73v0_A02	9467828	9472363	BnaA02T0158300ZY	0	+	749	3443	4535	0.7592062
zheyou73v0_A02	9473923	9474259	BnaA02T0158400ZY	0	+	51	336	336	1.0000000
zheyou73v0_A02	9474292	9475591	BnaA02T0158500ZY	0	+	789	1299	1299	1.0000000
zheyou73v0_A02	9481776	9483639	BnaA02T0158600ZY	0	-	408	1641	1863	0.8808374
zheyou73v0_A02	9485552	9486010	BnaA02T0158700ZY	0	-	54	340	458	0.7423581
zheyou73v0_A02	9499809	9502079	BnaA02T0158800ZY	0	-	755	1946	2270	0.8572688
zheyou73v0_A02	9506239	9507720	BnaA02T0158900ZY	0	-	89	1308	1481	0.8831871
zheyou73v0_A02	9511340	9513647	BnaA02T0159000ZY	0	+	7	361	2307	0.1564803
zheyou73v0_A02	9517917	9521425	BnaA02T0159100ZY	0	+	865	2964	3508	0.8449259
zheyou73v0_A02	9521883	9525700	BnaA02T0159200ZY	0	+	916	3279	3817	0.8590516
zheyou73v0_A02	9521883	9525176	BnaA02T0159200ZY.1	0	+	678	2755	3293	0.8366231
zheyou73v0_A02	9525841	9527944	BnaA02T0159300ZY	0	-	651	2018	2103	0.9595816
zheyou73v0_A02	9536711	9539273	BnaA02T0159400ZY	0	+	36	334	2562	0.1303669
zheyou73v0_A02	9544109	9544430	BnaA02T0159500ZY	0	+	20	321	321	1.0000000
zheyou73v0_A02	9546712	9548261	BnaA02T0159600ZY	0	+	96	789	1549	0.5093608
zheyou73v0_A02	9549917	9550388	BnaA02T0159700ZY	0	-	11	337	471	0.7154989
zheyou73v0_A02	9553283	9555497	BnaA02T0159800ZY	0	-	189	1218	2214	0.5501355
zheyou73v0_A02	9582733	9583474	BnaA02T0159900ZY	0	+	136	741	741	1.0000000
zheyou73v0_A02	9586724	9592797	BnaA02T0160000ZY	0	+	1741	5036	6073	0.8292442
zheyou73v0_A02	9593715	9595400	BnaA02T0160100ZY	0	+	106	1309	1685	0.7768546
zheyou73v0_A02	9595678	9597580	BnaA02T0160200ZY	0	-	158	1325	1902	0.6966351
zheyou73v0_A02	9597687	9598668	BnaA02T0160300ZY	0	+	405	981	981	1.0000000
zheyou73v0_A02	9601104	9603042	BnaA02T0160400ZY	0	+	265	1378	1938	0.7110423
zheyou73v0_A02	9613899	9616182	BnaA02T0160500ZY	0	+	30	595	2283	0.2606220
zheyou73v0_A02	9613899	9616182	BnaA02T0160500ZY.1	0	+	30	595	2283	0.2606220
zheyou73v0_A02	9613899	9616182	BnaA02T0160500ZY.2	0	+	30	595	2283	0.2606220
zheyou73v0_A02	9616929	9619746	BnaA02T0160600ZY	0	-	307	2493	2817	0.8849840
zheyou73v0_A02	9639264	9642329	BnaA02T0160700ZY	0	+	973	2808	3065	0.9161501
zheyou73v0_A02	9649642	9650384	BnaA02T0160800ZY	0	-	129	734	742	0.9892184
zheyou73v0_A02	9656507	9657711	BnaA02T0160900ZY	0	+	2	201	1204	0.1669435
zheyou73v0_A02	9660570	9662164	BnaA02T0161000ZY	0	-	0	0	1594	0.0000000
zheyou73v0_A02	9664805	9665203	BnaA02T0161100ZY	0	-	31	397	398	0.9974874
zheyou73v0_A02	9690303	9691279	BnaA02T0161200ZY	0	+	0	0	976	0.0000000
zheyou73v0_A02	9691812	9696531	BnaA02T0161300ZY	0	-	207	1109	4719	0.2350074
zheyou73v0_A02	9697474	9698581	BnaA02T0161400ZY	0	-	96	341	1107	0.3080398
zheyou73v0_A02	9701704	9702239	BnaA02T0161500ZY	0	-	1	48	535	0.0897196
zheyou73v0_A02	9846444	9847340	BnaA02T0161600ZY	0	-	0	0	896	0.0000000
zheyou73v0_A02	9935263	9935987	BnaA02T0161700ZY	0	+	55	320	724	0.4419889
zheyou73v0_A02	9936893	9937316	BnaA02T0161800ZY	0	-	65	321	423	0.7588652
zheyou73v0_A02	9937759	9939035	BnaA02T0161900ZY	0	-	114	881	1276	0.6904389
zheyou73v0_A02	9945717	9946364	BnaA02T0162000ZY	0	-	91	543	647	0.8392581
zheyou73v0_A02	9947858	9949471	BnaA02T0162100ZY	0	+	37	405	1613	0.2510849
zheyou73v0_A02	9954907	9956184	BnaA02T0162200ZY	0	+	44	849	1277	0.6648394
zheyou73v0_A02	9972668	9973578	BnaA02T0162300ZY	0	-	8	218	910	0.2395604
zheyou73v0_A02	9979903	9980267	BnaA02T0162400ZY	0	-	201	364	364	1.0000000
zheyou73v0_A02	9986830	9987058	BnaA02T0162500ZY	0	-	203	228	228	1.0000000
zheyou73v0_A02	9992514	9995094	BnaA02T0162600ZY	0	+	583	2029	2580	0.7864341
zheyou73v0_A02	9993488	9995094	BnaA02T0162600ZY.1	0	+	251	1055	1606	0.6569116
zheyou73v0_A02	9995416	9996563	BnaA02T0162700ZY	0	-	75	592	1147	0.5161290
zheyou73v0_A02	9995416	9996563	BnaA02T0162700ZY.1	0	-	75	592	1147	0.5161290
zheyou73v0_A02	9998169	10000232	BnaA02T0162800ZY	0	+	607	1924	2063	0.9326224
zheyou73v0_A02	10000406	10003578	BnaA02T0162900ZY	0	-	146	1294	3172	0.4079445
zheyou73v0_A02	10023656	10026970	BnaA02T0163000ZY	0	+	494	2930	3314	0.8841279
zheyou73v0_A02	10028173	10029224	BnaA02T0163100ZY	0	-	183	664	1051	0.6317793
zheyou73v0_A02	10034817	10037009	BnaA02T0163200ZY	0	-	520	2123	2192	0.9685219
zheyou73v0_A02	10041782	10043798	BnaA02T0163300ZY	0	-	521	1837	2016	0.9112103
zheyou73v0_A02	10041782	10043927	BnaA02T0163300ZY.1	0	-	539	1966	2145	0.9165501
zheyou73v0_A02	10055767	10057201	BnaA02T0163400ZY	0	-	563	1424	1434	0.9930265
zheyou73v0_A02	10070218	10072985	BnaA02T0163500ZY	0	+	310	1728	2767	0.6245031
zheyou73v0_A02	10074637	10075038	BnaA02T0163600ZY	0	+	0	0	401	0.0000000
zheyou73v0_A02	10075039	10075443	BnaA02T0163700ZY	0	+	0	0	404	0.0000000
zheyou73v0_A02	10088171	10090153	BnaA02T0163800ZY	0	+	44	1184	1982	0.5973764
zheyou73v0_A02	10090419	10090729	BnaA02T0163900ZY	0	-	98	310	310	1.0000000
zheyou73v0_A02	10092073	10095470	BnaA02T0164000ZY	0	+	1690	3345	3397	0.9846924
zheyou73v0_A02	10098473	10099796	BnaA02T0164100ZY	0	-	250	898	1323	0.6787604
zheyou73v0_A02	10100363	10101684	BnaA02T0164200ZY	0	+	117	1231	1321	0.9318698
zheyou73v0_A02	10104194	10105745	BnaA02T0164300ZY	0	-	0	0	1551	0.0000000
zheyou73v0_A02	10132655	10134134	BnaA02T0164400ZY	0	+	5	337	1479	0.2278567
zheyou73v0_A02	10146415	10147435	BnaA02T0164500ZY	0	+	202	931	1020	0.9127451
zheyou73v0_A02	10147994	10148581	BnaA02T0164600ZY	0	-	170	544	587	0.9267462
zheyou73v0_A02	10151310	10153235	BnaA02T0164700ZY	0	-	453	1751	1925	0.9096104
zheyou73v0_A02	10171142	10173307	BnaA02T0164800ZY	0	+	29	826	2165	0.3815242
zheyou73v0_A02	10186936	10188967	BnaA02T0164900ZY	0	-	342	1300	2031	0.6400788
zheyou73v0_A02	10199407	10200947	BnaA02T0165000ZY	0	+	439	1320	1540	0.8571429
zheyou73v0_A02	10206195	10210796	BnaA02T0165100ZY	0	+	777	3193	4601	0.6939796
zheyou73v0_A02	10211424	10212430	BnaA02T0165200ZY	0	-	212	997	1006	0.9910537
zheyou73v0_A02	10213452	10214643	BnaA02T0165300ZY	0	+	204	691	1191	0.5801847
zheyou73v0_A02	10234291	10237432	BnaA02T0165400ZY	0	+	292	2483	3141	0.7905126
zheyou73v0_A02	10234291	10237432	BnaA02T0165400ZY.1	0	+	292	2483	3141	0.7905126
zheyou73v0_A02	10237613	10240187	BnaA02T0165500ZY	0	-	887	2288	2574	0.8888889
zheyou73v0_A02	10245032	10248088	BnaA02T0165600ZY	0	-	840	2684	3056	0.8782722
zheyou73v0_A02	10253438	10257315	BnaA02T0165700ZY	0	-	1274	3099	3877	0.7993294
zheyou73v0_A02	10259334	10261738	BnaA02T0165800ZY	0	-	388	1796	2404	0.7470882
zheyou73v0_A02	10262387	10263938	BnaA02T0165900ZY	0	-	139	1333	1551	0.8594455
zheyou73v0_A02	10264897	10267883	BnaA02T0166000ZY	0	-	361	2693	2986	0.9018754
zheyou73v0_A02	10271651	10275644	BnaA02T0166100ZY	0	-	383	2998	3993	0.7508139
zheyou73v0_A02	10280728	10283466	BnaA02T0166200ZY	0	+	1478	2258	2738	0.8246896
zheyou73v0_A02	10283940	10284452	BnaA02T0166300ZY	0	+	39	311	512	0.6074219
zheyou73v0_A02	10293554	10294214	BnaA02T0166400ZY	0	-	459	660	660	1.0000000
zheyou73v0_A02	10299192	10300237	BnaA02T0166500ZY	0	-	111	891	1045	0.8526316
zheyou73v0_A02	10302195	10302963	BnaA02T0166600ZY	0	-	136	768	768	1.0000000
zheyou73v0_A02	10308992	10310417	BnaA02T0166700ZY	0	+	27	807	1425	0.5663158
zheyou73v0_A02	10328879	10332057	BnaA02T0166800ZY	0	+	1204	3000	3178	0.9439899
zheyou73v0_A02	10332460	10335188	BnaA02T0166900ZY	0	-	186	1017	2728	0.3728006
zheyou73v0_A02	10342479	10345216	BnaA02T0167000ZY	0	+	118	1017	2737	0.3715747
zheyou73v0_A02	10350625	10351571	BnaA02T0167100ZY	0	+	139	515	946	0.5443975
zheyou73v0_A02	10360834	10361959	BnaA02T0167200ZY	0	+	131	683	1125	0.6071111
zheyou73v0_A02	10363020	10363773	BnaA02T0167300ZY	0	+	118	687	753	0.9123506
zheyou73v0_A02	10372480	10374341	BnaA02T0167400ZY	0	+	78	632	1861	0.3396024
zheyou73v0_A02	10376764	10378673	BnaA02T0167500ZY	0	-	654	1819	1909	0.9528549
zheyou73v0_A02	10380250	10381594	BnaA02T0167600ZY	0	-	49	476	1344	0.3541667
zheyou73v0_A02	10396590	10399413	BnaA02T0167700ZY	0	-	369	2344	2823	0.8303223
zheyou73v0_A02	10400409	10401387	BnaA02T0167800ZY	0	-	22	475	978	0.4856851
zheyou73v0_A02	10401484	10404591	BnaA02T0167900ZY	0	-	868	2505	3107	0.8062440
zheyou73v0_A02	10410624	10411727	BnaA02T0168000ZY	0	-	143	570	1103	0.5167724
zheyou73v0_A02	10432917	10433322	BnaA02T0168100ZY	0	+	1	113	405	0.2790124
zheyou73v0_A02	10445784	10447430	BnaA02T0168200ZY	0	+	118	914	1646	0.5552855
zheyou73v0_A02	10451522	10452301	BnaA02T0168300ZY	0	+	6	160	779	0.2053915
zheyou73v0_A02	10452569	10456484	BnaA02T0168400ZY	0	-	173	1422	3915	0.3632184
zheyou73v0_A02	10458430	10460125	BnaA02T0168500ZY	0	+	716	1695	1695	1.0000000
zheyou73v0_A02	10458430	10460125	BnaA02T0168500ZY.1	0	+	716	1695	1695	1.0000000
zheyou73v0_A02	10461149	10461464	BnaA02T0168600ZY	0	+	28	138	315	0.4380952
zheyou73v0_A02	10464928	10466455	BnaA02T0168700ZY	0	-	483	1275	1527	0.8349705
zheyou73v0_A02	10466894	10469016	BnaA02T0168800ZY	0	+	562	2059	2122	0.9703110
zheyou73v0_A02	10469379	10472324	BnaA02T0168900ZY	0	-	695	2495	2945	0.8471987
zheyou73v0_A02	10476440	10478419	BnaA02T0169000ZY	0	-	219	1469	1979	0.7422941
zheyou73v0_A02	10490394	10492567	BnaA02T0169100ZY	0	-	154	1085	2173	0.4993097
zheyou73v0_A02	10495936	10498638	BnaA02T0169200ZY	0	+	284	2228	2702	0.8245744
zheyou73v0_A02	10501973	10503251	BnaA02T0169300ZY	0	-	118	1102	1278	0.8622848
zheyou73v0_A02	10510493	10518676	BnaA02T0169400ZY	0	-	270	2154	8183	0.2632287
zheyou73v0_A02	10520764	10522087	BnaA02T0169500ZY	0	-	22	815	1323	0.6160242
zheyou73v0_A02	10522405	10523938	BnaA02T0169600ZY	0	-	126	1318	1533	0.8597521
zheyou73v0_A02	10527201	10529849	BnaA02T0169700ZY	0	-	47	951	2648	0.3591390
zheyou73v0_A02	10554858	10560005	BnaA02T0169800ZY	0	+	795	4535	5147	0.8810958
zheyou73v0_A02	10561613	10564879	BnaA02T0169900ZY	0	-	142	2229	3266	0.6824862
zheyou73v0_A02	10568822	10571432	BnaA02T0170000ZY	0	-	403	2127	2610	0.8149425
zheyou73v0_A02	10568822	10571432	BnaA02T0170000ZY.1	0	-	403	2127	2610	0.8149425
zheyou73v0_A02	10568822	10571432	BnaA02T0170000ZY.2	0	-	403	2127	2610	0.8149425
zheyou73v0_A02	10568822	10571432	BnaA02T0170000ZY.3	0	-	403	2127	2610	0.8149425
zheyou73v0_A02	10568822	10571432	BnaA02T0170000ZY.4	0	-	403	2127	2610	0.8149425
zheyou73v0_A02	10575564	10577981	BnaA02T0170100ZY	0	-	367	1821	2417	0.7534133
zheyou73v0_A02	10582008	10585049	BnaA02T0170200ZY	0	-	214	2288	3041	0.7523841
zheyou73v0_A02	10592471	10593569	BnaA02T0170300ZY	0	+	86	899	1098	0.8187614
zheyou73v0_A02	10595822	10599414	BnaA02T0170400ZY	0	+	153	1993	3592	0.5548441
zheyou73v0_A02	10601262	10603303	BnaA02T0170500ZY	0	+	0	0	2041	0.0000000
zheyou73v0_A02	10606703	10607067	BnaA02T0170600ZY	0	-	16	141	364	0.3873626
zheyou73v0_A02	10607626	10608997	BnaA02T0170700ZY	0	-	4	175	1371	0.1276441
zheyou73v0_A02	10610080	10611193	BnaA02T0170800ZY	0	-	96	807	1113	0.7250674
zheyou73v0_A02	10615261	10617112	BnaA02T0170900ZY	0	+	338	1676	1851	0.9054565
zheyou73v0_A02	10641097	10641502	BnaA02T0171000ZY	0	-	12	261	405	0.6444445
zheyou73v0_A02	10661649	10663605	BnaA02T0171100ZY	0	-	397	1875	1956	0.9585890
zheyou73v0_A02	10670407	10671082	BnaA02T0171200ZY	0	+	45	589	675	0.8725926
zheyou73v0_A02	10675233	10675652	BnaA02T0171300ZY	0	-	35	363	419	0.8663484
zheyou73v0_A02	10678057	10679161	BnaA02T0171400ZY	0	+	124	779	1104	0.7056159
zheyou73v0_A02	10681773	10683439	BnaA02T0171500ZY	0	-	10	380	1666	0.2280912
zheyou73v0_A02	10691517	10693221	BnaA02T0171600ZY	0	+	75	1070	1704	0.6279343
zheyou73v0_A02	10697383	10698505	BnaA02T0171700ZY	0	+	220	846	1122	0.7540107
zheyou73v0_A02	10705032	10706212	BnaA02T0171800ZY	0	+	39	376	1180	0.3186441
zheyou73v0_A02	10722298	10723916	BnaA02T0171900ZY	0	+	33	560	1618	0.3461063
zheyou73v0_A02	10730851	10734485	BnaA02T0172000ZY	0	-	17	433	3634	0.1191524
zheyou73v0_A02	10752407	10753754	BnaA02T0172100ZY	0	-	47	444	1347	0.3296214
zheyou73v0_A02	10767562	10769213	BnaA02T0172200ZY	0	+	172	1154	1651	0.6989703
zheyou73v0_A02	10768089	10769213	BnaA02T0172200ZY.1	0	+	100	727	1124	0.6467972
zheyou73v0_A02	10769989	10772394	BnaA02T0172300ZY	0	+	153	1661	2405	0.6906445
zheyou73v0_A02	10769989	10772394	BnaA02T0172300ZY.1	0	+	153	1661	2405	0.6906445
zheyou73v0_A02	10772098	10773298	BnaA02T0172400ZY	0	-	168	1059	1200	0.8825000
zheyou73v0_A02	10774835	10776744	BnaA02T0172500ZY	0	-	62	988	1909	0.5175484
zheyou73v0_A02	10788503	10796923	BnaA02T0172600ZY	0	-	0	0	8420	0.0000000
zheyou73v0_A02	10810080	10816278	BnaA02T0172700ZY	0	-	14	548	6198	0.0884156
zheyou73v0_A02	10823671	10825745	BnaA02T0172800ZY	0	+	177	1046	2074	0.5043395
zheyou73v0_A02	10823671	10825745	BnaA02T0172800ZY.1	0	+	177	1046	2074	0.5043395
zheyou73v0_A02	10831617	10833926	BnaA02T0172900ZY	0	+	658	1972	2309	0.8540494
zheyou73v0_A02	10896236	10896605	BnaA02T0173000ZY	0	-	127	369	369	1.0000000
zheyou73v0_A02	10898388	10898757	BnaA02T0173100ZY	0	-	16	369	369	1.0000000
zheyou73v0_A02	10914321	10915286	BnaA02T0173200ZY	0	-	125	597	965	0.6186528
zheyou73v0_A02	10914321	10915286	BnaA02T0173200ZY.1	0	-	125	597	965	0.6186528
zheyou73v0_A02	10922436	10923872	BnaA02T0173300ZY	0	+	110	376	1436	0.2618384
zheyou73v0_A02	10941226	10943179	BnaA02T0173400ZY	0	+	181	1062	1953	0.5437788
zheyou73v0_A02	10943478	10946410	BnaA02T0173500ZY	0	-	161	1947	2932	0.6640518
zheyou73v0_A02	10957057	10960786	BnaA02T0173600ZY	0	-	164	2048	3729	0.5492089
zheyou73v0_A02	10957057	10959958	BnaA02T0173600ZY.1	0	-	104	1310	2901	0.4515684
zheyou73v0_A02	10957557	10960786	BnaA02T0173600ZY.2	0	-	163	2005	3229	0.6209353
zheyou73v0_A02	10968519	10969020	BnaA02T0173700ZY	0	-	163	492	501	0.9820359
zheyou73v0_A02	10973763	10982097	BnaA02T0173800ZY	0	+	1805	6803	8334	0.8162947
zheyou73v0_A02	10986772	10989432	BnaA02T0173900ZY	0	+	552	2177	2660	0.8184211
zheyou73v0_A02	10991524	10994248	BnaA02T0174000ZY	0	-	23	789	2724	0.2896476
zheyou73v0_A02	11003494	11005380	BnaA02T0174100ZY	0	+	291	1467	1886	0.7778367
zheyou73v0_A02	11012377	11015529	BnaA02T0174200ZY	0	+	437	2709	3152	0.8594543
zheyou73v0_A02	11017603	11018902	BnaA02T0174300ZY	0	+	194	1202	1299	0.9253272
zheyou73v0_A02	11020117	11025130	BnaA02T0174400ZY	0	-	983	4051	5013	0.8080990
zheyou73v0_A02	11044565	11045234	BnaA02T0174500ZY	0	+	3	107	669	0.1599402
zheyou73v0_A02	11046221	11046811	BnaA02T0174600ZY	0	+	290	590	590	1.0000000
zheyou73v0_A02	11048367	11049411	BnaA02T0174700ZY	0	-	135	1044	1044	1.0000000
zheyou73v0_A02	11055748	11058237	BnaA02T0174800ZY	0	+	410	1238	2489	0.4973885
zheyou73v0_A02	11058227	11060803	BnaA02T0174900ZY	0	-	285	1845	2576	0.7162267
zheyou73v0_A02	11058227	11060803	BnaA02T0174900ZY.1	0	-	285	1845	2576	0.7162267
zheyou73v0_A02	11063434	11064980	BnaA02T0175000ZY	0	-	51	997	1546	0.6448900
zheyou73v0_A02	11067033	11067389	BnaA02T0175100ZY	0	-	80	319	356	0.8960674
zheyou73v0_A02	11077118	11078216	BnaA02T0175200ZY	0	-	148	727	1098	0.6621130
zheyou73v0_A02	11078926	11080606	BnaA02T0175300ZY	0	-	525	1667	1680	0.9922619
zheyou73v0_A02	11083511	11087322	BnaA02T0175400ZY	0	+	10	1083	3811	0.2841774
zheyou73v0_A02	11094348	11096121	BnaA02T0175500ZY	0	+	333	1351	1773	0.7619854
zheyou73v0_A02	11096763	11098493	BnaA02T0175600ZY	0	-	139	1258	1730	0.7271676
zheyou73v0_A02	11100188	11103419	BnaA02T0175700ZY	0	-	847	3208	3231	0.9928815
zheyou73v0_A02	11105715	11108262	BnaA02T0175800ZY	0	-	623	2533	2547	0.9945033
zheyou73v0_A02	11110097	11111727	BnaA02T0175900ZY	0	-	429	1621	1630	0.9944785
zheyou73v0_A02	11115627	11116727	BnaA02T0176000ZY	0	-	0	0	1100	0.0000000
zheyou73v0_A02	11117533	11119577	BnaA02T0176100ZY	0	+	700	2044	2044	1.0000000
zheyou73v0_A02	11125366	11125903	BnaA02T0176200ZY	0	-	97	439	537	0.8175046
zheyou73v0_A02	11134297	11135972	BnaA02T0176300ZY	0	+	110	1345	1675	0.8029851
zheyou73v0_A02	11143189	11159745	BnaA02T0176400ZY	0	+	4918	15061	16556	0.9097004
zheyou73v0_A02	11143189	11159745	BnaA02T0176400ZY.1	0	+	4918	15061	16556	0.9097004
zheyou73v0_A02	11143189	11159745	BnaA02T0176400ZY.2	0	+	4918	15061	16556	0.9097004
zheyou73v0_A02	11164098	11166275	BnaA02T0176500ZY	0	+	461	1708	2177	0.7845659
zheyou73v0_A02	11170192	11173619	BnaA02T0176600ZY	0	-	516	2474	3427	0.7219142
zheyou73v0_A02	11178333	11178971	BnaA02T0176700ZY	0	+	55	501	638	0.7852665
zheyou73v0_A02	11186910	11187948	BnaA02T0176800ZY	0	+	33	367	1038	0.3535646
zheyou73v0_A02	11186910	11187948	BnaA02T0176800ZY.1	0	+	33	367	1038	0.3535646
zheyou73v0_A02	11193247	11194787	BnaA02T0176900ZY	0	+	69	1062	1540	0.6896104
zheyou73v0_A02	11193247	11194787	BnaA02T0176900ZY.1	0	+	69	1062	1540	0.6896104
zheyou73v0_A02	11199555	11199935	BnaA02T0177000ZY	0	-	18	83	380	0.2184211
zheyou73v0_A02	11209296	11211458	BnaA02T0177100ZY	0	+	360	1897	2162	0.8774283
zheyou73v0_A02	11212507	11213200	BnaA02T0177200ZY	0	-	5	159	693	0.2294372
zheyou73v0_A02	11213444	11213755	BnaA02T0177300ZY	0	-	1	3	311	0.0096463
zheyou73v0_A02	11219971	11221099	BnaA02T0177400ZY	0	+	67	858	1128	0.7606383
zheyou73v0_A02	11222439	11225104	BnaA02T0177500ZY	0	+	177	1475	2665	0.5534709
zheyou73v0_A02	11231840	11232677	BnaA02T0177600ZY	0	-	47	505	837	0.6033453
zheyou73v0_A02	11232778	11233040	BnaA02T0177700ZY	0	-	0	0	262	0.0000000
zheyou73v0_A02	11234741	11236100	BnaA02T0177800ZY	0	-	299	1359	1359	1.0000000
zheyou73v0_A02	11240872	11245383	BnaA02T0177900ZY	0	+	336	2553	4511	0.5659499
zheyou73v0_A02	11245751	11246768	BnaA02T0178000ZY	0	-	138	838	1017	0.8239921
zheyou73v0_A02	11271026	11272442	BnaA02T0178100ZY	0	+	493	1263	1416	0.8919492
zheyou73v0_A02	11282435	11286007	BnaA02T0178200ZY	0	+	300	1837	3572	0.5142777
zheyou73v0_A02	11287899	11291026	BnaA02T0178300ZY	0	+	1791	3127	3127	1.0000000
zheyou73v0_A02	11292898	11295860	BnaA02T0178400ZY	0	+	154	1724	2962	0.5820392
zheyou73v0_A02	11292898	11295860	BnaA02T0178400ZY.1	0	+	154	1724	2962	0.5820392
zheyou73v0_A02	11297653	11303875	BnaA02T0178500ZY	0	-	938	3836	6222	0.6165220
zheyou73v0_A02	11309283	11311382	BnaA02T0178600ZY	0	-	21	885	2099	0.4216293
zheyou73v0_A02	11309283	11311382	BnaA02T0178600ZY.1	0	-	21	885	2099	0.4216293
zheyou73v0_A02	11315597	11316917	BnaA02T0178700ZY	0	-	183	1178	1320	0.8924242
zheyou73v0_A02	11318376	11323068	BnaA02T0178800ZY	0	-	86	1409	4692	0.3002984
zheyou73v0_A02	11328692	11333088	BnaA02T0178900ZY	0	+	423	3040	4396	0.6915377
zheyou73v0_A02	11333171	11335368	BnaA02T0179000ZY.1	0	-	531	1875	2197	0.8534365
zheyou73v0_A02	11333171	11335368	BnaA02T0179000ZY.2	0	-	531	1875	2197	0.8534365
zheyou73v0_A02	11333372	11335368	BnaA02T0179000ZY	0	-	447	1674	1996	0.8386773
zheyou73v0_A02	11336813	11339344	BnaA02T0179100ZY	0	-	221	1928	2531	0.7617543
zheyou73v0_A02	11340062	11343675	BnaA02T0179200ZY	0	-	159	1911	3613	0.5289233
zheyou73v0_A02	11344658	11348136	BnaA02T0179300ZY	0	+	293	2879	3478	0.8277746
zheyou73v0_A02	11349013	11350906	BnaA02T0179400ZY	0	-	107	1214	1893	0.6413101
zheyou73v0_A02	11354579	11356123	BnaA02T0179500ZY	0	+	154	1386	1544	0.8976684
zheyou73v0_A02	11354579	11356123	BnaA02T0179500ZY.1	0	+	154	1386	1544	0.8976684
zheyou73v0_A02	11360481	11361906	BnaA02T0179600ZY	0	+	64	1114	1425	0.7817544
zheyou73v0_A02	11362313	11366552	BnaA02T0179700ZY	0	-	1278	3955	4239	0.9330031
zheyou73v0_A02	11367621	11369526	BnaA02T0179800ZY	0	+	361	1592	1905	0.8356956
zheyou73v0_A02	11369733	11374302	BnaA02T0179900ZY	0	-	449	2825	4569	0.6182972
zheyou73v0_A02	11370855	11374302	BnaA02T0179900ZY.1	0	-	264	1761	3447	0.5108790
zheyou73v0_A02	11378269	11380492	BnaA02T0180000ZY	0	+	202	1497	2223	0.6734143
zheyou73v0_A02	11380852	11382534	BnaA02T0180100ZY	0	+	27	859	1682	0.5107015
zheyou73v0_A02	11388664	11392076	BnaA02T0180200ZY	0	+	1064	3171	3412	0.9293669
zheyou73v0_A02	11393249	11395545	BnaA02T0180300ZY	0	+	491	1533	2296	0.6676829
zheyou73v0_A02	11396101	11397005	BnaA02T0180400ZY	0	-	57	602	904	0.6659292
zheyou73v0_A02	11400410	11400936	BnaA02T0180500ZY	0	+	2	19	526	0.0361217
zheyou73v0_A02	11403983	11406225	BnaA02T0180600ZY	0	+	46	876	2242	0.3907226
zheyou73v0_A02	11408011	11410371	BnaA02T0180700ZY	0	+	229	1699	2360	0.7199153
zheyou73v0_A02	11410645	11411288	BnaA02T0180800ZY	0	-	71	643	643	1.0000000
zheyou73v0_A02	11413394	11418324	BnaA02T0180900ZY	0	-	691	3361	4930	0.6817444
zheyou73v0_A02	11413394	11418324	BnaA02T0180900ZY.1	0	-	691	3361	4930	0.6817444
zheyou73v0_A02	11422155	11429267	BnaA02T0181000ZY	0	-	816	3283	7112	0.4616142
zheyou73v0_A02	11440658	11443545	BnaA02T0181100ZY	0	+	542	2484	2887	0.8604087
zheyou73v0_A02	11460191	11462754	BnaA02T0181200ZY	0	+	305	1835	2563	0.7159579
zheyou73v0_A02	11472388	11475420	BnaA02T0181300ZY	0	-	255	2056	3032	0.6781003
zheyou73v0_A02	11472450	11472879	BnaA02T0181400ZY	0	+	46	267	429	0.6223776
zheyou73v0_A02	11479818	11481856	BnaA02T0181500ZY	0	-	291	1799	2038	0.8827282
zheyou73v0_A02	11479818	11481856	BnaA02T0181500ZY.1	0	-	291	1799	2038	0.8827282
zheyou73v0_A02	11484399	11488331	BnaA02T0181600ZY	0	-	362	1896	3932	0.4821973
zheyou73v0_A02	11492587	11494112	BnaA02T0181700ZY	0	-	153	936	1525	0.6137705
zheyou73v0_A02	11503647	11506512	BnaA02T0181800ZY	0	+	187	1715	2865	0.5986038
zheyou73v0_A02	11504942	11506512	BnaA02T0181800ZY.1	0	+	92	604	1570	0.3847134
zheyou73v0_A02	11526578	11528028	BnaA02T0181900ZY	0	-	534	1425	1450	0.9827586
zheyou73v0_A02	11534847	11540249	BnaA02T0182000ZY	0	-	662	3676	5402	0.6804887
zheyou73v0_A02	11534847	11540249	BnaA02T0182000ZY.1	0	-	662	3676	5402	0.6804887
zheyou73v0_A02	11534847	11540249	BnaA02T0182000ZY.2	0	-	662	3676	5402	0.6804887
zheyou73v0_A02	11552663	11553337	BnaA02T0182100ZY	0	-	123	674	674	1.0000000
zheyou73v0_A02	11557734	11558961	BnaA02T0182200ZY	0	-	170	810	1227	0.6601467
zheyou73v0_A02	11560479	11561934	BnaA02T0182300ZY	0	-	386	1353	1455	0.9298969
zheyou73v0_A02	11566411	11566942	BnaA02T0182400ZY	0	-	138	531	531	1.0000000
zheyou73v0_A02	11568101	11568689	BnaA02T0182500ZY	0	-	424	588	588	1.0000000
zheyou73v0_A02	11569480	11570242	BnaA02T0182600ZY	0	+	112	617	762	0.8097113
zheyou73v0_A02	11574399	11577633	BnaA02T0182700ZY	0	+	300	1849	3234	0.5717378
zheyou73v0_A02	11578960	11581319	BnaA02T0182800ZY	0	-	151	598	2359	0.2534972
zheyou73v0_A02	11578960	11581330	BnaA02T0182800ZY.1	0	-	151	598	2370	0.2523207
zheyou73v0_A02	11587274	11590122	BnaA02T0182900ZY	0	-	331	1558	2848	0.5470505
zheyou73v0_A02	11599791	11603355	BnaA02T0183000ZY	0	-	149	1602	3564	0.4494950
zheyou73v0_A02	11599791	11603355	BnaA02T0183000ZY.1	0	-	149	1602	3564	0.4494950
zheyou73v0_A02	11606434	11609437	BnaA02T0183100ZY	0	+	133	1731	3003	0.5764236
zheyou73v0_A02	11610443	11611628	BnaA02T0183200ZY	0	-	172	761	1185	0.6421941
zheyou73v0_A02	11613452	11615336	BnaA02T0183300ZY	0	-	153	975	1884	0.5175159
zheyou73v0_A02	11613452	11615123	BnaA02T0183300ZY.1	0	-	89	762	1671	0.4560144
zheyou73v0_A02	11613452	11615336	BnaA02T0183300ZY.2	0	-	153	975	1884	0.5175159
zheyou73v0_A02	11618075	11618886	BnaA02T0183400ZY	0	-	200	793	811	0.9778052
zheyou73v0_A02	11621105	11623208	BnaA02T0183500ZY	0	-	0	0	2103	0.0000000
zheyou73v0_A02	11628859	11629648	BnaA02T0183600ZY	0	-	37	384	789	0.4866920
zheyou73v0_A02	11660247	11661645	BnaA02T0183700ZY	0	+	3	85	1398	0.0608011
zheyou73v0_A02	11662123	11664552	BnaA02T0183800ZY	0	-	107	1051	2429	0.4326884
zheyou73v0_A02	11668528	11668990	BnaA02T0183900ZY	0	+	9	277	462	0.5995671
zheyou73v0_A02	11670808	11671807	BnaA02T0184000ZY	0	-	6	209	999	0.2092092
zheyou73v0_A02	11679104	11687521	BnaA02T0184100ZY	0	-	20	140	8417	0.0166330
zheyou73v0_A02	11702864	11704867	BnaA02T0184200ZY	0	-	37	861	2003	0.4298552
zheyou73v0_A02	11733499	11736128	BnaA02T0184300ZY	0	+	135	1411	2629	0.5367060
zheyou73v0_A02	11741454	11743763	BnaA02T0184400ZY	0	-	182	1625	2309	0.7037678
zheyou73v0_A02	11746112	11757052	BnaA02T0184500ZY	0	-	633	4533	10940	0.4143510
zheyou73v0_A02	11757461	11760062	BnaA02T0184600ZY	0	-	22	418	2601	0.1607074
zheyou73v0_A02	11757461	11759670	BnaA02T0184600ZY.1	0	-	18	263	2209	0.1190584
zheyou73v0_A02	11762507	11764202	BnaA02T0184700ZY	0	+	38	830	1695	0.4896755
zheyou73v0_A02	11765698	11766135	BnaA02T0184800ZY	0	+	0	0	437	0.0000000
zheyou73v0_A02	11774974	11776882	BnaA02T0184900ZY	0	+	44	407	1908	0.2133124
zheyou73v0_A02	11791802	11793797	BnaA02T0185000ZY	0	+	106	839	1995	0.4205514
zheyou73v0_A02	11815235	11816612	BnaA02T0185100ZY	0	+	7	321	1377	0.2331155
zheyou73v0_A02	11846717	11847777	BnaA02T0185200ZY	0	+	674	1060	1060	1.0000000
zheyou73v0_A02	11850841	11852404	BnaA02T0185300ZY	0	-	666	1518	1563	0.9712092
zheyou73v0_A02	11863652	11864927	BnaA02T0185400ZY	0	-	35	496	1275	0.3890196
zheyou73v0_A02	11881546	11883333	BnaA02T0185500ZY	0	+	45	247	1787	0.1382205
zheyou73v0_A02	11893325	11894827	BnaA02T0185600ZY	0	+	276	889	1502	0.5918775
zheyou73v0_A02	11911936	11912173	BnaA02T0185700ZY	0	-	122	237	237	1.0000000
zheyou73v0_A02	11919131	11920384	BnaA02T0185800ZY	0	+	36	78	1253	0.0622506
zheyou73v0_A02	11926103	11926756	BnaA02T0185900ZY	0	+	34	477	653	0.7304747
zheyou73v0_A02	11929360	11930460	BnaA02T0186000ZY	0	-	5	33	1100	0.0300000
zheyou73v0_A02	11932246	11932622	BnaA02T0186100ZY	0	+	21	265	376	0.7047873
zheyou73v0_A02	11940336	11943540	BnaA02T0186200ZY	0	+	8	325	3204	0.1014357
zheyou73v0_A02	11947615	11958823	BnaA02T0186300ZY	0	+	429	5181	11208	0.4622591
zheyou73v0_A02	11990008	11991775	BnaA02T0186400ZY	0	+	138	1252	1767	0.7085456
zheyou73v0_A02	11999419	12003498	BnaA02T0186500ZY	0	-	1645	3901	4079	0.9563618
zheyou73v0_A02	12041231	12041936	BnaA02T0186600ZY	0	+	237	648	705	0.9191489
zheyou73v0_A02	12042039	12045036	BnaA02T0186700ZY	0	-	391	2226	2997	0.7427427
zheyou73v0_A02	12042039	12044544	BnaA02T0186700ZY.1	0	-	367	1749	2505	0.6982036
zheyou73v0_A02	12074522	12082613	BnaA02T0186800ZY	0	-	2448	6509	8091	0.8044741
zheyou73v0_A02	12100622	12103314	BnaA02T0186900ZY	0	+	354	1700	2692	0.6315007
zheyou73v0_A02	12100622	12103314	BnaA02T0186900ZY.1	0	+	354	1700	2692	0.6315007
zheyou73v0_A02	12107923	12110530	BnaA02T0187000ZY	0	+	353	1984	2607	0.7610280
zheyou73v0_A02	12115671	12132050	BnaA02T0187100ZY	0	-	4399	12783	16379	0.7804506
zheyou73v0_A02	12121523	12122881	BnaA02T0187200ZY	0	-	231	1252	1358	0.9219440
zheyou73v0_A02	12126201	12126592	BnaA02T0187300ZY	0	+	531	391	391	1.0000000
zheyou73v0_A02	12143085	12144413	BnaA02T0187400ZY	0	+	10	292	1328	0.2198795
zheyou73v0_A02	12159359	12166321	BnaA02T0187500ZY	0	-	559	2957	6962	0.4247343
zheyou73v0_A02	12172730	12194724	BnaA02T0187600ZY	0	-	1375	9053	21994	0.4116123
zheyou73v0_A02	12213236	12215245	BnaA02T0187700ZY	0	+	468	1759	2009	0.8755600
zheyou73v0_A02	12216578	12218683	BnaA02T0187800ZY	0	+	211	1503	2105	0.7140142
zheyou73v0_A02	12228264	12228744	BnaA02T0187900ZY	0	-	133	480	480	1.0000000
zheyou73v0_A02	12245063	12247399	BnaA02T0188000ZY	0	+	351	1626	2336	0.6960617
zheyou73v0_A02	12245063	12247399	BnaA02T0188000ZY.1	0	+	351	1626	2336	0.6960617
zheyou73v0_A02	12250636	12254410	BnaA02T0188100ZY	0	+	626	2584	3774	0.6846847
zheyou73v0_A02	12255227	12259704	BnaA02T0188200ZY	0	-	880	3812	4477	0.8514630
zheyou73v0_A02	12261952	12263232	BnaA02T0188300ZY	0	-	533	1280	1280	1.0000000
zheyou73v0_A02	12267646	12268944	BnaA02T0188400ZY	0	-	73	1061	1298	0.8174114
zheyou73v0_A02	12274652	12277528	BnaA02T0188500ZY	0	-	292	1556	2876	0.5410292
zheyou73v0_A02	12293264	12295555	BnaA02T0188600ZY	0	-	68	874	2291	0.3814928
zheyou73v0_A02	12301432	12306238	BnaA02T0188700ZY	0	-	462	3219	4806	0.6697878
zheyou73v0_A02	12307284	12310656	BnaA02T0188800ZY	0	-	213	1521	3372	0.4510676
zheyou73v0_A02	12314265	12315391	BnaA02T0188900ZY	0	+	38	250	1126	0.2220249
zheyou73v0_A02	12354347	12356217	BnaA02T0189000ZY	0	+	134	689	1870	0.3684492
zheyou73v0_A02	12358002	12358429	BnaA02T0189100ZY	0	+	49	178	427	0.4168618
zheyou73v0_A02	12359068	12360234	BnaA02T0189200ZY	0	-	84	691	1166	0.5926244
zheyou73v0_A02	12365382	12369113	BnaA02T0189300ZY	0	-	1629	3684	3731	0.9874029
zheyou73v0_A02	12369702	12371217	BnaA02T0189400ZY	0	-	243	1394	1515	0.9201320
zheyou73v0_A02	12372442	12373787	BnaA02T0189500ZY	0	+	268	1320	1345	0.9814126
zheyou73v0_A02	12387694	12389273	BnaA02T0189600ZY	0	+	107	1051	1579	0.6656111
zheyou73v0_A02	12395522	12396374	BnaA02T0189700ZY	0	+	456	852	852	1.0000000
zheyou73v0_A02	12398346	12400134	BnaA02T0189800ZY	0	-	241	1367	1788	0.7645414
zheyou73v0_A02	12402061	12406123	BnaA02T0189900ZY	0	+	164	1580	4062	0.3889709
zheyou73v0_A02	12406904	12409359	BnaA02T0190000ZY	0	-	881	1745	2455	0.7107943
zheyou73v0_A02	12412354	12417204	BnaA02T0190100ZY	0	+	408	2123	4850	0.4377320
zheyou73v0_A02	12412354	12417204	BnaA02T0190100ZY.1	0	+	408	2123	4850	0.4377320
zheyou73v0_A02	12423281	12430037	BnaA02T0190200ZY	0	+	229	2363	6756	0.3497632
zheyou73v0_A02	12432019	12434678	BnaA02T0190300ZY	0	-	110	990	2659	0.3723204
zheyou73v0_A02	12438895	12440515	BnaA02T0190400ZY	0	-	14	566	1620	0.3493827
zheyou73v0_A02	12443481	12445232	BnaA02T0190500ZY	0	-	23	189	1751	0.1079383
zheyou73v0_A02	12443481	12444905	BnaA02T0190500ZY.1	0	-	0	0	1424	0.0000000
zheyou73v0_A02	12456083	12457327	BnaA02T0190600ZY	0	-	114	1077	1244	0.8657556
zheyou73v0_A02	12460809	12464325	BnaA02T0190700ZY	0	-	192	1361	3516	0.3870876
zheyou73v0_A02	12466985	12469205	BnaA02T0190800ZY	0	-	39	586	2220	0.2639640
zheyou73v0_A02	12473018	12473962	BnaA02T0190900ZY	0	+	2	82	944	0.0868644
zheyou73v0_A02	12479688	12481657	BnaA02T0191000ZY	0	+	186	1153	1969	0.5855764
zheyou73v0_A02	12482471	12483138	BnaA02T0191100ZY	0	-	8	335	667	0.5022489
zheyou73v0_A02	12490387	12492706	BnaA02T0191200ZY	0	+	74	562	2319	0.2423458
zheyou73v0_A02	12500495	12502411	BnaA02T0191300ZY	0	+	1	100	1916	0.0521921
zheyou73v0_A02	12508009	12508537	BnaA02T0191400ZY	0	-	111	474	528	0.8977273
zheyou73v0_A02	12513534	12514055	BnaA02T0191500ZY	0	+	47	207	521	0.3973128
zheyou73v0_A02	12530950	12531892	BnaA02T0191600ZY	0	+	35	418	942	0.4437367
zheyou73v0_A02	12538726	12540127	BnaA02T0191700ZY	0	+	170	1185	1401	0.8458244
zheyou73v0_A02	12540226	12545208	BnaA02T0191800ZY	0	-	2291	4708	4982	0.9450020
zheyou73v0_A02	12546890	12550273	BnaA02T0191900ZY	0	+	978	2916	3383	0.8619568
zheyou73v0_A02	12547641	12550273	BnaA02T0191900ZY.1	0	+	832	2178	2632	0.8275076
zheyou73v0_A02	12556598	12557845	BnaA02T0192000ZY	0	-	13	663	1247	0.5316760
zheyou73v0_A02	12561280	12561607	BnaA02T0192100ZY	0	+	143	327	327	1.0000000
zheyou73v0_A02	12568783	12569470	BnaA02T0192200ZY	0	-	209	587	687	0.8544396
zheyou73v0_A02	12571367	12572246	BnaA02T0192300ZY	0	-	75	833	879	0.9476678
zheyou73v0_A02	12575348	12575630	BnaA02T0192400ZY	0	+	0	0	282	0.0000000
zheyou73v0_A02	12576388	12577918	BnaA02T0192500ZY	0	+	14	263	1530	0.1718954
zheyou73v0_A02	12576388	12577918	BnaA02T0192500ZY.1	0	+	14	263	1530	0.1718954
zheyou73v0_A02	12578843	12581102	BnaA02T0192600ZY	0	+	571	2154	2259	0.9535193
zheyou73v0_A02	12583051	12585124	BnaA02T0192700ZY	0	+	243	1790	2073	0.8634829
zheyou73v0_A02	12586595	12587858	BnaA02T0192800ZY	0	+	440	1211	1263	0.9588282
zheyou73v0_A02	12592601	12595250	BnaA02T0192900ZY	0	+	161	1934	2649	0.7300868
zheyou73v0_A02	12598845	12600573	BnaA02T0193000ZY	0	-	781	1691	1728	0.9785880
zheyou73v0_A02	12598845	12600573	BnaA02T0193000ZY.1	0	-	781	1691	1728	0.9785880
zheyou73v0_A02	12601518	12602110	BnaA02T0193100ZY	0	+	0	0	592	0.0000000
zheyou73v0_A02	12602270	12604039	BnaA02T0193200ZY	0	-	359	1661	1769	0.9389486
zheyou73v0_A02	12605757	12606228	BnaA02T0193300ZY	0	-	198	471	471	1.0000000
zheyou73v0_A02	12610998	12611546	BnaA02T0193400ZY	0	-	205	386	548	0.7043796
zheyou73v0_A02	12614482	12615744	BnaA02T0193500ZY	0	+	84	1141	1262	0.9041204
zheyou73v0_A02	12615879	12619746	BnaA02T0193600ZY	0	-	776	2597	3867	0.6715800
zheyou73v0_A02	12623276	12634186	BnaA02T0193700ZY	0	+	1583	7382	10910	0.6766269
zheyou73v0_A02	12636838	12640218	BnaA02T0193800ZY	0	+	1408	3094	3380	0.9153846
zheyou73v0_A02	12646720	12648244	BnaA02T0193900ZY	0	+	1288	1524	1524	1.0000000
zheyou73v0_A02	12649891	12652225	BnaA02T0194000ZY	0	+	1481	2334	2334	1.0000000
zheyou73v0_A02	12652988	12654995	BnaA02T0194100ZY	0	+	516	1666	2007	0.8300947
zheyou73v0_A02	12665080	12667807	BnaA02T0194200ZY	0	+	542	2322	2727	0.8514851
zheyou73v0_A02	12669095	12670154	BnaA02T0194300ZY	0	+	49	498	1059	0.4702550
zheyou73v0_A02	12671034	12672210	BnaA02T0194400ZY	0	+	0	0	1176	0.0000000
zheyou73v0_A02	12676037	12676490	BnaA02T0194500ZY	0	-	0	0	453	0.0000000
zheyou73v0_A02	12685550	12690482	BnaA02T0194600ZY	0	+	282	2763	4932	0.5602190
zheyou73v0_A02	12695753	12696192	BnaA02T0194700ZY	0	+	27	430	439	0.9794989
zheyou73v0_A02	12696507	12697690	BnaA02T0194800ZY.1	0	-	135	1053	1183	0.8901099
zheyou73v0_A02	12696510	12697690	BnaA02T0194800ZY	0	-	134	1050	1180	0.8898305
zheyou73v0_A02	12717691	12719184	BnaA02T0194900ZY	0	+	211	1163	1493	0.7789685
zheyou73v0_A02	12717691	12719265	BnaA02T0194900ZY.1	0	+	213	1186	1574	0.7534943
zheyou73v0_A02	12722551	12723978	BnaA02T0195000ZY	0	+	26	383	1427	0.2683952
zheyou73v0_A02	12731884	12732676	BnaA02T0195100ZY	0	+	2	93	792	0.1174242
zheyou73v0_A02	12738553	12739758	BnaA02T0195200ZY	0	-	267	1151	1205	0.9551867
zheyou73v0_A02	12742278	12742449	BnaA02T0195300ZY	0	+	26	171	171	1.0000000
zheyou73v0_A02	12754763	12755906	BnaA02T0195400ZY	0	-	0	0	1143	0.0000000
zheyou73v0_A02	12754763	12755906	BnaA02T0195400ZY.1	0	-	0	0	1143	0.0000000
zheyou73v0_A02	12754763	12755906	BnaA02T0195400ZY.2	0	-	0	0	1143	0.0000000
zheyou73v0_A02	12766692	12767585	BnaA02T0195500ZY	0	-	0	0	893	0.0000000
zheyou73v0_A02	12781044	12783043	BnaA02T0195600ZY	0	-	173	1817	1999	0.9089545
zheyou73v0_A02	12788760	12791041	BnaA02T0195700ZY	0	+	317	1630	2281	0.7145988
zheyou73v0_A02	12792297	12795851	BnaA02T0195800ZY	0	-	456	2143	3554	0.6029826
zheyou73v0_A02	12803778	12806593	BnaA02T0195900ZY	0	-	589	2719	2815	0.9658970
zheyou73v0_A02	12810902	12811346	BnaA02T0196000ZY	0	-	41	154	444	0.3468468
zheyou73v0_A02	12818163	12819472	BnaA02T0196100ZY	0	+	199	845	1309	0.6455309
zheyou73v0_A02	12829130	12829837	BnaA02T0196200ZY	0	-	108	561	707	0.7934936
zheyou73v0_A02	12840998	12842045	BnaA02T0196300ZY	0	-	7	298	1047	0.2846227
zheyou73v0_A02	12847279	12860995	BnaA02T0196400ZY	0	-	2007	9339	13716	0.6808836
zheyou73v0_A02	12888342	12889673	BnaA02T0196500ZY	0	+	257	766	1331	0.5755072
zheyou73v0_A02	12904351	12905030	BnaA02T0196600ZY	0	+	159	425	679	0.6259205
zheyou73v0_A02	12914005	12916130	BnaA02T0196700ZY	0	-	494	813	2125	0.3825882
zheyou73v0_A02	12927350	12927935	BnaA02T0196800ZY	0	-	126	583	585	0.9965812
zheyou73v0_A02	12940265	12941216	BnaA02T0196900ZY	0	-	12	374	951	0.3932703
zheyou73v0_A02	12941330	12941671	BnaA02T0197000ZY	0	-	34	297	341	0.8709677
zheyou73v0_A02	12954072	12958196	BnaA02T0197100ZY	0	-	140	2163	4124	0.5244908
zheyou73v0_A02	12995914	12999761	BnaA02T0197200ZY	0	+	133	1842	3847	0.4788147
zheyou73v0_A02	13013449	13014015	BnaA02T0197300ZY	0	+	60	540	566	0.9540636
zheyou73v0_A02	13014163	13014674	BnaA02T0197400ZY	0	-	7	83	511	0.1624266
zheyou73v0_A02	13023685	13024929	BnaA02T0197500ZY	0	+	232	1142	1244	0.9180064
zheyou73v0_A02	13027526	13028987	BnaA02T0197600ZY	0	-	299	1233	1461	0.8439425
zheyou73v0_A02	13034278	13036181	BnaA02T0197700ZY	0	+	61	1210	1903	0.6358382
zheyou73v0_A02	13042078	13046409	BnaA02T0197800ZY	0	+	230	1748	4331	0.4036019
zheyou73v0_A02	13046989	13047824	BnaA02T0197900ZY	0	-	48	512	835	0.6131737
zheyou73v0_A02	13048038	13053862	BnaA02T0198000ZY	0	-	870	3410	5824	0.5855082
zheyou73v0_A02	13087209	13087715	BnaA02T0198100ZY	0	+	24	394	506	0.7786561
zheyou73v0_A02	13088088	13088295	BnaA02T0198200ZY	0	+	0	0	207	0.0000000
zheyou73v0_A02	13091740	13092110	BnaA02T0198300ZY	0	-	0	0	370	0.0000000
zheyou73v0_A02	13095196	13098856	BnaA02T0198400ZY	0	-	731	2888	3660	0.7890710
zheyou73v0_A02	13109834	13110238	BnaA02T0198500ZY	0	-	153	404	404	1.0000000
zheyou73v0_A02	13125652	13126423	BnaA02T0198600ZY	0	-	0	0	771	0.0000000
zheyou73v0_A02	13138086	13138353	BnaA02T0198700ZY	0	-	0	0	267	0.0000000
zheyou73v0_A02	13139440	13139737	BnaA02T0198800ZY	0	-	0	0	297	0.0000000
zheyou73v0_A02	13148793	13149144	BnaA02T0198900ZY	0	+	0	0	351	0.0000000
zheyou73v0_A02	13163689	13170299	BnaA02T0199000ZY	0	-	4	279	6610	0.0422088
zheyou73v0_A02	13179141	13180253	BnaA02T0199100ZY	0	-	14	544	1112	0.4892086
zheyou73v0_A02	13197708	13199915	BnaA02T0199200ZY	0	+	276	1618	2207	0.7331219
zheyou73v0_A02	13214662	13215069	BnaA02T0199300ZY	0	-	0	0	407	0.0000000
zheyou73v0_A02	13230890	13231445	BnaA02T0199400ZY	0	-	0	0	555	0.0000000
zheyou73v0_A02	13272135	13273560	BnaA02T0199500ZY	0	-	0	0	1425	0.0000000
zheyou73v0_A02	13274769	13277205	BnaA02T0199600ZY	0	+	363	2105	2436	0.8641215
zheyou73v0_A02	13280833	13283339	BnaA02T0199700ZY	0	+	892	2457	2506	0.9804469
zheyou73v0_A02	13292024	13293273	BnaA02T0199800ZY	0	+	59	488	1249	0.3907126
zheyou73v0_A02	13298878	13300601	BnaA02T0199900ZY	0	-	63	1219	1723	0.7074869
zheyou73v0_A02	13317646	13318255	BnaA02T0200000ZY	0	+	29	386	609	0.6338260
zheyou73v0_A02	13321073	13321664	BnaA02T0200100ZY	0	+	11	229	591	0.3874789
zheyou73v0_A02	13322202	13322376	BnaA02T0200200ZY	0	-	17	126	174	0.7241379
zheyou73v0_A02	13323088	13324631	BnaA02T0200300ZY	0	-	73	982	1543	0.6364226
zheyou73v0_A02	13335769	13336239	BnaA02T0200400ZY	0	+	27	338	470	0.7191489
zheyou73v0_A02	13338764	13348193	BnaA02T0200500ZY	0	+	5788	9429	9429	1.0000000
zheyou73v0_A02	13350376	13352986	BnaA02T0200600ZY	0	-	195	1854	2610	0.7103449
zheyou73v0_A02	13354169	13354337	BnaA02T0200700ZY	0	+	71	168	168	1.0000000
zheyou73v0_A02	13375064	13377734	BnaA02T0200800ZY	0	+	969	2222	2670	0.8322098
zheyou73v0_A02	13378981	13379617	BnaA02T0200900ZY	0	-	776	636	636	1.0000000
zheyou73v0_A02	13379937	13381572	BnaA02T0201000ZY	0	-	440	1556	1635	0.9516820
zheyou73v0_A02	13382493	13384526	BnaA02T0201100ZY	0	+	251	1517	2033	0.7461879
zheyou73v0_A02	13385580	13387186	BnaA02T0201200ZY	0	+	258	1366	1606	0.8505604
zheyou73v0_A02	13387621	13389408	BnaA02T0201300ZY	0	-	77	965	1787	0.5400112
zheyou73v0_A02	13409852	13412204	BnaA02T0201400ZY	0	+	161	1823	2352	0.7750850
zheyou73v0_A02	13414020	13414305	BnaA02T0201500ZY	0	+	39	235	285	0.8245614
zheyou73v0_A02	13417506	13418742	BnaA02T0201600ZY	0	-	113	916	1236	0.7411003
zheyou73v0_A02	13422591	13426363	BnaA02T0201700ZY	0	-	399	1951	3772	0.5172322
zheyou73v0_A02	13427797	13431544	BnaA02T0201800ZY	0	-	374	1177	3747	0.3141180
zheyou73v0_A02	13453430	13454603	BnaA02T0201900ZY	0	+	227	926	1173	0.7894288
zheyou73v0_A02	13461643	13463067	BnaA02T0202000ZY	0	+	100	774	1424	0.5435393
zheyou73v0_A02	13475878	13478205	BnaA02T0202100ZY	0	+	71	1054	2327	0.4529437
zheyou73v0_A02	13486658	13488104	BnaA02T0202200ZY	0	-	245	1208	1446	0.8354080
zheyou73v0_A02	13488421	13493822	BnaA02T0202300ZY	0	-	265	2671	5401	0.4945380
zheyou73v0_A02	13494303	13495922	BnaA02T0202400ZY	0	-	24	502	1619	0.3100680
zheyou73v0_A02	13494303	13495922	BnaA02T0202400ZY.1	0	-	24	502	1619	0.3100680
zheyou73v0_A02	13497795	13498371	BnaA02T0202500ZY	0	-	20	144	576	0.2500000
zheyou73v0_A02	13509473	13512031	BnaA02T0202600ZY	0	+	202	1868	2558	0.7302580
zheyou73v0_A02	13513863	13518115	BnaA02T0202700ZY	0	+	716	2956	4252	0.6952022
zheyou73v0_A02	13519751	13521736	BnaA02T0202800ZY	0	-	93	1272	1985	0.6408060
zheyou73v0_A02	13529298	13531562	BnaA02T0202900ZY	0	-	234	1593	2264	0.7036219
zheyou73v0_A02	13532910	13534542	BnaA02T0203000ZY	0	-	259	1256	1632	0.7696078
zheyou73v0_A02	13544257	13546154	BnaA02T0203100ZY	0	-	26	690	1897	0.3637322
zheyou73v0_A02	13553778	13554705	BnaA02T0203200ZY	0	+	145	874	927	0.9428263
zheyou73v0_A02	13555858	13558866	BnaA02T0203300ZY	0	+	466	1813	3008	0.6027260
zheyou73v0_A02	13560060	13561054	BnaA02T0203400ZY	0	-	182	854	994	0.8591549
zheyou73v0_A02	13562534	13564516	BnaA02T0203500ZY	0	-	587	1704	1982	0.8597376
zheyou73v0_A02	13564819	13566450	BnaA02T0203600ZY	0	+	139	1079	1631	0.6615573
zheyou73v0_A02	13566912	13569308	BnaA02T0203700ZY	0	+	81	1097	2396	0.4578464
zheyou73v0_A02	13569660	13570318	BnaA02T0203800ZY	0	+	384	658	658	1.0000000
zheyou73v0_A02	13575470	13578363	BnaA02T0203900ZY	0	+	403	2340	2893	0.8088489
zheyou73v0_A02	13594116	13595500	BnaA02T0204000ZY	0	+	92	997	1384	0.7203757
zheyou73v0_A02	13647866	13648878	BnaA02T0204100ZY	0	+	74	792	1012	0.7826087
zheyou73v0_A02	13656682	13656955	BnaA02T0204200ZY	0	-	2	75	273	0.2747253
zheyou73v0_A02	13661456	13661941	BnaA02T0204300ZY	0	-	34	457	485	0.9422680
zheyou73v0_A02	13668981	13670917	BnaA02T0204400ZY	0	+	399	1820	1936	0.9400827
zheyou73v0_A02	13685209	13687123	BnaA02T0204500ZY	0	+	81	1245	1914	0.6504702
zheyou73v0_A02	13695835	13696521	BnaA02T0204600ZY	0	+	2	102	686	0.1486880
zheyou73v0_A02	13699948	13700377	BnaA02T0204700ZY	0	+	0	0	429	0.0000000
zheyou73v0_A02	13705721	13706854	BnaA02T0204800ZY	0	+	195	688	1133	0.6072374
zheyou73v0_A02	13714561	13717591	BnaA02T0204900ZY	0	+	577	2726	3030	0.8996699
zheyou73v0_A02	13718236	13719107	BnaA02T0205000ZY	0	+	11	97	871	0.1113662
zheyou73v0_A02	13720322	13721873	BnaA02T0205100ZY	0	-	436	1231	1551	0.7936815
zheyou73v0_A02	13726463	13727791	BnaA02T0205200ZY	0	-	660	1328	1328	1.0000000
zheyou73v0_A02	13729125	13743956	BnaA02T0205300ZY	0	-	3204	8559	14831	0.5771020
zheyou73v0_A02	13756286	13757252	BnaA02T0205400ZY	0	+	2	125	966	0.1293996
zheyou73v0_A02	13762719	13771123	BnaA02T0205500ZY	0	+	724	4253	8404	0.5060685
zheyou73v0_A02	13773330	13774051	BnaA02T0205600ZY	0	+	52	681	721	0.9445215
zheyou73v0_A02	13775329	13775663	BnaA02T0205700ZY	0	+	45	334	334	1.0000000
zheyou73v0_A02	13788733	13789596	BnaA02T0205800ZY	0	-	83	754	863	0.8736964
zheyou73v0_A02	13812263	13812712	BnaA02T0205900ZY	0	-	179	449	449	1.0000000
zheyou73v0_A02	13820502	13822611	BnaA02T0206000ZY	0	+	164	1298	2109	0.6154575
zheyou73v0_A02	13831004	13838104	BnaA02T0206100ZY	0	-	1618	4540	7100	0.6394366
zheyou73v0_A02	13841442	13860449	BnaA02T0206200ZY	0	-	643	4173	19007	0.2195507
zheyou73v0_A02	13866740	13867947	BnaA02T0206300ZY	0	-	39	657	1207	0.5443248
zheyou73v0_A02	13876764	13880467	BnaA02T0206400ZY	0	-	51	1841	3703	0.4971645
zheyou73v0_A02	13887472	13894216	BnaA02T0206500ZY	0	+	1230	5415	6744	0.8029360
zheyou73v0_A02	13895255	13896575	BnaA02T0206600ZY	0	-	10	378	1320	0.2863636
zheyou73v0_A02	13897152	13898875	BnaA02T0206700ZY	0	-	40	900	1723	0.5223448
zheyou73v0_A02	13904079	13904850	BnaA02T0206800ZY	0	-	12	508	771	0.6588846
zheyou73v0_A02	13909759	13911048	BnaA02T0206900ZY	0	-	31	377	1289	0.2924748
zheyou73v0_A02	13919794	13920436	BnaA02T0207000ZY	0	-	0	0	642	0.0000000
zheyou73v0_A02	13920677	13921070	BnaA02T0207100ZY	0	-	0	0	393	0.0000000
zheyou73v0_A02	13933946	13935545	BnaA02T0207200ZY	0	-	545	1389	1599	0.8686679
zheyou73v0_A02	13945056	13946015	BnaA02T0207300ZY	0	-	29	363	959	0.3785193
zheyou73v0_A02	13958686	13961249	BnaA02T0207400ZY	0	+	304	1414	2563	0.5516973
zheyou73v0_A02	13988547	13990842	BnaA02T0207500ZY	0	+	120	1000	2295	0.4357299
zheyou73v0_A02	13992170	13992624	BnaA02T0207600ZY	0	+	2	18	454	0.0396476
zheyou73v0_A02	13995054	13997323	BnaA02T0207700ZY	0	+	198	1788	2269	0.7880123
zheyou73v0_A02	14001280	14004080	BnaA02T0207800ZY	0	+	766	2489	2800	0.8889286
zheyou73v0_A02	14012185	14014642	BnaA02T0207900ZY	0	+	97	1802	2457	0.7334147
zheyou73v0_A02	14019172	14019856	BnaA02T0208000ZY	0	+	27	505	684	0.7383041
zheyou73v0_A02	14031673	14033350	BnaA02T0208100ZY	0	-	354	1672	1677	0.9970185
zheyou73v0_A02	14035230	14037482	BnaA02T0208200ZY	0	+	374	766	2252	0.3401421
zheyou73v0_A02	14040470	14042848	BnaA02T0208300ZY	0	-	601	1680	2378	0.7064760
zheyou73v0_A02	14040470	14042848	BnaA02T0208300ZY.1	0	-	601	1680	2378	0.7064760
zheyou73v0_A02	14040470	14042848	BnaA02T0208300ZY.2	0	-	601	1680	2378	0.7064760
zheyou73v0_A02	14040470	14042848	BnaA02T0208300ZY.3	0	-	601	1680	2378	0.7064760
zheyou73v0_A02	14054460	14054991	BnaA02T0208400ZY	0	+	1	117	531	0.2203390
zheyou73v0_A02	14056497	14060513	BnaA02T0208500ZY	0	-	274	2363	4016	0.5883964
zheyou73v0_A02	14068307	14084993	BnaA02T0208600ZY	0	-	1902	8456	16686	0.5067722
zheyou73v0_A02	14085949	14090469	BnaA02T0208700ZY	0	-	625	3292	4520	0.7283186
zheyou73v0_A02	14097926	14099964	BnaA02T0208800ZY	0	+	211	1134	2038	0.5564279
zheyou73v0_A02	14101036	14102157	BnaA02T0208900ZY	0	-	59	630	1121	0.5619982
zheyou73v0_A02	14102716	14106866	BnaA02T0209000ZY	0	-	1076	3503	4150	0.8440964
zheyou73v0_A02	14109098	14110033	BnaA02T0209100ZY	0	-	68	917	935	0.9807487
zheyou73v0_A02	14117101	14120592	BnaA02T0209200ZY	0	+	436	3298	3491	0.9447150
zheyou73v0_A02	14121659	14124853	BnaA02T0209300ZY	0	+	914	3127	3194	0.9790232
zheyou73v0_A02	14125197	14125712	BnaA02T0209400ZY	0	-	70	394	515	0.7650486
zheyou73v0_A02	14127724	14129610	BnaA02T0209500ZY	0	-	714	1886	1886	1.0000000
zheyou73v0_A02	14133065	14134019	BnaA02T0209600ZY	0	-	198	865	954	0.9067086
zheyou73v0_A02	14137645	14139761	BnaA02T0209700ZY	0	+	721	1935	2116	0.9144613
zheyou73v0_A02	14157598	14163214	BnaA02T0209800ZY	0	+	1095	4546	5616	0.8094729
zheyou73v0_A02	14165526	14165979	BnaA02T0209900ZY	0	-	3	86	453	0.1898455
zheyou73v0_A02	14166412	14168073	BnaA02T0210000ZY	0	-	258	1534	1661	0.9235401
zheyou73v0_A02	14174456	14174957	BnaA02T0210100ZY	0	+	9	55	501	0.1097804
zheyou73v0_A02	14181919	14185142	BnaA02T0210200ZY	0	+	440	2736	3223	0.8488985
zheyou73v0_A02	14182503	14185142	BnaA02T0210200ZY.1	0	+	417	2214	2639	0.8389542
zheyou73v0_A02	14209006	14211645	BnaA02T0210300ZY	0	+	241	2123	2639	0.8044714
zheyou73v0_A02	14209006	14211645	BnaA02T0210300ZY.1	0	+	241	2123	2639	0.8044714
zheyou73v0_A02	14226546	14229187	BnaA02T0210400ZY	0	+	1071	2468	2641	0.9344945
zheyou73v0_A02	14239188	14240474	BnaA02T0210500ZY	0	+	0	0	1286	0.0000000
zheyou73v0_A02	14242155	14242524	BnaA02T0210600ZY	0	+	2	130	369	0.3523035
zheyou73v0_A02	14244030	14244270	BnaA02T0210700ZY	0	+	0	0	240	0.0000000
zheyou73v0_A02	14248414	14249700	BnaA02T0210800ZY	0	+	0	0	1286	0.0000000
zheyou73v0_A02	14251381	14251751	BnaA02T0210900ZY	0	+	41	370	370	1.0000000
zheyou73v0_A02	14253257	14253497	BnaA02T0211000ZY	0	+	45	240	240	1.0000000
zheyou73v0_A02	14255032	14259223	BnaA02T0211100ZY	0	+	531	3693	4191	0.8811740
zheyou73v0_A02	14255032	14259223	BnaA02T0211100ZY.1	0	+	531	3693	4191	0.8811740
zheyou73v0_A02	14255032	14259223	BnaA02T0211100ZY.2	0	+	531	3693	4191	0.8811740
zheyou73v0_A02	14259694	14261628	BnaA02T0211200ZY	0	+	355	1333	1934	0.6892451
zheyou73v0_A02	14259694	14261628	BnaA02T0211200ZY.1	0	+	355	1333	1934	0.6892451
zheyou73v0_A02	14264212	14265852	BnaA02T0211300ZY	0	+	544	1297	1640	0.7908537
zheyou73v0_A02	14278002	14279445	BnaA02T0211400ZY	0	+	174	1310	1443	0.9078309
zheyou73v0_A02	14294907	14296471	BnaA02T0211500ZY	0	+	123	855	1564	0.5466752
zheyou73v0_A02	14294907	14296471	BnaA02T0211500ZY.1	0	+	123	855	1564	0.5466752
zheyou73v0_A02	14300774	14302841	BnaA02T0211600ZY	0	+	182	1293	2067	0.6255443
zheyou73v0_A02	14312396	14313002	BnaA02T0211700ZY	0	+	192	592	606	0.9768977
zheyou73v0_A02	14316416	14318173	BnaA02T0211800ZY	0	-	270	1365	1757	0.7768924
zheyou73v0_A02	14334780	14336230	BnaA02T0211900ZY	0	+	62	368	1450	0.2537931
zheyou73v0_A02	14336019	14338885	BnaA02T0212000ZY	0	-	381	1838	2866	0.6413119
zheyou73v0_A02	14346945	14347436	BnaA02T0212100ZY	0	-	44	396	491	0.8065173
zheyou73v0_A02	14353462	14356241	BnaA02T0212200ZY	0	+	738	2566	2779	0.9233537
zheyou73v0_A02	14357375	14358222	BnaA02T0212300ZY	0	+	48	432	847	0.5100354
zheyou73v0_A02	14361954	14363113	BnaA02T0212400ZY	0	-	57	387	1159	0.3339085
zheyou73v0_A02	14364959	14365937	BnaA02T0212500ZY	0	-	0	0	978	0.0000000
zheyou73v0_A02	14383284	14383983	BnaA02T0212600ZY	0	-	222	699	699	1.0000000
zheyou73v0_A02	14386156	14387040	BnaA02T0212700ZY	0	-	4	123	884	0.1391403
zheyou73v0_A02	14398474	14398875	BnaA02T0212800ZY	0	+	182	291	401	0.7256858
zheyou73v0_A02	14399705	14400335	BnaA02T0212900ZY	0	+	257	630	630	1.0000000
zheyou73v0_A02	14401236	14401500	BnaA02T0213000ZY	0	+	246	264	264	1.0000000
zheyou73v0_A02	14404145	14405020	BnaA02T0213100ZY	0	-	85	658	875	0.7520000
zheyou73v0_A02	14406567	14407340	BnaA02T0213200ZY	0	-	38	241	773	0.3117723
zheyou73v0_A02	14409159	14409693	BnaA02T0213300ZY	0	-	41	494	534	0.9250937
zheyou73v0_A02	14411926	14417826	BnaA02T0213400ZY	0	-	4352	5574	5900	0.9447458
zheyou73v0_A02	14420172	14429491	BnaA02T0213500ZY	0	+	1470	6493	9319	0.6967486
zheyou73v0_A02	14420172	14421024	BnaA02T0213500ZY.1	0	+	33	353	852	0.4143192
zheyou73v0_A02	14433718	14434870	BnaA02T0213600ZY	0	-	692	1152	1152	1.0000000
zheyou73v0_A02	14461502	14466890	BnaA02T0213700ZY	0	+	456	3455	5388	0.6412398
zheyou73v0_A02	14473107	14473865	BnaA02T0213800ZY	0	-	16	241	758	0.3179420
zheyou73v0_A02	14474479	14474686	BnaA02T0213900ZY	0	-	218	207	207	1.0000000
zheyou73v0_A02	14475620	14476669	BnaA02T0214000ZY	0	-	316	970	1049	0.9246902
zheyou73v0_A02	14483574	14485737	BnaA02T0214100ZY	0	+	0	0	2163	0.0000000
zheyou73v0_A02	14491619	14493140	BnaA02T0214200ZY	0	-	179	883	1521	0.5805391
zheyou73v0_A02	14493944	14495891	BnaA02T0214300ZY	0	-	475	1878	1947	0.9645609
zheyou73v0_A02	14496600	14497363	BnaA02T0214400ZY	0	-	150	497	763	0.6513761
zheyou73v0_A02	14498648	14499741	BnaA02T0214500ZY	0	+	15	198	1093	0.1811528
zheyou73v0_A02	14500281	14501613	BnaA02T0214600ZY	0	-	27	187	1332	0.1403904
zheyou73v0_A02	14502157	14502957	BnaA02T0214700ZY	0	+	329	800	800	1.0000000
zheyou73v0_A02	14505136	14510874	BnaA02T0214800ZY	0	+	2111	5165	5738	0.9001395
zheyou73v0_A02	14513105	14514455	BnaA02T0214900ZY	0	-	85	972	1350	0.7200000
zheyou73v0_A02	14514807	14515929	BnaA02T0215000ZY	0	+	591	1122	1122	1.0000000
zheyou73v0_A02	14516938	14517307	BnaA02T0215100ZY	0	+	0	0	369	0.0000000
zheyou73v0_A02	14523054	14524317	BnaA02T0215200ZY	0	-	903	1263	1263	1.0000000
zheyou73v0_A02	14536542	14539557	BnaA02T0215300ZY	0	+	493	2808	3015	0.9313433
zheyou73v0_A02	14540059	14543213	BnaA02T0215400ZY	0	-	68	1124	3154	0.3563729
zheyou73v0_A02	14560940	14564043	BnaA02T0215500ZY	0	+	559	2612	3103	0.8417661
zheyou73v0_A02	14569058	14571940	BnaA02T0215600ZY	0	-	398	2476	2882	0.8591256
zheyou73v0_A02	14577548	14577992	BnaA02T0215700ZY	0	-	24	287	444	0.6463964
zheyou73v0_A02	14582586	14583135	BnaA02T0215800ZY	0	-	9	207	549	0.3770492
zheyou73v0_A02	14590854	14591521	BnaA02T0215900ZY	0	-	106	667	667	1.0000000
zheyou73v0_A02	14592230	14596909	BnaA02T0216000ZY	0	+	678	3697	4679	0.7901261
zheyou73v0_A02	14611865	14612135	BnaA02T0216100ZY	0	-	363	270	270	1.0000000
zheyou73v0_A02	14618665	14620921	BnaA02T0216200ZY	0	-	0	0	2256	0.0000000
zheyou73v0_A02	14635814	14638491	BnaA02T0216300ZY	0	-	728	2287	2677	0.8543145
zheyou73v0_A02	14642612	14645519	BnaA02T0216400ZY	0	+	518	2617	2907	0.9002408
zheyou73v0_A02	14646502	14647558	BnaA02T0216500ZY	0	-	284	1056	1056	1.0000000
zheyou73v0_A02	14653250	14655341	BnaA02T0216600ZY	0	-	1329	2091	2091	1.0000000
zheyou73v0_A02	14663777	14665598	BnaA02T0216700ZY	0	-	86	896	1821	0.4920374
zheyou73v0_A02	14723468	14723663	BnaA02T0216800ZY	0	-	262	195	195	1.0000000
zheyou73v0_A02	14733486	14735501	BnaA02T0216900ZY	0	+	24	495	2015	0.2456576
zheyou73v0_A02	14739231	14739635	BnaA02T0217000ZY	0	-	3	243	404	0.6014851
zheyou73v0_A02	14754303	14756606	BnaA02T0217100ZY	0	+	571	2298	2303	0.9978289
zheyou73v0_A02	14757211	14761717	BnaA02T0217200ZY	0	+	614	3403	4506	0.7552153
zheyou73v0_A02	14779958	14785444	BnaA02T0217300ZY	0	+	368	2875	5486	0.5240613
zheyou73v0_A02	14786765	14787753	BnaA02T0217400ZY	0	+	15	444	988	0.4493927
zheyou73v0_A02	14788230	14789058	BnaA02T0217500ZY	0	-	270	828	828	1.0000000
zheyou73v0_A02	14791430	14796597	BnaA02T0217600ZY	0	-	1739	4455	5167	0.8622025
zheyou73v0_A02	14808458	14809335	BnaA02T0217700ZY	0	+	552	877	877	1.0000000
zheyou73v0_A02	14829938	14831346	BnaA02T0217800ZY	0	+	166	996	1408	0.7073864
zheyou73v0_A02	14831354	14832333	BnaA02T0217900ZY	0	-	202	860	979	0.8784474
zheyou73v0_A02	14832910	14835245	BnaA02T0218000ZY	0	-	434	2114	2335	0.9053533
zheyou73v0_A02	14835431	14837342	BnaA02T0218100ZY	0	+	534	1611	1911	0.8430141
zheyou73v0_A02	14837667	14838060	BnaA02T0218200ZY	0	+	118	336	393	0.8549618
zheyou73v0_A02	14838916	14840644	BnaA02T0218300ZY	0	+	227	1346	1728	0.7789352
zheyou73v0_A02	14840829	14849990	BnaA02T0218400ZY	0	-	3344	7527	9161	0.8216352
zheyou73v0_A02	14858712	14860820	BnaA02T0218500ZY	0	+	250	1756	2108	0.8330171
zheyou73v0_A02	14858712	14860820	BnaA02T0218500ZY.1	0	+	250	1756	2108	0.8330171
zheyou73v0_A02	14862388	14864210	BnaA02T0218600ZY	0	-	126	649	1822	0.3562020
zheyou73v0_A02	14876498	14881857	BnaA02T0218700ZY	0	+	671	3068	5359	0.5724949
zheyou73v0_A02	14888697	14891018	BnaA02T0218800ZY	0	+	199	1576	2321	0.6790177
zheyou73v0_A02	14888697	14891018	BnaA02T0218800ZY.1	0	+	199	1576	2321	0.6790177
zheyou73v0_A02	14894791	14901728	BnaA02T0218900ZY	0	-	394	1868	6937	0.2692807
zheyou73v0_A02	14910263	14912613	BnaA02T0219000ZY	0	-	2	42	2350	0.0178723
zheyou73v0_A02	14915700	14916480	BnaA02T0219100ZY	0	-	510	780	780	1.0000000
zheyou73v0_A02	14916522	14916885	BnaA02T0219200ZY	0	-	315	363	363	1.0000000
zheyou73v0_A02	14935857	14937196	BnaA02T0219300ZY	0	-	545	1126	1339	0.8409261
zheyou73v0_A02	14943821	14946199	BnaA02T0219400ZY	0	+	663	2127	2378	0.8944491
zheyou73v0_A02	14955730	14957106	BnaA02T0219500ZY	0	-	126	693	1376	0.5036337
zheyou73v0_A02	14963224	14964585	BnaA02T0219600ZY	0	+	124	864	1361	0.6348273
zheyou73v0_A02	14965482	14966574	BnaA02T0219700ZY	0	-	165	1081	1092	0.9899268
zheyou73v0_A02	14967792	14969423	BnaA02T0219800ZY	0	+	481	1617	1631	0.9914163
zheyou73v0_A02	14972336	14972879	BnaA02T0219900ZY	0	+	135	543	543	1.0000000
zheyou73v0_A02	14980019	14986063	BnaA02T0220000ZY	0	+	1419	4953	6044	0.8194904
zheyou73v0_A02	14991944	14992625	BnaA02T0220100ZY	0	+	1003	681	681	1.0000000
zheyou73v0_A02	15004282	15004585	BnaA02T0220200ZY	0	+	0	0	303	0.0000000
zheyou73v0_A02	15019917	15024989	BnaA02T0220300ZY	0	-	529	2957	5072	0.5830047
zheyou73v0_A02	15030849	15032087	BnaA02T0220400ZY	0	+	245	1103	1238	0.8909531
zheyou73v0_A02	15032810	15033041	BnaA02T0220500ZY	0	+	2	3	231	0.0129870
zheyou73v0_A02	15040663	15042581	BnaA02T0220600ZY	0	+	107	1090	1918	0.5683003
zheyou73v0_A02	15045168	15047115	BnaA02T0220700ZY	0	-	467	1613	1947	0.8284540
zheyou73v0_A02	15047367	15053489	BnaA02T0220800ZY	0	+	626	3181	6122	0.5196015
zheyou73v0_A02	15056198	15056873	BnaA02T0220900ZY	0	-	26	527	675	0.7807407
zheyou73v0_A02	15070603	15072324	BnaA02T0221000ZY	0	-	457	1594	1721	0.9262057
zheyou73v0_A02	15070603	15072324	BnaA02T0221000ZY.1	0	-	457	1594	1721	0.9262057
zheyou73v0_A02	15078058	15080210	BnaA02T0221100ZY	0	+	153	1369	2152	0.6361524
zheyou73v0_A02	15083793	15085038	BnaA02T0221200ZY	0	-	216	1244	1245	0.9991968
zheyou73v0_A02	15094835	15095567	BnaA02T0221300ZY	0	+	2	52	732	0.0710383
zheyou73v0_A02	15114924	15116200	BnaA02T0221400ZY	0	+	69	554	1276	0.4341693
zheyou73v0_A02	15132388	15136347	BnaA02T0221500ZY	0	+	169	1117	3959	0.2821420
zheyou73v0_A02	15137292	15139560	BnaA02T0221600ZY	0	-	90	965	2268	0.4254850
zheyou73v0_A02	15158267	15158438	BnaA02T0221700ZY	0	-	224	171	171	1.0000000
zheyou73v0_A02	15162089	15165332	BnaA02T0221800ZY	0	+	16	758	3243	0.2337342
zheyou73v0_A02	15175700	15176489	BnaA02T0221900ZY	0	-	13	405	789	0.5133080
zheyou73v0_A02	15181425	15181785	BnaA02T0222000ZY	0	+	3	127	360	0.3527778
zheyou73v0_A02	15191021	15191174	BnaA02T0222100ZY	0	-	0	0	153	0.0000000
zheyou73v0_A02	15191422	15192031	BnaA02T0222200ZY	0	-	0	0	609	0.0000000
zheyou73v0_A02	15204680	15210039	BnaA02T0222300ZY	0	+	663	4179	5359	0.7798097
zheyou73v0_A02	15212462	15222299	BnaA02T0222400ZY	0	-	261	4449	9837	0.4522720
zheyou73v0_A02	15223349	15228248	BnaA02T0222500ZY	0	+	1042	4353	4899	0.8885487
zheyou73v0_A02	15228292	15228670	BnaA02T0222600ZY	0	-	6	134	378	0.3544973
zheyou73v0_A02	15237636	15237864	BnaA02T0222700ZY	0	-	0	0	228	0.0000000
zheyou73v0_A02	15238317	15238685	BnaA02T0222800ZY	0	-	60	368	368	1.0000000
zheyou73v0_A02	15239169	15240145	BnaA02T0222900ZY	0	+	71	915	976	0.9375000
zheyou73v0_A02	15240847	15244155	BnaA02T0223000ZY	0	-	208	1208	3308	0.3651753
zheyou73v0_A02	15251248	15251900	BnaA02T0223100ZY	0	+	247	652	652	1.0000000
zheyou73v0_A02	15261714	15261927	BnaA02T0223200ZY	0	-	111	213	213	1.0000000
zheyou73v0_A02	15266104	15266485	BnaA02T0223300ZY	0	+	40	123	381	0.3228346
zheyou73v0_A02	15266749	15268841	BnaA02T0223400ZY	0	-	59	1324	2092	0.6328872
zheyou73v0_A02	15275356	15276655	BnaA02T0223500ZY	0	-	62	584	1299	0.4495766
zheyou73v0_A02	15284592	15286655	BnaA02T0223600ZY	0	-	524	1562	2063	0.7571498
zheyou73v0_A02	15294667	15296159	BnaA02T0223700ZY	0	-	276	1089	1492	0.7298928
zheyou73v0_A02	15305233	15308255	BnaA02T0223800ZY	0	+	925	2541	3022	0.8408339
zheyou73v0_A02	15309442	15312410	BnaA02T0223900ZY	0	+	554	2339	2968	0.7880728
zheyou73v0_A02	15313009	15313558	BnaA02T0224000ZY	0	-	197	549	549	1.0000000
zheyou73v0_A02	15315135	15315417	BnaA02T0224100ZY	0	-	148	282	282	1.0000000
zheyou73v0_A02	15316466	15317084	BnaA02T0224200ZY	0	+	47	282	618	0.4563107
zheyou73v0_A02	15322752	15324323	BnaA02T0224300ZY	0	-	187	1077	1571	0.6855506
zheyou73v0_A02	15336148	15336515	BnaA02T0224400ZY	0	+	34	232	367	0.6321526
zheyou73v0_A02	15336745	15338724	BnaA02T0224500ZY	0	-	340	873	1979	0.4411319
zheyou73v0_A02	15339410	15340554	BnaA02T0224600ZY	0	-	162	1062	1144	0.9283217
zheyou73v0_A02	15340665	15340936	BnaA02T0224700ZY	0	-	5	164	271	0.6051661
zheyou73v0_A02	15341596	15343844	BnaA02T0224800ZY	0	+	305	1722	2248	0.7660142
zheyou73v0_A02	15348462	15348918	BnaA02T0224900ZY	0	-	292	456	456	1.0000000
zheyou73v0_A02	15350796	15351576	BnaA02T0225000ZY	0	+	128	536	780	0.6871795
zheyou73v0_A02	15352259	15354968	BnaA02T0225100ZY	0	-	231	2026	2709	0.7478774
zheyou73v0_A02	15357806	15358433	BnaA02T0225200ZY	0	+	238	620	627	0.9888358
zheyou73v0_A02	15361665	15362122	BnaA02T0225300ZY	0	-	0	0	457	0.0000000
zheyou73v0_A02	15367457	15370604	BnaA02T0225400ZY	0	-	211	2288	3147	0.7270416
zheyou73v0_A02	15371656	15372379	BnaA02T0225500ZY	0	+	207	576	723	0.7966805
zheyou73v0_A02	15372755	15373704	BnaA02T0225600ZY	0	+	20	405	949	0.4267650
zheyou73v0_A02	15373924	15377016	BnaA02T0225700ZY	0	-	638	2511	3092	0.8120957
zheyou73v0_A02	15378643	15379062	BnaA02T0225800ZY	0	-	8	338	419	0.8066826
zheyou73v0_A02	15380873	15381422	BnaA02T0225900ZY	0	-	246	549	549	1.0000000
zheyou73v0_A02	15381799	15384588	BnaA02T0226000ZY	0	-	1035	2471	2789	0.8859807
zheyou73v0_A02	15381799	15384591	BnaA02T0226000ZY.1	0	-	1036	2474	2792	0.8861032
zheyou73v0_A02	15381799	15383077	BnaA02T0226000ZY.2	0	-	265	960	1278	0.7511737
zheyou73v0_A02	15389708	15390612	BnaA02T0226100ZY	0	-	0	0	904	0.0000000
zheyou73v0_A02	15402647	15403265	BnaA02T0226200ZY	0	+	83	594	618	0.9611651
zheyou73v0_A02	15408001	15408647	BnaA02T0226300ZY	0	+	273	646	646	1.0000000
zheyou73v0_A02	15414355	15416437	BnaA02T0226400ZY	0	+	189	1295	2082	0.6219981
zheyou73v0_A02	15416688	15418296	BnaA02T0226500ZY	0	-	134	900	1608	0.5597015
zheyou73v0_A02	15418711	15419305	BnaA02T0226600ZY	0	-	12	43	594	0.0723906
zheyou73v0_A02	15419748	15420372	BnaA02T0226700ZY	0	-	3	125	624	0.2003205
zheyou73v0_A02	15423128	15423779	BnaA02T0226800ZY	0	-	96	539	651	0.8279570
zheyou73v0_A02	15437470	15439314	BnaA02T0226900ZY	0	+	0	0	1844	0.0000000
zheyou73v0_A02	15449395	15451402	BnaA02T0227000ZY	0	+	97	873	2007	0.4349776
zheyou73v0_A02	15453163	15454305	BnaA02T0227100ZY	0	+	248	1022	1142	0.8949212
zheyou73v0_A02	15462645	15463776	BnaA02T0227200ZY	0	+	844	1131	1131	1.0000000
zheyou73v0_A02	15467002	15469227	BnaA02T0227300ZY	0	+	247	1698	2225	0.7631460
zheyou73v0_A02	15472815	15473878	BnaA02T0227400ZY	0	-	137	865	1063	0.8137347
zheyou73v0_A02	15481255	15483262	BnaA02T0227500ZY	0	-	17	273	2007	0.1360239
zheyou73v0_A02	15483718	15484386	BnaA02T0227600ZY	0	-	23	409	668	0.6122754
zheyou73v0_A02	15485492	15486192	BnaA02T0227700ZY	0	-	77	326	700	0.4657143
zheyou73v0_A02	15502050	15502854	BnaA02T0227800ZY	0	+	39	422	804	0.5248756
zheyou73v0_A02	15513634	15516506	BnaA02T0227900ZY	0	+	536	1955	2872	0.6807103
zheyou73v0_A02	15536774	15539108	BnaA02T0228000ZY	0	-	832	2334	2334	1.0000000
zheyou73v0_A02	15540300	15543289	BnaA02T0228100ZY	0	-	181	1770	2989	0.5921713
zheyou73v0_A02	15554154	15555300	BnaA02T0228200ZY	0	-	81	932	1146	0.8132635
zheyou73v0_A02	15558973	15560149	BnaA02T0228300ZY	0	-	62	702	1176	0.5969388
zheyou73v0_A02	15561367	15562987	BnaA02T0228400ZY	0	-	497	1401	1620	0.8648148
zheyou73v0_A02	15570227	15571454	BnaA02T0228500ZY	0	+	211	1096	1227	0.8932355
zheyou73v0_A02	15570227	15571175	BnaA02T0228500ZY.1	0	+	201	948	948	1.0000000
zheyou73v0_A02	15571683	15572224	BnaA02T0228600ZY	0	+	19	180	541	0.3327172
zheyou73v0_A02	15574915	15576204	BnaA02T0228700ZY	0	+	156	889	1289	0.6896819
zheyou73v0_A02	15584887	15585534	BnaA02T0228800ZY	0	-	185	647	647	1.0000000
zheyou73v0_A02	15587420	15588334	BnaA02T0228900ZY	0	+	2	143	914	0.1564551
zheyou73v0_A02	15589914	15592455	BnaA02T0229000ZY	0	-	344	1746	2541	0.6871310
zheyou73v0_A02	15592785	15596205	BnaA02T0229100ZY	0	-	659	2916	3420	0.8526316
zheyou73v0_A02	15609350	15610631	BnaA02T0229200ZY	0	+	10	255	1281	0.1990632
zheyou73v0_A02	15616820	15618095	BnaA02T0229300ZY	0	+	33	365	1275	0.2862745
zheyou73v0_A02	15619296	15619833	BnaA02T0229400ZY	0	-	0	0	537	0.0000000
zheyou73v0_A02	15631062	15631575	BnaA02T0229500ZY	0	+	115	411	513	0.8011696
zheyou73v0_A02	15631583	15632330	BnaA02T0229600ZY	0	+	1	60	747	0.0803213
zheyou73v0_A02	15633571	15636201	BnaA02T0229700ZY	0	-	30	487	2630	0.1851711
zheyou73v0_A02	15637792	15639618	BnaA02T0229800ZY	0	-	4	222	1826	0.1215772
zheyou73v0_A02	15651942	15654950	BnaA02T0229900ZY	0	-	476	2148	3008	0.7140958
zheyou73v0_A02	15657071	15657547	BnaA02T0230000ZY	0	+	600	476	476	1.0000000
zheyou73v0_A02	15661491	15661802	BnaA02T0230100ZY	0	+	0	0	311	0.0000000
zheyou73v0_A02	15662995	15664557	BnaA02T0230200ZY	0	-	149	1331	1562	0.8521127
zheyou73v0_A02	15665655	15667068	BnaA02T0230300ZY	0	-	319	1261	1413	0.8924274
zheyou73v0_A02	15673210	15675580	BnaA02T0230400ZY	0	+	871	2353	2370	0.9928270
zheyou73v0_A02	15683329	15684383	BnaA02T0230500ZY	0	-	23	458	1054	0.4345351
zheyou73v0_A02	15689016	15690940	BnaA02T0230600ZY	0	-	0	0	1924	0.0000000
zheyou73v0_A02	15701321	15703245	BnaA02T0230700ZY	0	-	0	0	1924	0.0000000
zheyou73v0_A02	15708455	15710674	BnaA02T0230800ZY	0	+	200	1456	2219	0.6561514
zheyou73v0_A02	15713747	15717738	BnaA02T0230900ZY	0	+	242	1660	3991	0.4159358
zheyou73v0_A02	15718046	15718933	BnaA02T0231000ZY	0	-	430	810	887	0.9131905
zheyou73v0_A02	15737229	15738384	BnaA02T0231100ZY	0	-	39	559	1155	0.4839827
zheyou73v0_A02	15738522	15739904	BnaA02T0231200ZY	0	-	192	1201	1382	0.8690304
zheyou73v0_A02	15740157	15740522	BnaA02T0231300ZY	0	-	16	235	365	0.6438356
zheyou73v0_A02	15741893	15744656	BnaA02T0231400ZY	0	-	72	965	2763	0.3492581
zheyou73v0_A02	15747652	15748114	BnaA02T0231500ZY	0	-	17	346	462	0.7489178
zheyou73v0_A02	15750200	15750869	BnaA02T0231600ZY	0	-	15	428	669	0.6397609
zheyou73v0_A02	15752127	15753670	BnaA02T0231700ZY	0	+	57	573	1543	0.3713545
zheyou73v0_A02	15754821	15756397	BnaA02T0231800ZY	0	+	79	384	1576	0.2436548
zheyou73v0_A02	15756624	15758642	BnaA02T0231900ZY	0	+	233	1202	2018	0.5956392
zheyou73v0_A02	15760370	15761405	BnaA02T0232000ZY	0	-	59	491	1035	0.4743961
zheyou73v0_A02	15766419	15767216	BnaA02T0232100ZY	0	-	11	183	797	0.2296110
zheyou73v0_A02	15771983	15772357	BnaA02T0232200ZY	0	-	64	374	374	1.0000000
zheyou73v0_A02	15772424	15774340	BnaA02T0232300ZY	0	-	222	420	1916	0.2192067
zheyou73v0_A02	15775286	15775975	BnaA02T0232400ZY	0	+	367	689	689	1.0000000
zheyou73v0_A02	15776073	15776622	BnaA02T0232500ZY	0	+	42	484	549	0.8816029
zheyou73v0_A02	15776690	15777086	BnaA02T0232600ZY	0	+	70	396	396	1.0000000
zheyou73v0_A02	15791216	15791399	BnaA02T0232700ZY	0	+	0	0	183	0.0000000
zheyou73v0_A02	15793470	15793955	BnaA02T0232800ZY	0	+	52	423	485	0.8721650
zheyou73v0_A02	15825706	15827078	BnaA02T0232900ZY	0	+	0	0	1372	0.0000000
zheyou73v0_A02	15850232	15850725	BnaA02T0233000ZY	0	+	0	0	493	0.0000000
zheyou73v0_A02	15853126	15854360	BnaA02T0233100ZY	0	-	0	0	1234	0.0000000
zheyou73v0_A02	15856557	15858278	BnaA02T0233200ZY	0	-	0	0	1721	0.0000000
zheyou73v0_A02	15863429	15865430	BnaA02T0233300ZY	0	+	42	894	2001	0.4467766
zheyou73v0_A02	15865370	15866241	BnaA02T0233400ZY	0	-	26	353	871	0.4052813
zheyou73v0_A02	15869665	15870038	BnaA02T0233500ZY	0	+	3	231	373	0.6193029
zheyou73v0_A02	15872021	15873107	BnaA02T0233600ZY	0	+	1	49	1086	0.0451197
zheyou73v0_A02	15891242	15892017	BnaA02T0233700ZY	0	-	2	78	775	0.1006452
zheyou73v0_A02	15950356	15951397	BnaA02T0233800ZY	0	-	0	0	1041	0.0000000
zheyou73v0_A02	15952218	15953140	BnaA02T0233900ZY	0	+	16	289	922	0.3134490
zheyou73v0_A02	15953237	15954171	BnaA02T0234000ZY	0	-	4	38	934	0.0406852
zheyou73v0_A02	15954410	15956605	BnaA02T0234100ZY	0	-	87	672	2195	0.3061503
zheyou73v0_A02	15957822	15960215	BnaA02T0234200ZY	0	+	200	1274	2393	0.5323861
zheyou73v0_A02	16024280	16027998	BnaA02T0234300ZY	0	+	9	616	3718	0.1656805
zheyou73v0_A02	16033773	16036789	BnaA02T0234400ZY	0	+	2	77	3016	0.0255305
zheyou73v0_A02	16053491	16055571	BnaA02T0234500ZY	0	+	84	1045	2080	0.5024039
zheyou73v0_A02	16061853	16063170	BnaA02T0234600ZY	0	+	17	509	1317	0.3864844
zheyou73v0_A02	16076338	16080500	BnaA02T0234700ZY	0	+	70	834	4162	0.2003844
zheyou73v0_A02	16076338	16080307	BnaA02T0234700ZY.1	0	+	61	666	3969	0.1678005
zheyou73v0_A02	16076338	16080307	BnaA02T0234700ZY.2	0	+	61	666	3969	0.1678005
zheyou73v0_A02	16076338	16080500	BnaA02T0234700ZY.3	0	+	70	834	4162	0.2003844
zheyou73v0_A02	16101805	16102273	BnaA02T0234800ZY	0	-	0	0	468	0.0000000
zheyou73v0_A02	16102316	16102952	BnaA02T0234900ZY	0	-	1	118	636	0.1855346
zheyou73v0_A02	16103660	16104956	BnaA02T0235000ZY	0	-	4	226	1296	0.1743827
zheyou73v0_A02	16112440	16113250	BnaA02T0235100ZY	0	+	93	762	810	0.9407408
zheyou73v0_A02	16113749	16116733	BnaA02T0235200ZY	0	-	201	1634	2984	0.5475872
zheyou73v0_A02	16125855	16127271	BnaA02T0235300ZY	0	-	202	1210	1416	0.8545198
zheyou73v0_A02	16128591	16132237	BnaA02T0235400ZY	0	-	52	605	3646	0.1659353
zheyou73v0_A02	16148727	16151439	BnaA02T0235500ZY	0	-	98	1401	2712	0.5165929
zheyou73v0_A02	16152520	16157544	BnaA02T0235600ZY	0	-	187	1264	5024	0.2515924
zheyou73v0_A02	16159064	16161283	BnaA02T0235700ZY	0	+	6	237	2219	0.1068049
zheyou73v0_A02	16162189	16163022	BnaA02T0235800ZY	0	+	28	715	833	0.8583434
zheyou73v0_A02	16166664	16168780	BnaA02T0235900ZY	0	-	306	1432	2116	0.6767486
zheyou73v0_A02	16177560	16179515	BnaA02T0236000ZY	0	+	162	719	1955	0.3677749
zheyou73v0_A02	16182597	16183296	BnaA02T0236100ZY	0	+	4	128	699	0.1831187
zheyou73v0_A02	16184081	16184285	BnaA02T0236200ZY	0	-	91	192	204	0.9411765
zheyou73v0_A02	16185700	16188205	BnaA02T0236300ZY	0	+	0	0	2505	0.0000000
zheyou73v0_A02	16190023	16192544	BnaA02T0236400ZY	0	+	82	1025	2521	0.4065847
zheyou73v0_A02	16193007	16195554	BnaA02T0236500ZY	0	-	406	1791	2547	0.7031802
zheyou73v0_A02	16197276	16197708	BnaA02T0236600ZY	0	+	66	299	432	0.6921296
zheyou73v0_A02	16203942	16207300	BnaA02T0236700ZY	0	-	144	1407	3358	0.4189994
zheyou73v0_A02	16213497	16213926	BnaA02T0236800ZY	0	+	0	0	429	0.0000000
zheyou73v0_A02	16227888	16234408	BnaA02T0236900ZY	0	+	16	857	6520	0.1314417
zheyou73v0_A02	16253216	16254235	BnaA02T0237000ZY	0	+	87	822	1019	0.8066732
zheyou73v0_A02	16256556	16258779	BnaA02T0237100ZY	0	-	1	77	2223	0.0346379
zheyou73v0_A02	16264500	16265927	BnaA02T0237200ZY	0	-	0	0	1427	0.0000000
zheyou73v0_A02	16266997	16267186	BnaA02T0237300ZY	0	+	0	0	189	0.0000000
zheyou73v0_A02	16303542	16305017	BnaA02T0237400ZY	0	+	36	376	1475	0.2549153
zheyou73v0_A02	16305124	16306190	BnaA02T0237500ZY	0	-	6	373	1066	0.3499062
zheyou73v0_A02	16306649	16309371	BnaA02T0237600ZY	0	+	42	1129	2722	0.4147685
zheyou73v0_A02	16309479	16311201	BnaA02T0237700ZY	0	-	21	279	1722	0.1620209
zheyou73v0_A02	16321145	16322008	BnaA02T0237800ZY	0	+	24	345	863	0.3997683
zheyou73v0_A02	16346807	16349809	BnaA02T0237900ZY	0	-	32	947	3002	0.3154564
zheyou73v0_A02	16346807	16349809	BnaA02T0237900ZY.1	0	-	32	947	3002	0.3154564
zheyou73v0_A02	16356645	16365851	BnaA02T0238000ZY	0	-	83	1252	9206	0.1359983
zheyou73v0_A02	16366639	16368020	BnaA02T0238100ZY	0	+	0	0	1381	0.0000000
zheyou73v0_A02	16391658	16392319	BnaA02T0238200ZY	0	+	3	94	661	0.1422088
zheyou73v0_A02	16430921	16431804	BnaA02T0238300ZY	0	+	25	563	883	0.6375991
zheyou73v0_A02	16443577	16445436	BnaA02T0238400ZY	0	+	40	631	1859	0.3394298
zheyou73v0_A02	16445070	16447003	BnaA02T0238500ZY	0	-	15	286	1933	0.1479566
zheyou73v0_A02	16445070	16447003	BnaA02T0238500ZY.1	0	-	15	286	1933	0.1479566
zheyou73v0_A02	16470693	16471130	BnaA02T0238600ZY	0	+	12	53	437	0.1212815
zheyou73v0_A02	16471711	16476464	BnaA02T0238700ZY	0	+	36	661	4753	0.1390701
zheyou73v0_A02	16478200	16479616	BnaA02T0238800ZY	0	+	109	358	1416	0.2528249
zheyou73v0_A02	16479919	16480425	BnaA02T0238900ZY	0	+	0	0	506	0.0000000
zheyou73v0_A02	16504870	16505241	BnaA02T0239000ZY	0	+	19	59	371	0.1590296
zheyou73v0_A02	16514437	16515196	BnaA02T0239100ZY	0	+	0	0	759	0.0000000
zheyou73v0_A02	16529575	16530172	BnaA02T0239200ZY	0	+	78	576	597	0.9648241
zheyou73v0_A02	16531050	16533170	BnaA02T0239300ZY	0	-	348	2014	2120	0.9500000
zheyou73v0_A02	16589180	16590586	BnaA02T0239400ZY	0	-	11	347	1406	0.2467994
zheyou73v0_A02	16593546	16594909	BnaA02T0239500ZY	0	-	0	0	1363	0.0000000
zheyou73v0_A02	16601148	16601418	BnaA02T0239600ZY	0	+	0	0	270	0.0000000
zheyou73v0_A02	16622658	16623408	BnaA02T0239700ZY	0	-	0	0	750	0.0000000
zheyou73v0_A02	16660846	16662322	BnaA02T0239800ZY	0	+	139	613	1476	0.4153117
zheyou73v0_A02	16665391	16666153	BnaA02T0239900ZY	0	-	66	541	762	0.7099738
zheyou73v0_A02	16688257	16688713	BnaA02T0240000ZY	0	-	1	2	456	0.0043860
zheyou73v0_A02	16688886	16689665	BnaA02T0240100ZY	0	+	2	165	779	0.2118100
zheyou73v0_A02	16719132	16719852	BnaA02T0240200ZY	0	+	0	0	720	0.0000000
zheyou73v0_A02	16723010	16723736	BnaA02T0240300ZY	0	-	46	542	726	0.7465565
zheyou73v0_A02	16762309	16762853	BnaA02T0240400ZY	0	-	38	441	544	0.8106618
zheyou73v0_A02	16810701	16811618	BnaA02T0240500ZY	0	+	103	841	917	0.9171211
zheyou73v0_A02	16813298	16814963	BnaA02T0240600ZY	0	-	183	598	1665	0.3591592
zheyou73v0_A02	16831867	16833145	BnaA02T0240700ZY	0	-	0	0	1278	0.0000000
zheyou73v0_A02	16845575	16845926	BnaA02T0240800ZY	0	-	8	73	351	0.2079772
zheyou73v0_A02	16847600	16848143	BnaA02T0240900ZY	0	-	0	0	543	0.0000000
zheyou73v0_A02	16853124	16853352	BnaA02T0241000ZY	0	+	8	140	228	0.6140351
zheyou73v0_A02	16862782	16868259	BnaA02T0241100ZY	0	+	314	3199	5477	0.5840788
zheyou73v0_A02	16868494	16869987	BnaA02T0241200ZY	0	-	52	625	1493	0.4186202
zheyou73v0_A02	16868494	16869987	BnaA02T0241200ZY.1	0	-	52	625	1493	0.4186202
zheyou73v0_A02	16870669	16874685	BnaA02T0241300ZY	0	-	176	2251	4016	0.5605080
zheyou73v0_A02	16870669	16874685	BnaA02T0241300ZY.1	0	-	176	2251	4016	0.5605080
zheyou73v0_A02	16870669	16874685	BnaA02T0241300ZY.2	0	-	176	2251	4016	0.5605080
zheyou73v0_A02	16876379	16877794	BnaA02T0241400ZY	0	+	56	1102	1415	0.7787986
zheyou73v0_A02	16876379	16877794	BnaA02T0241400ZY.1	0	+	56	1102	1415	0.7787986
zheyou73v0_A02	16877663	16878867	BnaA02T0241500ZY	0	-	92	1075	1204	0.8928571
zheyou73v0_A02	16893348	16894725	BnaA02T0241600ZY	0	+	156	1183	1377	0.8591140
zheyou73v0_A02	16908439	16911481	BnaA02T0241700ZY	0	+	6	378	3042	0.1242604
zheyou73v0_A02	16913605	16914250	BnaA02T0241800ZY	0	-	16	379	645	0.5875969
zheyou73v0_A02	16914603	16917808	BnaA02T0241900ZY	0	-	68	1316	3205	0.4106084
zheyou73v0_A02	16915657	16918482	BnaA02T0241900ZY.1	0	-	61	1207	2825	0.4272566
zheyou73v0_A02	16926622	16929167	BnaA02T0242000ZY	0	-	31	395	2545	0.1552063
zheyou73v0_A02	16926622	16929167	BnaA02T0242000ZY.1	0	-	31	395	2545	0.1552063
zheyou73v0_A02	16928013	16929167	BnaA02T0242000ZY.2	0	-	0	0	1154	0.0000000
zheyou73v0_A02	16930532	16931019	BnaA02T0242100ZY	0	-	140	473	487	0.9712526
zheyou73v0_A02	16969560	16970692	BnaA02T0242200ZY	0	+	77	964	1132	0.8515901
zheyou73v0_A02	16973364	16973832	BnaA02T0242300ZY	0	-	7	135	468	0.2884615
zheyou73v0_A02	16997426	17000236	BnaA02T0242400ZY	0	-	94	1473	2810	0.5241993
zheyou73v0_A02	17027782	17029915	BnaA02T0242500ZY	0	+	102	1835	2133	0.8602906
zheyou73v0_A02	17027782	17029286	BnaA02T0242500ZY.1	0	+	69	1206	1504	0.8018617
zheyou73v0_A02	17030956	17031756	BnaA02T0242600ZY	0	+	51	615	800	0.7687500
zheyou73v0_A02	17033611	17034208	BnaA02T0242700ZY	0	+	73	417	597	0.6984925
zheyou73v0_A02	17036990	17037515	BnaA02T0242800ZY	0	+	37	225	525	0.4285714
zheyou73v0_A02	17049786	17050138	BnaA02T0242900ZY	0	+	48	293	352	0.8323864
zheyou73v0_A02	17051501	17057135	BnaA02T0243000ZY	0	+	3	335	5634	0.0594604
zheyou73v0_A02	17097750	17099430	BnaA02T0243100ZY	0	+	10	212	1680	0.1261905
zheyou73v0_A02	17099651	17105597	BnaA02T0243200ZY	0	-	5	86	5946	0.0144635
zheyou73v0_A02	17109177	17110000	BnaA02T0243300ZY	0	+	2	58	823	0.0704739
zheyou73v0_A02	17110934	17112676	BnaA02T0243400ZY	0	+	0	0	1742	0.0000000
zheyou73v0_A02	17122509	17124114	BnaA02T0243500ZY	0	+	0	0	1605	0.0000000
zheyou73v0_A02	17133061	17136058	BnaA02T0243600ZY	0	+	0	0	2997	0.0000000
zheyou73v0_A02	17138761	17139638	BnaA02T0243700ZY	0	+	0	0	877	0.0000000
zheyou73v0_A02	17158057	17159863	BnaA02T0243800ZY	0	+	8	110	1806	0.0609081
zheyou73v0_A02	17162579	17163514	BnaA02T0243900ZY	0	-	117	624	935	0.6673797
zheyou73v0_A02	17164557	17176468	BnaA02T0244000ZY	0	-	275	6436	11911	0.5403408
zheyou73v0_A02	17178716	17179188	BnaA02T0244100ZY	0	-	3	81	472	0.1716102
zheyou73v0_A02	17182854	17183646	BnaA02T0244200ZY	0	+	0	0	792	0.0000000
zheyou73v0_A02	17186372	17187148	BnaA02T0244300ZY	0	-	18	130	776	0.1675258
zheyou73v0_A02	17192991	17193186	BnaA02T0244400ZY	0	-	1	105	195	0.5384616
zheyou73v0_A02	17206174	17206642	BnaA02T0244500ZY	0	-	0	0	468	0.0000000
zheyou73v0_A02	17233538	17237751	BnaA02T0244600ZY	0	+	161	2090	4213	0.4960836
zheyou73v0_A02	17236795	17245230	BnaA02T0244700ZY	0	-	148	2223	8435	0.2635448
zheyou73v0_A02	17236795	17245230	BnaA02T0244700ZY.1	0	-	148	2223	8435	0.2635448
zheyou73v0_A02	17249424	17250180	BnaA02T0244800ZY	0	-	2	26	756	0.0343915
zheyou73v0_A02	17259573	17260587	BnaA02T0244900ZY	0	+	48	480	1014	0.4733728
zheyou73v0_A02	17261005	17261605	BnaA02T0245000ZY	0	+	5	82	600	0.1366667
zheyou73v0_A02	17264567	17271646	BnaA02T0245100ZY	0	-	94	459	7079	0.0648397
zheyou73v0_A02	17272306	17274093	BnaA02T0245200ZY	0	-	1	94	1787	0.0526021
zheyou73v0_A02	17274934	17279095	BnaA02T0245300ZY	0	-	5	226	4161	0.0543139
zheyou73v0_A02	17282518	17283055	BnaA02T0245400ZY	0	+	0	0	537	0.0000000
zheyou73v0_A02	17311553	17312151	BnaA02T0245500ZY	0	+	0	0	598	0.0000000
zheyou73v0_A02	17317922	17322467	BnaA02T0245600ZY	0	+	5	310	4545	0.0682068
zheyou73v0_A02	17322868	17323363	BnaA02T0245700ZY	0	+	0	0	495	0.0000000
zheyou73v0_A02	17328881	17330428	BnaA02T0245800ZY	0	+	1	99	1547	0.0639948
zheyou73v0_A02	17332244	17332635	BnaA02T0245900ZY	0	+	0	0	391	0.0000000
zheyou73v0_A02	17344598	17345047	BnaA02T0246000ZY	0	+	5	113	449	0.2516704
zheyou73v0_A02	17350184	17350630	BnaA02T0246100ZY	0	-	0	0	446	0.0000000
zheyou73v0_A02	17377937	17379635	BnaA02T0246200ZY	0	-	4	308	1698	0.1813899
zheyou73v0_A02	17380472	17382211	BnaA02T0246300ZY	0	-	0	0	1739	0.0000000
zheyou73v0_A02	17384144	17384667	BnaA02T0246400ZY	0	+	0	0	523	0.0000000
zheyou73v0_A02	17391325	17392576	BnaA02T0246500ZY	0	-	4	73	1251	0.0583533
zheyou73v0_A02	17391325	17392576	BnaA02T0246500ZY.1	0	-	4	73	1251	0.0583533
zheyou73v0_A02	17398215	17398923	BnaA02T0246600ZY	0	+	0	0	708	0.0000000
zheyou73v0_A02	17408436	17411654	BnaA02T0246700ZY	0	-	1	82	3218	0.0254817
zheyou73v0_A02	17448910	17449477	BnaA02T0246800ZY	0	+	27	501	567	0.8835979
zheyou73v0_A02	17453850	17455966	BnaA02T0246900ZY	0	-	2	106	2116	0.0500945
zheyou73v0_A02	17462889	17467350	BnaA02T0247000ZY	0	+	129	1226	4461	0.2748263
zheyou73v0_A02	17473985	17476932	BnaA02T0247100ZY	0	-	36	652	2947	0.2212419
zheyou73v0_A02	17491773	17492291	BnaA02T0247200ZY	0	-	95	348	518	0.6718147
zheyou73v0_A02	17500719	17503930	BnaA02T0247300ZY	0	+	54	1183	3211	0.3684210
zheyou73v0_A02	17505581	17507771	BnaA02T0247400ZY	0	-	0	0	2190	0.0000000
zheyou73v0_A02	17523234	17524127	BnaA02T0247500ZY	0	+	0	0	893	0.0000000
zheyou73v0_A02	17536033	17536234	BnaA02T0247600ZY	0	-	4	151	201	0.7512438
zheyou73v0_A02	17538401	17542436	BnaA02T0247700ZY	0	-	42	1020	4035	0.2527881
zheyou73v0_A02	17549941	17550262	BnaA02T0247800ZY	0	-	0	0	321	0.0000000
zheyou73v0_A02	17559605	17562005	BnaA02T0247900ZY.1	0	+	0	0	2400	0.0000000
zheyou73v0_A02	17559605	17562005	BnaA02T0247900ZY.2	0	+	0	0	2400	0.0000000
zheyou73v0_A02	17559855	17562005	BnaA02T0247900ZY	0	+	0	0	2150	0.0000000
zheyou73v0_A02	17559855	17562005	BnaA02T0247900ZY.3	0	+	0	0	2150	0.0000000
zheyou73v0_A02	17562953	17564863	BnaA02T0248000ZY	0	+	1	150	1910	0.0785340
zheyou73v0_A02	17562953	17564863	BnaA02T0248000ZY.1	0	+	1	150	1910	0.0785340
zheyou73v0_A02	17565553	17570186	BnaA02T0248100ZY	0	+	170	2597	4633	0.5605439
zheyou73v0_A02	17565553	17570186	BnaA02T0248100ZY.1	0	+	170	2597	4633	0.5605439
zheyou73v0_A02	17580470	17580740	BnaA02T0248200ZY	0	+	0	0	270	0.0000000
zheyou73v0_A02	17580886	17581807	BnaA02T0248300ZY	0	+	13	182	921	0.1976113
zheyou73v0_A02	17582992	17583812	BnaA02T0248400ZY	0	+	0	0	820	0.0000000
zheyou73v0_A02	17592687	17593198	BnaA02T0248500ZY	0	-	2	161	511	0.3150685
zheyou73v0_A02	17594772	17595168	BnaA02T0248600ZY	0	-	46	221	396	0.5580808
zheyou73v0_A02	17635005	17637107	BnaA02T0248700ZY	0	-	55	1620	2102	0.7706946
zheyou73v0_A02	17653471	17655309	BnaA02T0248800ZY	0	+	32	331	1838	0.1800870
zheyou73v0_A02	17657692	17659199	BnaA02T0248900ZY	0	+	2	88	1507	0.0583942
zheyou73v0_A02	17659455	17660524	BnaA02T0249000ZY	0	+	16	203	1069	0.1898971
zheyou73v0_A02	17661083	17661977	BnaA02T0249100ZY	0	+	0	0	894	0.0000000
zheyou73v0_A02	17677189	17677678	BnaA02T0249200ZY	0	+	0	0	489	0.0000000
zheyou73v0_A02	17685192	17685777	BnaA02T0249300ZY	0	+	3	26	585	0.0444444
zheyou73v0_A02	17688038	17690119	BnaA02T0249400ZY	0	+	568	1903	2081	0.9144642
zheyou73v0_A02	17693912	17699481	BnaA02T0249500ZY.1	0	-	15	642	5569	0.1152810
zheyou73v0_A02	17694362	17699481	BnaA02T0249500ZY	0	-	14	519	5119	0.1013870
zheyou73v0_A02	17707812	17714016	BnaA02T0249600ZY	0	+	125	1925	6204	0.3102837
zheyou73v0_A02	17714324	17715172	BnaA02T0249700ZY	0	-	88	739	848	0.8714623
zheyou73v0_A02	17716128	17717435	BnaA02T0249800ZY	0	+	141	1161	1307	0.8882938
zheyou73v0_A02	17717466	17717779	BnaA02T0249900ZY	0	+	74	313	313	1.0000000
zheyou73v0_A02	17732871	17735641	BnaA02T0250000ZY	0	+	238	1772	2770	0.6397112
zheyou73v0_A02	17755428	17757485	BnaA02T0250100ZY	0	-	1777	2057	2057	1.0000000
zheyou73v0_A02	17780988	17788158	BnaA02T0250200ZY	0	+	2419	7041	7170	0.9820084
zheyou73v0_A02	17801026	17803487	BnaA02T0250300ZY	0	+	247	1538	2461	0.6249492
zheyou73v0_A02	17801026	17803487	BnaA02T0250300ZY.1	0	+	247	1538	2461	0.6249492
zheyou73v0_A02	17801026	17803487	BnaA02T0250300ZY.2	0	+	247	1538	2461	0.6249492
zheyou73v0_A02	17801026	17803487	BnaA02T0250300ZY.3	0	+	247	1538	2461	0.6249492
zheyou73v0_A02	17801026	17803487	BnaA02T0250300ZY.4	0	+	247	1538	2461	0.6249492
zheyou73v0_A02	17819006	17819832	BnaA02T0250400ZY	0	-	134	733	826	0.8874092
zheyou73v0_A02	17826409	17833429	BnaA02T0250500ZY	0	-	7762	5145	7020	0.7329060
zheyou73v0_A02	17893391	17896073	BnaA02T0250600ZY	0	+	399	2601	2682	0.9697987
zheyou73v0_A02	17907484	17908794	BnaA02T0250700ZY	0	-	793	1310	1310	1.0000000
zheyou73v0_A02	17933477	17935823	BnaA02T0250800ZY	0	-	38	572	2346	0.2438193
zheyou73v0_A02	17944042	17945509	BnaA02T0250900ZY	0	-	596	1467	1467	1.0000000
zheyou73v0_A02	17953204	17954298	BnaA02T0251000ZY	0	+	3	124	1094	0.1133455
zheyou73v0_A02	17954610	17956651	BnaA02T0251100ZY	0	-	155	988	2041	0.4840764
zheyou73v0_A02	17962941	17965654	BnaA02T0251200ZY	0	+	96	1151	2713	0.4242536
zheyou73v0_A02	17966035	17969166	BnaA02T0251300ZY	0	-	121	1219	3131	0.3893325
zheyou73v0_A02	17984944	17985517	BnaA02T0251400ZY	0	+	0	0	573	0.0000000
zheyou73v0_A02	17985543	17985883	BnaA02T0251500ZY	0	+	0	0	340	0.0000000
zheyou73v0_A02	17988985	17993722	BnaA02T0251600ZY	0	+	424	3227	4737	0.6812329
zheyou73v0_A02	17995959	17997172	BnaA02T0251700ZY	0	-	51	758	1213	0.6248969
zheyou73v0_A02	18006123	18007741	BnaA02T0251800ZY	0	-	157	528	1618	0.3263288
zheyou73v0_A02	18008960	18009575	BnaA02T0251900ZY	0	+	45	603	615	0.9804878
zheyou73v0_A02	18016212	18018108	BnaA02T0252000ZY	0	+	409	1748	1896	0.9219409
zheyou73v0_A02	18019290	18020513	BnaA02T0252100ZY	0	+	359	1172	1223	0.9582993
zheyou73v0_A02	18020897	18022837	BnaA02T0252200ZY	0	-	155	1297	1940	0.6685567
zheyou73v0_A02	18025430	18028077	BnaA02T0252300ZY	0	-	2	19	2647	0.0071779
zheyou73v0_A02	18029158	18030700	BnaA02T0252400ZY	0	+	0	0	1542	0.0000000
zheyou73v0_A02	18031173	18034006	BnaA02T0252500ZY	0	-	0	0	2833	0.0000000
zheyou73v0_A02	18031173	18034006	BnaA02T0252500ZY.1	0	-	0	0	2833	0.0000000
zheyou73v0_A02	18031173	18034006	BnaA02T0252500ZY.2	0	-	0	0	2833	0.0000000
zheyou73v0_A02	18031173	18032728	BnaA02T0252500ZY.3	0	-	0	0	1555	0.0000000
zheyou73v0_A02	18060337	18062643	BnaA02T0252600ZY	0	+	0	0	2306	0.0000000
zheyou73v0_A02	18064502	18066174	BnaA02T0252700ZY	0	-	0	0	1672	0.0000000
zheyou73v0_A02	18074213	18081838	BnaA02T0252800ZY	0	+	50	811	7625	0.1063607
zheyou73v0_A02	18086783	18090166	BnaA02T0252900ZY	0	-	161	621	3383	0.1835649
zheyou73v0_A02	18099348	18101060	BnaA02T0253000ZY	0	-	20	367	1712	0.2143692
zheyou73v0_A02	18135048	18136427	BnaA02T0253100ZY	0	-	2	19	1379	0.0137781
zheyou73v0_A02	18188472	18191315	BnaA02T0253200ZY	0	-	0	0	2843	0.0000000
zheyou73v0_A02	18210782	18212803	BnaA02T0253300ZY	0	-	0	0	2021	0.0000000
zheyou73v0_A02	18215215	18218048	BnaA02T0253400ZY	0	+	0	0	2833	0.0000000
zheyou73v0_A02	18215215	18218048	BnaA02T0253400ZY.1	0	+	0	0	2833	0.0000000
zheyou73v0_A02	18215215	18218048	BnaA02T0253400ZY.2	0	+	0	0	2833	0.0000000
zheyou73v0_A02	18216493	18218048	BnaA02T0253400ZY.3	0	+	0	0	1555	0.0000000
zheyou73v0_A02	18218521	18221993	BnaA02T0253500ZY	0	-	19	555	3472	0.1598502
zheyou73v0_A02	18225419	18229516	BnaA02T0253600ZY	0	-	140	697	4097	0.1701245
zheyou73v0_A02	18231537	18233660	BnaA02T0253700ZY	0	+	116	1563	2123	0.7362223
zheyou73v0_A02	18238373	18240071	BnaA02T0253800ZY	0	-	12	319	1698	0.1878681
zheyou73v0_A02	18243942	18247557	BnaA02T0253900ZY	0	-	195	1057	3615	0.2923928
zheyou73v0_A02	18248978	18251514	BnaA02T0254000ZY	0	+	4	326	2536	0.1285489
zheyou73v0_A02	18265315	18268110	BnaA02T0254100ZY	0	-	113	1186	2795	0.4243292
zheyou73v0_A02	18270439	18275540	BnaA02T0254200ZY	0	+	859	3970	5101	0.7782788
zheyou73v0_A02	18276051	18278822	BnaA02T0254300ZY	0	-	581	1029	2771	0.3713461
zheyou73v0_A02	18280339	18282647	BnaA02T0254400ZY	0	-	117	1269	2308	0.5498267
zheyou73v0_A02	18285446	18287759	BnaA02T0254500ZY	0	-	2	115	2313	0.0497190
zheyou73v0_A02	18291613	18293427	BnaA02T0254600ZY	0	+	227	979	1814	0.5396913
zheyou73v0_A02	18301893	18305226	BnaA02T0254700ZY	0	+	74	942	3333	0.2826283
zheyou73v0_A02	18309306	18321009	BnaA02T0254800ZY	0	+	359	5194	11703	0.4438178
zheyou73v0_A02	18321620	18322986	BnaA02T0254900ZY	0	-	314	1234	1366	0.9033675
zheyou73v0_A02	18326880	18333462	BnaA02T0255000ZY	0	+	228	4690	6582	0.7125494
zheyou73v0_A02	18344752	18350103	BnaA02T0255100ZY	0	-	697	3500	5351	0.6540834
zheyou73v0_A02	18365689	18367709	BnaA02T0255200ZY	0	+	120	1234	2020	0.6108911
zheyou73v0_A02	18366986	18368405	BnaA02T0255300ZY	0	-	45	590	1419	0.4157858
zheyou73v0_A02	18370427	18371718	BnaA02T0255400ZY	0	-	161	870	1291	0.6738962
zheyou73v0_A02	18372599	18373853	BnaA02T0255500ZY	0	+	0	0	1254	0.0000000
zheyou73v0_A02	18377811	18384500	BnaA02T0255600ZY	0	+	605	4373	6689	0.6537599
zheyou73v0_A02	18390028	18390673	BnaA02T0255700ZY	0	+	468	645	645	1.0000000
zheyou73v0_A02	18393400	18393994	BnaA02T0255800ZY	0	-	618	594	594	1.0000000
zheyou73v0_A02	18405722	18410714	BnaA02T0255900ZY	0	+	506	2878	4992	0.5765224
zheyou73v0_A02	18422123	18423033	BnaA02T0256000ZY	0	+	203	722	910	0.7934066
zheyou73v0_A02	18430665	18432773	BnaA02T0256100ZY	0	+	577	1972	2108	0.9354839
zheyou73v0_A02	18436828	18437089	BnaA02T0256200ZY	0	+	3	185	261	0.7088122
zheyou73v0_A02	18437205	18437487	BnaA02T0256300ZY	0	+	35	103	282	0.3652482
zheyou73v0_A02	18449217	18451007	BnaA02T0256400ZY	0	+	257	1404	1790	0.7843575
zheyou73v0_A02	18462529	18465139	BnaA02T0256500ZY	0	+	65	1448	2610	0.5547892
zheyou73v0_A02	18469725	18470188	BnaA02T0256600ZY	0	+	502	463	463	1.0000000
zheyou73v0_A02	18494674	18495973	BnaA02T0256700ZY	0	+	82	1128	1299	0.8683603
zheyou73v0_A02	18504973	18506142	BnaA02T0256800ZY	0	+	26	666	1169	0.5697177
zheyou73v0_A02	18506966	18508559	BnaA02T0256900ZY	0	+	81	1305	1593	0.8192090
zheyou73v0_A02	18508671	18510248	BnaA02T0257000ZY	0	-	456	1549	1577	0.9822448
zheyou73v0_A02	18511572	18513155	BnaA02T0257100ZY	0	+	96	1234	1583	0.7795326
zheyou73v0_A02	18515635	18518131	BnaA02T0257200ZY	0	+	243	1701	2496	0.6814904
zheyou73v0_A02	18527419	18528908	BnaA02T0257300ZY	0	+	86	786	1489	0.5278711
zheyou73v0_A02	18531379	18535028	BnaA02T0257400ZY	0	-	106	2266	3649	0.6209921
zheyou73v0_A02	18548598	18551434	BnaA02T0257500ZY	0	-	511	2368	2836	0.8349788
zheyou73v0_A02	18554353	18555775	BnaA02T0257600ZY	0	+	97	1138	1422	0.8002813
zheyou73v0_A02	18556191	18557460	BnaA02T0257700ZY	0	-	108	1157	1269	0.9117416
zheyou73v0_A02	18563676	18564232	BnaA02T0257800ZY	0	-	345	545	556	0.9802158
zheyou73v0_A02	18569592	18571086	BnaA02T0257900ZY	0	-	50	1025	1494	0.6860777
zheyou73v0_A02	18582852	18583855	BnaA02T0258000ZY	0	-	600	1003	1003	1.0000000
zheyou73v0_A02	18588946	18589536	BnaA02T0258100ZY	0	+	19	220	590	0.3728814
zheyou73v0_A02	18590761	18593413	BnaA02T0258200ZY	0	+	1116	2612	2652	0.9849170
zheyou73v0_A02	18602514	18604603	BnaA02T0258300ZY	0	-	355	1748	2089	0.8367640
zheyou73v0_A02	18616570	18616948	BnaA02T0258400ZY	0	+	9	308	378	0.8148148
zheyou73v0_A02	18623758	18626789	BnaA02T0258500ZY	0	+	378	1825	3031	0.6021115
zheyou73v0_A02	18633437	18639340	BnaA02T0258600ZY	0	-	2781	5903	5903	1.0000000
zheyou73v0_A02	18639791	18649052	BnaA02T0258700ZY	0	-	1968	8569	9261	0.9252781
zheyou73v0_A02	18665419	18667649	BnaA02T0258800ZY	0	+	233	1527	2230	0.6847534
zheyou73v0_A02	18669771	18671258	BnaA02T0258900ZY	0	+	111	1334	1487	0.8971083
zheyou73v0_A02	18671485	18671869	BnaA02T0259000ZY	0	-	200	384	384	1.0000000
zheyou73v0_A02	18671899	18673437	BnaA02T0259100ZY	0	-	491	1136	1538	0.7386216
zheyou73v0_A02	18675042	18676841	BnaA02T0259200ZY	0	+	385	1291	1799	0.7176209
zheyou73v0_A02	18686423	18686804	BnaA02T0259300ZY	0	-	69	359	381	0.9422572
zheyou73v0_A02	18692189	18692483	BnaA02T0259400ZY	0	+	225	294	294	1.0000000
zheyou73v0_A02	18699326	18701721	BnaA02T0259500ZY	0	+	835	2395	2395	1.0000000
zheyou73v0_A02	18702340	18704074	BnaA02T0259600ZY	0	+	595	1734	1734	1.0000000
zheyou73v0_A02	18705128	18707058	BnaA02T0259700ZY	0	+	471	1714	1930	0.8880829
zheyou73v0_A02	18707619	18708860	BnaA02T0259800ZY	0	-	936	1241	1241	1.0000000
zheyou73v0_A02	18709874	18711922	BnaA02T0259900ZY	0	-	244	2032	2048	0.9921875
zheyou73v0_A02	18714580	18716435	BnaA02T0260000ZY	0	-	87	1040	1855	0.5606469
zheyou73v0_A02	18717967	18718730	BnaA02T0260100ZY	0	-	0	0	763	0.0000000
zheyou73v0_A02	18722045	18723330	BnaA02T0260200ZY	0	+	137	1077	1285	0.8381323
zheyou73v0_A02	18723812	18726213	BnaA02T0260300ZY	0	-	224	1628	2401	0.6780508
zheyou73v0_A02	18737689	18742349	BnaA02T0260400ZY	0	+	477	3308	4660	0.7098712
zheyou73v0_A02	18737794	18741930	BnaA02T0260400ZY.1	0	+	341	2966	4136	0.7171180
zheyou73v0_A02	18742889	18747599	BnaA02T0260500ZY	0	+	521	3538	4710	0.7511677
zheyou73v0_A02	18742889	18747599	BnaA02T0260500ZY.1	0	+	521	3538	4710	0.7511677
zheyou73v0_A02	18748503	18752528	BnaA02T0260600ZY	0	-	434	2068	4025	0.5137888
zheyou73v0_A02	18757466	18757775	BnaA02T0260700ZY	0	-	159	309	309	1.0000000
zheyou73v0_A02	18757984	18765722	BnaA02T0260800ZY	0	-	808	3843	7738	0.4966400
zheyou73v0_A02	18757984	18765722	BnaA02T0260800ZY.1	0	-	808	3843	7738	0.4966400
zheyou73v0_A02	18769014	18769176	BnaA02T0260900ZY	0	+	3	29	162	0.1790123
zheyou73v0_A02	18775357	18777881	BnaA02T0261000ZY	0	-	809	2237	2524	0.8862916
zheyou73v0_A02	18779089	18779926	BnaA02T0261100ZY	0	+	105	656	837	0.7837515
zheyou73v0_A02	18780124	18782653	BnaA02T0261200ZY	0	-	506	2086	2529	0.8248320
zheyou73v0_A02	18785443	18787804	BnaA02T0261300ZY	0	-	0	0	2361	0.0000000
zheyou73v0_A02	18799369	18800311	BnaA02T0261400ZY	0	+	37	618	942	0.6560510
zheyou73v0_A02	18805072	18805456	BnaA02T0261500ZY	0	-	0	0	384	0.0000000
zheyou73v0_A02	18806486	18809127	BnaA02T0261600ZY	0	+	1241	2641	2641	1.0000000
zheyou73v0_A02	18812461	18815018	BnaA02T0261700ZY	0	+	728	2532	2557	0.9902229
zheyou73v0_A02	18820813	18820993	BnaA02T0261800ZY	0	-	135	180	180	1.0000000
zheyou73v0_A02	18823497	18824080	BnaA02T0261900ZY	0	-	186	479	583	0.8216124
zheyou73v0_A02	18835154	18835727	BnaA02T0262000ZY	0	-	22	379	573	0.6614311
zheyou73v0_A02	18841904	18847607	BnaA02T0262100ZY	0	-	2463	5629	5703	0.9870244
zheyou73v0_A02	18850432	18851028	BnaA02T0262200ZY	0	-	60	556	596	0.9328859
zheyou73v0_A02	18858466	18858735	BnaA02T0262300ZY	0	+	212	269	269	1.0000000
zheyou73v0_A02	18876858	18877496	BnaA02T0262400ZY	0	-	30	157	638	0.2460815
zheyou73v0_A02	18878788	18880917	BnaA02T0262500ZY	0	+	119	1490	2129	0.6998591
zheyou73v0_A02	18883933	18889206	BnaA02T0262600ZY	0	+	215	4021	5273	0.7625640
zheyou73v0_A02	18889540	18892026	BnaA02T0262700ZY	0	-	583	2369	2486	0.9529365
zheyou73v0_A02	18892868	18893977	BnaA02T0262800ZY	0	+	350	1109	1109	1.0000000
zheyou73v0_A02	18894040	18894508	BnaA02T0262900ZY	0	-	90	458	468	0.9786325
zheyou73v0_A02	18894827	18897150	BnaA02T0263000ZY	0	-	1062	2267	2323	0.9758933
zheyou73v0_A02	18901007	18901926	BnaA02T0263100ZY	0	-	821	919	919	1.0000000
zheyou73v0_A02	18906266	18909065	BnaA02T0263200ZY	0	-	216	2095	2799	0.7484816
zheyou73v0_A02	18911502	18912568	BnaA02T0263300ZY	0	+	243	1019	1066	0.9559100
zheyou73v0_A02	18911502	18912568	BnaA02T0263300ZY.1	0	+	243	1019	1066	0.9559100
zheyou73v0_A02	18914937	18917592	BnaA02T0263400ZY.1	0	+	307	2283	2655	0.8598870
zheyou73v0_A02	18915287	18917798	BnaA02T0263400ZY	0	+	353	2139	2511	0.8518519
zheyou73v0_A02	18919956	18921561	BnaA02T0263500ZY	0	-	452	1407	1605	0.8766355
zheyou73v0_A02	18923961	18926065	BnaA02T0263600ZY	0	+	249	1487	2104	0.7067490
zheyou73v0_A02	18927051	18928713	BnaA02T0263700ZY	0	-	264	839	1662	0.5048135
zheyou73v0_A02	18930586	18932325	BnaA02T0263800ZY	0	-	47	1055	1739	0.6066705
zheyou73v0_A02	18944902	18948183	BnaA02T0263900ZY	0	+	121	1665	3281	0.5074672
zheyou73v0_A02	18948197	18950061	BnaA02T0264000ZY	0	-	18	183	1864	0.0981760
zheyou73v0_A02	18960941	18962799	BnaA02T0264100ZY	0	-	13	528	1858	0.2841765
zheyou73v0_A02	18980934	18982555	BnaA02T0264200ZY	0	-	0	0	1621	0.0000000
zheyou73v0_A02	18986797	19000921	BnaA02T0264300ZY	0	-	1400	9155	14124	0.6481875
zheyou73v0_A02	19002713	19004071	BnaA02T0264400ZY	0	-	54	822	1358	0.6053019
zheyou73v0_A02	19007214	19009874	BnaA02T0264500ZY	0	+	980	2513	2660	0.9447368
zheyou73v0_A02	19007242	19010133	BnaA02T0264500ZY.1	0	+	1074	2744	2891	0.9491525
zheyou73v0_A02	19007242	19010133	BnaA02T0264500ZY.2	0	+	1074	2744	2891	0.9491525
zheyou73v0_A02	19012772	19013595	BnaA02T0264600ZY	0	-	0	0	823	0.0000000
zheyou73v0_A02	19017188	19019650	BnaA02T0264700ZY	0	-	544	2265	2462	0.9199837
zheyou73v0_A02	19020858	19023874	BnaA02T0264800ZY	0	-	217	1791	3016	0.5938329
zheyou73v0_A02	19028016	19028607	BnaA02T0264900ZY	0	+	6	236	591	0.3993232
zheyou73v0_A02	19029155	19047673	BnaA02T0265000ZY	0	+	3053	14685	18518	0.7930122
zheyou73v0_A02	19052012	19052331	BnaA02T0265100ZY	0	-	11	93	319	0.2915361
zheyou73v0_A02	19053013	19055039	BnaA02T0265200ZY	0	-	223	1631	2026	0.8050346
zheyou73v0_A02	19075251	19076836	BnaA02T0265300ZY	0	+	40	1184	1585	0.7470031
zheyou73v0_A02	19079856	19081561	BnaA02T0265400ZY	0	-	536	1377	1705	0.8076246
zheyou73v0_A02	19084892	19096368	BnaA02T0265500ZY	0	-	1459	5857	11476	0.5103695
zheyou73v0_A02	19104601	19106358	BnaA02T0265600ZY	0	+	804	1667	1757	0.9487763
zheyou73v0_A02	19104601	19106181	BnaA02T0265600ZY.1	0	+	732	1490	1580	0.9430380
zheyou73v0_A02	19104601	19106358	BnaA02T0265600ZY.2	0	+	804	1667	1757	0.9487763
zheyou73v0_A02	19104601	19106358	BnaA02T0265600ZY.3	0	+	804	1667	1757	0.9487763
zheyou73v0_A02	19106298	19109076	BnaA02T0265700ZY	0	-	344	1898	2778	0.6832253
zheyou73v0_A02	19109502	19110145	BnaA02T0265800ZY	0	-	160	641	643	0.9968896
zheyou73v0_A02	19110671	19119257	BnaA02T0265900ZY	0	-	1538	7352	8586	0.8562776
zheyou73v0_A02	19119814	19124635	BnaA02T0266000ZY	0	-	1580	4751	4821	0.9854802
zheyou73v0_A02	19124699	19125119	BnaA02T0266100ZY	0	-	264	420	420	1.0000000
zheyou73v0_A02	19127464	19131042	BnaA02T0266200ZY	0	+	473	2640	3578	0.7378424
zheyou73v0_A02	19132137	19132760	BnaA02T0266300ZY	0	+	4	128	623	0.2054575
zheyou73v0_A02	19138312	19139800	BnaA02T0266400ZY	0	+	224	1470	1488	0.9879032
zheyou73v0_A02	19142923	19144709	BnaA02T0266500ZY	0	+	341	1493	1786	0.8359463
zheyou73v0_A02	19145654	19147679	BnaA02T0266600ZY	0	-	19	603	2025	0.2977778
zheyou73v0_A02	19157359	19158467	BnaA02T0266700ZY	0	+	185	791	1108	0.7138989
zheyou73v0_A02	19158683	19160930	BnaA02T0266800ZY	0	-	147	1477	2247	0.6573209
zheyou73v0_A02	19188801	19191950	BnaA02T0266900ZY	0	+	228	2230	3149	0.7081613
zheyou73v0_A02	19188801	19191950	BnaA02T0266900ZY.1	0	+	228	2230	3149	0.7081613
zheyou73v0_A02	19191820	19194114	BnaA02T0267000ZY	0	-	342	1953	2294	0.8513514
zheyou73v0_A02	19191820	19193755	BnaA02T0267000ZY.1	0	-	310	1645	1935	0.8501292
zheyou73v0_A02	19195588	19196771	BnaA02T0267100ZY	0	-	171	830	1183	0.7016061
zheyou73v0_A02	19198253	19198589	BnaA02T0267200ZY	0	-	105	336	336	1.0000000
zheyou73v0_A02	19201883	19202784	BnaA02T0267300ZY	0	+	118	745	901	0.8268591
zheyou73v0_A02	19204858	19205955	BnaA02T0267400ZY	0	+	25	465	1097	0.4238833
zheyou73v0_A02	19212078	19213743	BnaA02T0267500ZY	0	+	42	757	1665	0.4546547
zheyou73v0_A02	19216298	19217665	BnaA02T0267600ZY	0	-	0	0	1367	0.0000000
zheyou73v0_A02	19242351	19243035	BnaA02T0267700ZY	0	+	0	0	684	0.0000000
zheyou73v0_A02	19249826	19257370	BnaA02T0267800ZY	0	-	789	5266	7544	0.6980382
zheyou73v0_A02	19257577	19260043	BnaA02T0267900ZY	0	+	245	1898	2466	0.7696675
zheyou73v0_A02	19267689	19268716	BnaA02T0268000ZY	0	-	105	886	1027	0.8627069
zheyou73v0_A02	19268938	19271077	BnaA02T0268100ZY	0	-	222	2033	2139	0.9504442
zheyou73v0_A02	19268938	19271077	BnaA02T0268100ZY.1	0	-	222	2033	2139	0.9504442
zheyou73v0_A02	19271968	19273773	BnaA02T0268200ZY	0	-	77	1092	1805	0.6049861
zheyou73v0_A02	19275319	19282894	BnaA02T0268300ZY	0	+	2556	7247	7575	0.9566997
zheyou73v0_A02	19283782	19285917	BnaA02T0268400ZY	0	+	265	1908	2135	0.8936768
zheyou73v0_A02	19297807	19299096	BnaA02T0268500ZY	0	+	1168	1289	1289	1.0000000
zheyou73v0_A02	19307562	19308535	BnaA02T0268600ZY	0	+	538	973	973	1.0000000
zheyou73v0_A02	19310416	19312133	BnaA02T0268700ZY	0	+	835	1717	1717	1.0000000
zheyou73v0_A02	19330038	19331104	BnaA02T0268800ZY	0	+	6	238	1066	0.2232645
zheyou73v0_A02	19333069	19334232	BnaA02T0268900ZY	0	-	120	910	1163	0.7824591
zheyou73v0_A02	19337875	19338506	BnaA02T0269000ZY	0	+	230	631	631	1.0000000
zheyou73v0_A02	19340282	19340474	BnaA02T0269100ZY	0	+	111	192	192	1.0000000
zheyou73v0_A02	19345081	19347012	BnaA02T0269200ZY	0	-	240	1165	1931	0.6033143
zheyou73v0_A02	19347088	19349984	BnaA02T0269300ZY	0	-	152	1249	2896	0.4312845
zheyou73v0_A02	19350086	19352427	BnaA02T0269400ZY	0	-	314	1816	2341	0.7757369
zheyou73v0_A02	19353423	19355860	BnaA02T0269500ZY	0	-	297	2093	2437	0.8588428
zheyou73v0_A02	19360872	19361165	BnaA02T0269600ZY	0	-	162	293	293	1.0000000
zheyou73v0_A02	19365666	19368077	BnaA02T0269700ZY	0	-	81	1225	2411	0.5080879
zheyou73v0_A02	19369475	19370368	BnaA02T0269800ZY	0	-	589	893	893	1.0000000
zheyou73v0_A02	19384089	19386780	BnaA02T0269900ZY	0	+	240	1673	2691	0.6217020
zheyou73v0_A02	19386847	19388666	BnaA02T0270000ZY	0	-	144	1047	1819	0.5755910
zheyou73v0_A02	19392804	19395209	BnaA02T0270100ZY	0	+	138	1101	2405	0.4577962
zheyou73v0_A02	19399182	19399595	BnaA02T0270200ZY	0	+	0	0	413	0.0000000
zheyou73v0_A02	19400235	19400556	BnaA02T0270300ZY	0	+	223	321	321	1.0000000
zheyou73v0_A02	19400580	19400942	BnaA02T0270400ZY	0	+	101	362	362	1.0000000
zheyou73v0_A02	19401024	19402461	BnaA02T0270500ZY	0	+	483	1369	1437	0.9526792
zheyou73v0_A02	19403427	19403748	BnaA02T0270600ZY	0	+	150	321	321	1.0000000
zheyou73v0_A02	19416953	19419264	BnaA02T0270700ZY	0	+	24	537	2311	0.2323669
zheyou73v0_A02	19420959	19421709	BnaA02T0270800ZY	0	+	30	362	750	0.4826667
zheyou73v0_A02	19423419	19424990	BnaA02T0270900ZY	0	+	423	1542	1571	0.9815404
zheyou73v0_A02	19425428	19431823	BnaA02T0271000ZY	0	+	493	5310	6395	0.8303362
zheyou73v0_A02	19432384	19433853	BnaA02T0271100ZY	0	-	37	1036	1469	0.7052417
zheyou73v0_A02	19434728	19437324	BnaA02T0271200ZY	0	-	463	2458	2596	0.9468413
zheyou73v0_A02	19434728	19437324	BnaA02T0271200ZY.1	0	-	463	2458	2596	0.9468413
zheyou73v0_A02	19437638	19440926	BnaA02T0271300ZY	0	-	619	3227	3288	0.9814477
zheyou73v0_A02	19444344	19446755	BnaA02T0271400ZY	0	+	150	1654	2411	0.6860224
zheyou73v0_A02	19448010	19450668	BnaA02T0271500ZY	0	+	262	1841	2658	0.6926261
zheyou73v0_A02	19454597	19456192	BnaA02T0271600ZY	0	+	57	711	1595	0.4457680
zheyou73v0_A02	19456982	19458229	BnaA02T0271700ZY	0	+	124	967	1247	0.7754611
zheyou73v0_A02	19458359	19459514	BnaA02T0271800ZY	0	-	84	893	1155	0.7731602
zheyou73v0_A02	19459718	19460989	BnaA02T0271900ZY	0	-	229	926	1271	0.7285602
zheyou73v0_A02	19464686	19467497	BnaA02T0272000ZY	0	+	538	2273	2811	0.8086090
zheyou73v0_A02	19468583	19473368	BnaA02T0272100ZY	0	-	1309	4484	4785	0.9370951
zheyou73v0_A02	19473565	19474881	BnaA02T0272200ZY	0	-	419	1285	1316	0.9764438
zheyou73v0_A02	19473565	19474881	BnaA02T0272200ZY.1	0	-	419	1285	1316	0.9764438
zheyou73v0_A02	19475498	19475793	BnaA02T0272300ZY	0	+	94	295	295	1.0000000
zheyou73v0_A02	19484272	19485052	BnaA02T0272400ZY	0	-	630	780	780	1.0000000
zheyou73v0_A02	19487351	19492110	BnaA02T0272500ZY	0	-	2166	4739	4759	0.9957975
zheyou73v0_A02	19492517	19494652	BnaA02T0272600ZY	0	-	387	2078	2135	0.9733021
zheyou73v0_A02	19492517	19494652	BnaA02T0272600ZY.1	0	-	387	2078	2135	0.9733021
zheyou73v0_A02	19504084	19504462	BnaA02T0272700ZY	0	+	74	373	378	0.9867725
zheyou73v0_A02	19505902	19506332	BnaA02T0272800ZY	0	+	94	430	430	1.0000000
zheyou73v0_A02	19506413	19507540	BnaA02T0272900ZY	0	-	115	886	1127	0.7861580
zheyou73v0_A02	19508513	19509692	BnaA02T0273000ZY	0	-	133	719	1179	0.6098388
zheyou73v0_A02	19510264	19511991	BnaA02T0273100ZY	0	-	88	1202	1727	0.6960046
zheyou73v0_A02	19515663	19516063	BnaA02T0273200ZY	0	+	56	400	400	1.0000000
zheyou73v0_A02	19530066	19531680	BnaA02T0273300ZY	0	+	216	1088	1614	0.6741016
zheyou73v0_A02	19532308	19533686	BnaA02T0273400ZY	0	-	101	998	1378	0.7242380
zheyou73v0_A02	19556579	19558383	BnaA02T0273500ZY	0	+	463	1713	1804	0.9495565
zheyou73v0_A02	19556820	19558383	BnaA02T0273500ZY.1	0	+	365	1472	1563	0.9417787
zheyou73v0_A02	19559256	19560439	BnaA02T0273600ZY	0	-	46	584	1183	0.4936602
zheyou73v0_A02	19559256	19560439	BnaA02T0273600ZY.1	0	-	46	584	1183	0.4936602
zheyou73v0_A02	19562936	19563278	BnaA02T0273700ZY	0	-	74	342	342	1.0000000
zheyou73v0_A02	19565515	19566403	BnaA02T0273800ZY	0	+	88	302	888	0.3400901
zheyou73v0_A02	19569811	19572177	BnaA02T0273900ZY	0	-	208	1811	2366	0.7654269
zheyou73v0_A02	19576795	19580499	BnaA02T0274000ZY	0	-	137	1252	3704	0.3380130
zheyou73v0_A02	19585350	19601227	BnaA02T0274100ZY	0	+	599	7307	15877	0.4602255
zheyou73v0_A02	19608005	19611038	BnaA02T0274200ZY	0	+	312	1600	3033	0.5275305
zheyou73v0_A02	19616546	19617210	BnaA02T0274300ZY	0	+	27	432	664	0.6506024
zheyou73v0_A02	19617217	19619432	BnaA02T0274400ZY	0	-	223	1385	2215	0.6252822
zheyou73v0_A02	19617217	19619432	BnaA02T0274400ZY.1	0	-	223	1385	2215	0.6252822
zheyou73v0_A02	19619985	19621804	BnaA02T0274500ZY	0	-	155	739	1819	0.4062672
zheyou73v0_A02	19627820	19627994	BnaA02T0274600ZY	0	+	8	174	174	1.0000000
zheyou73v0_A02	19641065	19641374	BnaA02T0274700ZY	0	+	59	261	309	0.8446602
zheyou73v0_A02	19641594	19644712	BnaA02T0274800ZY	0	-	405	2540	3118	0.8146248
zheyou73v0_A02	19641594	19644712	BnaA02T0274800ZY.1	0	-	405	2540	3118	0.8146248
zheyou73v0_A02	19645081	19648232	BnaA02T0274900ZY	0	-	398	2751	3151	0.8730562
zheyou73v0_A02	19657704	19658555	BnaA02T0275000ZY	0	-	0	0	851	0.0000000
zheyou73v0_A02	19663045	19665863	BnaA02T0275100ZY	0	+	645	2509	2818	0.8903478
zheyou73v0_A02	19682604	19687130	BnaA02T0275200ZY	0	-	296	3012	4526	0.6654883
zheyou73v0_A02	19682604	19687130	BnaA02T0275200ZY.1	0	-	296	3012	4526	0.6654883
zheyou73v0_A02	19687400	19689953	BnaA02T0275300ZY	0	-	373	2524	2553	0.9886408
zheyou73v0_A02	19692131	19693932	BnaA02T0275400ZY	0	+	31	374	1801	0.2076624
zheyou73v0_A02	19695024	19696763	BnaA02T0275500ZY	0	+	35	360	1739	0.2070155
zheyou73v0_A02	19717169	19717697	BnaA02T0275600ZY	0	+	84	360	528	0.6818182
zheyou73v0_A02	19728416	19730626	BnaA02T0275700ZY	0	+	11	529	2210	0.2393665
zheyou73v0_A02	19734493	19735838	BnaA02T0275800ZY	0	+	87	1212	1345	0.9011152
zheyou73v0_A02	19755020	19758857	BnaA02T0275900ZY	0	+	252	2394	3837	0.6239250
zheyou73v0_A02	19760468	19760999	BnaA02T0276000ZY	0	-	2	106	531	0.1996233
zheyou73v0_A02	19761523	19765070	BnaA02T0276100ZY	0	-	306	2032	3547	0.5728785
zheyou73v0_A02	19767037	19769496	BnaA02T0276200ZY	0	-	265	1619	2459	0.6583977
zheyou73v0_A02	19783485	19784901	BnaA02T0276300ZY	0	-	259	1319	1416	0.9314972
zheyou73v0_A02	19790437	19792804	BnaA02T0276400ZY	0	+	685	2322	2367	0.9809886
zheyou73v0_A02	19794708	19798035	BnaA02T0276500ZY	0	+	35	814	3327	0.2446649
zheyou73v0_A02	19813440	19817109	BnaA02T0276600ZY	0	+	248	1861	3669	0.5072227
zheyou73v0_A02	19832956	19834209	BnaA02T0276700ZY	0	-	0	0	1253	0.0000000
zheyou73v0_A02	19840101	19842056	BnaA02T0276800ZY	0	+	83	1318	1955	0.6741688
zheyou73v0_A02	19840101	19842056	BnaA02T0276800ZY.1	0	+	83	1318	1955	0.6741688
zheyou73v0_A02	19840101	19842056	BnaA02T0276800ZY.2	0	+	83	1318	1955	0.6741688
zheyou73v0_A02	19840264	19842056	BnaA02T0276800ZY.3	0	+	77	1161	1792	0.6478795
zheyou73v0_A02	19842113	19842500	BnaA02T0276900ZY	0	+	152	387	387	1.0000000
zheyou73v0_A02	19849313	19855125	BnaA02T0277000ZY	0	+	3083	5536	5812	0.9525120
zheyou73v0_A02	19849313	19855125	BnaA02T0277000ZY.1	0	+	3083	5536	5812	0.9525120
zheyou73v0_A02	19849313	19855125	BnaA02T0277000ZY.2	0	+	3083	5536	5812	0.9525120
zheyou73v0_A02	19866161	19867586	BnaA02T0277100ZY	0	+	5	71	1425	0.0498246
zheyou73v0_A02	19875835	19876885	BnaA02T0277200ZY	0	-	36	540	1050	0.5142857
zheyou73v0_A02	19877686	19878301	BnaA02T0277300ZY	0	+	0	0	615	0.0000000
zheyou73v0_A02	19883988	19884860	BnaA02T0277400ZY	0	+	51	849	872	0.9736239
zheyou73v0_A02	19888598	19890023	BnaA02T0277500ZY	0	+	7	34	1425	0.0238596
zheyou73v0_A02	19900354	19901269	BnaA02T0277600ZY	0	+	35	576	915	0.6295082
zheyou73v0_A02	19903467	19909992	BnaA02T0277700ZY	0	+	2344	6376	6525	0.9771647
zheyou73v0_A02	19915303	19916204	BnaA02T0277800ZY	0	+	124	560	901	0.6215316
zheyou73v0_A02	19916840	19918622	BnaA02T0277900ZY	0	-	21	335	1782	0.1879910
zheyou73v0_A02	19927449	19930130	BnaA02T0278000ZY	0	-	319	2160	2681	0.8056695
zheyou73v0_A02	19938288	19940228	BnaA02T0278100ZY	0	+	200	1591	1940	0.8201031
zheyou73v0_A02	19940315	19941067	BnaA02T0278200ZY	0	-	132	654	752	0.8696808
zheyou73v0_A02	19941515	19944134	BnaA02T0278300ZY	0	+	885	2619	2619	1.0000000
zheyou73v0_A02	19964629	19966732	BnaA02T0278400ZY	0	+	343	1765	2103	0.8392772
zheyou73v0_A02	19971857	19972314	BnaA02T0278500ZY	0	+	26	217	457	0.4748359
zheyou73v0_A02	19989255	19992591	BnaA02T0278600ZY	0	+	761	3053	3336	0.9151679
zheyou73v0_A02	20028085	20029806	BnaA02T0278700ZY	0	+	50	762	1721	0.4427658
zheyou73v0_A02	20069502	20069947	BnaA02T0278800ZY	0	-	334	445	445	1.0000000
zheyou73v0_A02	20082646	20084504	BnaA02T0278900ZY	0	+	217	1573	1858	0.8466092
zheyou73v0_A02	20082721	20084504	BnaA02T0278900ZY.1	0	+	200	1498	1783	0.8401570
zheyou73v0_A02	20108333	20109895	BnaA02T0279000ZY	0	+	36	550	1562	0.3521127
zheyou73v0_A02	20120651	20123174	BnaA02T0279100ZY	0	-	310	1972	2523	0.7816092
zheyou73v0_A02	20120651	20123174	BnaA02T0279100ZY.1	0	-	310	1972	2523	0.7816092
zheyou73v0_A02	20130689	20135396	BnaA02T0279200ZY	0	-	1343	4208	4707	0.8939877
zheyou73v0_A02	20137802	20140244	BnaA02T0279300ZY	0	+	424	2288	2442	0.9369369
zheyou73v0_A02	20152409	20155763	BnaA02T0279400ZY	0	+	169	2206	3354	0.6577221
zheyou73v0_A02	20157451	20160285	BnaA02T0279500ZY	0	-	361	2063	2834	0.7279463
zheyou73v0_A02	20157451	20160285	BnaA02T0279500ZY.1	0	-	361	2063	2834	0.7279463
zheyou73v0_A02	20170923	20173655	BnaA02T0279600ZY	0	-	463	1995	2732	0.7302343
zheyou73v0_A02	20170923	20173655	BnaA02T0279600ZY.1	0	-	463	1995	2732	0.7302343
zheyou73v0_A02	20199013	20199304	BnaA02T0279700ZY	0	-	1	109	291	0.3745705
zheyou73v0_A02	20237768	20240408	BnaA02T0279800ZY	0	-	26	412	2640	0.1560606
zheyou73v0_A02	20244797	20245352	BnaA02T0279900ZY	0	+	4	32	555	0.0576577
zheyou73v0_A02	20252852	20257755	BnaA02T0280000ZY	0	+	273	1006	4903	0.2051805
zheyou73v0_A02	20258216	20259733	BnaA02T0280100ZY	0	-	291	1106	1517	0.7290705
zheyou73v0_A02	20280272	20282897	BnaA02T0280200ZY	0	-	32	638	2625	0.2430476
zheyou73v0_A02	20303315	20305909	BnaA02T0280300ZY	0	+	42	464	2594	0.1788743
zheyou73v0_A02	20308293	20309137	BnaA02T0280400ZY	0	+	61	607	844	0.7191943
zheyou73v0_A02	20314312	20315112	BnaA02T0280500ZY	0	-	34	366	800	0.4575000
zheyou73v0_A02	20325535	20328751	BnaA02T0280600ZY	0	+	111	1970	3216	0.6125622
zheyou73v0_A02	20329945	20333906	BnaA02T0280700ZY	0	+	134	2234	3961	0.5639990
zheyou73v0_A02	20334266	20336504	BnaA02T0280800ZY	0	-	167	1757	2238	0.7850760
zheyou73v0_A02	20370021	20373129	BnaA02T0280900ZY	0	+	0	0	3108	0.0000000
zheyou73v0_A02	20373473	20373788	BnaA02T0281000ZY	0	-	0	0	315	0.0000000
zheyou73v0_A02	20392451	20394029	BnaA02T0281100ZY	0	-	0	0	1578	0.0000000
zheyou73v0_A02	20394877	20397245	BnaA02T0281200ZY	0	+	0	0	2368	0.0000000
zheyou73v0_A02	20398123	20399491	BnaA02T0281300ZY	0	-	0	0	1368	0.0000000
zheyou73v0_A02	20401688	20404943	BnaA02T0281400ZY	0	+	0	0	3255	0.0000000
zheyou73v0_A02	20405287	20408285	BnaA02T0281500ZY	0	-	0	0	2998	0.0000000
zheyou73v0_A02	20411913	20413491	BnaA02T0281600ZY	0	-	0	0	1578	0.0000000
zheyou73v0_A02	20414339	20416707	BnaA02T0281700ZY	0	+	0	0	2368	0.0000000
zheyou73v0_A02	20417585	20424205	BnaA02T0281800ZY	0	-	195	2851	6620	0.4306647
zheyou73v0_A02	20419821	20424262	BnaA02T0281800ZY.1	0	-	97	1805	4441	0.4064400
zheyou73v0_A02	20425160	20431227	BnaA02T0281900ZY	0	-	323	3359	6067	0.5536509
zheyou73v0_A02	20444688	20448108	BnaA02T0282000ZY	0	-	1868	3420	3420	1.0000000
zheyou73v0_A02	20464255	20466841	BnaA02T0282100ZY	0	+	341	2015	2586	0.7791957
zheyou73v0_A02	20466895	20468239	BnaA02T0282200ZY	0	+	25	821	1344	0.6108631
zheyou73v0_A02	20473745	20475845	BnaA02T0282300ZY	0	+	66	1061	2100	0.5052381
zheyou73v0_A02	20482185	20482557	BnaA02T0282400ZY	0	+	3	66	372	0.1774193
zheyou73v0_A02	20487235	20489624	BnaA02T0282500ZY	0	+	248	1890	2389	0.7911260
zheyou73v0_A02	20494270	20495331	BnaA02T0282600ZY	0	-	87	787	1061	0.7417530
zheyou73v0_A02	20495936	20506041	BnaA02T0282700ZY	0	-	5647	9734	10105	0.9632855
zheyou73v0_A02	20511937	20516674	BnaA02T0282800ZY	0	-	300	1878	4737	0.3964534
zheyou73v0_A02	20518225	20520013	BnaA02T0282900ZY	0	-	325	1595	1788	0.8920582
zheyou73v0_A02	20532143	20534798	BnaA02T0283000ZY	0	+	170	1528	2655	0.5755179
zheyou73v0_A02	20539108	20539645	BnaA02T0283100ZY	0	+	46	411	537	0.7653632
zheyou73v0_A02	20556080	20558598	BnaA02T0283200ZY	0	-	92	1476	2518	0.5861795
zheyou73v0_A02	20563041	20564164	BnaA02T0283300ZY	0	+	40	185	1123	0.1647373
zheyou73v0_A02	20565584	20566055	BnaA02T0283400ZY	0	-	177	471	471	1.0000000
zheyou73v0_A02	20570764	20572035	BnaA02T0283500ZY	0	-	307	1207	1271	0.9496459
zheyou73v0_A02	20570764	20572035	BnaA02T0283500ZY.1	0	-	307	1207	1271	0.9496459
zheyou73v0_A02	20575023	20576051	BnaA02T0283600ZY	0	+	38	489	1028	0.4756809
zheyou73v0_A02	20576347	20578522	BnaA02T0283700ZY	0	-	210	1716	2175	0.7889655
zheyou73v0_A02	20581380	20582449	BnaA02T0283800ZY	0	+	27	482	1069	0.4508887
zheyou73v0_A02	20589410	20591515	BnaA02T0283900ZY	0	+	142	1567	2105	0.7444180
zheyou73v0_A02	20599303	20600668	BnaA02T0284000ZY	0	+	6	194	1365	0.1421245
zheyou73v0_A02	20608299	20609882	BnaA02T0284100ZY	0	-	25	420	1583	0.2653190
zheyou73v0_A02	20617464	20620207	BnaA02T0284200ZY	0	+	259	2257	2743	0.8228217
zheyou73v0_A02	20617464	20619595	BnaA02T0284200ZY.1	0	+	185	1808	2131	0.8484280
zheyou73v0_A02	20627349	20637379	BnaA02T0284300ZY	0	-	2957	7572	10030	0.7549352
zheyou73v0_A02	20654493	20655425	BnaA02T0284400ZY	0	+	12	51	932	0.0547210
zheyou73v0_A02	20666830	20669372	BnaA02T0284500ZY	0	-	241	1342	2542	0.5279307
zheyou73v0_A02	20680690	20685828	BnaA02T0284600ZY	0	-	335	3307	5138	0.6436356
zheyou73v0_A02	20692785	20696741	BnaA02T0284700ZY	0	-	69	1063	3956	0.2687058
zheyou73v0_A02	20709123	20711690	BnaA02T0284800ZY	0	-	28	354	2567	0.1379042
zheyou73v0_A02	20716421	20717617	BnaA02T0284900ZY	0	-	12	227	1196	0.1897993
zheyou73v0_A02	20718225	20719412	BnaA02T0285000ZY	0	+	96	630	1187	0.5307498
zheyou73v0_A02	20726777	20728899	BnaA02T0285100ZY.1	0	+	120	1196	2122	0.5636193
zheyou73v0_A02	20726975	20728899	BnaA02T0285100ZY	0	+	79	998	1924	0.5187110
zheyou73v0_A02	20728009	20728567	BnaA02T0285200ZY	0	-	2	216	558	0.3870968
zheyou73v0_A02	20733174	20734811	BnaA02T0285300ZY	0	-	98	314	1637	0.1918143
zheyou73v0_A02	20754074	20754528	BnaA02T0285400ZY	0	+	253	454	454	1.0000000
zheyou73v0_A02	20758499	20760675	BnaA02T0285500ZY	0	-	20	486	2176	0.2233456
zheyou73v0_A02	20769456	20769639	BnaA02T0285600ZY	0	+	13	170	183	0.9289618
zheyou73v0_A02	20779046	20790056	BnaA02T0285700ZY	0	+	2483	9539	11010	0.8663942
zheyou73v0_A02	20795075	20795553	BnaA02T0285800ZY	0	-	20	178	478	0.3723849
zheyou73v0_A02	20801221	20802582	BnaA02T0285900ZY	0	-	18	584	1361	0.4290963
zheyou73v0_A02	20801221	20802582	BnaA02T0285900ZY.1	0	-	18	584	1361	0.4290963
zheyou73v0_A02	20807618	20809800	BnaA02T0286000ZY	0	-	951	1900	2182	0.8707608
zheyou73v0_A02	20818329	20819156	BnaA02T0286100ZY	0	+	8	252	827	0.3047158
zheyou73v0_A02	20819411	20822646	BnaA02T0286200ZY	0	-	99	878	3235	0.2714065
zheyou73v0_A02	20819411	20822049	BnaA02T0286200ZY.1	0	-	98	814	2638	0.3085671
zheyou73v0_A02	20857336	20860288	BnaA02T0286300ZY	0	+	54	1009	2952	0.3418022
zheyou73v0_A02	20873351	20874782	BnaA02T0286400ZY	0	+	2	22	1431	0.0153739
zheyou73v0_A02	20879351	20880743	BnaA02T0286500ZY	0	+	27	739	1392	0.5308908
zheyou73v0_A02	20880948	20883476	BnaA02T0286600ZY	0	-	368	1761	2528	0.6965981
zheyou73v0_A02	20914547	20918124	BnaA02T0286700ZY	0	+	253	1350	3577	0.3774112
zheyou73v0_A02	20920044	20921782	BnaA02T0286800ZY	0	-	1458	1738	1738	1.0000000
zheyou73v0_A02	20926964	20929563	BnaA02T0286900ZY	0	-	19	266	2599	0.1023471
zheyou73v0_A02	20932403	20932595	BnaA02T0287000ZY	0	+	147	192	192	1.0000000
zheyou73v0_A02	20940953	20944801	BnaA02T0287100ZY	0	-	2396	3848	3848	1.0000000
zheyou73v0_A02	20955145	20958954	BnaA02T0287200ZY	0	-	58	914	3809	0.2399580
zheyou73v0_A02	20955145	20958954	BnaA02T0287200ZY.1	0	-	58	914	3809	0.2399580
zheyou73v0_A02	21011149	21011353	BnaA02T0287300ZY	0	-	8	96	204	0.4705882
zheyou73v0_A02	21022720	21024310	BnaA02T0287400ZY	0	+	121	1120	1590	0.7044025
zheyou73v0_A02	21032207	21033193	BnaA02T0287500ZY	0	+	11	487	986	0.4939148
zheyou73v0_A02	21040249	21042175	BnaA02T0287600ZY	0	-	414	1307	1926	0.6786085
zheyou73v0_A02	21045456	21050679	BnaA02T0287700ZY	0	+	181	2035	5223	0.3896228
zheyou73v0_A02	21051708	21052716	BnaA02T0287800ZY	0	-	39	674	1008	0.6686508
zheyou73v0_A02	21057360	21058164	BnaA02T0287900ZY	0	+	4	250	804	0.3109453
zheyou73v0_A02	21058319	21058729	BnaA02T0288000ZY	0	-	216	410	410	1.0000000
zheyou73v0_A02	21060796	21062699	BnaA02T0288100ZY	0	-	9	344	1903	0.1807672
zheyou73v0_A02	21060796	21062699	BnaA02T0288100ZY.1	0	-	9	344	1903	0.1807672
zheyou73v0_A02	21121610	21123442	BnaA02T0288200ZY	0	-	433	1775	1832	0.9688864
zheyou73v0_A02	21138692	21140039	BnaA02T0288300ZY	0	+	25	330	1347	0.2449889
zheyou73v0_A02	21140243	21141347	BnaA02T0288400ZY	0	+	49	740	1104	0.6702899
zheyou73v0_A02	21149447	21152761	BnaA02T0288500ZY	0	+	102	927	3314	0.2797224
zheyou73v0_A02	21161413	21161590	BnaA02T0288600ZY	0	+	91	177	177	1.0000000
zheyou73v0_A02	21164948	21165107	BnaA02T0288700ZY	0	-	87	159	159	1.0000000
zheyou73v0_A02	21170812	21171253	BnaA02T0288800ZY	0	+	23	410	441	0.9297052
zheyou73v0_A02	21171973	21174674	BnaA02T0288900ZY	0	+	86	1417	2701	0.5246205
zheyou73v0_A02	21188195	21189077	BnaA02T0289000ZY	0	-	29	615	882	0.6972789
zheyou73v0_A02	21193061	21194895	BnaA02T0289100ZY	0	-	672	1568	1834	0.8549618
zheyou73v0_A02	21211058	21213365	BnaA02T0289200ZY	0	+	917	2230	2307	0.9666233
zheyou73v0_A02	21217336	21220322	BnaA02T0289300ZY	0	+	468	2636	2986	0.8827863
zheyou73v0_A02	21228254	21230324	BnaA02T0289400ZY	0	+	15	199	2070	0.0961353
zheyou73v0_A02	21236300	21236702	BnaA02T0289500ZY	0	+	24	96	402	0.2388060
zheyou73v0_A02	21245675	21246009	BnaA02T0289600ZY	0	-	13	291	334	0.8712575
zheyou73v0_A02	21253709	21256663	BnaA02T0289700ZY	0	-	4	168	2954	0.0568720
zheyou73v0_A02	21266279	21270360	BnaA02T0289800ZY	0	+	1198	3669	4081	0.8990443
zheyou73v0_A02	21273543	21280552	BnaA02T0289900ZY	0	-	3211	7009	7009	1.0000000
zheyou73v0_A02	21300983	21301286	BnaA02T0290000ZY	0	+	0	0	303	0.0000000
zheyou73v0_A02	21301908	21303545	BnaA02T0290100ZY	0	+	58	864	1637	0.5277947
zheyou73v0_A02	21306043	21312254	BnaA02T0290200ZY	0	-	1266	4965	6211	0.7993882
zheyou73v0_A02	21328789	21330745	BnaA02T0290300ZY	0	-	765	1862	1956	0.9519427
zheyou73v0_A02	21334174	21340109	BnaA02T0290400ZY	0	-	1113	4673	5935	0.7873631
zheyou73v0_A02	21343500	21345082	BnaA02T0290500ZY	0	+	38	579	1582	0.3659924
zheyou73v0_A02	21346920	21347609	BnaA02T0290600ZY	0	+	10	431	689	0.6255443
zheyou73v0_A02	21352062	21352640	BnaA02T0290700ZY	0	+	1174	578	578	1.0000000
zheyou73v0_A02	21364007	21364184	BnaA02T0290800ZY	0	-	5	171	177	0.9661017
zheyou73v0_A02	21364238	21365939	BnaA02T0290900ZY	0	-	24	459	1701	0.2698413
zheyou73v0_A02	21390801	21393877	BnaA02T0291000ZY	0	-	22	931	3076	0.3026658
zheyou73v0_A02	21398311	21399650	BnaA02T0291100ZY	0	-	32	397	1339	0.2964899
zheyou73v0_A02	21398311	21399650	BnaA02T0291100ZY.1	0	-	32	397	1339	0.2964899
zheyou73v0_A02	21406754	21408764	BnaA02T0291200ZY	0	-	290	1207	2010	0.6004975
zheyou73v0_A02	21406754	21408764	BnaA02T0291200ZY.1	0	-	290	1207	2010	0.6004975
zheyou73v0_A02	21406754	21408764	BnaA02T0291200ZY.2	0	-	290	1207	2010	0.6004975
zheyou73v0_A02	21431798	21433859	BnaA02T0291300ZY	0	+	18	505	2061	0.2450267
zheyou73v0_A02	21435944	21438774	BnaA02T0291400ZY	0	+	93	1267	2830	0.4477032
zheyou73v0_A02	21450700	21455811	BnaA02T0291500ZY	0	+	309	1956	5111	0.3827040
zheyou73v0_A02	21455537	21458359	BnaA02T0291600ZY	0	-	307	2393	2822	0.8479801
zheyou73v0_A02	21463428	21465773	BnaA02T0291700ZY	0	-	153	1664	2345	0.7095949
zheyou73v0_A02	21485651	21488744	BnaA02T0291800ZY	0	-	358	2361	3093	0.7633365
zheyou73v0_A02	21493211	21493559	BnaA02T0291900ZY	0	+	26	143	348	0.4109195
zheyou73v0_A02	21493973	21496499	BnaA02T0292000ZY	0	-	482	2086	2526	0.8258116
zheyou73v0_A02	21501257	21503252	BnaA02T0292100ZY	0	+	139	1272	1995	0.6375940
zheyou73v0_A02	21545625	21546734	BnaA02T0292200ZY	0	-	195	1109	1109	1.0000000
zheyou73v0_A02	21571089	21573391	BnaA02T0292300ZY	0	+	224	1726	2302	0.7497828
zheyou73v0_A02	21584621	21584843	BnaA02T0292400ZY	0	+	231	222	222	1.0000000
zheyou73v0_A02	21597581	21599223	BnaA02T0292500ZY	0	-	342	1642	1642	1.0000000
zheyou73v0_A02	21608818	21610537	BnaA02T0292600ZY	0	+	148	1526	1719	0.8877254
zheyou73v0_A02	21608818	21610537	BnaA02T0292600ZY.1	0	+	148	1526	1719	0.8877254
zheyou73v0_A02	21608818	21610537	BnaA02T0292600ZY.2	0	+	148	1526	1719	0.8877254
zheyou73v0_A02	21608818	21610537	BnaA02T0292600ZY.3	0	+	148	1526	1719	0.8877254
zheyou73v0_A02	21608818	21610537	BnaA02T0292600ZY.4	0	+	148	1526	1719	0.8877254
zheyou73v0_A02	21612694	21613502	BnaA02T0292700ZY	0	-	243	808	808	1.0000000
zheyou73v0_A02	21615953	21618649	BnaA02T0292800ZY	0	+	607	2254	2696	0.8360534
zheyou73v0_A02	21634991	21637135	BnaA02T0292900ZY	0	+	96	1057	2144	0.4930037
zheyou73v0_A02	21637578	21639606	BnaA02T0293000ZY	0	-	395	1458	2028	0.7189349
zheyou73v0_A02	21646491	21651018	BnaA02T0293100ZY	0	+	329	2569	4527	0.5674840
zheyou73v0_A02	21654942	21658457	BnaA02T0293200ZY	0	+	2404	3515	3515	1.0000000
zheyou73v0_A02	21678058	21680984	BnaA02T0293300ZY	0	-	574	2288	2926	0.7819549
zheyou73v0_A02	21690224	21690598	BnaA02T0293400ZY	0	-	95	374	374	1.0000000
zheyou73v0_A02	21693496	21695479	BnaA02T0293500ZY	0	-	202	1889	1983	0.9525971
zheyou73v0_A02	21701266	21703728	BnaA02T0293600ZY	0	+	336	2119	2462	0.8606824
zheyou73v0_A02	21704313	21708775	BnaA02T0293700ZY	0	+	2479	4462	4462	1.0000000
zheyou73v0_A02	21710317	21721343	BnaA02T0293800ZY	0	+	1992	6675	11026	0.6053873
zheyou73v0_A02	21725720	21726508	BnaA02T0293900ZY	0	-	30	201	788	0.2550761
zheyou73v0_A02	21743569	21747318	BnaA02T0294000ZY	0	-	315	1241	3749	0.3310216
zheyou73v0_A02	21743569	21747318	BnaA02T0294000ZY.1	0	-	315	1241	3749	0.3310216
zheyou73v0_A02	21756176	21757590	BnaA02T0294100ZY	0	-	435	1413	1414	0.9992928
zheyou73v0_A02	21759069	21760955	BnaA02T0294200ZY	0	+	439	1608	1886	0.8525981
zheyou73v0_A02	21759069	21760955	BnaA02T0294200ZY.1	0	+	439	1608	1886	0.8525981
zheyou73v0_A02	21760778	21761587	BnaA02T0294300ZY	0	-	154	647	809	0.7997528
zheyou73v0_A02	21764951	21766779	BnaA02T0294400ZY	0	-	96	966	1828	0.5284464
zheyou73v0_A02	21764951	21766779	BnaA02T0294400ZY.1	0	-	96	966	1828	0.5284464
zheyou73v0_A02	21776444	21780478	BnaA02T0294500ZY	0	-	709	3324	4034	0.8239960
zheyou73v0_A02	21800062	21800433	BnaA02T0294600ZY	0	+	2	174	371	0.4690027
zheyou73v0_A02	21803760	21804711	BnaA02T0294700ZY	0	-	142	880	951	0.9253417
zheyou73v0_A02	21823860	21825399	BnaA02T0294800ZY	0	+	482	1413	1539	0.9181287
zheyou73v0_A02	21830090	21830558	BnaA02T0294900ZY	0	-	11	289	468	0.6175213
zheyou73v0_A02	21835288	21836369	BnaA02T0295000ZY	0	+	638	1081	1081	1.0000000
zheyou73v0_A02	21836725	21836953	BnaA02T0295100ZY	0	-	29	151	228	0.6622807
zheyou73v0_A02	21853529	21853776	BnaA02T0295200ZY	0	+	181	247	247	1.0000000
zheyou73v0_A02	21856867	21859399	BnaA02T0295300ZY	0	+	737	2532	2532	1.0000000
zheyou73v0_A02	21861631	21872534	BnaA02T0295400ZY	0	+	5845	10660	10903	0.9777126
zheyou73v0_A02	21885451	21888774	BnaA02T0295500ZY	0	+	203	2704	3323	0.8137226
zheyou73v0_A02	21896976	21905155	BnaA02T0295600ZY	0	+	2368	6239	8179	0.7628072
zheyou73v0_A02	21905396	21909113	BnaA02T0295700ZY	0	-	497	3305	3717	0.8891580
zheyou73v0_A02	21918886	21920050	BnaA02T0295800ZY	0	+	146	875	1164	0.7517182
zheyou73v0_A02	21921025	21923445	BnaA02T0295900ZY	0	+	93	838	2420	0.3462810
zheyou73v0_A02	21934345	21937412	BnaA02T0296000ZY	0	+	615	2662	3067	0.8679491
zheyou73v0_A02	21934345	21936899	BnaA02T0296000ZY.1	0	+	590	2171	2554	0.8500391
zheyou73v0_A02	21934345	21937412	BnaA02T0296000ZY.2	0	+	615	2662	3067	0.8679491
zheyou73v0_A02	21940744	21941092	BnaA02T0296100ZY	0	+	307	348	348	1.0000000
zheyou73v0_A02	21952238	21955916	BnaA02T0296200ZY	0	+	1656	3678	3678	1.0000000
zheyou73v0_A02	21975241	21975655	BnaA02T0296300ZY	0	+	195	414	414	1.0000000
zheyou73v0_A02	21975671	21975929	BnaA02T0296400ZY	0	+	143	258	258	1.0000000
zheyou73v0_A02	21978340	21978929	BnaA02T0296500ZY	0	-	139	589	589	1.0000000
zheyou73v0_A02	21999411	22034106	BnaA02T0296600ZY	0	+	70	2190	34695	0.0631215
zheyou73v0_A02	22001509	22001863	BnaA02T0296700ZY	0	+	0	0	354	0.0000000
zheyou73v0_A02	22070769	22073595	BnaA02T0296800ZY	0	+	4	482	2826	0.1705591
zheyou73v0_A02	22109404	22111568	BnaA02T0296900ZY	0	+	380	1467	2164	0.6779113
zheyou73v0_A02	22149487	22149917	BnaA02T0297000ZY	0	+	240	430	430	1.0000000
zheyou73v0_A02	22155082	22157071	BnaA02T0297100ZY	0	+	359	1989	1989	1.0000000
zheyou73v0_A02	22155082	22157071	BnaA02T0297100ZY.2	0	+	359	1989	1989	1.0000000
zheyou73v0_A02	22155319	22157071	BnaA02T0297100ZY.1	0	+	352	1752	1752	1.0000000
zheyou73v0_A02	22157839	22158651	BnaA02T0297200ZY	0	-	198	812	812	1.0000000
zheyou73v0_A02	22178404	22178587	BnaA02T0297300ZY	0	+	194	183	183	1.0000000
zheyou73v0_A02	22202657	22205674	BnaA02T0297400ZY	0	-	427	1773	3017	0.5876698
zheyou73v0_A02	22255934	22256171	BnaA02T0297500ZY	0	+	106	237	237	1.0000000
zheyou73v0_A02	22325891	22328184	BnaA02T0297600ZY	0	-	242	1735	2293	0.7566507
zheyou73v0_A02	22355099	22356557	BnaA02T0297700ZY	0	-	111	852	1458	0.5843621
zheyou73v0_A02	22362138	22366860	BnaA02T0297800ZY	0	-	67	1831	4722	0.3877594
zheyou73v0_A02	22362138	22366860	BnaA02T0297800ZY.1	0	-	67	1831	4722	0.3877594
zheyou73v0_A02	22362138	22366860	BnaA02T0297800ZY.2	0	-	67	1831	4722	0.3877594
zheyou73v0_A02	22362138	22366860	BnaA02T0297800ZY.3	0	-	67	1831	4722	0.3877594
zheyou73v0_A02	22416624	22417952	BnaA02T0297900ZY	0	-	612	1328	1328	1.0000000
zheyou73v0_A02	22421962	22424087	BnaA02T0298000ZY	0	+	379	1661	2125	0.7816471
zheyou73v0_A02	22421962	22425647	BnaA02T0298100ZY.1	0	-	518	2572	3685	0.6979647
zheyou73v0_A02	22423465	22425647	BnaA02T0298100ZY	0	-	169	1089	2182	0.4990834
zheyou73v0_A02	22427915	22432454	BnaA02T0298200ZY	0	-	436	2796	4539	0.6159947
zheyou73v0_A02	22444811	22455423	BnaA02T0298300ZY	0	+	1964	9994	10612	0.9417641
zheyou73v0_A02	22493973	22496585	BnaA02T0298400ZY	0	-	500	2517	2612	0.9636294
zheyou73v0_A02	22497487	22497977	BnaA02T0298500ZY	0	+	99	490	490	1.0000000
zheyou73v0_A02	22504285	22504735	BnaA02T0298600ZY	0	+	0	0	450	0.0000000
zheyou73v0_A02	22507009	22509526	BnaA02T0298700ZY	0	+	2	271	2517	0.1076679
zheyou73v0_A02	22525345	22526318	BnaA02T0298800ZY	0	+	0	0	973	0.0000000
zheyou73v0_A02	22724783	22725343	BnaA02T0298900ZY	0	+	212	560	560	1.0000000
zheyou73v0_A02	22748410	22750780	BnaA02T0299000ZY	0	+	943	2370	2370	1.0000000
zheyou73v0_A02	22760743	22761612	BnaA02T0299100ZY	0	-	220	869	869	1.0000000
zheyou73v0_A02	22761640	22762839	BnaA02T0299200ZY	0	-	250	1199	1199	1.0000000
zheyou73v0_A02	22763927	22766324	BnaA02T0299300ZY	0	+	42	329	2397	0.1372549
zheyou73v0_A02	22816040	22817175	BnaA02T0299400ZY	0	+	730	1135	1135	1.0000000
zheyou73v0_A02	22816385	22817175	BnaA02T0299400ZY.1	0	+	562	790	790	1.0000000
zheyou73v0_A02	22816385	22817175	BnaA02T0299400ZY.2	0	+	562	790	790	1.0000000
zheyou73v0_A02	22864772	22866580	BnaA02T0299500ZY	0	-	845	1808	1808	1.0000000
zheyou73v0_A02	22868730	22870930	BnaA02T0299600ZY	0	+	674	2180	2200	0.9909091
zheyou73v0_A02	22883543	22886246	BnaA02T0299700ZY	0	+	892	2267	2703	0.8386977
zheyou73v0_A02	22912642	22917023	BnaA02T0299800ZY	0	+	1040	3952	4381	0.9020771
zheyou73v0_A02	22978739	22979279	BnaA02T0299900ZY	0	-	274	540	540	1.0000000
zheyou73v0_A02	22983551	22985778	BnaA02T0300000ZY	0	+	1104	2227	2227	1.0000000
zheyou73v0_A02	22985821	22986706	BnaA02T0300100ZY	0	-	450	885	885	1.0000000
zheyou73v0_A02	23215816	23217465	BnaA02T0300200ZY	0	-	1113	1649	1649	1.0000000
zheyou73v0_A02	23219500	23220054	BnaA02T0300300ZY	0	+	203	554	554	1.0000000
zheyou73v0_A02	23336437	23339050	BnaA02T0300400ZY	0	+	1730	2613	2613	1.0000000
zheyou73v0_A02	23336437	23338709	BnaA02T0300400ZY.1	0	+	1461	2272	2272	1.0000000
zheyou73v0_A02	23336437	23338709	BnaA02T0300400ZY.2	0	+	1461	2272	2272	1.0000000
zheyou73v0_A02	23336437	23339050	BnaA02T0300400ZY.3	0	+	1730	2613	2613	1.0000000
zheyou73v0_A02	23348375	23350891	BnaA02T0300500ZY	0	-	22	340	2516	0.1351351
zheyou73v0_A02	23353331	23353589	BnaA02T0300600ZY	0	-	0	0	258	0.0000000
zheyou73v0_A02	24520972	24521176	BnaA02T0300700ZY	0	-	0	0	204	0.0000000
zheyou73v0_A02	25949218	25949731	BnaA02T0300800ZY	0	+	80	437	513	0.8518519
zheyou73v0_A02	26537236	26539374	BnaA02T0300900ZY	0	+	695	2138	2138	1.0000000
zheyou73v0_A02	26567509	26569645	BnaA02T0301000ZY	0	+	37	472	2136	0.2209738
zheyou73v0_A02	26567509	26569645	BnaA02T0301000ZY.1	0	+	37	472	2136	0.2209738
zheyou73v0_A02	26580360	26580606	BnaA02T0301100ZY	0	-	71	246	246	1.0000000
zheyou73v0_A02	26645926	26662300	BnaA02T0301200ZY	0	-	4529	15571	16374	0.9509588
zheyou73v0_A02	26751955	26752519	BnaA02T0301300ZY	0	+	58	272	564	0.4822695
zheyou73v0_A02	26872257	26878809	BnaA02T0301400ZY.1	0	-	1167	5114	6552	0.7805250
zheyou73v0_A02	26873529	26878809	BnaA02T0301400ZY	0	-	734	3842	5280	0.7276515
zheyou73v0_A02	26901115	26903039	BnaA02T0301500ZY	0	-	272	1232	1924	0.6403326
zheyou73v0_A02	26928462	26928885	BnaA02T0301600ZY	0	-	405	423	423	1.0000000
zheyou73v0_A02	26937850	26938337	BnaA02T0301700ZY	0	-	223	487	487	1.0000000
zheyou73v0_A02	26993958	26996624	BnaA02T0301800ZY	0	-	0	0	2666	0.0000000
zheyou73v0_A02	26998044	27001960	BnaA02T0301900ZY	0	+	288	2095	3916	0.5349847
zheyou73v0_A02	27002834	27004551	BnaA02T0302000ZY	0	+	85	712	1717	0.4146768
zheyou73v0_A02	27008320	27009862	BnaA02T0302100ZY	0	+	6	223	1542	0.1446174
zheyou73v0_A02	27014647	27015026	BnaA02T0302200ZY	0	-	419	379	379	1.0000000
zheyou73v0_A02	27015614	27019800	BnaA02T0302300ZY	0	-	121	1973	4186	0.4713330
zheyou73v0_A02	27023373	27024884	BnaA02T0302400ZY	0	-	290	1278	1511	0.8457975
zheyou73v0_A02	27023373	27024674	BnaA02T0302400ZY.1	0	-	232	1068	1301	0.8209070
zheyou73v0_A02	27119227	27120691	BnaA02T0302500ZY	0	+	134	1015	1464	0.6933060
zheyou73v0_A02	27133986	27135747	BnaA02T0302600ZY	0	+	106	947	1761	0.5377626
zheyou73v0_A02	27139120	27144095	BnaA02T0302700ZY	0	-	18	1059	4975	0.2128643
zheyou73v0_A02	27207217	27209093	BnaA02T0302800ZY	0	-	27	589	1876	0.3139659
zheyou73v0_A02	27216558	27217573	BnaA02T0302900ZY	0	+	2	57	1015	0.0561576
zheyou73v0_A02	27219916	27220168	BnaA02T0303000ZY	0	-	66	252	252	1.0000000
zheyou73v0_A02	27253047	27255677	BnaA02T0303100ZY	0	-	1718	2630	2630	1.0000000
zheyou73v0_A02	27299320	27302009	BnaA02T0303200ZY	0	+	2064	2689	2689	1.0000000
zheyou73v0_A02	27304137	27307182	BnaA02T0303300ZY	0	+	1534	3045	3045	1.0000000
zheyou73v0_A02	27307466	27311207	BnaA02T0303400ZY	0	+	1482	3741	3741	1.0000000
zheyou73v0_A02	27357859	27359845	BnaA02T0303500ZY	0	-	171	637	1986	0.3207452
zheyou73v0_A02	27365881	27366683	BnaA02T0303600ZY	0	-	957	802	802	1.0000000
zheyou73v0_A02	27370384	27370947	BnaA02T0303700ZY	0	+	483	563	563	1.0000000
zheyou73v0_A02	27372012	27373320	BnaA02T0303800ZY	0	+	305	1308	1308	1.0000000
zheyou73v0_A02	27377102	27377737	BnaA02T0303900ZY	0	-	14	363	635	0.5716535
zheyou73v0_A02	27390916	27392248	BnaA02T0304000ZY	0	+	65	879	1332	0.6599099
zheyou73v0_A02	27390916	27392248	BnaA02T0304000ZY.1	0	+	65	879	1332	0.6599099
zheyou73v0_A02	27394854	27395070	BnaA02T0304100ZY	0	-	91	216	216	1.0000000
zheyou73v0_A02	27403532	27405672	BnaA02T0304200ZY	0	-	9	414	2140	0.1934579
zheyou73v0_A02	27408408	27408956	BnaA02T0304300ZY	0	+	180	548	548	1.0000000
zheyou73v0_A02	27469525	27471752	BnaA02T0304400ZY	0	-	40	1018	2227	0.4571172
zheyou73v0_A02	27487706	27488135	BnaA02T0304500ZY	0	-	486	429	429	1.0000000
zheyou73v0_A02	27507106	27507781	BnaA02T0304600ZY	0	-	340	675	675	1.0000000
zheyou73v0_A02	27528608	27528987	BnaA02T0304700ZY	0	-	0	0	379	0.0000000
zheyou73v0_A02	27531201	27532702	BnaA02T0304800ZY	0	-	96	631	1501	0.4203864
zheyou73v0_A02	27569412	27571019	BnaA02T0304900ZY	0	-	269	948	1607	0.5899191
zheyou73v0_A02	27577785	27579238	BnaA02T0305000ZY	0	+	805	1453	1453	1.0000000
zheyou73v0_A02	27586974	27589156	BnaA02T0305100ZY	0	+	164	820	2182	0.3758020
zheyou73v0_A02	27607521	27608018	BnaA02T0305200ZY	0	-	16	350	497	0.7042254
zheyou73v0_A02	27608100	27608661	BnaA02T0305300ZY	0	-	20	127	561	0.2263815
zheyou73v0_A02	27611037	27614022	BnaA02T0305400ZY	0	-	288	1713	2985	0.5738693
zheyou73v0_A02	27660207	27661632	BnaA02T0305500ZY	0	-	448	1175	1425	0.8245614
zheyou73v0_A02	27668844	27671201	BnaA02T0305600ZY	0	-	324	1838	2357	0.7798048
zheyou73v0_A02	27676271	27712683	BnaA02T0305700ZY	0	-	11224	35128	36412	0.9647369
zheyou73v0_A02	27713765	27716563	BnaA02T0305800ZY	0	-	1400	2688	2798	0.9606862
zheyou73v0_A02	27719770	27720182	BnaA02T0305900ZY	0	+	31	272	412	0.6601942
zheyou73v0_A02	27805220	27806202	BnaA02T0306000ZY	0	-	618	982	982	1.0000000
zheyou73v0_A02	27872225	27876415	BnaA02T0306100ZY	0	+	357	2591	4190	0.6183771
zheyou73v0_A02	27876838	27878421	BnaA02T0306200ZY	0	+	285	1534	1583	0.9690461
zheyou73v0_A02	27890253	27891166	BnaA02T0306300ZY	0	+	575	913	913	1.0000000
zheyou73v0_A02	27904936	27905425	BnaA02T0306400ZY	0	+	101	470	489	0.9611452
zheyou73v0_A02	27905999	27915680	BnaA02T0306500ZY	0	+	4685	9426	9681	0.9736598
zheyou73v0_A02	27930309	27935857	BnaA02T0306600ZY	0	+	394	3287	5548	0.5924658
zheyou73v0_A02	27945187	27948596	BnaA02T0306700ZY	0	-	958	3162	3409	0.9275447
zheyou73v0_A02	27957572	27958411	BnaA02T0306800ZY	0	+	271	839	839	1.0000000
zheyou73v0_A02	27971682	27977050	BnaA02T0306900ZY	0	-	1083	4702	5368	0.8759314
zheyou73v0_A02	27997872	27998352	BnaA02T0307000ZY	0	-	111	480	480	1.0000000
zheyou73v0_A02	27998793	27999096	BnaA02T0307100ZY	0	-	28	178	303	0.5874587
zheyou73v0_A02	28010263	28013417	BnaA02T0307200ZY	0	-	416	2433	3154	0.7714014
zheyou73v0_A02	28010263	28013417	BnaA02T0307200ZY.1	0	-	416	2433	3154	0.7714014
zheyou73v0_A02	28014076	28015867	BnaA02T0307300ZY	0	-	742	1791	1791	1.0000000
zheyou73v0_A02	28016945	28018499	BnaA02T0307400ZY	0	-	1	150	1554	0.0965251
zheyou73v0_A02	28070159	28071055	BnaA02T0307500ZY	0	-	98	620	896	0.6919643
zheyou73v0_A02	28106564	28109717	BnaA02T0307600ZY	0	+	519	2683	3153	0.8509356
zheyou73v0_A02	28106564	28109717	BnaA02T0307600ZY.1	0	+	519	2683	3153	0.8509356
zheyou73v0_A02	28106564	28108882	BnaA02T0307600ZY.2	0	+	469	1954	2318	0.8429680
zheyou73v0_A02	28106564	28109717	BnaA02T0307600ZY.3	0	+	519	2683	3153	0.8509356
zheyou73v0_A02	28111912	28112155	BnaA02T0307700ZY	0	-	27	235	243	0.9670782
zheyou73v0_A02	28115271	28118870	BnaA02T0307800ZY	0	-	657	2866	3599	0.7963323
zheyou73v0_A02	28120873	28122399	BnaA02T0307900ZY	0	-	267	1236	1526	0.8099607
zheyou73v0_A02	28146454	28147652	BnaA02T0308000ZY	0	-	153	1084	1198	0.9048414
zheyou73v0_A02	28152438	28157242	BnaA02T0308100ZY.1	0	-	349	3033	4804	0.6313488
zheyou73v0_A02	28152484	28157290	BnaA02T0308100ZY	0	-	340	3035	4806	0.6315023
zheyou73v0_A02	28171303	28171525	BnaA02T0308200ZY	0	-	188	222	222	1.0000000
zheyou73v0_A02	28172347	28173491	BnaA02T0308300ZY	0	-	6	171	1144	0.1494755
zheyou73v0_A02	28181429	28181747	BnaA02T0308400ZY	0	+	7	223	318	0.7012579
zheyou73v0_A02	28209923	28212859	BnaA02T0308500ZY	0	+	79	944	2936	0.3215259
zheyou73v0_A02	28217049	28217942	BnaA02T0308600ZY	0	-	3	68	893	0.0761478
zheyou73v0_A02	28225074	28226489	BnaA02T0308700ZY	0	-	29	232	1415	0.1639576
zheyou73v0_A02	28243629	28244905	BnaA02T0308800ZY	0	+	9	494	1276	0.3871473
zheyou73v0_A02	28253891	28262492	BnaA02T0308900ZY	0	+	2053	5781	8601	0.6721311
zheyou73v0_A02	28264113	28266142	BnaA02T0309000ZY	0	+	76	967	2029	0.4765894
zheyou73v0_A02	28274661	28279290	BnaA02T0309100ZY	0	-	259	3188	4629	0.6887017
zheyou73v0_A02	28291838	28292120	BnaA02T0309200ZY	0	-	11	83	282	0.2943262
zheyou73v0_A02	28297183	28298576	BnaA02T0309300ZY	0	-	18	213	1393	0.1529074
zheyou73v0_A02	28308746	28310160	BnaA02T0309400ZY	0	-	19	931	1414	0.6584159
zheyou73v0_A02	28314492	28316390	BnaA02T0309500ZY	0	-	4	188	1898	0.0990516
zheyou73v0_A02	28323625	28323805	BnaA02T0309600ZY	0	+	23	173	180	0.9611111
zheyou73v0_A02	28324467	28330363	BnaA02T0309700ZY	0	+	490	3877	5896	0.6575645
zheyou73v0_A02	28333231	28333539	BnaA02T0309800ZY	0	-	0	0	308	0.0000000
zheyou73v0_A02	28334792	28334969	BnaA02T0309900ZY	0	-	60	177	177	1.0000000
zheyou73v0_A02	28354851	28356397	BnaA02T0310000ZY	0	+	0	0	1546	0.0000000
zheyou73v0_A02	28382747	28384293	BnaA02T0310100ZY	0	+	0	0	1546	0.0000000
zheyou73v0_A02	28389989	28398762	BnaA02T0310200ZY	0	+	3054	7805	8773	0.8896615
zheyou73v0_A02	28411245	28413787	BnaA02T0310300ZY	0	+	32	792	2542	0.3115657
zheyou73v0_A02	28427534	28429659	BnaA02T0310400ZY	0	-	308	1934	2125	0.9101176
zheyou73v0_A02	28431915	28432370	BnaA02T0310500ZY	0	-	269	455	455	1.0000000
zheyou73v0_A02	28436244	28437284	BnaA02T0310600ZY	0	+	182	979	1040	0.9413462
zheyou73v0_A02	28457732	28457975	BnaA02T0310700ZY	0	-	8	141	243	0.5802469
zheyou73v0_A02	28475424	28478192	BnaA02T0310800ZY	0	+	543	2207	2768	0.7973266
zheyou73v0_A02	28488690	28489592	BnaA02T0310900ZY	0	+	52	418	902	0.4634146
zheyou73v0_A02	28495832	28496204	BnaA02T0311000ZY	0	-	0	0	372	0.0000000
zheyou73v0_A02	28497105	28499925	BnaA02T0311100ZY	0	-	98	1061	2820	0.3762411
zheyou73v0_A02	28505088	28514926	BnaA02T0311200ZY	0	+	1791	8803	9838	0.8947957
zheyou73v0_A02	28515079	28517140	BnaA02T0311300ZY	0	+	68	1095	2061	0.5312955
zheyou73v0_A02	28531484	28532429	BnaA02T0311400ZY	0	-	52	647	945	0.6846561
zheyou73v0_A02	28533394	28534626	BnaA02T0311500ZY	0	-	249	998	1232	0.8100649
zheyou73v0_A02	28552276	28557787	BnaA02T0311600ZY	0	+	2223	5465	5511	0.9916531
zheyou73v0_A02	28558069	28558363	BnaA02T0311700ZY	0	-	230	294	294	1.0000000
zheyou73v0_A02	28559085	28560859	BnaA02T0311800ZY	0	-	172	1378	1774	0.7767757
zheyou73v0_A02	28574519	28575565	BnaA02T0311900ZY	0	+	58	406	1046	0.3881453
zheyou73v0_A02	28583223	28592029	BnaA02T0312000ZY	0	-	309	4128	8806	0.4687713
zheyou73v0_A02	28594538	28600762	BnaA02T0312100ZY	0	-	2175	5512	6224	0.8856041
zheyou73v0_A02	28614808	28615415	BnaA02T0312200ZY	0	+	30	176	607	0.2899506
zheyou73v0_A02	28616393	28618431	BnaA02T0312300ZY	0	+	1567	2038	2038	1.0000000
zheyou73v0_A02	28627504	28627855	BnaA02T0312400ZY	0	-	130	351	351	1.0000000
zheyou73v0_A02	28628408	28631068	BnaA02T0312500ZY	0	-	696	2009	2660	0.7552631
zheyou73v0_A02	28647733	28650061	BnaA02T0312600ZY	0	-	827	2077	2328	0.8921821
zheyou73v0_A02	28665540	28668259	BnaA02T0312700ZY	0	+	3199	2719	2719	1.0000000
zheyou73v0_A02	28676017	28690775	BnaA02T0312800ZY	0	-	1925	8949	14758	0.6063830
zheyou73v0_A02	28691497	28697185	BnaA02T0312900ZY	0	+	941	5466	5688	0.9609705
zheyou73v0_A02	28697680	28698679	BnaA02T0313000ZY	0	+	7	226	999	0.2262262
zheyou73v0_A02	28704608	28705020	BnaA02T0313100ZY	0	+	70	412	412	1.0000000
zheyou73v0_A02	28708178	28720974	BnaA02T0313200ZY	0	-	3559	10940	12796	0.8549547
zheyou73v0_A02	28724610	28728415	BnaA02T0313300ZY	0	-	295	2666	3805	0.7006570
zheyou73v0_A02	28735391	28736846	BnaA02T0313400ZY	0	+	193	920	1455	0.6323024
zheyou73v0_A02	28737024	28737975	BnaA02T0313500ZY	0	-	0	0	951	0.0000000
zheyou73v0_A02	28758430	28758982	BnaA02T0313600ZY	0	+	694	552	552	1.0000000
zheyou73v0_A02	28767603	28767783	BnaA02T0313700ZY	0	-	228	180	180	1.0000000
zheyou73v0_A02	28768659	28768827	BnaA02T0313800ZY	0	-	3	168	168	1.0000000
zheyou73v0_A02	28836975	28840722	BnaA02T0313900ZY	0	-	1697	3665	3747	0.9781158
zheyou73v0_A02	28842903	28845832	BnaA02T0314000ZY	0	+	0	0	2929	0.0000000
zheyou73v0_A02	28863571	28864570	BnaA02T0314100ZY	0	-	0	0	999	0.0000000
zheyou73v0_A02	28872434	28873911	BnaA02T0314200ZY	0	-	275	1418	1477	0.9600542
zheyou73v0_A02	28885036	28886645	BnaA02T0314300ZY	0	-	881	1609	1609	1.0000000
zheyou73v0_A02	28892049	28893329	BnaA02T0314400ZY	0	-	907	1280	1280	1.0000000
zheyou73v0_A02	28892049	28893329	BnaA02T0314400ZY.1	0	-	907	1280	1280	1.0000000
zheyou73v0_A02	28899204	28900198	BnaA02T0314500ZY	0	+	725	994	994	1.0000000
zheyou73v0_A02	28903989	28905866	BnaA02T0314600ZY	0	+	140	1246	1877	0.6638253
zheyou73v0_A02	28903989	28905866	BnaA02T0314600ZY.1	0	+	140	1246	1877	0.6638253
zheyou73v0_A02	28906363	28907657	BnaA02T0314700ZY	0	-	8	325	1294	0.2511592
zheyou73v0_A02	28919372	28922729	BnaA02T0314800ZY	0	-	12	528	3357	0.1572833
zheyou73v0_A02	28932366	28942956	BnaA02T0314900ZY	0	+	2788	4973	10590	0.4695939
zheyou73v0_A02	28956686	28957955	BnaA02T0315000ZY	0	+	67	538	1269	0.4239559
zheyou73v0_A02	28967058	28967555	BnaA02T0315100ZY	0	+	47	342	497	0.6881288
zheyou73v0_A02	28975271	28976507	BnaA02T0315200ZY	0	-	325	1039	1236	0.8406149
zheyou73v0_A02	28976583	28976904	BnaA02T0315300ZY	0	-	663	321	321	1.0000000
zheyou73v0_A02	28990206	28992492	BnaA02T0315400ZY	0	+	557	2109	2286	0.9225722
zheyou73v0_A02	28995509	29004211	BnaA02T0315500ZY	0	-	5652	8702	8702	1.0000000
zheyou73v0_A02	29007380	29010430	BnaA02T0315600ZY	0	-	454	2690	3050	0.8819672
zheyou73v0_A02	29014004	29015131	BnaA02T0315700ZY	0	+	53	622	1127	0.5519077
zheyou73v0_A02	29014724	29021032	BnaA02T0315800ZY	0	-	1150	3772	6308	0.5979708
zheyou73v0_A02	29037294	29042949	BnaA02T0315900ZY	0	+	189	1266	5655	0.2238727
zheyou73v0_A02	29060360	29063671	BnaA02T0316000ZY	0	+	1935	3231	3311	0.9758381
zheyou73v0_A02	29063773	29064448	BnaA02T0316100ZY	0	+	83	530	675	0.7851852
zheyou73v0_A02	29077430	29089131	BnaA02T0316200ZY	0	-	7047	11701	11701	1.0000000
zheyou73v0_A02	29077430	29089131	BnaA02T0316200ZY.1	0	-	7047	11701	11701	1.0000000
zheyou73v0_A02	29091269	29092306	BnaA02T0316300ZY	0	-	17	476	1037	0.4590164
zheyou73v0_A02	29109736	29116241	BnaA02T0316400ZY	0	+	1431	4536	6505	0.6973097
zheyou73v0_A02	29116626	29121821	BnaA02T0316500ZY	0	+	3313	5195	5195	1.0000000
zheyou73v0_A02	29122736	29127341	BnaA02T0316600ZY	0	-	1482	3734	4605	0.8108578
zheyou73v0_A02	29128066	29130644	BnaA02T0316700ZY	0	-	213	1844	2578	0.7152832
zheyou73v0_A02	29136161	29140612	BnaA02T0316800ZY	0	+	114	2730	4451	0.6133453
zheyou73v0_A02	29152997	29156065	BnaA02T0316900ZY	0	+	121	1728	3068	0.5632334
zheyou73v0_A02	29156991	29157878	BnaA02T0317000ZY	0	-	0	0	887	0.0000000
zheyou73v0_A02	29158447	29160834	BnaA02T0317100ZY	0	-	224	1861	2387	0.7796397
zheyou73v0_A02	29162404	29163586	BnaA02T0317200ZY	0	-	0	0	1182	0.0000000
zheyou73v0_A02	29164661	29166895	BnaA02T0317300ZY	0	-	13	661	2234	0.2958818
zheyou73v0_A02	29225061	29233533	BnaA02T0317400ZY	0	+	1586	5154	8472	0.6083570
zheyou73v0_A02	29237623	29237884	BnaA02T0317500ZY	0	+	37	152	261	0.5823755
zheyou73v0_A02	29240288	29243082	BnaA02T0317600ZY	0	+	344	1801	2794	0.6445956
zheyou73v0_A02	29243108	29244399	BnaA02T0317700ZY	0	-	169	1100	1291	0.8520527
zheyou73v0_A02	29258415	29258994	BnaA02T0317800ZY	0	+	541	579	579	1.0000000
zheyou73v0_A02	29261861	29262308	BnaA02T0317900ZY	0	+	15	167	447	0.3736018
zheyou73v0_A02	29267195	29267387	BnaA02T0318000ZY	0	-	4	114	192	0.5937500
zheyou73v0_A02	29267785	29268333	BnaA02T0318100ZY	0	+	31	427	548	0.7791971
zheyou73v0_A02	29268428	29268869	BnaA02T0318200ZY	0	+	33	403	441	0.9138322
zheyou73v0_A02	29269593	29270118	BnaA02T0318300ZY	0	-	40	454	525	0.8647619
zheyou73v0_A02	29272159	29273775	BnaA02T0318400ZY	0	+	394	1616	1616	1.0000000
zheyou73v0_A02	29273826	29274175	BnaA02T0318500ZY	0	+	58	319	349	0.9140401
zheyou73v0_A02	29283891	29285473	BnaA02T0318600ZY	0	-	221	448	1582	0.2831858
zheyou73v0_A02	29296421	29297830	BnaA02T0318700ZY	0	+	40	313	1409	0.2221434
zheyou73v0_A02	29297970	29300301	BnaA02T0318800ZY	0	-	116	1140	2331	0.4890605
zheyou73v0_A02	29315711	29317087	BnaA02T0318900ZY	0	+	1166	1342	1376	0.9752907
zheyou73v0_A02	29317350	29319649	BnaA02T0319000ZY	0	+	133	1438	2299	0.6254894
zheyou73v0_A02	29365977	29366801	BnaA02T0319100ZY	0	-	300	803	824	0.9745145
zheyou73v0_A02	29370299	29371549	BnaA02T0319200ZY	0	+	278	1217	1250	0.9736000
zheyou73v0_A02	29383309	29384123	BnaA02T0319300ZY	0	-	9	326	814	0.4004914
zheyou73v0_A02	29396891	29397475	BnaA02T0319400ZY	0	-	15	159	584	0.2722603
zheyou73v0_A02	29403662	29404244	BnaA02T0319500ZY	0	-	34	322	582	0.5532646
zheyou73v0_A02	29414038	29415548	BnaA02T0319600ZY	0	-	251	1359	1510	0.9000000
zheyou73v0_A02	29424180	29425673	BnaA02T0319700ZY	0	-	109	687	1493	0.4601474
zheyou73v0_A02	29427731	29428015	BnaA02T0319800ZY	0	+	235	284	284	1.0000000
zheyou73v0_A02	29436056	29439476	BnaA02T0319900ZY	0	-	100	744	3420	0.2175439
zheyou73v0_A02	29445441	29446839	BnaA02T0320000ZY	0	-	62	543	1398	0.3884120
zheyou73v0_A02	29465868	29466444	BnaA02T0320100ZY	0	-	38	230	576	0.3993056
zheyou73v0_A02	29480424	29481995	BnaA02T0320200ZY	0	-	135	733	1571	0.4665818
zheyou73v0_A02	29508851	29510910	BnaA02T0320300ZY	0	+	0	0	2059	0.0000000
zheyou73v0_A02	29515345	29518792	BnaA02T0320400ZY	0	+	920	2951	3447	0.8561068
zheyou73v0_A02	29524748	29527497	BnaA02T0320500ZY	0	+	550	2286	2749	0.8315751
zheyou73v0_A02	29524748	29527497	BnaA02T0320500ZY.1	0	+	550	2286	2749	0.8315751
zheyou73v0_A02	29525450	29527497	BnaA02T0320600ZY	0	-	511	1695	2047	0.8280410
zheyou73v0_A02	29545727	29549117	BnaA02T0320700ZY	0	+	579	2637	3390	0.7778761
zheyou73v0_A02	29545727	29549117	BnaA02T0320700ZY.1	0	+	579	2637	3390	0.7778761
zheyou73v0_A02	29567141	29571533	BnaA02T0320800ZY	0	-	1047	3920	4392	0.8925319
zheyou73v0_A02	29591562	29593113	BnaA02T0320900ZY	0	+	1507	1551	1551	1.0000000
zheyou73v0_A02	29591562	29593113	BnaA02T0320900ZY.1	0	+	1507	1551	1551	1.0000000
zheyou73v0_A02	29604738	29607284	BnaA02T0321000ZY	0	+	481	2102	2546	0.8256088
zheyou73v0_A02	29604738	29607284	BnaA02T0321000ZY.1	0	+	481	2102	2546	0.8256088
zheyou73v0_A02	29613728	29614412	BnaA02T0321100ZY	0	+	420	684	684	1.0000000
zheyou73v0_A02	29630681	29631209	BnaA02T0321200ZY	0	+	101	528	528	1.0000000
zheyou73v0_A02	29649941	29651995	BnaA02T0321300ZY	0	+	1668	2054	2054	1.0000000
zheyou73v0_A02	29649941	29652201	BnaA02T0321300ZY.1	0	+	1817	2260	2260	1.0000000
zheyou73v0_A02	29649941	29651995	BnaA02T0321300ZY.2	0	+	1668	2054	2054	1.0000000
zheyou73v0_A02	29664360	29665973	BnaA02T0321400ZY	0	+	159	966	1613	0.5988840
zheyou73v0_A02	29678577	29680358	BnaA02T0321500ZY	0	-	638	1769	1781	0.9932622
zheyou73v0_A02	29689796	29690918	BnaA02T0321600ZY	0	+	231	1090	1122	0.9714795
zheyou73v0_A02	29689796	29690918	BnaA02T0321600ZY.1	0	+	231	1090	1122	0.9714795
zheyou73v0_A02	29690917	29694112	BnaA02T0321700ZY	0	-	740	2680	3195	0.8388106
zheyou73v0_A02	29704374	29707553	BnaA02T0321800ZY	0	-	1756	3179	3179	1.0000000
zheyou73v0_A02	29708518	29708713	BnaA02T0321900ZY	0	+	196	195	195	1.0000000
zheyou73v0_A02	29711401	29711697	BnaA02T0322000ZY	0	-	267	296	296	1.0000000
zheyou73v0_A02	29717846	29720889	BnaA02T0322100ZY	0	-	1966	3043	3043	1.0000000
zheyou73v0_A02	29728418	29729302	BnaA02T0322200ZY	0	+	146	659	884	0.7454751
zheyou73v0_A02	29757689	29758667	BnaA02T0322300ZY	0	-	717	978	978	1.0000000
zheyou73v0_A02	29767325	29770257	BnaA02T0322400ZY	0	+	291	2158	2932	0.7360164
zheyou73v0_A02	29771422	29771931	BnaA02T0322500ZY	0	+	2	84	509	0.1650295
zheyou73v0_A02	29798897	29799257	BnaA02T0322600ZY	0	-	31	124	360	0.3444445
zheyou73v0_A02	29807831	29809028	BnaA02T0322700ZY	0	-	118	1033	1197	0.8629908
zheyou73v0_A02	29812958	29814619	BnaA02T0322800ZY	0	-	19	320	1661	0.1926550
zheyou73v0_A02	29814655	29815038	BnaA02T0322900ZY	0	-	7	204	383	0.5326371
zheyou73v0_A02	29819379	29824280	BnaA02T0323000ZY	0	-	194	1913	4901	0.3903285
zheyou73v0_A02	29829948	29833124	BnaA02T0323100ZY	0	+	1390	3167	3176	0.9971663
zheyou73v0_A02	29838986	29839417	BnaA02T0323200ZY	0	-	272	431	431	1.0000000
zheyou73v0_A02	29840854	29844406	BnaA02T0323300ZY	0	-	1305	3531	3552	0.9940878
zheyou73v0_A02	29850287	29853074	BnaA02T0323400ZY	0	-	871	2306	2787	0.8274130
zheyou73v0_A02	29850287	29853161	BnaA02T0323400ZY.1	0	-	876	2393	2874	0.8326374
zheyou73v0_A02	29855772	29856132	BnaA02T0323500ZY	0	-	7	265	360	0.7361111
zheyou73v0_A02	29868270	29868598	BnaA02T0323600ZY	0	+	4	163	328	0.4969512
zheyou73v0_A02	29880472	29882130	BnaA02T0323700ZY	0	+	47	965	1658	0.5820265
zheyou73v0_A02	29882161	29883258	BnaA02T0323800ZY	0	+	23	426	1097	0.3883318
zheyou73v0_A02	29883335	29884181	BnaA02T0323900ZY	0	+	257	846	846	1.0000000
zheyou73v0_A02	29902997	29905336	BnaA02T0324000ZY	0	-	553	1991	2339	0.8512185
zheyou73v0_A02	29910858	29913603	BnaA02T0324100ZY	0	+	0	0	2745	0.0000000
zheyou73v0_A02	29925774	29927738	BnaA02T0324200ZY	0	-	1038	1964	1964	1.0000000
zheyou73v0_A02	29960624	29962371	BnaA02T0324300ZY	0	+	292	1161	1747	0.6645678
zheyou73v0_A02	29975203	29984388	BnaA02T0324400ZY	0	+	1959	7725	9185	0.8410452
zheyou73v0_A02	29988832	29993190	BnaA02T0324500ZY	0	+	382	2620	4358	0.6011932
zheyou73v0_A02	29993743	29994691	BnaA02T0324600ZY	0	+	529	948	948	1.0000000
zheyou73v0_A02	29997759	29999546	BnaA02T0324700ZY	0	+	342	1760	1787	0.9848909
zheyou73v0_A02	30004884	30013123	BnaA02T0324800ZY	0	-	1581	5579	8239	0.6771453
zheyou73v0_A02	30004884	30013123	BnaA02T0324800ZY.1	0	-	1581	5579	8239	0.6771453
zheyou73v0_A02	30013518	30016465	BnaA02T0324900ZY	0	-	516	2316	2947	0.7858840
zheyou73v0_A02	30039119	30041388	BnaA02T0325000ZY	0	-	597	2269	2269	1.0000000
zheyou73v0_A02	30044461	30044620	BnaA02T0325100ZY	0	-	212	159	159	1.0000000
zheyou73v0_A02	30049723	30050856	BnaA02T0325200ZY	0	+	1	41	1133	0.0361871
zheyou73v0_A02	30068996	30069896	BnaA02T0325300ZY	0	-	38	665	900	0.7388889
zheyou73v0_A02	30074240	30076678	BnaA02T0325400ZY	0	-	122	1942	2438	0.7965546
zheyou73v0_A02	30083595	30092071	BnaA02T0325500ZY	0	-	4333	7386	8476	0.8714016
zheyou73v0_A02	30111784	30113630	BnaA02T0325600ZY	0	-	239	1470	1846	0.7963164
zheyou73v0_A02	30119823	30120072	BnaA02T0325700ZY	0	-	27	235	249	0.9437751
zheyou73v0_A02	30122030	30123257	BnaA02T0325800ZY	0	-	222	1162	1227	0.9470252
zheyou73v0_A02	30123679	30137107	BnaA02T0325900ZY	0	+	554	2748	13428	0.2046470
zheyou73v0_A02	30143727	30145142	BnaA02T0326000ZY	0	+	386	1411	1415	0.9971731
zheyou73v0_A02	30147528	30149442	BnaA02T0326100ZY	0	+	317	1792	1914	0.9362592
zheyou73v0_A02	30149821	30151167	BnaA02T0326200ZY	0	-	636	1343	1346	0.9977712
zheyou73v0_A02	30162452	30163933	BnaA02T0326300ZY	0	-	1	24	1481	0.0162053
zheyou73v0_A02	30187700	30188967	BnaA02T0326400ZY	0	+	423	1241	1267	0.9794791
zheyou73v0_A02	30195430	30196765	BnaA02T0326500ZY	0	-	167	1074	1335	0.8044944
zheyou73v0_A02	30207998	30210965	BnaA02T0326600ZY	0	-	296	2319	2967	0.7815976
zheyou73v0_A02	30212054	30212619	BnaA02T0326700ZY	0	+	526	565	565	1.0000000
zheyou73v0_A02	30223885	30224473	BnaA02T0326800ZY	0	+	104	449	588	0.7636054
zheyou73v0_A02	30228031	30229169	BnaA02T0326900ZY	0	+	128	681	1138	0.5984183
zheyou73v0_A02	30232316	30233405	BnaA02T0327000ZY	0	-	17	264	1089	0.2424242
zheyou73v0_A02	30234387	30235810	BnaA02T0327100ZY	0	-	60	734	1423	0.5158117
zheyou73v0_A02	30236220	30237259	BnaA02T0327200ZY	0	+	602	1039	1039	1.0000000
zheyou73v0_A02	30241108	30242933	BnaA02T0327300ZY	0	+	122	943	1825	0.5167123
zheyou73v0_A02	30246932	30251082	BnaA02T0327400ZY	0	+	309	2095	4150	0.5048193
zheyou73v0_A02	30246932	30251082	BnaA02T0327400ZY.1	0	+	309	2095	4150	0.5048193
zheyou73v0_A02	30251696	30252171	BnaA02T0327500ZY	0	-	0	0	475	0.0000000
zheyou73v0_A02	30263248	30274490	BnaA02T0327600ZY	0	+	5199	9902	11242	0.8808041
zheyou73v0_A02	30318250	30320121	BnaA02T0327700ZY	0	-	519	1537	1871	0.8214858
zheyou73v0_A02	30343671	30348299	BnaA02T0327800ZY	0	+	353	3059	4628	0.6609766
zheyou73v0_A02	30351892	30352238	BnaA02T0327900ZY	0	+	78	346	346	1.0000000
zheyou73v0_A02	30361680	30362225	BnaA02T0328000ZY	0	+	162	515	545	0.9449542
zheyou73v0_A02	30402620	30414530	BnaA02T0328100ZY	0	+	2618	10076	11910	0.8460118
zheyou73v0_A02	30435257	30435957	BnaA02T0328200ZY	0	-	50	377	700	0.5385714
zheyou73v0_A02	30496234	30503679	BnaA02T0328300ZY	0	+	569	5714	7445	0.7674950
zheyou73v0_A02	30506036	30507319	BnaA02T0328400ZY	0	+	420	1190	1283	0.9275137
zheyou73v0_A02	30525755	30527252	BnaA02T0328500ZY	0	+	236	1323	1497	0.8837675
zheyou73v0_A02	30534547	30535040	BnaA02T0328600ZY	0	-	395	493	493	1.0000000
zheyou73v0_A02	30538155	30541062	BnaA02T0328700ZY	0	-	212	1723	2907	0.5927073
zheyou73v0_A02	30559610	30560123	BnaA02T0328800ZY	0	-	553	513	513	1.0000000
zheyou73v0_A02	30610804	30611477	BnaA02T0328900ZY	0	+	209	673	673	1.0000000
zheyou73v0_A02	30612322	30614035	BnaA02T0329000ZY	0	-	367	1643	1713	0.9591360
zheyou73v0_A02	30614281	30614732	BnaA02T0329100ZY	0	-	32	385	451	0.8536586
zheyou73v0_A02	30628561	30628892	BnaA02T0329200ZY	0	-	24	264	331	0.7975831
zheyou73v0_A02	30645860	30647459	BnaA02T0329300ZY	0	-	88	1078	1599	0.6741713
zheyou73v0_A02	30647962	30649555	BnaA02T0329400ZY	0	-	81	760	1593	0.4770873
zheyou73v0_A02	30673826	30680273	BnaA02T0329500ZY	0	+	3870	6447	6447	1.0000000
zheyou73v0_A02	30688796	30690440	BnaA02T0329600ZY	0	-	285	1304	1644	0.7931873
zheyou73v0_A02	30696163	30696388	BnaA02T0329700ZY	0	-	21	225	225	1.0000000
zheyou73v0_A02	30700252	30700585	BnaA02T0329800ZY	0	+	34	251	333	0.7537538
zheyou73v0_A02	30716805	30719012	BnaA02T0329900ZY	0	+	549	2093	2207	0.9483462
zheyou73v0_A02	30721114	30722316	BnaA02T0330000ZY	0	-	408	1036	1202	0.8618968
zheyou73v0_A02	30727251	30728606	BnaA02T0330100ZY	0	+	313	1355	1355	1.0000000
zheyou73v0_A02	30733496	30736176	BnaA02T0330200ZY	0	+	625	2401	2680	0.8958955
zheyou73v0_A02	30737141	30738398	BnaA02T0330300ZY	0	+	49	485	1257	0.3858393
zheyou73v0_A02	30748544	30749297	BnaA02T0330400ZY	0	+	120	611	753	0.8114210
zheyou73v0_A02	30754159	30756363	BnaA02T0330500ZY	0	-	534	1950	2204	0.8847550
zheyou73v0_A02	30758517	30761004	BnaA02T0330600ZY	0	+	786	2484	2487	0.9987937
zheyou73v0_A02	30758517	30761004	BnaA02T0330600ZY.1	0	+	786	2484	2487	0.9987937
zheyou73v0_A02	30766003	30768091	BnaA02T0330700ZY	0	+	293	1818	2088	0.8706896
zheyou73v0_A02	30768352	30770247	BnaA02T0330800ZY	0	-	90	1470	1895	0.7757256
zheyou73v0_A02	30773181	30774108	BnaA02T0330900ZY	0	-	71	306	927	0.3300971
zheyou73v0_A02	30781183	30782017	BnaA02T0331000ZY	0	-	29	328	834	0.3932854
zheyou73v0_A02	30782130	30782613	BnaA02T0331100ZY	0	-	10	150	483	0.3105590
zheyou73v0_A02	30813927	30814340	BnaA02T0331200ZY	0	+	0	0	413	0.0000000
zheyou73v0_A02	30832857	30835914	BnaA02T0331300ZY	0	+	1225	2982	3057	0.9754661
zheyou73v0_A02	30900960	30901611	BnaA02T0331400ZY	0	-	26	619	651	0.9508448
zheyou73v0_A02	30906469	30907813	BnaA02T0331500ZY	0	+	607	1344	1344	1.0000000
zheyou73v0_A02	30906469	30907813	BnaA02T0331500ZY.1	0	+	607	1344	1344	1.0000000
zheyou73v0_A02	30912836	30913193	BnaA02T0331600ZY	0	+	10	248	357	0.6946779
zheyou73v0_A02	30913542	30914899	BnaA02T0331700ZY	0	+	27	925	1357	0.6816507
zheyou73v0_A02	30923526	30925613	BnaA02T0331800ZY	0	+	183	1080	2087	0.5174892
zheyou73v0_A02	30961520	30966492	BnaA02T0331900ZY	0	-	1413	4230	4972	0.8507643
zheyou73v0_A02	30992304	30992935	BnaA02T0332000ZY	0	-	394	631	631	1.0000000
zheyou73v0_A02	31019532	31020859	BnaA02T0332100ZY	0	+	96	956	1327	0.7204220
zheyou73v0_A02	31021802	31023824	BnaA02T0332200ZY	0	+	435	1735	2022	0.8580613
zheyou73v0_A02	31023975	31035211	BnaA02T0332300ZY	0	-	2455	10162	11236	0.9044144
zheyou73v0_A02	31042591	31043536	BnaA02T0332400ZY	0	+	757	945	945	1.0000000
zheyou73v0_A02	31052856	31054968	BnaA02T0332500ZY	0	+	40	754	2112	0.3570076
zheyou73v0_A02	31052856	31055283	BnaA02T0332500ZY.1	0	+	41	950	2427	0.3914298
zheyou73v0_A02	31058450	31067261	BnaA02T0332600ZY	0	-	978	4751	8811	0.5392123
zheyou73v0_A02	31070805	31073035	BnaA02T0332700ZY	0	+	232	1820	2230	0.8161435
zheyou73v0_A02	31070805	31073035	BnaA02T0332700ZY.1	0	+	232	1820	2230	0.8161435
zheyou73v0_A02	31070805	31073035	BnaA02T0332700ZY.2	0	+	232	1820	2230	0.8161435
zheyou73v0_A02	31070805	31073035	BnaA02T0332700ZY.3	0	+	232	1820	2230	0.8161435
zheyou73v0_A02	31070805	31073035	BnaA02T0332700ZY.4	0	+	232	1820	2230	0.8161435
zheyou73v0_A02	31070805	31073035	BnaA02T0332700ZY.5	0	+	232	1820	2230	0.8161435
zheyou73v0_A02	31070805	31073035	BnaA02T0332700ZY.6	0	+	232	1820	2230	0.8161435
zheyou73v0_A02	31070805	31073035	BnaA02T0332700ZY.7	0	+	232	1820	2230	0.8161435
zheyou73v0_A02	31070805	31073035	BnaA02T0332700ZY.8	0	+	232	1820	2230	0.8161435
zheyou73v0_A02	31072538	31074302	BnaA02T0332800ZY	0	-	165	1014	1764	0.5748299
zheyou73v0_A02	31074756	31076230	BnaA02T0332900ZY	0	+	42	986	1474	0.6689281
zheyou73v0_A02	31076985	31078875	BnaA02T0333000ZY	0	-	76	1092	1890	0.5777778
zheyou73v0_A02	31082607	31083496	BnaA02T0333100ZY	0	+	211	746	889	0.8391451
zheyou73v0_A02	31083968	31084175	BnaA02T0333200ZY	0	-	2	132	207	0.6376812
zheyou73v0_A02	31087529	31089108	BnaA02T0333300ZY	0	+	112	913	1579	0.5782140
zheyou73v0_A02	31088880	31091818	BnaA02T0333400ZY	0	-	300	2486	2938	0.8461539
zheyou73v0_A02	31102253	31105508	BnaA02T0333500ZY	0	-	472	1735	3255	0.5330261
zheyou73v0_A02	31115220	31117514	BnaA02T0333600ZY	0	-	372	2038	2294	0.8884045
zheyou73v0_A02	31120009	31120644	BnaA02T0333700ZY	0	+	93	419	635	0.6598425
zheyou73v0_A02	31121614	31124694	BnaA02T0333800ZY	0	-	963	2941	3080	0.9548701
zheyou73v0_A02	31121614	31124551	BnaA02T0333800ZY.1	0	-	932	2798	2937	0.9526728
zheyou73v0_A02	31121761	31122322	BnaA02T0333900ZY	0	+	159	488	561	0.8698753
zheyou73v0_A02	31124951	31126906	BnaA02T0334000ZY	0	+	295	1233	1955	0.6306905
zheyou73v0_A02	31128212	31129855	BnaA02T0334100ZY	0	+	658	1635	1643	0.9951308
zheyou73v0_A02	31130415	31138479	BnaA02T0334200ZY	0	+	973	6117	8064	0.7585565
zheyou73v0_A02	31140541	31141655	BnaA02T0334300ZY	0	+	275	1114	1114	1.0000000
zheyou73v0_A02	31157365	31157989	BnaA02T0334400ZY	0	+	11	297	624	0.4759615
zheyou73v0_A02	31158388	31158819	BnaA02T0334500ZY	0	-	18	330	431	0.7656612
zheyou73v0_A02	31163147	31165046	BnaA02T0334600ZY	0	-	131	828	1899	0.4360189
zheyou73v0_A02	31166414	31168366	BnaA02T0334700ZY	0	+	411	1750	1952	0.8965164
zheyou73v0_A02	31172646	31172826	BnaA02T0334800ZY	0	+	177	180	180	1.0000000
zheyou73v0_A02	31172910	31173111	BnaA02T0334900ZY	0	+	210	201	201	1.0000000
zheyou73v0_A02	31175741	31177981	BnaA02T0335000ZY	0	+	235	1884	2240	0.8410714
zheyou73v0_A02	31188521	31189244	BnaA02T0335100ZY	0	+	183	475	723	0.6569848
zheyou73v0_A02	31189596	31190882	BnaA02T0335200ZY	0	+	49	889	1286	0.6912908
zheyou73v0_A02	31194497	31197843	BnaA02T0335300ZY	0	+	105	1332	3346	0.3980873
zheyou73v0_A02	31198378	31201082	BnaA02T0335400ZY	0	+	116	1575	2704	0.5824704
zheyou73v0_A02	31201459	31203511	BnaA02T0335500ZY	0	-	494	1978	2052	0.9639376
zheyou73v0_A02	31203614	31205179	BnaA02T0335600ZY	0	+	620	1565	1565	1.0000000
zheyou73v0_A02	31205767	31207391	BnaA02T0335700ZY	0	+	188	1463	1624	0.9008621
zheyou73v0_A02	31207460	31208371	BnaA02T0335800ZY	0	-	94	664	911	0.7288694
zheyou73v0_A02	31208550	31209574	BnaA02T0335900ZY	0	+	23	489	1024	0.4775391
zheyou73v0_A02	31211178	31212169	BnaA02T0336000ZY	0	+	184	827	991	0.8345106
zheyou73v0_A02	31215140	31216473	BnaA02T0336100ZY	0	-	260	1265	1333	0.9489872
zheyou73v0_A02	31217308	31219525	BnaA02T0336200ZY	0	+	471	1634	2217	0.7370320
zheyou73v0_A02	31219846	31221713	BnaA02T0336300ZY	0	-	235	1370	1867	0.7337976
zheyou73v0_A02	31232778	31233348	BnaA02T0336400ZY	0	+	126	570	570	1.0000000
zheyou73v0_A02	31237401	31239808	BnaA02T0336500ZY	0	-	433	1803	2407	0.7490652
zheyou73v0_A02	31252169	31252322	BnaA02T0336600ZY	0	+	99	153	153	1.0000000
zheyou73v0_A02	31252382	31253410	BnaA02T0336700ZY	0	+	536	1028	1028	1.0000000
zheyou73v0_A02	31256923	31266461	BnaA02T0336800ZY	0	+	1632	6132	9538	0.6429021
zheyou73v0_A02	31271470	31272222	BnaA02T0336900ZY	0	+	38	605	752	0.8045213
zheyou73v0_A02	31277121	31278343	BnaA02T0337000ZY	0	-	226	1151	1222	0.9418985
zheyou73v0_A02	31282065	31283554	BnaA02T0337100ZY	0	-	336	1286	1489	0.8636669
zheyou73v0_A02	31287122	31287932	BnaA02T0337200ZY	0	-	240	810	810	1.0000000
zheyou73v0_A02	31304130	31305901	BnaA02T0337300ZY	0	-	331	1760	1771	0.9937888
zheyou73v0_A02	31308633	31310845	BnaA02T0337400ZY	0	-	451	1929	2212	0.8720615
zheyou73v0_A02	31317636	31320242	BnaA02T0337500ZY	0	+	342	2148	2606	0.8242517
zheyou73v0_A02	31320521	31321850	BnaA02T0337600ZY	0	-	209	1214	1329	0.9134688
zheyou73v0_A02	31323965	31324769	BnaA02T0337700ZY	0	-	128	671	804	0.8345771
zheyou73v0_A02	31326082	31326571	BnaA02T0337800ZY	0	-	72	385	489	0.7873211
zheyou73v0_A02	31329099	31332241	BnaA02T0337900ZY	0	-	444	2765	3142	0.8800128
zheyou73v0_A02	31349404	31350960	BnaA02T0338000ZY	0	+	330	1511	1556	0.9710797
zheyou73v0_A02	31350924	31352757	BnaA02T0338100ZY	0	-	804	1815	1833	0.9901800
zheyou73v0_A02	31354141	31354387	BnaA02T0338200ZY	0	+	23	170	246	0.6910569
zheyou73v0_A02	31362548	31363644	BnaA02T0338300ZY	0	+	401	963	1096	0.8786497
zheyou73v0_A02	31362548	31363644	BnaA02T0338300ZY.1	0	+	401	963	1096	0.8786497
zheyou73v0_A02	31389454	31392559	BnaA02T0338400ZY	0	-	700	2816	3105	0.9069243
zheyou73v0_A02	31398435	31400040	BnaA02T0338500ZY	0	-	479	1605	1605	1.0000000
zheyou73v0_A02	31408596	31411167	BnaA02T0338600ZY	0	-	473	2418	2571	0.9404901
zheyou73v0_A02	31427413	31429916	BnaA02T0338700ZY	0	-	409	2073	2503	0.8282062
zheyou73v0_A02	31440784	31447489	BnaA02T0338800ZY	0	+	987	4837	6705	0.7214019
zheyou73v0_A02	31447747	31449891	BnaA02T0338900ZY	0	-	453	2120	2144	0.9888059
zheyou73v0_A02	31462797	31466315	BnaA02T0339000ZY	0	+	1139	3294	3518	0.9363275
zheyou73v0_A02	31467591	31468651	BnaA02T0339100ZY	0	-	303	997	1060	0.9405661
zheyou73v0_A02	31474705	31475753	BnaA02T0339200ZY	0	-	612	1048	1048	1.0000000
zheyou73v0_A02	31476771	31479924	BnaA02T0339300ZY	0	-	1391	3153	3153	1.0000000
zheyou73v0_A02	31480554	31483090	BnaA02T0339400ZY	0	+	765	2536	2536	1.0000000
zheyou73v0_A02	31493927	31494254	BnaA02T0339500ZY	0	-	37	288	327	0.8807340
zheyou73v0_A02	31519563	31519879	BnaA02T0339600ZY	0	+	12	282	316	0.8924051
zheyou73v0_A02	31539124	31540614	BnaA02T0339700ZY	0	-	43	748	1490	0.5020134
zheyou73v0_A02	31568788	31571153	BnaA02T0339800ZY	0	-	5	85	2365	0.0359408
zheyou73v0_A02	31571397	31572152	BnaA02T0339900ZY	0	+	18	420	755	0.5562914
zheyou73v0_A02	31575302	31577204	BnaA02T0340000ZY	0	-	18	446	1902	0.2344900
zheyou73v0_A02	31584407	31584566	BnaA02T0340100ZY	0	+	129	159	159	1.0000000
zheyou73v0_A02	31587055	31588378	BnaA02T0340200ZY	0	-	54	500	1323	0.3779289
zheyou73v0_A02	31589730	31590731	BnaA02T0340300ZY	0	+	174	854	1001	0.8531469
zheyou73v0_A02	31589730	31590731	BnaA02T0340300ZY.1	0	+	174	854	1001	0.8531469
zheyou73v0_A02	31591219	31592785	BnaA02T0340400ZY	0	-	47	960	1566	0.6130268
zheyou73v0_A02	31596860	31600130	BnaA02T0340500ZY	0	+	1180	3243	3270	0.9917431
zheyou73v0_A02	31596860	31599966	BnaA02T0340500ZY.1	0	+	1078	3079	3106	0.9913071
zheyou73v0_A02	31617909	31618656	BnaA02T0340600ZY	0	+	337	747	747	1.0000000
zheyou73v0_A02	31619810	31620467	BnaA02T0340700ZY	0	+	454	657	657	1.0000000
zheyou73v0_A02	31627979	31628621	BnaA02T0340800ZY	0	+	15	477	642	0.7429907
zheyou73v0_A02	31631947	31632152	BnaA02T0340900ZY	0	-	90	205	205	1.0000000
zheyou73v0_A02	31632205	31632829	BnaA02T0341000ZY	0	-	39	497	624	0.7964743
zheyou73v0_A02	31637241	31638329	BnaA02T0341100ZY	0	+	342	1067	1088	0.9806985
zheyou73v0_A02	31638684	31641009	BnaA02T0341200ZY	0	-	354	1851	2325	0.7961290
zheyou73v0_A02	31645111	31646384	BnaA02T0341300ZY	0	+	360	1186	1273	0.9316575
zheyou73v0_A02	31651531	31653001	BnaA02T0341400ZY	0	-	106	535	1470	0.3639456
zheyou73v0_A02	31684552	31689501	BnaA02T0341500ZY	0	-	366	1737	4949	0.3509800
zheyou73v0_A02	31696686	31698000	BnaA02T0341600ZY	0	+	161	1224	1314	0.9315069
zheyou73v0_A02	31698475	31703239	BnaA02T0341700ZY	0	-	877	3646	4764	0.7653233
zheyou73v0_A02	31703480	31706477	BnaA02T0341800ZY	0	+	235	1591	2997	0.5308642
zheyou73v0_A02	31707701	31709127	BnaA02T0341900ZY	0	+	71	874	1426	0.6129032
zheyou73v0_A02	31712855	31715060	BnaA02T0342000ZY	0	+	246	1873	2205	0.8494331
zheyou73v0_A02	31716081	31718420	BnaA02T0342100ZY	0	-	229	1360	2339	0.5814450
zheyou73v0_A02	31731482	31732045	BnaA02T0342200ZY	0	-	201	550	563	0.9769094
zheyou73v0_A02	31733346	31734040	BnaA02T0342300ZY	0	+	312	694	694	1.0000000
zheyou73v0_A02	31738441	31740430	BnaA02T0342400ZY	0	+	314	1646	1989	0.8275515
zheyou73v0_A02	31744597	31745990	BnaA02T0342500ZY	0	-	130	732	1393	0.5254846
zheyou73v0_A02	31766261	31769418	BnaA02T0342600ZY	0	-	377	2101	3157	0.6655052
zheyou73v0_A02	31782434	31783079	BnaA02T0342700ZY	0	+	677	645	645	1.0000000
zheyou73v0_A02	31786113	31787740	BnaA02T0342800ZY.4	0	-	675	1620	1627	0.9956976
zheyou73v0_A02	31786178	31787740	BnaA02T0342800ZY	0	-	661	1555	1562	0.9955186
zheyou73v0_A02	31786178	31787740	BnaA02T0342800ZY.1	0	-	661	1555	1562	0.9955186
zheyou73v0_A02	31786178	31787740	BnaA02T0342800ZY.2	0	-	661	1555	1562	0.9955186
zheyou73v0_A02	31786178	31787740	BnaA02T0342800ZY.3	0	-	661	1555	1562	0.9955186
zheyou73v0_A02	31819518	31821259	BnaA02T0342900ZY	0	+	106	1581	1741	0.9080988
zheyou73v0_A02	31826800	31827903	BnaA02T0343000ZY	0	+	279	1093	1103	0.9909338
zheyou73v0_A02	31836212	31837271	BnaA02T0343100ZY	0	+	917	1059	1059	1.0000000
zheyou73v0_A02	31839409	31846673	BnaA02T0343200ZY	0	-	2142	6646	7264	0.9149229
zheyou73v0_A02	31863792	31868893	BnaA02T0343300ZY	0	-	1986	5004	5101	0.9809841
zheyou73v0_A02	31871221	31872051	BnaA02T0343400ZY	0	-	594	830	830	1.0000000
zheyou73v0_A02	31885240	31888018	BnaA02T0343500ZY	0	+	479	2223	2778	0.8002160
zheyou73v0_A02	31911239	31912063	BnaA02T0343600ZY	0	+	437	824	824	1.0000000
zheyou73v0_A02	31923680	31926549	BnaA02T0343700ZY	0	+	524	2313	2869	0.8062043
zheyou73v0_A02	31946363	31946842	BnaA02T0343800ZY	0	-	144	479	479	1.0000000
zheyou73v0_A02	31946894	31948738	BnaA02T0343900ZY	0	-	805	1844	1844	1.0000000
zheyou73v0_A02	31951701	31953543	BnaA02T0344000ZY	0	-	494	1635	1842	0.8876222
zheyou73v0_A02	31960038	31962461	BnaA02T0344100ZY	0	-	173	1417	2423	0.5848122
zheyou73v0_A02	31966168	31968467	BnaA02T0344200ZY	0	+	478	1520	2299	0.6611570
zheyou73v0_A02	31972011	31972320	BnaA02T0344300ZY	0	+	266	309	309	1.0000000
zheyou73v0_A02	31990728	31992974	BnaA02T0344400ZY	0	+	194	1652	2246	0.7355298
zheyou73v0_A02	32006320	32011822	BnaA02T0344500ZY	0	+	928	3192	5502	0.5801527
zheyou73v0_A02	32006320	32011301	BnaA02T0344500ZY.1	0	+	924	2845	4981	0.5711704
zheyou73v0_A02	32006320	32011453	BnaA02T0344500ZY.2	0	+	925	2981	5133	0.5807520
zheyou73v0_A02	32006320	32013860	BnaA02T0344500ZY.3	0	+	1263	4822	7540	0.6395226
zheyou73v0_A02	32034009	32035248	BnaA02T0344600ZY	0	-	124	904	1239	0.7296206
zheyou73v0_A02	32040065	32042919	BnaA02T0344700ZY	0	-	90	813	2854	0.2848634
zheyou73v0_A02	32059985	32060839	BnaA02T0344800ZY	0	+	34	403	854	0.4718969
zheyou73v0_A02	32066060	32066828	BnaA02T0344900ZY	0	+	141	752	768	0.9791667
zheyou73v0_A02	32073524	32074373	BnaA02T0345000ZY	0	+	345	796	849	0.9375736
zheyou73v0_A02	32085079	32087691	BnaA02T0345100ZY	0	-	173	1422	2612	0.5444104
zheyou73v0_A02	32088354	32090281	BnaA02T0345200ZY	0	-	54	1169	1927	0.6066424
zheyou73v0_A02	32095527	32097857	BnaA02T0345300ZY	0	+	994	2330	2330	1.0000000
zheyou73v0_A02	32100111	32103082	BnaA02T0345400ZY	0	-	276	1864	2971	0.6273982
zheyou73v0_A02	32124905	32127296	BnaA02T0345500ZY	0	+	98	852	2391	0.3563363
zheyou73v0_A02	32130518	32131369	BnaA02T0345600ZY	0	+	0	0	851	0.0000000
zheyou73v0_A02	32132332	32132906	BnaA02T0345700ZY	0	-	0	0	574	0.0000000
zheyou73v0_A02	32135871	32137812	BnaA02T0345800ZY	0	+	0	0	1941	0.0000000
zheyou73v0_A02	32135994	32137413	BnaA02T0345800ZY.1	0	+	0	0	1419	0.0000000
zheyou73v0_A02	32138121	32146803	BnaA02T0345900ZY	0	-	695	4202	8682	0.4839899
zheyou73v0_A02	32191879	32192839	BnaA02T0346000ZY	0	+	4	281	960	0.2927083
zheyou73v0_A02	32224040	32226641	BnaA02T0346100ZY	0	+	61	1091	2601	0.4194541
zheyou73v0_A02	32235454	32237848	BnaA02T0346200ZY	0	-	443	1540	2394	0.6432748
zheyou73v0_A02	32241780	32242795	BnaA02T0346300ZY	0	-	25	374	1015	0.3684729
zheyou73v0_A02	32243384	32243865	BnaA02T0346400ZY	0	-	0	0	481	0.0000000
zheyou73v0_A02	32247708	32248982	BnaA02T0346500ZY	0	-	349	1112	1274	0.8728414
zheyou73v0_A02	32262981	32271047	BnaA02T0346600ZY	0	-	540	5855	8066	0.7258865
zheyou73v0_A02	32272529	32272854	BnaA02T0346700ZY	0	+	28	317	325	0.9753846
zheyou73v0_A02	32284997	32286160	BnaA02T0346800ZY	0	-	169	961	1163	0.8263113
zheyou73v0_A02	32291819	32292977	BnaA02T0346900ZY	0	-	322	1090	1158	0.9412780
zheyou73v0_A02	32293429	32294101	BnaA02T0347000ZY	0	+	220	672	672	1.0000000
zheyou73v0_A02	32296047	32298037	BnaA02T0347100ZY	0	+	263	1791	1990	0.9000000
zheyou73v0_A02	32309598	32310421	BnaA02T0347200ZY	0	+	80	630	823	0.7654921
zheyou73v0_A02	32312016	32312706	BnaA02T0347300ZY	0	+	159	459	690	0.6652174
zheyou73v0_A02	32313567	32315048	BnaA02T0347400ZY	0	+	229	1033	1481	0.6975017
zheyou73v0_A02	32319994	32321205	BnaA02T0347500ZY	0	+	856	1211	1211	1.0000000
zheyou73v0_A02	32325246	32326503	BnaA02T0347600ZY	0	-	35	606	1257	0.4821002
zheyou73v0_A02	32331884	32333644	BnaA02T0347700ZY	0	+	265	1360	1760	0.7727273
zheyou73v0_A02	32334740	32336836	BnaA02T0347800ZY	0	+	171	1460	2096	0.6965649
zheyou73v0_A02	32343194	32346314	BnaA02T0347900ZY	0	+	1179	2208	3120	0.7076923
zheyou73v0_A02	32347344	32348119	BnaA02T0348000ZY	0	-	457	775	775	1.0000000
zheyou73v0_A02	32348820	32350537	BnaA02T0348100ZY	0	-	1117	1717	1717	1.0000000
zheyou73v0_A02	32357341	32361946	BnaA02T0348200ZY	0	+	764	2499	4605	0.5426710
zheyou73v0_A02	32361955	32362493	BnaA02T0348300ZY	0	+	0	0	538	0.0000000
zheyou73v0_A02	32363198	32363652	BnaA02T0348400ZY	0	+	0	0	454	0.0000000
zheyou73v0_A02	32386722	32387091	BnaA02T0348500ZY	0	+	1	46	369	0.1246612
zheyou73v0_A02	32392999	32393583	BnaA02T0348600ZY	0	+	126	259	584	0.4434932
zheyou73v0_A02	32394560	32394973	BnaA02T0348700ZY	0	+	399	413	413	1.0000000
zheyou73v0_A02	32399813	32400263	BnaA02T0348800ZY	0	+	185	450	450	1.0000000
zheyou73v0_A02	32416590	32417257	BnaA02T0348900ZY	0	+	19	257	667	0.3853073
zheyou73v0_A02	32424320	32426667	BnaA02T0349000ZY	0	+	324	1952	2347	0.8317000
zheyou73v0_A02	32424320	32426667	BnaA02T0349000ZY.1	0	+	324	1952	2347	0.8317000
zheyou73v0_A02	32431573	32433165	BnaA02T0349100ZY	0	+	790	1498	1592	0.9409547
zheyou73v0_A02	32433482	32434760	BnaA02T0349200ZY	0	-	857	1278	1278	1.0000000
zheyou73v0_A02	32437904	32439730	BnaA02T0349300ZY	0	-	509	1328	1826	0.7272727
zheyou73v0_A02	32437904	32439730	BnaA02T0349300ZY.1	0	-	509	1328	1826	0.7272727
zheyou73v0_A02	32455757	32458180	BnaA02T0349400ZY	0	+	697	2062	2423	0.8510112
zheyou73v0_A02	32463101	32465347	BnaA02T0349500ZY	0	+	799	1877	2246	0.8357079
zheyou73v0_A02	32466070	32466915	BnaA02T0349600ZY	0	-	560	845	845	1.0000000
zheyou73v0_A02	32469469	32470089	BnaA02T0349700ZY	0	+	2	116	620	0.1870968
zheyou73v0_A02	32471895	32477552	BnaA02T0349800ZY	0	-	666	3753	5657	0.6634259
zheyou73v0_A02	32486700	32489836	BnaA02T0349900ZY	0	-	235	1292	3136	0.4119898
zheyou73v0_A02	32516286	32517241	BnaA02T0350000ZY	0	+	153	753	955	0.7884817
zheyou73v0_A02	32526814	32527818	BnaA02T0350100ZY	0	-	360	1004	1004	1.0000000
zheyou73v0_A02	32529582	32531328	BnaA02T0350200ZY	0	+	475	1702	1746	0.9747995
zheyou73v0_A02	32546166	32547979	BnaA02T0350300ZY	0	+	309	1193	1813	0.6580254
zheyou73v0_A02	32571951	32573050	BnaA02T0350400ZY	0	+	185	864	1099	0.7861692
zheyou73v0_A02	32573974	32576872	BnaA02T0350500ZY	0	-	773	2411	2898	0.8319530
zheyou73v0_A02	32580357	32580835	BnaA02T0350600ZY	0	-	160	478	478	1.0000000
zheyou73v0_A02	32588787	32589252	BnaA02T0350700ZY	0	-	140	438	465	0.9419355
zheyou73v0_A02	32590218	32591653	BnaA02T0350800ZY	0	-	1080	1435	1435	1.0000000
zheyou73v0_A02	32591660	32592389	BnaA02T0350900ZY	0	-	89	686	729	0.9410151
zheyou73v0_A02	32601459	32602600	BnaA02T0351000ZY	0	+	310	1141	1141	1.0000000
zheyou73v0_A02	32611559	32612241	BnaA02T0351100ZY	0	-	52	508	682	0.7448680
zheyou73v0_A02	32628886	32636468	BnaA02T0351200ZY	0	+	2045	7517	7582	0.9914271
zheyou73v0_A02	32638345	32640300	BnaA02T0351300ZY	0	-	608	1860	1955	0.9514067
zheyou73v0_A02	32642005	32644194	BnaA02T0351400ZY	0	-	212	1966	2189	0.8981270
zheyou73v0_A02	32644919	32646781	BnaA02T0351500ZY	0	-	396	1849	1862	0.9930183
zheyou73v0_A02	32647523	32649487	BnaA02T0351600ZY	0	-	280	1771	1964	0.9017311
zheyou73v0_A02	32653267	32658022	BnaA02T0351700ZY	0	+	684	3766	4755	0.7920084
zheyou73v0_A02	32660792	32663254	BnaA02T0351800ZY	0	+	482	2365	2462	0.9606012
zheyou73v0_A02	32682155	32685374	BnaA02T0351900ZY	0	+	339	2794	3219	0.8679714
zheyou73v0_A02	32691133	32691753	BnaA02T0352000ZY	0	+	64	410	620	0.6612903
zheyou73v0_A02	32695853	32698673	BnaA02T0352100ZY	0	+	157	1875	2820	0.6648936
zheyou73v0_A02	32703449	32706426	BnaA02T0352200ZY	0	-	619	2977	2977	1.0000000
zheyou73v0_A02	32718380	32720805	BnaA02T0352300ZY	0	+	25	932	2425	0.3843299
zheyou73v0_A02	32733506	32733939	BnaA02T0352400ZY	0	-	0	0	433	0.0000000
zheyou73v0_A02	32733983	32734724	BnaA02T0352500ZY	0	-	0	0	741	0.0000000
zheyou73v0_A02	32741665	32743606	BnaA02T0352600ZY	0	+	117	1119	1941	0.5765070
zheyou73v0_A02	32748471	32752764	BnaA02T0352700ZY	0	-	549	3572	4293	0.8320522
zheyou73v0_A02	32753977	32755918	BnaA02T0352800ZY	0	-	231	1674	1941	0.8624420
zheyou73v0_A02	32756462	32758269	BnaA02T0352900ZY	0	-	107	1049	1807	0.5805202
zheyou73v0_A02	32766554	32766878	BnaA02T0353000ZY	0	-	0	0	324	0.0000000
zheyou73v0_A02	32767088	32768469	BnaA02T0353100ZY	0	-	0	0	1381	0.0000000
zheyou73v0_A02	32787470	32789310	BnaA02T0353200ZY	0	-	180	793	1840	0.4309783
zheyou73v0_A02	32806167	32806871	BnaA02T0353300ZY	0	-	0	0	704	0.0000000
zheyou73v0_A02	32818484	32819692	BnaA02T0353400ZY	0	-	0	0	1208	0.0000000
zheyou73v0_A02	32822065	32822769	BnaA02T0353500ZY	0	-	0	0	704	0.0000000
zheyou73v0_A02	32863871	32866171	BnaA02T0353600ZY	0	-	21	360	2300	0.1565217
zheyou73v0_A02	32866983	32871474	BnaA02T0353700ZY	0	+	385	2019	4491	0.4495658
zheyou73v0_A02	32871925	32872381	BnaA02T0353800ZY	0	-	0	0	456	0.0000000
zheyou73v0_A02	32893776	32895649	BnaA02T0353900ZY	0	+	835	1780	1873	0.9503471
zheyou73v0_A02	32896185	32897253	BnaA02T0354000ZY	0	-	44	612	1068	0.5730337
zheyou73v0_A02	32898567	32898882	BnaA02T0354100ZY	0	-	58	315	315	1.0000000
zheyou73v0_A02	32900162	32903330	BnaA02T0354200ZY	0	+	648	3129	3168	0.9876894
zheyou73v0_A02	32904958	32906756	BnaA02T0354300ZY	0	-	549	1798	1798	1.0000000
zheyou73v0_A02	32907175	32908056	BnaA02T0354400ZY	0	+	50	652	881	0.7400681
zheyou73v0_A02	32908473	32910018	BnaA02T0354500ZY	0	+	369	1545	1545	1.0000000
zheyou73v0_A02	32910366	32912039	BnaA02T0354600ZY	0	-	119	1173	1673	0.7011357
zheyou73v0_A02	32913683	32914764	BnaA02T0354700ZY	0	-	403	1081	1081	1.0000000
zheyou73v0_A02	32924789	32924963	BnaA02T0354800ZY	0	+	17	149	174	0.8563218
zheyou73v0_A02	32928213	32929831	BnaA02T0354900ZY	0	-	352	1447	1618	0.8943140
zheyou73v0_A02	32935816	32936296	BnaA02T0355000ZY	0	+	145	480	480	1.0000000
zheyou73v0_A02	32937141	32938840	BnaA02T0355100ZY	0	+	669	1642	1699	0.9664509
zheyou73v0_A02	32938960	32941333	BnaA02T0355200ZY	0	-	903	2321	2373	0.9780868
zheyou73v0_A02	32942690	32944124	BnaA02T0355300ZY	0	-	178	1329	1434	0.9267783
zheyou73v0_A02	32951021	32953034	BnaA02T0355400ZY	0	+	471	1979	2013	0.9831098
zheyou73v0_A02	32953914	32955164	BnaA02T0355500ZY	0	+	290	982	1250	0.7856000
zheyou73v0_A02	32955850	32959508	BnaA02T0355600ZY	0	+	566	3108	3658	0.8496446
zheyou73v0_A02	32955850	32959508	BnaA02T0355600ZY.1	0	+	566	3108	3658	0.8496446
zheyou73v0_A02	32955850	32959508	BnaA02T0355600ZY.2	0	+	566	3108	3658	0.8496446
zheyou73v0_A02	32959656	32960743	BnaA02T0355700ZY	0	+	515	1087	1087	1.0000000
zheyou73v0_A02	32965131	32966934	BnaA02T0355800ZY	0	-	582	1802	1803	0.9994454
zheyou73v0_A02	32969241	32969529	BnaA02T0355900ZY	0	-	256	288	288	1.0000000
zheyou73v0_A02	32969632	32974343	BnaA02T0356000ZY	0	+	1317	4306	4711	0.9140310
zheyou73v0_A02	32986696	32989546	BnaA02T0356100ZY	0	+	206	1746	2850	0.6126316
zheyou73v0_A02	32990873	32992935	BnaA02T0356200ZY	0	+	477	1562	2062	0.7575170
zheyou73v0_A02	32997479	32999382	BnaA02T0356300ZY	0	-	420	1609	1903	0.8455071
zheyou73v0_A02	33012091	33014465	BnaA02T0356400ZY	0	+	292	1857	2374	0.7822241
zheyou73v0_A02	33015897	33017430	BnaA02T0356500ZY	0	-	370	1402	1533	0.9145467
zheyou73v0_A02	33078956	33082591	BnaA02T0356600ZY	0	-	1291	3402	3635	0.9359010
zheyou73v0_A02	33083695	33086563	BnaA02T0356700ZY	0	-	683	2684	2868	0.9358438
zheyou73v0_A02	33083695	33086563	BnaA02T0356700ZY.1	0	-	683	2684	2868	0.9358438
zheyou73v0_A02	33083695	33086563	BnaA02T0356700ZY.2	0	-	683	2684	2868	0.9358438
zheyou73v0_A02	33083695	33086563	BnaA02T0356700ZY.3	0	-	683	2684	2868	0.9358438
zheyou73v0_A02	33097165	33098827	BnaA02T0356800ZY	0	-	502	1627	1662	0.9789410
zheyou73v0_A02	33099621	33102081	BnaA02T0356900ZY	0	-	731	2217	2460	0.9012195
zheyou73v0_A02	33105353	33107348	BnaA02T0357000ZY	0	-	730	1783	1995	0.8937343
zheyou73v0_A02	33112268	33112866	BnaA02T0357100ZY	0	+	415	598	598	1.0000000
zheyou73v0_A02	33126183	33126945	BnaA02T0357200ZY	0	+	20	471	762	0.6181102
zheyou73v0_A02	33134721	33135070	BnaA02T0357300ZY	0	-	0	0	349	0.0000000
zheyou73v0_A02	33137244	33137856	BnaA02T0357400ZY	0	+	33	153	612	0.2500000
zheyou73v0_A02	33139290	33145744	BnaA02T0357500ZY	0	-	3601	6454	6454	1.0000000
zheyou73v0_A02	33161577	33162190	BnaA02T0357600ZY	0	-	307	613	613	1.0000000
zheyou73v0_A02	33180124	33181657	BnaA02T0357700ZY	0	+	389	1533	1533	1.0000000
zheyou73v0_A02	33182545	33182755	BnaA02T0357800ZY	0	+	12	127	210	0.6047619
zheyou73v0_A02	33183151	33183361	BnaA02T0357900ZY	0	-	58	209	210	0.9952381
zheyou73v0_A02	33186486	33186696	BnaA02T0358000ZY	0	-	70	210	210	1.0000000
zheyou73v0_A02	33192508	33193805	BnaA02T0358100ZY	0	-	259	1162	1297	0.8959137
zheyou73v0_A02	33201148	33201445	BnaA02T0358200ZY	0	+	323	297	297	1.0000000
zheyou73v0_A02	33201505	33203007	BnaA02T0358300ZY	0	-	622	1502	1502	1.0000000
zheyou73v0_A02	33201505	33203007	BnaA02T0358300ZY.1	0	-	622	1502	1502	1.0000000
zheyou73v0_A02	33209297	33209960	BnaA02T0358400ZY	0	+	15	526	663	0.7933635
zheyou73v0_A02	33214218	33216117	BnaA02T0358500ZY	0	+	752	1848	1899	0.9731438
zheyou73v0_A02	33216728	33217680	BnaA02T0358600ZY	0	+	610	952	952	1.0000000
zheyou73v0_A02	33220523	33221270	BnaA02T0358700ZY	0	+	39	348	747	0.4658635
zheyou73v0_A02	33221877	33225640	BnaA02T0358800ZY	0	-	394	2211	3763	0.5875631
zheyou73v0_A02	33240259	33241290	BnaA02T0358900ZY	0	+	109	743	1031	0.7206596
zheyou73v0_A02	33247720	33250786	BnaA02T0359000ZY	0	+	231	1886	3066	0.6151337
zheyou73v0_A02	33252128	33255924	BnaA02T0359100ZY	0	-	1116	3755	3796	0.9891992
zheyou73v0_A02	33257560	33258165	BnaA02T0359200ZY	0	-	25	372	605	0.6148760
zheyou73v0_A02	33259193	33261114	BnaA02T0359300ZY	0	-	582	1597	1921	0.8313379
zheyou73v0_A02	33276010	33277099	BnaA02T0359400ZY	0	+	69	914	1089	0.8393021
zheyou73v0_A02	33286639	33289642	BnaA02T0359500ZY	0	+	1330	2968	3003	0.9883450
zheyou73v0_A02	33314036	33314764	BnaA02T0359600ZY	0	-	104	616	728	0.8461539
zheyou73v0_A02	33318936	33319292	BnaA02T0359700ZY	0	-	27	339	356	0.9522472
zheyou73v0_A02	33319396	33319576	BnaA02T0359800ZY	0	-	11	180	180	1.0000000
zheyou73v0_A02	33321215	33322463	BnaA02T0359900ZY	0	+	312	1238	1248	0.9919872
zheyou73v0_A02	33329764	33332293	BnaA02T0360000ZY	0	+	406	1651	2529	0.6528272
zheyou73v0_A02	33332507	33336965	BnaA02T0360100ZY	0	-	570	3102	4458	0.6958277
zheyou73v0_A02	33339981	33345938	BnaA02T0360200ZY	0	+	1708	5825	5957	0.9778412
zheyou73v0_A02	33345712	33345907	BnaA02T0360300ZY	0	-	77	195	195	1.0000000
zheyou73v0_A02	33347584	33347996	BnaA02T0360400ZY	0	-	36	318	412	0.7718447
zheyou73v0_A02	33348325	33349418	BnaA02T0360500ZY	0	+	75	755	1093	0.6907594
zheyou73v0_A02	33351151	33351438	BnaA02T0360600ZY	0	-	20	187	287	0.6515679
zheyou73v0_A02	33355670	33357298	BnaA02T0360700ZY	0	-	169	1455	1628	0.8937346
zheyou73v0_A02	33357515	33359288	BnaA02T0360800ZY	0	-	145	1004	1773	0.5662718
zheyou73v0_A02	33360081	33361463	BnaA02T0360900ZY	0	+	331	1220	1382	0.8827786
zheyou73v0_A02	33360081	33361463	BnaA02T0360900ZY.1	0	+	331	1220	1382	0.8827786
zheyou73v0_A02	33364554	33365906	BnaA02T0361000ZY	0	+	7	297	1352	0.2196746
zheyou73v0_A02	33367784	33369755	BnaA02T0361100ZY	0	+	802	1971	1971	1.0000000
zheyou73v0_A02	33367920	33369755	BnaA02T0361100ZY.1	0	+	753	1835	1835	1.0000000
zheyou73v0_A02	33370201	33372309	BnaA02T0361200ZY	0	-	995	2108	2108	1.0000000
zheyou73v0_A02	33379326	33382831	BnaA02T0361300ZY	0	-	715	3134	3505	0.8941512
zheyou73v0_A02	33379326	33383076	BnaA02T0361300ZY.1	0	-	778	3379	3750	0.9010667
zheyou73v0_A02	33387923	33388891	BnaA02T0361400ZY	0	-	423	890	968	0.9194215
zheyou73v0_A02	33391209	33394056	BnaA02T0361500ZY	0	+	447	1154	2847	0.4053389
zheyou73v0_A02	33394982	33395366	BnaA02T0361600ZY	0	-	58	218	384	0.5677083
zheyou73v0_A02	33396252	33399783	BnaA02T0361700ZY	0	+	1105	3496	3531	0.9900878
zheyou73v0_A02	33401307	33403540	BnaA02T0361800ZY	0	+	596	2133	2233	0.9552172
zheyou73v0_A02	33404346	33409177	BnaA02T0361900ZY	0	-	572	3796	4831	0.7857586
zheyou73v0_A02	33418846	33420185	BnaA02T0362000ZY	0	-	288	1220	1339	0.9111277
zheyou73v0_A02	33420844	33421591	BnaA02T0362100ZY	0	+	8	156	747	0.2088353
zheyou73v0_A02	33421845	33427816	BnaA02T0362200ZY	0	-	1857	5523	5971	0.9249707
zheyou73v0_A02	33430052	33432821	BnaA02T0362300ZY	0	-	628	2071	2769	0.7479234
zheyou73v0_A02	33433355	33436037	BnaA02T0362400ZY	0	-	1348	2610	2682	0.9731544
zheyou73v0_A02	33442031	33443986	BnaA02T0362500ZY	0	+	373	1216	1955	0.6219949
zheyou73v0_A02	33447655	33447965	BnaA02T0362600ZY	0	-	216	310	310	1.0000000
zheyou73v0_A02	33449002	33449965	BnaA02T0362700ZY	0	+	703	963	963	1.0000000
zheyou73v0_A02	33452331	33452493	BnaA02T0362800ZY	0	+	115	162	162	1.0000000
zheyou73v0_A02	33453876	33457591	BnaA02T0362900ZY	0	-	481	3458	3715	0.9308210
zheyou73v0_A02	33460051	33461623	BnaA02T0363000ZY	0	+	110	1181	1572	0.7512723
zheyou73v0_A02	33461777	33468679	BnaA02T0363100ZY	0	-	445	2834	6902	0.4106056
zheyou73v0_A02	33468784	33471329	BnaA02T0363200ZY	0	-	1036	2520	2545	0.9901768
zheyou73v0_A02	33468784	33471329	BnaA02T0363200ZY.1	0	-	1036	2520	2545	0.9901768
zheyou73v0_A02	33468784	33471329	BnaA02T0363200ZY.2	0	-	1036	2520	2545	0.9901768
zheyou73v0_A02	33471702	33473876	BnaA02T0363300ZY	0	-	705	1855	2174	0.8532659
zheyou73v0_A02	33478211	33481338	BnaA02T0363400ZY	0	+	408	1794	3127	0.5737128
zheyou73v0_A02	33486179	33486998	BnaA02T0363500ZY	0	+	496	819	819	1.0000000
zheyou73v0_A02	33491116	33492102	BnaA02T0363600ZY	0	+	115	941	986	0.9543611
zheyou73v0_A02	33493513	33498152	BnaA02T0363700ZY	0	-	1370	4158	4639	0.8963138
zheyou73v0_A02	33499219	33500067	BnaA02T0363800ZY	0	-	51	747	848	0.8808962
zheyou73v0_A02	33509111	33510324	BnaA02T0363900ZY	0	+	143	799	1213	0.6586974
zheyou73v0_A02	33519908	33523198	BnaA02T0364000ZY	0	+	880	3110	3290	0.9452888
zheyou73v0_A02	33525800	33527580	BnaA02T0364100ZY	0	-	210	1571	1780	0.8825843
zheyou73v0_A02	33533860	33537092	BnaA02T0364200ZY	0	+	46	718	3232	0.2221535
zheyou73v0_A02	33539387	33540451	BnaA02T0364300ZY.1	0	-	0	0	1064	0.0000000
zheyou73v0_A02	33539614	33540033	BnaA02T0364300ZY	0	-	0	0	419	0.0000000
zheyou73v0_A02	33541702	33544364	BnaA02T0364400ZY	0	+	431	2094	2662	0.7866266
zheyou73v0_A02	33541702	33544364	BnaA02T0364400ZY.1	0	+	431	2094	2662	0.7866266
zheyou73v0_A02	33545618	33547194	BnaA02T0364500ZY	0	-	58	498	1576	0.3159899
zheyou73v0_A02	33581676	33582657	BnaA02T0364600ZY	0	+	346	981	981	1.0000000
zheyou73v0_A02	33589511	33590647	BnaA02T0364700ZY	0	+	128	988	1136	0.8697183
zheyou73v0_A02	33600969	33602232	BnaA02T0364800ZY	0	-	3	13	1263	0.0102930
zheyou73v0_A02	33610973	33612236	BnaA02T0364900ZY	0	-	6	27	1263	0.0213777
zheyou73v0_A02	33626303	33633641	BnaA02T0365000ZY	0	+	7199	5498	7338	0.7492505
zheyou73v0_A02	33658494	33659144	BnaA02T0365100ZY	0	-	385	650	650	1.0000000
zheyou73v0_A02	33663103	33665801	BnaA02T0365200ZY	0	+	567	1944	2698	0.7205337
zheyou73v0_A02	33666145	33667230	BnaA02T0365300ZY	0	-	168	1029	1085	0.9483871
zheyou73v0_A02	33670569	33671223	BnaA02T0365400ZY	0	+	90	469	654	0.7171254
zheyou73v0_A02	33673330	33675527	BnaA02T0365500ZY	0	+	290	1709	2197	0.7778789
zheyou73v0_A02	33678435	33679729	BnaA02T0365600ZY	0	-	375	1273	1294	0.9837713
zheyou73v0_A02	33682830	33684492	BnaA02T0365700ZY	0	+	94	1192	1662	0.7172082
zheyou73v0_A02	33688009	33690734	BnaA02T0365800ZY	0	+	516	2155	2725	0.7908257
zheyou73v0_A02	33691482	33694416	BnaA02T0365900ZY	0	+	664	2471	2934	0.8421950
zheyou73v0_A02	33696515	33700362	BnaA02T0366000ZY	0	+	1087	3523	3847	0.9157785
zheyou73v0_A02	33700139	33702031	BnaA02T0366100ZY	0	-	493	1865	1892	0.9857294
zheyou73v0_A02	33702511	33704758	BnaA02T0366200ZY	0	-	214	1430	2247	0.6364041
zheyou73v0_A02	33720082	33722802	BnaA02T0366300ZY	0	-	135	1356	2720	0.4985294
zheyou73v0_A02	33732066	33734885	BnaA02T0366400ZY	0	-	869	2606	2819	0.9244413
zheyou73v0_A02	33738664	33739624	BnaA02T0366500ZY	0	-	257	848	960	0.8833333
zheyou73v0_A02	33741491	33742505	BnaA02T0366600ZY	0	+	124	883	1014	0.8708087
zheyou73v0_A02	33745166	33745701	BnaA02T0366700ZY	0	-	133	427	535	0.7981309
zheyou73v0_A02	33756052	33756493	BnaA02T0366800ZY	0	-	205	441	441	1.0000000
zheyou73v0_A02	33759853	33763429	BnaA02T0366900ZY	0	+	717	3373	3576	0.9432327
zheyou73v0_A02	33770828	33772428	BnaA02T0367000ZY	0	+	62	1156	1600	0.7225000
zheyou73v0_A02	33775212	33775761	BnaA02T0367100ZY	0	-	440	549	549	1.0000000
zheyou73v0_A02	33778842	33779630	BnaA02T0367200ZY	0	-	601	788	788	1.0000000
zheyou73v0_A02	33782093	33783683	BnaA02T0367300ZY	0	-	1068	1590	1590	1.0000000
zheyou73v0_A02	33784784	33785653	BnaA02T0367400ZY	0	-	509	869	869	1.0000000
zheyou73v0_A02	33789343	33790716	BnaA02T0367500ZY	0	-	419	1237	1373	0.9009469
zheyou73v0_A02	33800301	33803585	BnaA02T0367600ZY	0	-	1632	3269	3284	0.9954324
zheyou73v0_A02	33805316	33806873	BnaA02T0367700ZY	0	-	335	709	1557	0.4553629
zheyou73v0_A02	33808796	33810401	BnaA02T0367800ZY	0	-	1108	1605	1605	1.0000000
zheyou73v0_A02	33818783	33819396	BnaA02T0367900ZY	0	+	335	613	613	1.0000000
zheyou73v0_A02	33820747	33821858	BnaA02T0368000ZY	0	-	379	1111	1111	1.0000000
zheyou73v0_A02	33822865	33824362	BnaA02T0368100ZY	0	-	75	690	1497	0.4609219
zheyou73v0_A02	33827047	33827579	BnaA02T0368200ZY	0	-	79	409	532	0.7687970
zheyou73v0_A02	33838528	33842536	BnaA02T0368300ZY	0	-	361	2823	4008	0.7043413
zheyou73v0_A02	33842847	33844404	BnaA02T0368400ZY	0	+	186	1313	1557	0.8432884
zheyou73v0_A02	33844516	33845971	BnaA02T0368500ZY	0	-	499	1449	1455	0.9958763
zheyou73v0_A02	33846628	33848333	BnaA02T0368600ZY	0	+	225	1476	1705	0.8656892
zheyou73v0_A02	33851131	33851473	BnaA02T0368700ZY	0	-	53	342	342	1.0000000
zheyou73v0_A02	33860942	33862666	BnaA02T0368800ZY	0	-	126	945	1724	0.5481439
zheyou73v0_A02	33866073	33866475	BnaA02T0368900ZY	0	-	231	402	402	1.0000000
zheyou73v0_A02	33867795	33868762	BnaA02T0369000ZY	0	-	349	967	967	1.0000000
zheyou73v0_A02	33869240	33870052	BnaA02T0369100ZY	0	+	65	644	812	0.7931035
zheyou73v0_A02	33873295	33873604	BnaA02T0369200ZY	0	-	198	309	309	1.0000000
zheyou73v0_A02	33876412	33879316	BnaA02T0369300ZY	0	-	485	2467	2904	0.8495179
zheyou73v0_A02	33880442	33881568	BnaA02T0369400ZY	0	-	744	1126	1126	1.0000000
zheyou73v0_A02	33886172	33886601	BnaA02T0369500ZY	0	-	4	199	429	0.4638695
zheyou73v0_A02	33889629	33889972	BnaA02T0369600ZY	0	+	159	343	343	1.0000000
zheyou73v0_A02	33891757	33892923	BnaA02T0369700ZY	0	+	133	475	1166	0.4073756
zheyou73v0_A02	33896809	33897562	BnaA02T0369800ZY	0	+	404	753	753	1.0000000
zheyou73v0_A02	33898175	33905496	BnaA02T0369900ZY	0	-	520	1989	7321	0.2716842
zheyou73v0_A02	33906497	33907524	BnaA02T0370000ZY	0	-	487	1018	1027	0.9912366
zheyou73v0_A02	33908178	33908763	BnaA02T0370100ZY	0	+	432	585	585	1.0000000
zheyou73v0_A02	33909213	33911260	BnaA02T0370200ZY	0	+	586	2047	2047	1.0000000
zheyou73v0_A02	33912164	33917122	BnaA02T0370300ZY	0	+	1577	4593	4958	0.9263816
zheyou73v0_A02	33912164	33917122	BnaA02T0370300ZY.1	0	+	1577	4593	4958	0.9263816
zheyou73v0_A02	33920143	33921046	BnaA02T0370400ZY	0	+	222	588	903	0.6511628
zheyou73v0_A02	33924092	33924473	BnaA02T0370500ZY	0	-	348	381	381	1.0000000
zheyou73v0_A02	33927985	33929231	BnaA02T0370600ZY	0	+	283	1222	1246	0.9807383
zheyou73v0_A02	33938384	33939493	BnaA02T0370700ZY	0	-	222	1109	1109	1.0000000
zheyou73v0_A02	33948641	33952211	BnaA02T0370800ZY	0	-	2740	3570	3570	1.0000000
zheyou73v0_A02	33955134	33959033	BnaA02T0370900ZY	0	+	1813	3814	3899	0.9781995
zheyou73v0_A02	33959976	33962336	BnaA02T0371000ZY	0	-	178	1975	2360	0.8368644
zheyou73v0_A02	33967733	33968601	BnaA02T0371100ZY	0	-	46	653	868	0.7523041
zheyou73v0_A02	33971253	33972069	BnaA02T0371200ZY	0	-	85	629	816	0.7708333
zheyou73v0_A02	33974932	33976493	BnaA02T0371300ZY	0	-	215	1039	1561	0.6655990
zheyou73v0_A02	33977236	33985214	BnaA02T0371400ZY	0	-	2728	7887	7978	0.9885936
zheyou73v0_A02	33987004	33988260	BnaA02T0371500ZY	0	+	195	1256	1256	1.0000000
zheyou73v0_A02	33993440	33995834	BnaA02T0371600ZY	0	+	805	2062	2394	0.8613200
zheyou73v0_A02	33995912	33996562	BnaA02T0371700ZY	0	+	27	214	650	0.3292308
zheyou73v0_A02	33996694	33997132	BnaA02T0371800ZY	0	+	1	96	438	0.2191781
zheyou73v0_A02	34008936	34009777	BnaA02T0371900ZY	0	-	8	440	841	0.5231867
zheyou73v0_A02	34010185	34010440	BnaA02T0372000ZY	0	+	0	0	255	0.0000000
zheyou73v0_A02	34013042	34013916	BnaA02T0372100ZY	0	+	607	874	874	1.0000000
zheyou73v0_A02	34043379	34048630	BnaA02T0372200ZY	0	-	186	3206	5251	0.6105503
zheyou73v0_A02	34050142	34066258	BnaA02T0372300ZY	0	+	1008	6641	16116	0.4120750
zheyou73v0_A02	34085293	34086313	BnaA02T0372400ZY	0	-	18	505	1020	0.4950980
zheyou73v0_A02	34091725	34095801	BnaA02T0372500ZY	0	+	25	601	4076	0.1474485
zheyou73v0_A02	34099993	34101498	BnaA02T0372600ZY	0	+	16	70	1505	0.0465116
zheyou73v0_A02	34112642	34116433	BnaA02T0372700ZY	0	-	700	3119	3791	0.8227381
zheyou73v0_A02	34147057	34150046	BnaA02T0372800ZY	0	+	733	2832	2989	0.9474741
zheyou73v0_A02	34154239	34154621	BnaA02T0372900ZY	0	-	253	382	382	1.0000000
zheyou73v0_A02	34159047	34162711	BnaA02T0373000ZY	0	+	1346	3492	3664	0.9530568
zheyou73v0_A02	34178161	34187438	BnaA02T0373100ZY	0	+	4348	8415	9277	0.9070820
zheyou73v0_A02	34191689	34192678	BnaA02T0373200ZY	0	-	773	989	989	1.0000000
zheyou73v0_A02	34209232	34211828	BnaA02T0373300ZY	0	+	472	2261	2596	0.8709553
zheyou73v0_A02	34213210	34213959	BnaA02T0373400ZY	0	-	414	749	749	1.0000000
zheyou73v0_A02	34219884	34221691	BnaA02T0373500ZY	0	+	297	1318	1807	0.7293857
zheyou73v0_A02	34222177	34224387	BnaA02T0373600ZY	0	-	438	2157	2210	0.9760181
zheyou73v0_A02	34239817	34240500	BnaA02T0373700ZY	0	+	20	307	683	0.4494876
zheyou73v0_A02	34256746	34257151	BnaA02T0373800ZY	0	-	19	289	405	0.7135803
zheyou73v0_A02	34267197	34267756	BnaA02T0373900ZY	0	+	34	239	559	0.4275492
zheyou73v0_A02	34272154	34274499	BnaA02T0374000ZY	0	-	350	1574	2345	0.6712154
zheyou73v0_A02	34285293	34287900	BnaA02T0374100ZY	0	+	652	2476	2607	0.9497507
zheyou73v0_A02	34292280	34298939	BnaA02T0374200ZY	0	+	1421	5516	6659	0.8283526
zheyou73v0_A02	34298970	34299721	BnaA02T0374300ZY	0	-	132	708	751	0.9427430
zheyou73v0_A02	34307981	34311517	BnaA02T0374400ZY	0	+	556	2291	3536	0.6479073
zheyou73v0_A02	34318664	34324592	BnaA02T0374500ZY	0	-	77	199	5928	0.0335695
zheyou73v0_A02	34325749	34327367	BnaA02T0374600ZY	0	+	600	1283	1618	0.7929543
zheyou73v0_A02	34335591	34340546	BnaA02T0374700ZY	0	+	177	1908	4955	0.3850656
zheyou73v0_A02	34341729	34342644	BnaA02T0374800ZY	0	-	78	824	915	0.9005464
zheyou73v0_A02	34345568	34350715	BnaA02T0374900ZY	0	-	1324	4425	5147	0.8597241
zheyou73v0_A02	34351155	34354605	BnaA02T0375000ZY	0	-	1235	3216	3450	0.9321739
zheyou73v0_A02	34359546	34365020	BnaA02T0375100ZY	0	-	376	3862	5474	0.7055170
zheyou73v0_A02	34369656	34371395	BnaA02T0375200ZY	0	-	4	197	1739	0.1132835
zheyou73v0_A02	34386246	34387799	BnaA02T0375300ZY	0	-	38	231	1553	0.1487444
zheyou73v0_A02	34416067	34417463	BnaA02T0375400ZY	0	-	127	1222	1396	0.8753582
zheyou73v0_A02	34419561	34419861	BnaA02T0375500ZY	0	+	60	300	300	1.0000000
zheyou73v0_A02	34433018	34433324	BnaA02T0375600ZY	0	+	153	306	306	1.0000000
zheyou73v0_A02	34435315	34435621	BnaA02T0375700ZY	0	+	42	190	306	0.6209151
zheyou73v0_A02	34439598	34439907	BnaA02T0375800ZY	0	+	156	309	309	1.0000000
zheyou73v0_A02	34441904	34444481	BnaA02T0375900ZY	0	-	535	2294	2577	0.8901824
zheyou73v0_A02	34446496	34448950	BnaA02T0376000ZY	0	-	511	1924	2454	0.7840261
zheyou73v0_A02	34446496	34448950	BnaA02T0376000ZY.1	0	-	511	1924	2454	0.7840261
zheyou73v0_A02	34450255	34451366	BnaA02T0376100ZY	0	-	17	718	1111	0.6462646
zheyou73v0_A02	34457181	34457821	BnaA02T0376200ZY	0	+	291	640	640	1.0000000
zheyou73v0_A02	34475029	34484258	BnaA02T0376300ZY	0	-	149	783	9229	0.0848413
zheyou73v0_A02	34492669	34494719	BnaA02T0376400ZY	0	-	0	0	2050	0.0000000
zheyou73v0_A02	34515695	34517912	BnaA02T0376500ZY	0	-	183	811	2217	0.3658096
zheyou73v0_A02	34518868	34522125	BnaA02T0376600ZY	0	+	292	1871	3257	0.5744550
zheyou73v0_A02	34522585	34526709	BnaA02T0376700ZY	0	+	292	2850	4124	0.6910766
zheyou73v0_A02	34527757	34528755	BnaA02T0376800ZY	0	-	22	228	998	0.2284569
zheyou73v0_A02	34529412	34540451	BnaA02T0376900ZY	0	+	332	2547	11039	0.2307274
zheyou73v0_A02	34542720	34546212	BnaA02T0377000ZY	0	+	1023	3149	3492	0.9017755
zheyou73v0_A02	34551278	34551859	BnaA02T0377100ZY	0	+	246	581	581	1.0000000
zheyou73v0_A02	34552187	34554765	BnaA02T0377200ZY	0	-	94	1431	2578	0.5550815
zheyou73v0_A02	34556922	34558067	BnaA02T0377300ZY	0	+	276	955	1145	0.8340611
zheyou73v0_A02	34560046	34560996	BnaA02T0377400ZY	0	+	176	860	950	0.9052632
zheyou73v0_A02	34561390	34561910	BnaA02T0377500ZY	0	-	448	520	520	1.0000000
zheyou73v0_A02	34566199	34567606	BnaA02T0377600ZY	0	+	244	1242	1407	0.8827292
zheyou73v0_A02	34573134	34573434	BnaA02T0377700ZY	0	+	112	221	300	0.7366667
zheyou73v0_A02	34576888	34577562	BnaA02T0377800ZY	0	-	4	256	674	0.3798220
zheyou73v0_A02	34590808	34591911	BnaA02T0377900ZY	0	+	91	884	1103	0.8014506
zheyou73v0_A02	34594279	34602347	BnaA02T0378000ZY	0	+	538	3198	8068	0.3963808
zheyou73v0_A02	34607512	34608858	BnaA02T0378100ZY	0	-	761	1242	1346	0.9227340
zheyou73v0_A02	34611043	34612447	BnaA02T0378200ZY.1	0	-	0	0	1404	0.0000000
zheyou73v0_A02	34611291	34612447	BnaA02T0378200ZY	0	-	0	0	1156	0.0000000
zheyou73v0_A02	34614639	34616109	BnaA02T0378300ZY	0	-	115	707	1470	0.4809524
zheyou73v0_A02	34618101	34619316	BnaA02T0378400ZY	0	-	0	0	1215	0.0000000
zheyou73v0_A02	34619525	34620391	BnaA02T0378500ZY	0	-	0	0	866	0.0000000
zheyou73v0_A02	34625984	34627535	BnaA02T0378600ZY	0	-	253	1241	1551	0.8001289
zheyou73v0_A02	34638997	34640844	BnaA02T0378700ZY	0	-	886	1591	1847	0.8613968
zheyou73v0_A02	34646193	34646867	BnaA02T0378800ZY	0	-	360	674	674	1.0000000
zheyou73v0_A02	34647727	34648707	BnaA02T0378900ZY	0	-	354	980	980	1.0000000
zheyou73v0_A02	34649164	34650424	BnaA02T0379000ZY	0	+	535	1252	1260	0.9936508
zheyou73v0_A02	34651063	34652992	BnaA02T0379100ZY	0	+	919	1921	1929	0.9958528
zheyou73v0_A02	34653348	34655306	BnaA02T0379200ZY	0	-	1232	1958	1958	1.0000000
zheyou73v0_A02	34656647	34663340	BnaA02T0379300ZY	0	-	1786	5688	6693	0.8498431
zheyou73v0_A02	34673695	34676066	BnaA02T0379400ZY	0	-	426	1702	2371	0.7178406
zheyou73v0_A02	34677393	34677819	BnaA02T0379500ZY	0	-	338	426	426	1.0000000
zheyou73v0_A02	34678130	34680199	BnaA02T0379600ZY	0	-	488	1548	2069	0.7481875
zheyou73v0_A02	34694178	34694364	BnaA02T0379700ZY	0	+	195	186	186	1.0000000
zheyou73v0_A02	34694635	34694875	BnaA02T0379800ZY	0	+	208	240	240	1.0000000
zheyou73v0_A02	34695775	34696995	BnaA02T0379900ZY	0	+	636	1220	1220	1.0000000
zheyou73v0_A02	34697196	34699542	BnaA02T0380000ZY	0	-	485	2256	2346	0.9616368
zheyou73v0_A02	34697196	34700323	BnaA02T0380000ZY.1	0	-	879	3037	3127	0.9712184
zheyou73v0_A02	34697196	34699542	BnaA02T0380000ZY.2	0	-	485	2256	2346	0.9616368
zheyou73v0_A02	34701683	34702181	BnaA02T0380100ZY	0	+	215	498	498	1.0000000
zheyou73v0_A02	34705144	34708927	BnaA02T0380200ZY	0	+	949	2768	3783	0.7316944
zheyou73v0_A02	34721426	34723104	BnaA02T0380300ZY	0	-	316	1193	1678	0.7109655
zheyou73v0_A02	34730609	34730780	BnaA02T0380400ZY	0	+	109	171	171	1.0000000
zheyou73v0_A02	34736731	34740735	BnaA02T0380500ZY	0	+	1637	3941	4004	0.9842657
zheyou73v0_A02	34741215	34744466	BnaA02T0380600ZY	0	+	1673	3251	3251	1.0000000
zheyou73v0_A02	34744748	34751970	BnaA02T0380700ZY	0	-	1423	5972	7222	0.8269178
zheyou73v0_A02	34744748	34751214	BnaA02T0380700ZY.1	0	-	1165	5216	6466	0.8066811
zheyou73v0_A02	34752791	34753587	BnaA02T0380800ZY	0	+	64	711	796	0.8932161
zheyou73v0_A02	34754059	34755433	BnaA02T0380900ZY	0	-	171	1142	1374	0.8311499
zheyou73v0_A02	34758429	34759798	BnaA02T0381000ZY	0	-	333	1258	1369	0.9189189
zheyou73v0_A02	34764615	34770733	BnaA02T0381100ZY	0	+	571	3163	6118	0.5169990
zheyou73v0_A02	34770908	34777178	BnaA02T0381200ZY	0	+	784	5005	6270	0.7982456
zheyou73v0_A02	34777698	34778418	BnaA02T0381300ZY	0	-	22	390	720	0.5416667
zheyou73v0_A02	34779059	34781654	BnaA02T0381400ZY	0	-	109	1513	2595	0.5830443
zheyou73v0_A02	34785502	34786864	BnaA02T0381500ZY	0	+	490	1353	1362	0.9933921
zheyou73v0_A02	34789489	34791878	BnaA02T0381600ZY	0	+	654	2368	2389	0.9912097
zheyou73v0_A02	34792856	34794837	BnaA02T0381700ZY	0	+	700	1884	1981	0.9510348
zheyou73v0_A02	34806353	34809278	BnaA02T0381800ZY	0	+	433	2053	2925	0.7018803
zheyou73v0_A02	34813284	34813785	BnaA02T0381900ZY	0	-	63	368	501	0.7345309
zheyou73v0_A02	34820647	34821519	BnaA02T0382000ZY	0	-	188	851	872	0.9759175
zheyou73v0_A02	34828017	34832812	BnaA02T0382100ZY	0	-	1698	4427	4795	0.9232534
zheyou73v0_A02	34833412	34835200	BnaA02T0382200ZY	0	-	323	1607	1788	0.8987696
zheyou73v0_A02	34837291	34837765	BnaA02T0382300ZY	0	-	458	474	474	1.0000000
zheyou73v0_A02	34842700	34844780	BnaA02T0382400ZY	0	-	255	1371	2080	0.6591346
zheyou73v0_A02	34845125	34850154	BnaA02T0382500ZY	0	-	867	3764	5029	0.7484589
zheyou73v0_A02	34858355	34860621	BnaA02T0382600ZY	0	+	407	2052	2266	0.9055604
zheyou73v0_A02	34858355	34860626	BnaA02T0382600ZY.1	0	+	408	2057	2271	0.9057684
zheyou73v0_A02	34862684	34863759	BnaA02T0382700ZY	0	-	103	1047	1075	0.9739535
zheyou73v0_A02	34872678	34878328	BnaA02T0382800ZY	0	-	329	4511	5650	0.7984071
zheyou73v0_A02	34872678	34878408	BnaA02T0382800ZY.1	0	-	357	4591	5730	0.8012217
zheyou73v0_A02	34888117	34890313	BnaA02T0382900ZY	0	-	768	2100	2196	0.9562842
zheyou73v0_A02	34894010	34895182	BnaA02T0383000ZY	0	-	264	679	1172	0.5793515
zheyou73v0_A02	34897451	34900766	BnaA02T0383100ZY	0	-	932	3267	3315	0.9855204
zheyou73v0_A02	34902424	34911447	BnaA02T0383200ZY	0	+	1116	6484	9023	0.7186080
zheyou73v0_A02	34915801	34918108	BnaA02T0383300ZY	0	-	637	1953	2307	0.8465540
zheyou73v0_A02	34919705	34925669	BnaA02T0383400ZY	0	-	576	3676	5964	0.6163648
zheyou73v0_A02	34926947	34928378	BnaA02T0383500ZY	0	-	790	1378	1431	0.9629630
zheyou73v0_A02	34930431	34935965	BnaA02T0383600ZY	0	-	706	3233	5534	0.5842067
zheyou73v0_A02	34936760	34937183	BnaA02T0383700ZY	0	-	54	348	423	0.8226950
zheyou73v0_A02	34950710	34956702	BnaA02T0383800ZY	0	+	3518	5822	5992	0.9716288
zheyou73v0_A02	34950710	34956702	BnaA02T0383800ZY.1	0	+	3518	5822	5992	0.9716288
zheyou73v0_A02	34950710	34956988	BnaA02T0383800ZY.2	0	+	3646	6108	6278	0.9729213
zheyou73v0_A02	34962063	34963148	BnaA02T0383900ZY	0	-	181	567	1085	0.5225806
zheyou73v0_A02	34996165	34999753	BnaA02T0384000ZY	0	+	555	2741	3588	0.7639353
zheyou73v0_A02	35010352	35012016	BnaA02T0384100ZY	0	+	892	1664	1664	1.0000000
zheyou73v0_A02	35015965	35016472	BnaA02T0384200ZY	0	+	13	370	507	0.7297831
zheyou73v0_A02	35019405	35020748	BnaA02T0384300ZY	0	-	93	1190	1343	0.8860760
zheyou73v0_A02	35028425	35030588	BnaA02T0384400ZY	0	-	160	1364	2163	0.6306056
zheyou73v0_A02	35037127	35039191	BnaA02T0384500ZY	0	-	306	1730	2064	0.8381783
zheyou73v0_A02	35040642	35043466	BnaA02T0384600ZY.1	0	+	463	2475	2824	0.8764164
zheyou73v0_A02	35040642	35043466	BnaA02T0384600ZY.2	0	+	463	2475	2824	0.8764164
zheyou73v0_A02	35041377	35043466	BnaA02T0384600ZY	0	+	223	1740	2089	0.8329344
zheyou73v0_A02	35045915	35047101	BnaA02T0384700ZY	0	+	379	1113	1186	0.9384485
zheyou73v0_A02	35047401	35047795	BnaA02T0384800ZY	0	+	61	394	394	1.0000000
zheyou73v0_A02	35050744	35054289	BnaA02T0384900ZY	0	+	839	3116	3545	0.8789845
zheyou73v0_A02	35054509	35058159	BnaA02T0385000ZY	0	-	408	3070	3650	0.8410959
zheyou73v0_A02	35061490	35064939	BnaA02T0385100ZY	0	+	201	1897	3449	0.5500145
zheyou73v0_A02	35067629	35069355	BnaA02T0385200ZY	0	+	294	1334	1726	0.7728853
zheyou73v0_A02	35077355	35079497	BnaA02T0385300ZY	0	+	955	2122	2142	0.9906629
zheyou73v0_A02	35081408	35081961	BnaA02T0385400ZY	0	-	483	553	553	1.0000000
zheyou73v0_A02	35089067	35089482	BnaA02T0385500ZY	0	-	150	415	415	1.0000000
zheyou73v0_A02	35093627	35093855	BnaA02T0385600ZY	0	-	29	215	228	0.9429824
zheyou73v0_A02	35096561	35098764	BnaA02T0385700ZY	0	+	953	2070	2203	0.9396278
zheyou73v0_A02	35109640	35110408	BnaA02T0385800ZY	0	+	10	325	768	0.4231771
zheyou73v0_A02	35116851	35119854	BnaA02T0385900ZY	0	-	75	1651	3003	0.5497835
zheyou73v0_A02	35120520	35122388	BnaA02T0386000ZY	0	-	154	1292	1868	0.6916488
zheyou73v0_A02	35126923	35129385	BnaA02T0386100ZY	0	+	127	1210	2462	0.4914703
zheyou73v0_A02	35131911	35136144	BnaA02T0386200ZY	0	+	727	3561	4233	0.8412473
zheyou73v0_A02	35137472	35147307	BnaA02T0386300ZY	0	+	1502	6790	9835	0.6903915
zheyou73v0_A02	35147562	35148321	BnaA02T0386400ZY	0	+	28	188	759	0.2476943
zheyou73v0_A02	35148697	35159708	BnaA02T0386500ZY	0	-	2472	9158	11011	0.8317137
zheyou73v0_A02	35161656	35162087	BnaA02T0386600ZY	0	+	0	0	431	0.0000000
zheyou73v0_A02	35166070	35168547	BnaA02T0386700ZY	0	+	378	2134	2477	0.8615260
zheyou73v0_A02	35169810	35170602	BnaA02T0386800ZY	0	+	98	792	792	1.0000000
zheyou73v0_A02	35170973	35171576	BnaA02T0386900ZY	0	+	101	459	603	0.7611941
zheyou73v0_A02	35179391	35183870	BnaA02T0387000ZY	0	+	1117	3605	4479	0.8048671
zheyou73v0_A02	35185936	35188609	BnaA02T0387100ZY	0	+	887	2300	2673	0.8604564
zheyou73v0_A02	35192635	35195615	BnaA02T0387200ZY	0	+	783	1952	2980	0.6550335
zheyou73v0_A02	35232559	35242558	BnaA02T0387300ZY	0	+	1468	5934	9999	0.5934594
zheyou73v0_A02	35246044	35247665	BnaA02T0387400ZY	0	-	1003	1621	1621	1.0000000
zheyou73v0_A02	35263631	35268711	BnaA02T0387500ZY	0	+	912	3691	5080	0.7265748
zheyou73v0_A02	35284891	35286037	BnaA02T0387600ZY	0	+	35	202	1146	0.1762653
zheyou73v0_A02	35305271	35306787	BnaA02T0387700ZY	0	+	616	1364	1516	0.8997362
zheyou73v0_A02	35307511	35309094	BnaA02T0387800ZY	0	+	372	1557	1583	0.9835755
zheyou73v0_A02	35307511	35309094	BnaA02T0387800ZY.1	0	+	372	1557	1583	0.9835755
zheyou73v0_A02	35309834	35311559	BnaA02T0387900ZY	0	-	396	1692	1725	0.9808696
zheyou73v0_A02	35312401	35314785	BnaA02T0388000ZY	0	+	428	2256	2384	0.9463087
zheyou73v0_A02	35315656	35320654	BnaA02T0388100ZY.1	0	+	1027	4455	4998	0.8913565
zheyou73v0_A02	35315689	35320780	BnaA02T0388100ZY	0	+	1032	4548	5091	0.8933412
zheyou73v0_A02	35316735	35320654	BnaA02T0388100ZY.2	0	+	548	3404	3919	0.8685889
zheyou73v0_A02	35321411	35324815	BnaA02T0388200ZY	0	-	1072	3403	3404	0.9997062
zheyou73v0_A02	35327161	35331791	BnaA02T0388300ZY	0	+	1186	4072	4630	0.8794816
zheyou73v0_A02	35332687	35335033	BnaA02T0388400ZY	0	+	746	2346	2346	1.0000000
zheyou73v0_A02	35342440	35347169	BnaA02T0388500ZY	0	+	703	3901	4729	0.8249101
zheyou73v0_A02	35342440	35347169	BnaA02T0388500ZY.1	0	+	703	3901	4729	0.8249101
zheyou73v0_A02	35348355	35349099	BnaA02T0388600ZY	0	-	134	744	744	1.0000000
zheyou73v0_A02	35358240	35359546	BnaA02T0388700ZY	0	+	513	1283	1306	0.9823890
zheyou73v0_A02	35360334	35360953	BnaA02T0388800ZY	0	-	49	594	619	0.9596123
zheyou73v0_A02	35363056	35365439	BnaA02T0388900ZY	0	+	474	2311	2383	0.9697860
zheyou73v0_A02	35366885	35369775	BnaA02T0389000ZY	0	+	1190	2885	2890	0.9982699
zheyou73v0_A02	35370587	35371609	BnaA02T0389100ZY	0	+	535	1022	1022	1.0000000
zheyou73v0_A02	35391020	35391365	BnaA02T0389200ZY	0	+	38	217	345	0.6289855
zheyou73v0_A02	35393465	35395190	BnaA02T0389300ZY	0	-	443	1692	1725	0.9808696
zheyou73v0_A02	35395334	35397960	BnaA02T0389400ZY	0	+	481	2501	2626	0.9523991
zheyou73v0_A02	35399948	35400770	BnaA02T0389500ZY	0	+	79	610	822	0.7420924
zheyou73v0_A02	35405481	35405925	BnaA02T0389600ZY	0	+	8	104	444	0.2342342
zheyou73v0_A02	35407020	35409650	BnaA02T0389700ZY	0	+	623	2139	2630	0.8133080
zheyou73v0_A02	35413387	35416177	BnaA02T0389800ZY	0	-	294	1860	2790	0.6666667
zheyou73v0_A02	35413387	35416728	BnaA02T0389800ZY.1	0	-	322	2269	3341	0.6791380
zheyou73v0_A02	35413387	35416177	BnaA02T0389800ZY.2	0	-	294	1860	2790	0.6666667
zheyou73v0_A02	35421351	35424915	BnaA02T0389900ZY	0	-	845	3426	3564	0.9612795
zheyou73v0_A02	35428727	35428937	BnaA02T0390000ZY	0	+	42	210	210	1.0000000
zheyou73v0_A02	35444128	35444557	BnaA02T0390100ZY	0	+	0	0	429	0.0000000
zheyou73v0_A02	35447612	35454428	BnaA02T0390200ZY	0	+	387	4367	6816	0.6406984
zheyou73v0_A02	35465212	35465575	BnaA02T0390300ZY	0	-	4	241	363	0.6639118
zheyou73v0_A02	35465700	35466443	BnaA02T0390400ZY	0	-	48	714	743	0.9609690
zheyou73v0_A02	35474898	35475878	BnaA02T0390500ZY	0	+	302	965	980	0.9846939
zheyou73v0_A02	35476870	35479057	BnaA02T0390600ZY	0	-	823	2171	2187	0.9926841
zheyou73v0_A02	35480308	35480766	BnaA02T0390700ZY	0	-	205	458	458	1.0000000
zheyou73v0_A02	35482438	35485253	BnaA02T0390800ZY	0	-	392	2473	2815	0.8785080
zheyou73v0_A02	35493440	35508156	BnaA02T0390900ZY	0	+	3306	13136	14716	0.8926339
zheyou73v0_A02	35507871	35513958	BnaA02T0391000ZY	0	-	999	5596	6087	0.9193363
zheyou73v0_A02	35516294	35517094	BnaA02T0391100ZY	0	-	11	213	800	0.2662500
zheyou73v0_A02	35520289	35524265	BnaA02T0391200ZY	0	-	852	3683	3976	0.9263079
zheyou73v0_A02	35529779	35530235	BnaA02T0391300ZY	0	-	3	66	456	0.1447368
zheyou73v0_A02	35530842	35531674	BnaA02T0391400ZY	0	-	66	698	832	0.8389423
zheyou73v0_A02	35533516	35537463	BnaA02T0391500ZY	0	+	1156	3947	3947	1.0000000
zheyou73v0_A02	35541633	35541996	BnaA02T0391600ZY	0	+	94	363	363	1.0000000
zheyou73v0_A02	35547379	35548030	BnaA02T0391700ZY	0	-	71	626	651	0.9615976
zheyou73v0_A02	35549597	35551855	BnaA02T0391800ZY	0	+	814	2239	2258	0.9915855
zheyou73v0_A02	35604081	35604559	BnaA02T0391900ZY	0	-	84	356	478	0.7447699
zheyou73v0_A02	35607023	35607569	BnaA02T0392000ZY	0	-	58	362	546	0.6630037
zheyou73v0_A02	35608629	35609160	BnaA02T0392100ZY	0	-	46	286	531	0.5386064
zheyou73v0_A02	35610937	35614408	BnaA02T0392200ZY	0	-	405	2867	3471	0.8259867
zheyou73v0_A02	35615672	35617051	BnaA02T0392300ZY	0	-	216	1173	1379	0.8506164
zheyou73v0_A02	35620022	35623392	BnaA02T0392400ZY	0	+	758	3255	3370	0.9658754
zheyou73v0_A02	35624621	35626491	BnaA02T0392500ZY	0	-	569	1714	1870	0.9165775
zheyou73v0_A02	35636741	35638889	BnaA02T0392600ZY	0	+	44	1173	2148	0.5460894
zheyou73v0_A02	35660869	35662061	BnaA02T0392700ZY	0	+	72	615	1192	0.5159396
zheyou73v0_A02	35664144	35665510	BnaA02T0392800ZY	0	-	242	1115	1366	0.8162518
zheyou73v0_A02	35672065	35672236	BnaA02T0392900ZY	0	+	72	171	171	1.0000000
zheyou73v0_A02	35673318	35679651	BnaA02T0393000ZY	0	+	915	5811	6333	0.9175746
zheyou73v0_A02	35680151	35680802	BnaA02T0393100ZY	0	+	16	110	651	0.1689708
zheyou73v0_A02	35682411	35684964	BnaA02T0393200ZY	0	+	171	2066	2553	0.8092440
zheyou73v0_A02	35691453	35695541	BnaA02T0393300ZY	0	-	1015	4050	4088	0.9907045
zheyou73v0_A02	35697205	35700077	BnaA02T0393400ZY	0	+	329	2547	2872	0.8868384
zheyou73v0_A02	35701951	35703198	BnaA02T0393500ZY	0	+	100	860	1247	0.6896552
zheyou73v0_A02	35705345	35705901	BnaA02T0393600ZY	0	+	180	556	556	1.0000000
zheyou73v0_A02	35711263	35715213	BnaA02T0393700ZY	0	+	322	3394	3950	0.8592405
zheyou73v0_A02	35715438	35716278	BnaA02T0393800ZY	0	-	27	459	840	0.5464286
zheyou73v0_A02	35717260	35717697	BnaA02T0393900ZY	0	+	38	322	437	0.7368421
zheyou73v0_A02	35717834	35719428	BnaA02T0394000ZY	0	-	883	1594	1594	1.0000000
zheyou73v0_A02	35717834	35719428	BnaA02T0394000ZY.1	0	-	883	1594	1594	1.0000000
zheyou73v0_A02	35724732	35725938	BnaA02T0394100ZY	0	-	86	702	1206	0.5820895
zheyou73v0_A02	35764826	35767623	BnaA02T0394200ZY	0	+	1719	2797	2797	1.0000000
zheyou73v0_A02	35768407	35770409	BnaA02T0394300ZY	0	+	1835	2002	2002	1.0000000
zheyou73v0_A02	35771959	35774024	BnaA02T0394400ZY	0	+	476	1715	2065	0.8305085
zheyou73v0_A02	35774759	35775434	BnaA02T0394500ZY	0	+	318	675	675	1.0000000
zheyou73v0_A02	35775710	35779682	BnaA02T0394600ZY	0	-	663	3534	3972	0.8897281
zheyou73v0_A02	35784995	35799602	BnaA02T0394700ZY	0	+	6805	14485	14607	0.9916478
zheyou73v0_A02	35802990	35810552	BnaA02T0394800ZY	0	+	1149	4976	7562	0.6580270
zheyou73v0_A02	35803823	35804785	BnaA02T0394900ZY	0	+	4	206	962	0.2141372
zheyou73v0_A02	35812177	35815398	BnaA02T0395000ZY	0	+	1304	3187	3221	0.9894443
zheyou73v0_A02	35816463	35817913	BnaA02T0395100ZY	0	+	338	1450	1450	1.0000000
zheyou73v0_A02	35835186	35837447	BnaA02T0395200ZY	0	+	351	2018	2261	0.8925254
zheyou73v0_A02	35854147	35857019	BnaA02T0395300ZY	0	+	396	2021	2872	0.7036908
zheyou73v0_A02	35867187	35869529	BnaA02T0395400ZY	0	+	356	1626	2342	0.6942784
zheyou73v0_A02	35870882	35874159	BnaA02T0395500ZY	0	-	599	2106	3277	0.6426610
zheyou73v0_A02	35870882	35874159	BnaA02T0395500ZY.1	0	-	599	2106	3277	0.6426610
zheyou73v0_A02	35870882	35874159	BnaA02T0395500ZY.2	0	-	599	2106	3277	0.6426610
zheyou73v0_A02	35870882	35874159	BnaA02T0395500ZY.3	0	-	599	2106	3277	0.6426610
zheyou73v0_A02	35870882	35874159	BnaA02T0395500ZY.4	0	-	599	2106	3277	0.6426610
zheyou73v0_A02	35870882	35874159	BnaA02T0395500ZY.5	0	-	599	2106	3277	0.6426610
zheyou73v0_A02	35870882	35874159	BnaA02T0395500ZY.6	0	-	599	2106	3277	0.6426610
zheyou73v0_A02	35875960	35876979	BnaA02T0395600ZY	0	+	500	1019	1019	1.0000000
zheyou73v0_A02	35877080	35878739	BnaA02T0395700ZY	0	+	285	1302	1659	0.7848101
zheyou73v0_A02	35879429	35882124	BnaA02T0395800ZY	0	+	496	2493	2695	0.9250464
zheyou73v0_A02	35882446	35883901	BnaA02T0395900ZY	0	-	189	1217	1455	0.8364261
zheyou73v0_A02	35887248	35887675	BnaA02T0396000ZY	0	-	3	207	427	0.4847775
zheyou73v0_A02	35897503	35898978	BnaA02T0396100ZY	0	+	382	1456	1475	0.9871187
zheyou73v0_A02	35903944	35904790	BnaA02T0396200ZY	0	-	219	846	846	1.0000000
zheyou73v0_A02	35910861	35912076	BnaA02T0396300ZY	0	-	69	512	1215	0.4213992
zheyou73v0_A02	35913236	35917161	BnaA02T0396400ZY	0	+	507	2587	3925	0.6591083
zheyou73v0_A02	35921795	35923776	BnaA02T0396500ZY	0	+	434	1704	1981	0.8601716
zheyou73v0_A02	35924399	35925600	BnaA02T0396600ZY	0	-	232	979	1201	0.8151540
zheyou73v0_A02	35966171	35966971	BnaA02T0396700ZY	0	-	199	800	800	1.0000000
zheyou73v0_A02	35976495	35978653	BnaA02T0396800ZY	0	+	563	2120	2158	0.9823911
zheyou73v0_A02	35978909	35981066	BnaA02T0396900ZY	0	+	305	1354	2157	0.6277237
zheyou73v0_A02	35982097	35984206	BnaA02T0397000ZY	0	-	373	1884	2109	0.8933144
zheyou73v0_A02	35989123	35991008	BnaA02T0397100ZY	0	-	311	1815	1885	0.9628647
zheyou73v0_A02	36013431	36013941	BnaA02T0397200ZY	0	+	102	510	510	1.0000000
zheyou73v0_A02	36020826	36026216	BnaA02T0397300ZY	0	+	792	4515	5390	0.8376623
zheyou73v0_A02	36034128	36035869	BnaA02T0397400ZY	0	+	159	1257	1741	0.7219989
zheyou73v0_A02	36035947	36036803	BnaA02T0397500ZY	0	-	18	389	856	0.4544393
zheyou73v0_A02	36048967	36049261	BnaA02T0397600ZY	0	-	264	294	294	1.0000000
zheyou73v0_A02	36050085	36051038	BnaA02T0397700ZY	0	-	26	512	953	0.5372508
zheyou73v0_A02	36053450	36058211	BnaA02T0397800ZY	0	-	666	3880	4761	0.8149548
zheyou73v0_A02	36059051	36061107	BnaA02T0397900ZY	0	-	153	828	2056	0.4027237
zheyou73v0_A02	36065901	36066369	BnaA02T0398000ZY	0	-	19	103	468	0.2200855
zheyou73v0_A02	36067448	36070002	BnaA02T0398100ZY	0	-	548	2436	2554	0.9537979
zheyou73v0_A02	36072797	36073896	BnaA02T0398200ZY	0	+	499	1099	1099	1.0000000
zheyou73v0_A02	36076372	36084023	BnaA02T0398300ZY	0	+	1935	7052	7651	0.9217096
zheyou73v0_A02	36084606	36086720	BnaA02T0398400ZY	0	+	504	2063	2114	0.9758751
zheyou73v0_A02	36100408	36101116	BnaA02T0398500ZY	0	+	218	708	708	1.0000000
zheyou73v0_A02	36103318	36105039	BnaA02T0398600ZY	0	+	86	1260	1721	0.7321325
zheyou73v0_A02	36109739	36110117	BnaA02T0398700ZY	0	-	398	378	378	1.0000000
zheyou73v0_A02	36134234	36135750	BnaA02T0398800ZY	0	+	569	1511	1516	0.9967018
zheyou73v0_A02	36138266	36139440	BnaA02T0398900ZY	0	+	298	1017	1174	0.8662692
zheyou73v0_A02	36141852	36144006	BnaA02T0399000ZY	0	-	976	2154	2154	1.0000000
zheyou73v0_A02	36156295	36156514	BnaA02T0399100ZY	0	+	96	219	219	1.0000000
zheyou73v0_A02	36158566	36165040	BnaA02T0399200ZY	0	+	1408	6303	6474	0.9735867
zheyou73v0_A02	36158566	36164798	BnaA02T0399200ZY.1	0	+	1267	6061	6232	0.9725610
zheyou73v0_A02	36166123	36167397	BnaA02T0399300ZY	0	-	106	879	1274	0.6899529
zheyou73v0_A02	36177034	36178283	BnaA02T0399400ZY	0	+	535	1249	1249	1.0000000
zheyou73v0_A02	36180366	36186568	BnaA02T0399500ZY	0	+	1886	5606	6202	0.9039020
zheyou73v0_A02	36188161	36190545	BnaA02T0399600ZY	0	+	309	1902	2384	0.7978188
zheyou73v0_A02	36192125	36192419	BnaA02T0399700ZY	0	+	29	230	294	0.7823129
zheyou73v0_A02	36194459	36196077	BnaA02T0399800ZY	0	-	127	1499	1618	0.9264524
zheyou73v0_A02	36198129	36198576	BnaA02T0399900ZY	0	-	55	404	447	0.9038031
zheyou73v0_A02	36202627	36204406	BnaA02T0400000ZY	0	+	11	200	1779	0.1124227
zheyou73v0_A02	36214188	36220903	BnaA02T0400100ZY	0	+	408	4549	6715	0.6774386
zheyou73v0_A02	36224672	36226577	BnaA02T0400200ZY	0	+	583	1904	1905	0.9994751
zheyou73v0_A02	36233645	36234194	BnaA02T0400300ZY	0	+	224	549	549	1.0000000
zheyou73v0_A02	36235841	36236992	BnaA02T0400400ZY	0	-	341	1029	1151	0.8940052
zheyou73v0_A02	36241078	36242858	BnaA02T0400500ZY	0	-	1124	1780	1780	1.0000000
zheyou73v0_A02	36259071	36260478	BnaA02T0400600ZY	0	+	104	967	1407	0.6872779
zheyou73v0_A02	36263489	36263940	BnaA02T0400700ZY	0	+	339	451	451	1.0000000
zheyou73v0_A02	36268748	36270852	BnaA02T0400800ZY	0	+	570	2066	2104	0.9819391
zheyou73v0_A02	36271079	36274723	BnaA02T0400900ZY	0	-	761	3241	3644	0.8894072
zheyou73v0_A02	36309831	36310200	BnaA02T0401000ZY	0	+	122	369	369	1.0000000
zheyou73v0_A02	36310746	36311058	BnaA02T0401100ZY	0	-	171	215	312	0.6891026
zheyou73v0_A02	36313388	36313942	BnaA02T0401200ZY	0	-	218	554	554	1.0000000
zheyou73v0_A02	36318853	36319739	BnaA02T0401300ZY	0	+	678	657	886	0.7415350
zheyou73v0_A02	36320104	36320875	BnaA02T0401400ZY	0	-	158	594	771	0.7704280
zheyou73v0_A02	36325132	36328211	BnaA02T0401500ZY	0	-	286	1502	3079	0.4878207
zheyou73v0_A02	36328558	36330320	BnaA02T0401600ZY	0	+	479	1643	1762	0.9324631
zheyou73v0_A02	36330685	36333463	BnaA02T0401700ZY	0	+	3847	2778	2778	1.0000000
zheyou73v0_A02	36334721	36336991	BnaA02T0401800ZY	0	-	1592	2270	2270	1.0000000
zheyou73v0_A02	36338883	36356825	BnaA02T0401900ZY	0	-	10155	17136	17942	0.9550775
zheyou73v0_A02	36370614	36373859	BnaA02T0402000ZY	0	+	447	2579	3245	0.7947612
zheyou73v0_A02	36373491	36375535	BnaA02T0402100ZY	0	-	381	1855	2044	0.9075342
zheyou73v0_A02	36378241	36379864	BnaA02T0402200ZY	0	-	440	1434	1623	0.8835490
zheyou73v0_A02	36381692	36382305	BnaA02T0402300ZY	0	-	109	414	613	0.6753671
zheyou73v0_A02	36396560	36400158	BnaA02T0402400ZY	0	+	2467	3598	3598	1.0000000
zheyou73v0_A02	36407874	36415146	BnaA02T0402500ZY	0	+	6933	7248	7272	0.9966997
zheyou73v0_A02	36421537	36424690	BnaA02T0402600ZY	0	+	533	2450	3153	0.7770377
zheyou73v0_A02	36433349	36434600	BnaA02T0402700ZY	0	+	214	418	1251	0.3341327
zheyou73v0_A02	36439625	36442508	BnaA02T0402800ZY	0	+	624	2576	2883	0.8935137
zheyou73v0_A02	36448642	36448918	BnaA02T0402900ZY	0	+	244	276	276	1.0000000
zheyou73v0_A02	36450092	36453974	BnaA02T0403000ZY	0	+	1252	3180	3882	0.8191653
zheyou73v0_A02	36456483	36457346	BnaA02T0403100ZY	0	+	699	863	863	1.0000000
zheyou73v0_A02	36469977	36471342	BnaA02T0403200ZY	0	+	505	1139	1365	0.8344322
zheyou73v0_A02	36473688	36481021	BnaA02T0403300ZY	0	+	2067	6720	7333	0.9164053
zheyou73v0_A02	36485487	36485646	BnaA02T0403400ZY	0	+	76	159	159	1.0000000
zheyou73v0_A02	36485726	36488518	BnaA02T0403500ZY	0	+	164	1753	2792	0.6278653
zheyou73v0_A02	36489287	36497155	BnaA02T0403600ZY	0	+	1009	3168	7868	0.4026436
zheyou73v0_A02	36501268	36501510	BnaA02T0403700ZY	0	+	200	242	242	1.0000000
zheyou73v0_A02	36501627	36504153	BnaA02T0403800ZY	0	-	2061	2526	2526	1.0000000
zheyou73v0_A02	36504846	36507258	BnaA02T0403900ZY	0	-	1383	2412	2412	1.0000000
zheyou73v0_A02	36509456	36513751	BnaA02T0404000ZY	0	+	923	3042	4295	0.7082654
zheyou73v0_A02	36509456	36513751	BnaA02T0404000ZY.1	0	+	923	3042	4295	0.7082654
zheyou73v0_A02	36514383	36515098	BnaA02T0404100ZY	0	+	360	715	715	1.0000000
zheyou73v0_A02	36519271	36521270	BnaA02T0404200ZY	0	+	1471	1999	1999	1.0000000
zheyou73v0_A02	36519271	36521270	BnaA02T0404200ZY.1	0	+	1471	1999	1999	1.0000000
zheyou73v0_A02	36530597	36532828	BnaA02T0404300ZY	0	-	369	2042	2231	0.9152846
zheyou73v0_A02	36535668	36536428	BnaA02T0404400ZY	0	-	118	715	760	0.9407895
zheyou73v0_A02	36537836	36540207	BnaA02T0404500ZY	0	-	2025	2356	2371	0.9936736
zheyou73v0_A02	36537836	36540207	BnaA02T0404500ZY.1	0	-	2025	2356	2371	0.9936736
zheyou73v0_A02	36543326	36544106	BnaA02T0404600ZY	0	+	258	780	780	1.0000000
zheyou73v0_A02	36544469	36548557	BnaA02T0404700ZY.2	0	-	869	3223	4088	0.7884051
zheyou73v0_A02	36544473	36548557	BnaA02T0404700ZY	0	-	867	3219	4084	0.7881979
zheyou73v0_A02	36544473	36548557	BnaA02T0404700ZY.1	0	-	867	3219	4084	0.7881979
zheyou73v0_A02	36544473	36548557	BnaA02T0404700ZY.3	0	-	867	3219	4084	0.7881979
zheyou73v0_A02	36558869	36559512	BnaA02T0404800ZY	0	+	777	643	643	1.0000000
zheyou73v0_A02	36560757	36561705	BnaA02T0404900ZY	0	+	906	937	948	0.9883966
zheyou73v0_A02	36565907	36571585	BnaA02T0405000ZY	0	-	1179	3507	5678	0.6176471
zheyou73v0_A02	36589289	36590184	BnaA02T0405100ZY	0	+	661	820	895	0.9162011
zheyou73v0_A02	36590949	36591998	BnaA02T0405200ZY	0	-	289	731	1049	0.6968542
zheyou73v0_A02	36614747	36618549	BnaA02T0405300ZY	0	-	1228	2860	3802	0.7522357
zheyou73v0_A02	36644155	36644854	BnaA02T0405400ZY	0	+	2	150	699	0.2145923
zheyou73v0_A02	36655004	36656525	BnaA02T0405500ZY	0	+	464	1312	1521	0.8625904
zheyou73v0_A02	36659471	36660709	BnaA02T0405600ZY	0	-	574	1122	1238	0.9063005
zheyou73v0_A02	36668608	36672532	BnaA02T0405700ZY	0	+	1782	3524	3924	0.8980632
zheyou73v0_A02	36681644	36683051	BnaA02T0405800ZY	0	-	624	1350	1407	0.9594883
zheyou73v0_A02	36691769	36695456	BnaA02T0405900ZY	0	-	4198	3618	3687	0.9812856
zheyou73v0_A02	36700331	36700788	BnaA02T0406000ZY	0	-	342	457	457	1.0000000
zheyou73v0_A02	36701466	36708457	BnaA02T0406100ZY	0	-	2087	6368	6991	0.9108855
zheyou73v0_A02	36711282	36712348	BnaA02T0406200ZY	0	-	56	687	1066	0.6444653
zheyou73v0_A02	36716708	36719056	BnaA02T0406300ZY	0	+	616	2172	2348	0.9250426
zheyou73v0_A02	36716708	36719056	BnaA02T0406300ZY.1	0	+	616	2172	2348	0.9250426
zheyou73v0_A02	36719476	36722113	BnaA02T0406400ZY	0	-	542	2385	2637	0.9044369
zheyou73v0_A02	36723737	36726181	BnaA02T0406500ZY	0	-	1676	2444	2444	1.0000000
zheyou73v0_A02	36733338	36734390	BnaA02T0406600ZY	0	-	483	1052	1052	1.0000000
zheyou73v0_A02	36735075	36735687	BnaA02T0406700ZY	0	-	101	540	612	0.8823529
zheyou73v0_A02	36738124	36742731	BnaA02T0406800ZY	0	-	2031	4064	4607	0.8821359
zheyou73v0_A02	36743511	36745606	BnaA02T0406900ZY	0	-	717	2053	2095	0.9799523
zheyou73v0_A02	36746179	36759100	BnaA02T0407000ZY	0	+	4833	9364	12921	0.7247117
zheyou73v0_A02	36763933	36767717	BnaA02T0407100ZY	0	-	1735	3746	3784	0.9899577
zheyou73v0_A02	36769096	36769693	BnaA02T0407200ZY	0	+	83	505	597	0.8458961
zheyou73v0_A02	36776683	36779802	BnaA02T0407300ZY	0	+	635	2882	3119	0.9240141
zheyou73v0_A02	36776683	36779802	BnaA02T0407300ZY.1	0	+	635	2882	3119	0.9240141
zheyou73v0_A02	36776683	36779802	BnaA02T0407300ZY.2	0	+	635	2882	3119	0.9240141
zheyou73v0_A02	36780642	36782912	BnaA02T0407400ZY	0	+	868	2252	2270	0.9920705
zheyou73v0_A02	36780973	36782912	BnaA02T0407400ZY.1	0	+	668	1921	1939	0.9907169
zheyou73v0_A02	36783054	36785602	BnaA02T0407500ZY	0	-	1531	2548	2548	1.0000000
zheyou73v0_A02	36786679	36787189	BnaA02T0407600ZY	0	-	248	469	510	0.9196078
zheyou73v0_A02	36787811	36788462	BnaA02T0407700ZY	0	+	779	651	651	1.0000000
zheyou73v0_A02	36788476	36789296	BnaA02T0407800ZY	0	+	593	820	820	1.0000000
zheyou73v0_A02	36790319	36791480	BnaA02T0407900ZY	0	+	658	1161	1161	1.0000000
zheyou73v0_A02	36793174	36794097	BnaA02T0408000ZY	0	+	1013	923	923	1.0000000
zheyou73v0_A02	36801164	36802066	BnaA02T0408100ZY	0	+	73	680	902	0.7538803
zheyou73v0_A02	36802335	36803499	BnaA02T0408200ZY	0	-	259	937	1164	0.8049828
zheyou73v0_A02	36808448	36809338	BnaA02T0408300ZY	0	+	28	461	890	0.5179775
zheyou73v0_A02	36810325	36814052	BnaA02T0408400ZY	0	-	579	2325	3727	0.6238261
zheyou73v0_A02	36817014	36820629	BnaA02T0408500ZY	0	-	683	2924	3615	0.8088520
zheyou73v0_A02	36826081	36828716	BnaA02T0408600ZY	0	-	1127	2076	2635	0.7878558
zheyou73v0_A02	36833833	36834535	BnaA02T0408700ZY	0	-	240	635	702	0.9045584
zheyou73v0_A02	36835277	36838188	BnaA02T0408800ZY	0	-	344	2187	2911	0.7512882
zheyou73v0_A02	36849504	36850792	BnaA02T0408900ZY	0	+	340	1288	1288	1.0000000
zheyou73v0_A02	36866297	36873501	BnaA02T0409000ZY	0	+	2191	5258	7204	0.7298723
zheyou73v0_A02	36878582	36880142	BnaA02T0409100ZY	0	+	817	1523	1560	0.9762821
zheyou73v0_A02	36878582	36880142	BnaA02T0409100ZY.1	0	+	817	1523	1560	0.9762821
zheyou73v0_A02	36878582	36880142	BnaA02T0409100ZY.2	0	+	817	1523	1560	0.9762821
zheyou73v0_A02	36885757	36891045	BnaA02T0409200ZY	0	+	818	4732	5288	0.8948563
zheyou73v0_A02	36891910	36894522	BnaA02T0409300ZY	0	-	1195	2434	2612	0.9318530
zheyou73v0_A02	36895675	36898673	BnaA02T0409400ZY	0	-	1740	2910	2998	0.9706471
zheyou73v0_A02	36904265	36906835	BnaA02T0409500ZY	0	+	546	2096	2570	0.8155642
zheyou73v0_A02	36907118	36912703	BnaA02T0409600ZY	0	-	1642	5270	5585	0.9435989
zheyou73v0_A02	36913659	36916775	BnaA02T0409700ZY	0	-	3260	2807	3116	0.9008344
zheyou73v0_A02	36924578	36925634	BnaA02T0409800ZY	0	-	320	982	1056	0.9299242
zheyou73v0_A02	36929096	36932754	BnaA02T0409900ZY	0	-	1649	3658	3658	1.0000000
zheyou73v0_A02	36935451	36938508	BnaA02T0410000ZY	0	-	712	2526	3057	0.8263003
zheyou73v0_A02	36935451	36938510	BnaA02T0410000ZY.1	0	-	718	2528	3059	0.8264139
zheyou73v0_A02	36939793	36950381	BnaA02T0410100ZY	0	+	2558	9513	10588	0.8984700
zheyou73v0_A02	36939793	36950381	BnaA02T0410100ZY.1	0	+	2558	9513	10588	0.8984700
zheyou73v0_A02	36939793	36944436	BnaA02T0410100ZY.2	0	+	942	4026	4643	0.8671118
zheyou73v0_A02	36950543	36956262	BnaA02T0410200ZY	0	-	1352	4886	5719	0.8543451
zheyou73v0_A02	36950543	36954802	BnaA02T0410200ZY.1	0	-	643	3436	4259	0.8067622
zheyou73v0_A02	36969207	36973074	BnaA02T0410300ZY	0	+	1644	3377	3867	0.8732868
zheyou73v0_A02	36974349	36980049	BnaA02T0410400ZY	0	+	1449	4817	5700	0.8450877
zheyou73v0_A02	36974349	36980049	BnaA02T0410400ZY.1	0	+	1449	4817	5700	0.8450877
zheyou73v0_A02	36985182	36985938	BnaA02T0410500ZY	0	+	378	756	756	1.0000000
zheyou73v0_A02	36986185	36987104	BnaA02T0410600ZY	0	+	139	919	919	1.0000000
zheyou73v0_A02	37000179	37004698	BnaA02T0410700ZY	0	+	2503	4467	4519	0.9884930
zheyou73v0_A02	37000179	37004698	BnaA02T0410700ZY.1	0	+	2503	4467	4519	0.9884930
zheyou73v0_A02	37033139	37034816	BnaA02T0410800ZY	0	-	585	1657	1677	0.9880739
zheyou73v0_A02	37037509	37039236	BnaA02T0410900ZY	0	+	230	1106	1727	0.6404169
zheyou73v0_A02	37037509	37039236	BnaA02T0410900ZY.1	0	+	230	1106	1727	0.6404169
zheyou73v0_A02	37039288	37044594	BnaA02T0411000ZY	0	-	731	3769	5306	0.7103279
zheyou73v0_A02	37056892	37059561	BnaA02T0411100ZY	0	-	1153	2426	2669	0.9089547
zheyou73v0_A02	37061739	37063221	BnaA02T0411200ZY	0	-	435	1285	1482	0.8670715
zheyou73v0_A02	37066985	37071685	BnaA02T0411300ZY	0	+	957	3542	4700	0.7536170
zheyou73v0_A02	37083561	37085031	BnaA02T0411400ZY	0	+	293	1234	1470	0.8394558
zheyou73v0_A02	37086210	37086601	BnaA02T0411500ZY	0	+	184	391	391	1.0000000
zheyou73v0_A02	37094313	37097648	BnaA02T0411600ZY	0	+	16	465	3335	0.1394303
zheyou73v0_A02	37094313	37097648	BnaA02T0411600ZY.1	0	+	16	465	3335	0.1394303
zheyou73v0_A02	37094313	37097295	BnaA02T0411600ZY.2	0	+	16	465	2982	0.1559356
zheyou73v0_A02	37094313	37097295	BnaA02T0411600ZY.3	0	+	16	465	2982	0.1559356
zheyou73v0_A02	37097934	37098192	BnaA02T0411700ZY	0	-	0	0	258	0.0000000
zheyou73v0_A02	37098491	37099036	BnaA02T0411800ZY	0	-	3	113	545	0.2073395
zheyou73v0_A02	37101386	37103017	BnaA02T0411900ZY	0	-	0	0	1631	0.0000000
zheyou73v0_A02	37103921	37104877	BnaA02T0412000ZY	0	-	34	393	956	0.4110879
zheyou73v0_A02	37109280	37112614	BnaA02T0412100ZY	0	+	0	0	3334	0.0000000
zheyou73v0_A02	37109280	37112614	BnaA02T0412100ZY.1	0	+	0	0	3334	0.0000000
zheyou73v0_A02	37109280	37112261	BnaA02T0412100ZY.2	0	+	0	0	2981	0.0000000
zheyou73v0_A02	37109280	37112261	BnaA02T0412100ZY.3	0	+	0	0	2981	0.0000000
zheyou73v0_A02	37112900	37113158	BnaA02T0412200ZY	0	-	0	0	258	0.0000000
zheyou73v0_A02	37113457	37114002	BnaA02T0412300ZY	0	-	1	95	545	0.1743119
zheyou73v0_A02	37116352	37117983	BnaA02T0412400ZY	0	-	0	0	1631	0.0000000
zheyou73v0_A02	37118887	37119843	BnaA02T0412500ZY	0	-	94	342	956	0.3577406
zheyou73v0_A02	37120383	37120800	BnaA02T0412600ZY	0	-	48	338	417	0.8105516
zheyou73v0_A02	37147800	37148628	BnaA02T0412700ZY	0	-	210	733	828	0.8852657
zheyou73v0_A02	37151186	37155388	BnaA02T0412800ZY	0	-	1458	4153	4202	0.9883389
zheyou73v0_A02	37156110	37161582	BnaA02T0412900ZY	0	-	1688	4899	5472	0.8952851
zheyou73v0_A02	37162426	37163903	BnaA02T0413000ZY	0	-	633	1434	1477	0.9708869
zheyou73v0_A02	37171867	37173847	BnaA02T0413100ZY	0	+	564	1884	1980	0.9515151
zheyou73v0_A02	37174714	37175924	BnaA02T0413200ZY	0	+	399	1205	1210	0.9958678
zheyou73v0_A02	37182534	37183467	BnaA02T0413300ZY	0	+	78	409	933	0.4383709
zheyou73v0_A02	37184882	37186871	BnaA02T0413400ZY	0	+	1106	1989	1989	1.0000000
zheyou73v0_A02	37188943	37199423	BnaA02T0413500ZY	0	+	2016	8247	10480	0.7869275
zheyou73v0_A02	37199716	37200370	BnaA02T0413600ZY	0	+	106	626	654	0.9571865
zheyou73v0_A02	37204165	37205024	BnaA02T0413700ZY	0	+	287	751	859	0.8742724
zheyou73v0_A02	37211500	37213448	BnaA02T0413800ZY	0	+	1243	1948	1948	1.0000000
zheyou73v0_A02	37232639	37233005	BnaA02T0413900ZY	0	+	219	366	366	1.0000000
zheyou73v0_A02	37237075	37238745	BnaA02T0414000ZY	0	+	502	1425	1670	0.8532934
zheyou73v0_A02	37242919	37244619	BnaA02T0414100ZY	0	-	1126	1595	1700	0.9382353
zheyou73v0_A02	37247648	37248949	BnaA02T0414200ZY	0	-	510	1275	1301	0.9800154
zheyou73v0_A02	37249666	37251758	BnaA02T0414300ZY	0	+	1553	2021	2092	0.9660612
zheyou73v0_A02	37249666	37251758	BnaA02T0414300ZY.1	0	+	1553	2021	2092	0.9660612
zheyou73v0_A02	37249666	37251758	BnaA02T0414300ZY.2	0	+	1553	2021	2092	0.9660612
zheyou73v0_A02	37256225	37258018	BnaA02T0414400ZY	0	-	651	1757	1793	0.9799219
zheyou73v0_A02	37270954	37272875	BnaA02T0414500ZY	0	+	638	1438	1921	0.7485685
zheyou73v0_A02	37273481	37274701	BnaA02T0414600ZY	0	+	715	1220	1220	1.0000000
zheyou73v0_A02	37275553	37277649	BnaA02T0414700ZY	0	+	549	1802	2096	0.8597328
zheyou73v0_A02	37282200	37284174	BnaA02T0414800ZY	0	+	631	1798	1974	0.9108409
zheyou73v0_A02	37284875	37285624	BnaA02T0414900ZY	0	-	137	640	749	0.8544726
zheyou73v0_A02	37286523	37287736	BnaA02T0415000ZY	0	+	484	1116	1213	0.9200330
zheyou73v0_A02	37290767	37291100	BnaA02T0415100ZY	0	+	522	333	333	1.0000000
zheyou73v0_A02	37307940	37326745	BnaA02T0415200ZY	0	+	4907	15118	18805	0.8039351
zheyou73v0_A02	37329070	37330696	BnaA02T0415300ZY	0	+	367	1442	1626	0.8868389
zheyou73v0_A02	37331937	37332147	BnaA02T0415400ZY	0	-	80	210	210	1.0000000
zheyou73v0_A02	37339913	37341678	BnaA02T0415500ZY	0	-	52	1120	1765	0.6345609
zheyou73v0_A02	37340251	37341678	BnaA02T0415500ZY.1	0	-	52	1067	1427	0.7477225
zheyou73v0_A02	37342921	37344112	BnaA02T0415600ZY	0	+	32	463	1191	0.3887489
zheyou73v0_A02	37357834	37358606	BnaA02T0415700ZY	0	+	493	766	772	0.9922280
zheyou73v0_A02	37361283	37361828	BnaA02T0415800ZY	0	+	774	545	545	1.0000000
zheyou73v0_A02	37363831	37365665	BnaA02T0415900ZY	0	+	887	1581	1834	0.8620502
zheyou73v0_A02	37363831	37365929	BnaA02T0415900ZY.1	0	+	891	1821	2098	0.8679695
zheyou73v0_A02	37363831	37365665	BnaA02T0415900ZY.2	0	+	887	1581	1834	0.8620502
zheyou73v0_A02	37363831	37365929	BnaA02T0415900ZY.3	0	+	891	1821	2098	0.8679695
zheyou73v0_A02	37377751	37380735	BnaA02T0416000ZY	0	+	950	2984	2984	1.0000000
zheyou73v0_A02	37381584	37382865	BnaA02T0416100ZY	0	+	1014	1275	1281	0.9953161
zheyou73v0_A02	37385134	37396150	BnaA02T0416200ZY	0	-	6698	9032	11016	0.8198983
zheyou73v0_A02	37397499	37399901	BnaA02T0416300ZY	0	-	890	2023	2402	0.8422148
zheyou73v0_A02	37397499	37399255	BnaA02T0416300ZY.1	0	-	814	1673	1756	0.9527335
zheyou73v0_A02	37403109	37404620	BnaA02T0416400ZY	0	-	193	941	1511	0.6227664
zheyou73v0_A02	37407711	37409219	BnaA02T0416500ZY	0	-	2190	1508	1508	1.0000000
zheyou73v0_A02	37410279	37412715	BnaA02T0416600ZY	0	+	1806	2371	2436	0.9733169
zheyou73v0_A02	37415085	37417273	BnaA02T0416700ZY	0	-	1700	2188	2188	1.0000000
zheyou73v0_A02	37424188	37425546	BnaA02T0416800ZY	0	-	436	1280	1358	0.9425626
zheyou73v0_A02	37426977	37429550	BnaA02T0416900ZY	0	-	866	2208	2573	0.8581423
zheyou73v0_A02	37426977	37429550	BnaA02T0416900ZY.1	0	-	866	2208	2573	0.8581423
zheyou73v0_A02	37426977	37429550	BnaA02T0416900ZY.2	0	-	866	2208	2573	0.8581423
zheyou73v0_A02	37430799	37431497	BnaA02T0417000ZY	0	-	429	655	698	0.9383954
zheyou73v0_A02	37433582	37434065	BnaA02T0417100ZY	0	+	161	483	483	1.0000000
zheyou73v0_A02	37436375	37437103	BnaA02T0417200ZY	0	-	64	508	728	0.6978022
zheyou73v0_A02	37441096	37442635	BnaA02T0417300ZY	0	-	1068	1430	1539	0.9291748
zheyou73v0_A02	37447809	37451802	BnaA02T0417400ZY	0	-	1266	3840	3993	0.9616829
zheyou73v0_A02	37452593	37454563	BnaA02T0417500ZY	0	+	365	1809	1970	0.9182741
zheyou73v0_A02	37455031	37455409	BnaA02T0417600ZY	0	+	2	56	378	0.1481481
zheyou73v0_A02	37458902	37459655	BnaA02T0417700ZY	0	+	585	753	753	1.0000000
zheyou73v0_A02	37461731	37462380	BnaA02T0417800ZY	0	+	35	460	649	0.7087827
zheyou73v0_A02	37462427	37465057	BnaA02T0417900ZY	0	-	674	2208	2630	0.8395437
zheyou73v0_A02	37472788	37475988	BnaA02T0418000ZY	0	+	1596	3143	3200	0.9821875
zheyou73v0_A02	37472788	37475988	BnaA02T0418000ZY.1	0	+	1596	3143	3200	0.9821875
zheyou73v0_A02	37481563	37483592	BnaA02T0418100ZY	0	+	1021	1636	2029	0.8063085
zheyou73v0_A02	37486565	37490163	BnaA02T0418200ZY	0	-	3256	3598	3598	1.0000000
zheyou73v0_A02	37496799	37499253	BnaA02T0418300ZY	0	-	895	2405	2454	0.9800326
zheyou73v0_A02	37506260	37508637	BnaA02T0418400ZY	0	+	414	2014	2377	0.8472865
zheyou73v0_A02	37514220	37514639	BnaA02T0418500ZY	0	+	156	419	419	1.0000000
zheyou73v0_A02	37515118	37517196	BnaA02T0418600ZY	0	-	649	1659	2078	0.7983638
zheyou73v0_A02	37518307	37518589	BnaA02T0418700ZY	0	+	24	282	282	1.0000000
zheyou73v0_A02	37518952	37520192	BnaA02T0418800ZY	0	+	485	1240	1240	1.0000000
zheyou73v0_A02	37521010	37521643	BnaA02T0418900ZY	0	-	809	633	633	1.0000000
zheyou73v0_A02	37522232	37524215	BnaA02T0419000ZY	0	-	828	1863	1983	0.9394856
zheyou73v0_A02	37525144	37525792	BnaA02T0419100ZY	0	+	161	648	648	1.0000000
zheyou73v0_A02	37527421	37530527	BnaA02T0419200ZY.1	0	+	654	2808	3106	0.9040567
zheyou73v0_A02	37528290	37530527	BnaA02T0419200ZY	0	+	449	1939	2237	0.8667859
zheyou73v0_A02	37528290	37530527	BnaA02T0419200ZY.2	0	+	449	1939	2237	0.8667859
zheyou73v0_A02	37530549	37531933	BnaA02T0419300ZY	0	-	530	1218	1384	0.8800578
zheyou73v0_A02	37535374	37540663	BnaA02T0419400ZY	0	+	815	4483	5289	0.8476083
zheyou73v0_A02	37550737	37552873	BnaA02T0419500ZY	0	+	324	1538	2136	0.7200375
zheyou73v0_A02	37555305	37558589	BnaA02T0419600ZY	0	-	1183	2813	3284	0.8565773
zheyou73v0_A02	37562078	37566087	BnaA02T0419700ZY	0	-	306	3631	4009	0.9057121
zheyou73v0_A02	37572685	37578199	BnaA02T0419800ZY	0	+	3335	4929	5514	0.8939064
zheyou73v0_A02	37580023	37583386	BnaA02T0419900ZY	0	+	1516	3057	3363	0.9090098
zheyou73v0_A02	37583741	37585606	BnaA02T0420000ZY	0	-	1747	1762	1865	0.9447721
zheyou73v0_A02	37591713	37593900	BnaA02T0420100ZY	0	+	1091	1984	2187	0.9071788
zheyou73v0_A02	37591713	37593246	BnaA02T0420100ZY.1	0	+	803	1330	1533	0.8675799
zheyou73v0_A02	37594231	37596442	BnaA02T0420200ZY	0	-	868	2211	2211	1.0000000
zheyou73v0_A02	37598332	37602318	BnaA02T0420300ZY	0	+	1600	3859	3986	0.9681385
zheyou73v0_A02	37602409	37603098	BnaA02T0420400ZY	0	-	81	614	689	0.8911466
zheyou73v0_A02	37604058	37611347	BnaA02T0420500ZY	0	-	3205	6254	7289	0.8580052
zheyou73v0_A02	37611645	37612995	BnaA02T0420600ZY	0	-	373	1237	1350	0.9162963
zheyou73v0_A02	37632844	37633609	BnaA02T0420700ZY	0	-	1679	765	765	1.0000000
zheyou73v0_A02	37635902	37637810	BnaA02T0420800ZY	0	+	991	1687	1908	0.8841719
zheyou73v0_A02	37638453	37640514	BnaA02T0420900ZY	0	-	751	1923	2061	0.9330422
zheyou73v0_A02	37641589	37643771	BnaA02T0421000ZY	0	+	350	1980	2182	0.9074244
zheyou73v0_A02	37641589	37643771	BnaA02T0421000ZY.1	0	+	350	1980	2182	0.9074244
zheyou73v0_A02	37652745	37653789	BnaA02T0421100ZY	0	+	31	589	1044	0.5641763
zheyou73v0_A02	37679803	37682529	BnaA02T0421200ZY	0	-	1245	2685	2726	0.9849597
zheyou73v0_A02	37684080	37684760	BnaA02T0421300ZY	0	+	203	680	680	1.0000000
zheyou73v0_A02	37685089	37687439	BnaA02T0421400ZY	0	-	357	2226	2350	0.9472340
zheyou73v0_A02	37688969	37689683	BnaA02T0421500ZY	0	-	197	714	714	1.0000000
zheyou73v0_A02	37689938	37690180	BnaA02T0421600ZY	0	-	202	242	242	1.0000000
zheyou73v0_A02	37693135	37694675	BnaA02T0421700ZY	0	-	632	1540	1540	1.0000000
zheyou73v0_A02	37695477	37701252	BnaA02T0421800ZY	0	-	1659	5300	5775	0.9177489
zheyou73v0_A02	37703628	37705390	BnaA02T0421900ZY	0	-	616	991	1762	0.5624291
zheyou73v0_A02	37706923	37711138	BnaA02T0422000ZY	0	+	567	3243	4215	0.7693950
zheyou73v0_A02	37706923	37711001	BnaA02T0422000ZY.1	0	+	543	3106	4078	0.7616479
zheyou73v0_A02	37723103	37724950	BnaA02T0422100ZY	0	+	234	1203	1847	0.6513265
zheyou73v0_A02	37726686	37731649	BnaA02T0422200ZY	0	-	409	2705	4963	0.5450332
zheyou73v0_A02	37733666	37736024	BnaA02T0422300ZY	0	-	87	1550	2358	0.6573367
zheyou73v0_A02	37737073	37740657	BnaA02T0422400ZY	0	-	305	2554	3584	0.7126116
zheyou73v0_A02	37745259	37746402	BnaA02T0422500ZY	0	-	329	1047	1143	0.9160105
zheyou73v0_A02	37751635	37753470	BnaA02T0422600ZY	0	-	527	1675	1835	0.9128065
zheyou73v0_A02	37754070	37754904	BnaA02T0422700ZY	0	+	58	783	834	0.9388489
zheyou73v0_A02	37758155	37761192	BnaA02T0422800ZY	0	+	634	2798	3037	0.9213039
zheyou73v0_A02	37761116	37761808	BnaA02T0422900ZY	0	-	257	692	692	1.0000000
zheyou73v0_A02	37761883	37762162	BnaA02T0423000ZY	0	-	225	279	279	1.0000000
zheyou73v0_A02	37763665	37764973	BnaA02T0423100ZY	0	+	394	1251	1308	0.9564220
zheyou73v0_A02	37770839	37776500	BnaA02T0423200ZY	0	+	301	3850	5661	0.6800919
zheyou73v0_A02	37788881	37790943	BnaA02T0423300ZY	0	+	536	1973	2062	0.9568380
zheyou73v0_A02	37792693	37793409	BnaA02T0423400ZY	0	-	152	682	716	0.9525140
zheyou73v0_A02	37803650	37804885	BnaA02T0423500ZY	0	+	219	1176	1235	0.9522267
zheyou73v0_A02	37811251	37811887	BnaA02T0423600ZY	0	-	526	636	636	1.0000000
zheyou73v0_A02	37819781	37822999	BnaA02T0423700ZY	0	-	540	2739	3218	0.8511498
zheyou73v0_A02	37824603	37826419	BnaA02T0423800ZY	0	+	107	1208	1816	0.6651983
zheyou73v0_A02	37824603	37826419	BnaA02T0423800ZY.1	0	+	107	1208	1816	0.6651983
zheyou73v0_A02	37831491	37834090	BnaA02T0423900ZY	0	-	244	1999	2599	0.7691420
zheyou73v0_A02	37842697	37843448	BnaA02T0424000ZY	0	+	153	722	751	0.9613848
zheyou73v0_A02	37845715	37846216	BnaA02T0424100ZY	0	+	13	375	501	0.7485030
zheyou73v0_A02	37847088	37847718	BnaA02T0424200ZY	0	-	153	564	630	0.8952381
zheyou73v0_A02	37848885	37851662	BnaA02T0424300ZY	0	+	201	2000	2777	0.7202017
zheyou73v0_A02	37852423	37853873	BnaA02T0424400ZY	0	-	294	1450	1450	1.0000000
zheyou73v0_A02	37856169	37857971	BnaA02T0424500ZY	0	+	35	630	1802	0.3496116
zheyou73v0_A02	37871799	37877488	BnaA02T0424600ZY	0	+	1441	3768	5689	0.6623308
zheyou73v0_A02	37880633	37881281	BnaA02T0424700ZY	0	+	464	648	648	1.0000000
zheyou73v0_A02	37883016	37885364	BnaA02T0424800ZY	0	-	91	1666	2348	0.7095400
zheyou73v0_A02	37903206	37904081	BnaA02T0424900ZY	0	+	4	137	875	0.1565714
zheyou73v0_A02	37904290	37905892	BnaA02T0425000ZY	0	-	150	637	1602	0.3976280
zheyou73v0_A02	37911102	37912387	BnaA02T0425100ZY	0	+	73	837	1285	0.6513619
zheyou73v0_A02	37918177	37920146	BnaA02T0425200ZY	0	-	539	1939	1969	0.9847639
zheyou73v0_A02	37920870	37921892	BnaA02T0425300ZY	0	-	244	985	1022	0.9637965
zheyou73v0_A02	37922089	37922608	BnaA02T0425400ZY	0	-	126	519	519	1.0000000
zheyou73v0_A02	37928330	37929030	BnaA02T0425500ZY	0	-	214	700	700	1.0000000
zheyou73v0_A02	37928436	37931438	BnaA02T0425600ZY	0	+	328	1993	3002	0.6638907
zheyou73v0_A02	37932537	37933491	BnaA02T0425700ZY	0	+	288	954	954	1.0000000
zheyou73v0_A02	37933932	37935135	BnaA02T0425800ZY	0	-	286	1173	1203	0.9750624
zheyou73v0_A02	37935301	37937027	BnaA02T0425900ZY	0	-	250	1573	1726	0.9113557
zheyou73v0_A02	37939691	37943657	BnaA02T0426000ZY	0	+	1143	3933	3966	0.9916793
zheyou73v0_A02	37944663	37945113	BnaA02T0426100ZY	0	-	176	450	450	1.0000000
zheyou73v0_A02	37950398	37952849	BnaA02T0426200ZY	0	-	545	2211	2451	0.9020808
zheyou73v0_A02	37958505	37960073	BnaA02T0426300ZY	0	-	764	1436	1568	0.9158163
zheyou73v0_A02	37961738	37962734	BnaA02T0426400ZY	0	+	184	891	996	0.8945783
zheyou73v0_A02	37966122	37966872	BnaA02T0426500ZY	0	-	53	430	750	0.5733333
zheyou73v0_A02	37972152	37973227	BnaA02T0426600ZY	0	+	436	836	1075	0.7776744
zheyou73v0_A02	37974528	37975992	BnaA02T0426700ZY	0	+	623	1464	1464	1.0000000
zheyou73v0_A02	37974528	37975992	BnaA02T0426700ZY.1	0	+	623	1464	1464	1.0000000
zheyou73v0_A02	37979199	37980018	BnaA02T0426800ZY	0	+	211	819	819	1.0000000
zheyou73v0_A02	37985696	37987567	BnaA02T0426900ZY	0	-	324	1699	1871	0.9080706
zheyou73v0_A02	37991533	37994423	BnaA02T0427000ZY	0	+	433	2293	2890	0.7934256
zheyou73v0_A02	37998671	37999782	BnaA02T0427100ZY	0	+	130	1010	1111	0.9090909
zheyou73v0_A02	38001897	38002815	BnaA02T0427200ZY	0	+	19	220	918	0.2396514
zheyou73v0_A02	38003717	38006504	BnaA02T0427300ZY	0	-	440	2133	2787	0.7653391
zheyou73v0_A02	38011248	38012388	BnaA02T0427400ZY	0	-	81	686	1140	0.6017544
zheyou73v0_A02	38033085	38036002	BnaA02T0427500ZY	0	+	1168	2480	2917	0.8501886
zheyou73v0_A02	38040405	38041519	BnaA02T0427600ZY	0	-	293	1075	1114	0.9649910
zheyou73v0_A02	38051226	38052431	BnaA02T0427700ZY	0	+	398	1205	1205	1.0000000
zheyou73v0_A02	38056971	38059316	BnaA02T0427800ZY	0	+	24	951	2345	0.4055437
zheyou73v0_A02	38063744	38066656	BnaA02T0427900ZY	0	+	87	1566	2912	0.5377747
zheyou73v0_A02	38073064	38074651	BnaA02T0428000ZY	0	+	112	939	1587	0.5916824
zheyou73v0_A02	38073064	38074651	BnaA02T0428000ZY.1	0	+	112	939	1587	0.5916824
zheyou73v0_A02	38115519	38117154	BnaA02T0428100ZY	0	-	18	829	1635	0.5070336
zheyou73v0_A02	38124760	38125425	BnaA02T0428200ZY	0	-	120	412	665	0.6195489
zheyou73v0_A02	38129905	38130751	BnaA02T0428300ZY	0	+	150	650	846	0.7683215
zheyou73v0_A02	38132035	38132764	BnaA02T0428400ZY	0	+	114	515	729	0.7064472
zheyou73v0_A02	38135139	38135358	BnaA02T0428500ZY	0	+	3	33	219	0.1506849
zheyou73v0_A02	38142813	38143128	BnaA02T0428600ZY	0	+	13	179	315	0.5682540
zheyou73v0_A02	38146392	38146955	BnaA02T0428700ZY	0	+	27	410	563	0.7282416
zheyou73v0_A02	38148227	38149046	BnaA02T0428800ZY	0	-	580	819	819	1.0000000
zheyou73v0_A02	38149640	38152118	BnaA02T0428900ZY	0	+	186	1669	2478	0.6735271
zheyou73v0_A02	38152534	38152729	BnaA02T0429000ZY	0	-	7	63	195	0.3230769
zheyou73v0_A02	38158907	38160129	BnaA02T0429100ZY	0	-	389	1138	1222	0.9312602
zheyou73v0_A02	38163574	38164185	BnaA02T0429200ZY	0	-	129	594	611	0.9721767
zheyou73v0_A02	38169114	38171215	BnaA02T0429300ZY	0	+	288	1174	2101	0.5587815
zheyou73v0_A02	38171920	38173122	BnaA02T0429400ZY	0	+	258	1146	1202	0.9534110
zheyou73v0_A02	38178895	38179712	BnaA02T0429500ZY	0	+	44	507	817	0.6205630
zheyou73v0_A02	38188919	38190124	BnaA02T0429600ZY	0	+	300	1205	1205	1.0000000
zheyou73v0_A02	38193030	38194390	BnaA02T0429700ZY	0	-	224	1047	1360	0.7698529
zheyou73v0_A02	38207704	38208642	BnaA02T0429800ZY	0	+	4	127	938	0.1353945
zheyou73v0_A02	38209850	38212915	BnaA02T0429900ZY	0	-	7	426	3065	0.1389886
zheyou73v0_A02	38209850	38212915	BnaA02T0429900ZY.1	0	-	7	426	3065	0.1389886
zheyou73v0_A02	38213975	38215162	BnaA02T0430000ZY	0	+	30	164	1187	0.1381634
zheyou73v0_A02	38244605	38245356	BnaA02T0430100ZY	0	+	0	0	751	0.0000000
zheyou73v0_A02	38260046	38260997	BnaA02T0430200ZY	0	-	309	951	951	1.0000000
zheyou73v0_A02	38270217	38271785	BnaA02T0430300ZY	0	+	1004	1568	1568	1.0000000
zheyou73v0_A02	38279122	38279353	BnaA02T0430400ZY	0	-	19	165	231	0.7142857
zheyou73v0_A02	38290493	38291261	BnaA02T0430500ZY	0	+	179	768	768	1.0000000
zheyou73v0_A02	38302675	38302975	BnaA02T0430600ZY	0	-	97	293	300	0.9766667
zheyou73v0_A02	38306159	38310059	BnaA02T0430700ZY	0	-	328	2936	3900	0.7528205
zheyou73v0_A02	38320216	38326596	BnaA02T0430800ZY	0	-	888	3722	6380	0.5833856
zheyou73v0_A02	38329254	38330224	BnaA02T0430900ZY	0	+	463	970	970	1.0000000
zheyou73v0_A02	38331692	38332807	BnaA02T0431000ZY	0	-	103	677	1115	0.6071749
zheyou73v0_A02	38340433	38341461	BnaA02T0431100ZY	0	+	702	1028	1028	1.0000000
zheyou73v0_A02	38346918	38347973	BnaA02T0431200ZY	0	+	6	165	1055	0.1563981
zheyou73v0_A02	38351547	38352246	BnaA02T0431300ZY	0	+	28	195	699	0.2789699
zheyou73v0_A02	38366628	38368285	BnaA02T0431400ZY	0	+	813	1601	1657	0.9662040
zheyou73v0_A02	38368404	38368927	BnaA02T0431500ZY	0	+	354	523	523	1.0000000
zheyou73v0_A02	38369287	38369743	BnaA02T0431600ZY	0	-	358	456	456	1.0000000
zheyou73v0_A02	38371973	38373536	BnaA02T0431700ZY	0	-	228	1254	1563	0.8023033
zheyou73v0_A02	38376359	38377207	BnaA02T0431800ZY	0	-	461	848	848	1.0000000
zheyou73v0_A02	38378798	38382393	BnaA02T0431900ZY	0	-	1069	3029	3595	0.8425591
zheyou73v0_A02	38378798	38382490	BnaA02T0431900ZY.1	0	-	1093	3126	3692	0.8466955
zheyou73v0_A02	38378935	38380190	BnaA02T0432000ZY	0	+	223	689	1255	0.5490040
zheyou73v0_A02	38386324	38390421	BnaA02T0432100ZY	0	-	429	3533	4097	0.8623383
zheyou73v0_A02	38391049	38393174	BnaA02T0432200ZY	0	-	635	2125	2125	1.0000000
zheyou73v0_A02	38391049	38393174	BnaA02T0432200ZY.1	0	-	635	2125	2125	1.0000000
zheyou73v0_A02	38396328	38398598	BnaA02T0432300ZY	0	+	485	1942	2270	0.8555066
zheyou73v0_A02	38402996	38404315	BnaA02T0432400ZY	0	-	557	1319	1319	1.0000000
zheyou73v0_A02	38405471	38406744	BnaA02T0432500ZY	0	-	613	1273	1273	1.0000000
zheyou73v0_A02	38412530	38414318	BnaA02T0432600ZY	0	-	53	937	1788	0.5240492
zheyou73v0_A02	38416454	38419649	BnaA02T0432700ZY	0	+	1022	3089	3195	0.9668232
zheyou73v0_A02	38416454	38419649	BnaA02T0432700ZY.1	0	+	1022	3089	3195	0.9668232
zheyou73v0_A02	38416454	38419649	BnaA02T0432700ZY.2	0	+	1022	3089	3195	0.9668232
zheyou73v0_A03	5784	6006	BnaA03T0000100ZY	0	-	0	0	222	0.0000000
zheyou73v0_A03	6186	6396	BnaA03T0000200ZY	0	-	0	0	210	0.0000000
zheyou73v0_A03	7532	9857	BnaA03T0000300ZY	0	-	0	0	2325	0.0000000
zheyou73v0_A03	35806	38131	BnaA03T0000400ZY	0	+	0	0	2325	0.0000000
zheyou73v0_A03	39267	39477	BnaA03T0000500ZY	0	+	0	0	210	0.0000000
zheyou73v0_A03	39657	39879	BnaA03T0000600ZY	0	+	0	0	222	0.0000000
zheyou73v0_A03	44161	44490	BnaA03T0000700ZY	0	+	0	0	329	0.0000000
zheyou73v0_A03	45407	47732	BnaA03T0000800ZY	0	+	0	0	2325	0.0000000
zheyou73v0_A03	48868	49078	BnaA03T0000900ZY	0	+	0	0	210	0.0000000
zheyou73v0_A03	49258	49480	BnaA03T0001000ZY	0	+	0	0	222	0.0000000
zheyou73v0_A03	57132	59261	BnaA03T0001100ZY	0	-	0	0	2129	0.0000000
zheyou73v0_A03	76475	77661	BnaA03T0001200ZY	0	+	0	0	1186	0.0000000
zheyou73v0_A03	77964	79024	BnaA03T0001300ZY	0	-	0	0	1060	0.0000000
zheyou73v0_A03	81283	82273	BnaA03T0001400ZY	0	-	0	0	990	0.0000000
zheyou73v0_A03	84268	86090	BnaA03T0001500ZY	0	-	0	0	1822	0.0000000
zheyou73v0_A03	84268	86090	BnaA03T0001500ZY.1	0	-	0	0	1822	0.0000000
zheyou73v0_A03	87356	89187	BnaA03T0001600ZY	0	-	0	0	1831	0.0000000
zheyou73v0_A03	90906	93875	BnaA03T0001700ZY	0	-	0	0	2969	0.0000000
zheyou73v0_A03	102385	104608	BnaA03T0001800ZY	0	-	0	0	2223	0.0000000
zheyou73v0_A03	102385	104628	BnaA03T0001800ZY.1	0	-	0	0	2243	0.0000000
zheyou73v0_A03	102385	104628	BnaA03T0001800ZY.2	0	-	0	0	2243	0.0000000
zheyou73v0_A03	105031	107779	BnaA03T0001900ZY	0	-	0	0	2748	0.0000000
zheyou73v0_A03	108389	109421	BnaA03T0002000ZY	0	+	0	0	1032	0.0000000
zheyou73v0_A03	113553	115385	BnaA03T0002100ZY	0	+	0	0	1832	0.0000000
zheyou73v0_A03	116404	118302	BnaA03T0002200ZY	0	-	0	0	1898	0.0000000
zheyou73v0_A03	121188	122228	BnaA03T0002300ZY	0	-	0	0	1040	0.0000000
zheyou73v0_A03	123963	125581	BnaA03T0002400ZY	0	+	0	0	1618	0.0000000
zheyou73v0_A03	126540	131515	BnaA03T0002500ZY	0	+	0	0	4975	0.0000000
zheyou73v0_A03	134746	138558	BnaA03T0002600ZY	0	+	0	0	3812	0.0000000
zheyou73v0_A03	139813	140350	BnaA03T0002700ZY	0	-	0	0	537	0.0000000
zheyou73v0_A03	141092	143419	BnaA03T0002800ZY	0	+	0	0	2327	0.0000000
zheyou73v0_A03	143690	144728	BnaA03T0002900ZY	0	-	0	0	1038	0.0000000
zheyou73v0_A03	145562	147650	BnaA03T0003000ZY	0	+	0	0	2088	0.0000000
zheyou73v0_A03	149045	150143	BnaA03T0003100ZY	0	+	0	0	1098	0.0000000
zheyou73v0_A03	151220	154022	BnaA03T0003200ZY	0	+	0	0	2802	0.0000000
zheyou73v0_A03	157254	161985	BnaA03T0003300ZY	0	+	0	0	4731	0.0000000
zheyou73v0_A03	170766	172604	BnaA03T0003400ZY	0	+	0	0	1838	0.0000000
zheyou73v0_A03	176224	178558	BnaA03T0003500ZY	0	+	0	0	2334	0.0000000
zheyou73v0_A03	176224	178558	BnaA03T0003500ZY.1	0	+	0	0	2334	0.0000000
zheyou73v0_A03	184894	185573	BnaA03T0003600ZY	0	-	0	0	679	0.0000000
zheyou73v0_A03	199540	200803	BnaA03T0003700ZY	0	-	0	0	1263	0.0000000
zheyou73v0_A03	207524	212689	BnaA03T0003800ZY	0	-	0	0	5165	0.0000000
zheyou73v0_A03	214568	218862	BnaA03T0003900ZY	0	-	0	0	4294	0.0000000
zheyou73v0_A03	219517	221065	BnaA03T0004000ZY	0	+	0	0	1548	0.0000000
zheyou73v0_A03	241898	245193	BnaA03T0004100ZY	0	-	0	0	3295	0.0000000
zheyou73v0_A03	258933	259484	BnaA03T0004200ZY	0	-	0	0	551	0.0000000
zheyou73v0_A03	264583	268264	BnaA03T0004300ZY	0	+	0	0	3681	0.0000000
zheyou73v0_A03	268684	269392	BnaA03T0004400ZY	0	-	0	0	708	0.0000000
zheyou73v0_A03	269571	271294	BnaA03T0004500ZY	0	+	0	0	1723	0.0000000
zheyou73v0_A03	271721	273591	BnaA03T0004600ZY	0	-	0	0	1870	0.0000000
zheyou73v0_A03	274092	291338	BnaA03T0004700ZY	0	-	0	0	17246	0.0000000
zheyou73v0_A03	292363	292702	BnaA03T0004800ZY	0	-	0	0	339	0.0000000
zheyou73v0_A03	366174	368393	BnaA03T0004900ZY	0	+	0	0	2219	0.0000000
zheyou73v0_A03	370523	371513	BnaA03T0005000ZY	0	-	0	0	990	0.0000000
zheyou73v0_A03	378997	382035	BnaA03T0005100ZY	0	+	0	0	3038	0.0000000
zheyou73v0_A03	382172	382734	BnaA03T0005200ZY	0	-	0	0	562	0.0000000
zheyou73v0_A03	397001	399761	BnaA03T0005300ZY	0	+	0	0	2760	0.0000000
zheyou73v0_A03	401257	403683	BnaA03T0005400ZY	0	+	0	0	2426	0.0000000
zheyou73v0_A03	401257	403683	BnaA03T0005400ZY.1	0	+	0	0	2426	0.0000000
zheyou73v0_A03	406350	408734	BnaA03T0005500ZY	0	+	0	0	2384	0.0000000
zheyou73v0_A03	409835	411959	BnaA03T0005600ZY	0	-	0	0	2124	0.0000000
zheyou73v0_A03	417089	417518	BnaA03T0005700ZY	0	-	0	0	429	0.0000000
zheyou73v0_A03	421754	427318	BnaA03T0005800ZY	0	-	0	0	5564	0.0000000
zheyou73v0_A03	428210	430263	BnaA03T0005900ZY	0	+	0	0	2053	0.0000000
zheyou73v0_A03	430926	436748	BnaA03T0006000ZY	0	+	0	0	5822	0.0000000
zheyou73v0_A03	464214	465516	BnaA03T0006100ZY	0	+	0	0	1302	0.0000000
zheyou73v0_A03	466253	466878	BnaA03T0006200ZY	0	+	0	0	625	0.0000000
zheyou73v0_A03	467041	469575	BnaA03T0006300ZY	0	-	0	0	2534	0.0000000
zheyou73v0_A03	470462	471250	BnaA03T0006400ZY	0	+	0	0	788	0.0000000
zheyou73v0_A03	472023	473401	BnaA03T0006500ZY	0	-	0	0	1378	0.0000000
zheyou73v0_A03	480755	484572	BnaA03T0006600ZY	0	+	0	0	3817	0.0000000
zheyou73v0_A03	487243	487816	BnaA03T0006700ZY	0	-	0	0	573	0.0000000
zheyou73v0_A03	488527	491831	BnaA03T0006800ZY	0	+	0	0	3304	0.0000000
zheyou73v0_A03	488527	491831	BnaA03T0006800ZY.1	0	+	0	0	3304	0.0000000
zheyou73v0_A03	492248	493499	BnaA03T0006900ZY	0	-	0	0	1251	0.0000000
zheyou73v0_A03	495154	496673	BnaA03T0007000ZY	0	+	0	0	1519	0.0000000
zheyou73v0_A03	496988	503094	BnaA03T0007100ZY	0	-	0	0	6106	0.0000000
zheyou73v0_A03	503515	506062	BnaA03T0007200ZY	0	+	0	0	2547	0.0000000
zheyou73v0_A03	506334	508643	BnaA03T0007300ZY	0	+	0	0	2309	0.0000000
zheyou73v0_A03	506334	508643	BnaA03T0007300ZY.1	0	+	0	0	2309	0.0000000
zheyou73v0_A03	506334	508643	BnaA03T0007300ZY.2	0	+	0	0	2309	0.0000000
zheyou73v0_A03	506334	535524	BnaA03T0007300ZY.3	0	+	0	0	29190	0.0000000
zheyou73v0_A03	506334	535499	BnaA03T0007300ZY.4	0	+	0	0	29165	0.0000000
zheyou73v0_A03	509354	509764	BnaA03T0007400ZY	0	+	0	0	410	0.0000000
zheyou73v0_A03	513759	515025	BnaA03T0007500ZY	0	+	0	0	1266	0.0000000
zheyou73v0_A03	526591	527655	BnaA03T0007600ZY	0	-	0	0	1064	0.0000000
zheyou73v0_A03	527751	528471	BnaA03T0007700ZY	0	-	0	0	720	0.0000000
zheyou73v0_A03	538924	540288	BnaA03T0007800ZY	0	+	0	0	1364	0.0000000
zheyou73v0_A03	543613	546786	BnaA03T0007900ZY	0	+	0	0	3173	0.0000000
zheyou73v0_A03	546950	549986	BnaA03T0008000ZY	0	-	0	0	3036	0.0000000
zheyou73v0_A03	550568	550783	BnaA03T0008100ZY	0	+	0	0	215	0.0000000
zheyou73v0_A03	551405	553649	BnaA03T0008200ZY	0	+	0	0	2244	0.0000000
zheyou73v0_A03	554604	555412	BnaA03T0008300ZY	0	+	0	0	808	0.0000000
zheyou73v0_A03	561532	562310	BnaA03T0008400ZY	0	+	0	0	778	0.0000000
zheyou73v0_A03	562806	567050	BnaA03T0008500ZY	0	-	0	0	4244	0.0000000
zheyou73v0_A03	567682	569055	BnaA03T0008600ZY	0	-	0	0	1373	0.0000000
zheyou73v0_A03	569691	570030	BnaA03T0008700ZY	0	-	0	0	339	0.0000000
zheyou73v0_A03	570123	570471	BnaA03T0008800ZY	0	-	0	0	348	0.0000000
zheyou73v0_A03	573473	575900	BnaA03T0008900ZY	0	+	0	0	2427	0.0000000
zheyou73v0_A03	576137	578745	BnaA03T0009000ZY	0	-	0	0	2608	0.0000000
zheyou73v0_A03	579624	584616	BnaA03T0009100ZY	0	-	0	0	4992	0.0000000
zheyou73v0_A03	585367	586908	BnaA03T0009200ZY	0	+	0	0	1541	0.0000000
zheyou73v0_A03	591412	592736	BnaA03T0009300ZY	0	+	0	0	1324	0.0000000
zheyou73v0_A03	597101	598905	BnaA03T0009400ZY	0	-	0	0	1804	0.0000000
zheyou73v0_A03	600634	604352	BnaA03T0009500ZY	0	+	0	0	3718	0.0000000
zheyou73v0_A03	605492	607221	BnaA03T0009600ZY	0	+	0	0	1729	0.0000000
zheyou73v0_A03	610387	612856	BnaA03T0009700ZY	0	+	0	0	2469	0.0000000
zheyou73v0_A03	613483	617921	BnaA03T0009800ZY	0	-	0	0	4438	0.0000000
zheyou73v0_A03	619650	621015	BnaA03T0009900ZY	0	-	0	0	1365	0.0000000
zheyou73v0_A03	621633	626069	BnaA03T0010000ZY	0	-	0	0	4436	0.0000000
zheyou73v0_A03	627836	632954	BnaA03T0010100ZY	0	+	0	0	5118	0.0000000
zheyou73v0_A03	633430	635588	BnaA03T0010200ZY	0	+	0	0	2158	0.0000000
zheyou73v0_A03	635572	638005	BnaA03T0010300ZY	0	-	0	0	2433	0.0000000
zheyou73v0_A03	642116	644759	BnaA03T0010400ZY	0	+	0	0	2643	0.0000000
zheyou73v0_A03	644869	645631	BnaA03T0010500ZY	0	-	0	0	762	0.0000000
zheyou73v0_A03	646003	652371	BnaA03T0010600ZY	0	-	0	0	6368	0.0000000
zheyou73v0_A03	657289	660904	BnaA03T0010700ZY	0	+	0	0	3615	0.0000000
zheyou73v0_A03	662553	663484	BnaA03T0010800ZY	0	+	0	0	931	0.0000000
zheyou73v0_A03	664111	665408	BnaA03T0010900ZY	0	-	0	0	1297	0.0000000
zheyou73v0_A03	666503	667427	BnaA03T0011000ZY	0	+	0	0	924	0.0000000
zheyou73v0_A03	667800	669720	BnaA03T0011100ZY	0	-	0	0	1920	0.0000000
zheyou73v0_A03	670438	671687	BnaA03T0011200ZY	0	+	0	0	1249	0.0000000
zheyou73v0_A03	673189	681848	BnaA03T0011300ZY	0	+	0	0	8659	0.0000000
zheyou73v0_A03	689833	690976	BnaA03T0011400ZY	0	-	0	0	1143	0.0000000
zheyou73v0_A03	696530	700998	BnaA03T0011500ZY	0	+	0	0	4468	0.0000000
zheyou73v0_A03	701282	702284	BnaA03T0011600ZY	0	-	0	0	1002	0.0000000
zheyou73v0_A03	703833	706560	BnaA03T0011700ZY	0	-	0	0	2727	0.0000000
zheyou73v0_A03	710604	710841	BnaA03T0011800ZY	0	-	0	0	237	0.0000000
zheyou73v0_A03	713822	718897	BnaA03T0011900ZY	0	+	0	0	5075	0.0000000
zheyou73v0_A03	719446	721681	BnaA03T0012000ZY	0	+	0	0	2235	0.0000000
zheyou73v0_A03	721986	725477	BnaA03T0012100ZY	0	+	0	0	3491	0.0000000
zheyou73v0_A03	721986	724813	BnaA03T0012100ZY.1	0	+	0	0	2827	0.0000000
zheyou73v0_A03	725546	726897	BnaA03T0012200ZY	0	-	0	0	1351	0.0000000
zheyou73v0_A03	727781	728114	BnaA03T0012300ZY	0	+	0	0	333	0.0000000
zheyou73v0_A03	729332	731257	BnaA03T0012400ZY	0	-	0	0	1925	0.0000000
zheyou73v0_A03	733037	734347	BnaA03T0012500ZY	0	+	0	0	1310	0.0000000
zheyou73v0_A03	735544	736439	BnaA03T0012600ZY	0	+	0	0	895	0.0000000
zheyou73v0_A03	736845	737646	BnaA03T0012700ZY	0	-	0	0	801	0.0000000
zheyou73v0_A03	737934	740058	BnaA03T0012800ZY	0	-	0	0	2124	0.0000000
zheyou73v0_A03	740245	743267	BnaA03T0012900ZY	0	-	0	0	3022	0.0000000
zheyou73v0_A03	743471	744684	BnaA03T0013000ZY	0	+	0	0	1213	0.0000000
zheyou73v0_A03	747179	748398	BnaA03T0013100ZY	0	+	0	0	1219	0.0000000
zheyou73v0_A03	749622	750840	BnaA03T0013200ZY	0	+	0	0	1218	0.0000000
zheyou73v0_A03	753286	755947	BnaA03T0013300ZY	0	+	0	0	2661	0.0000000
zheyou73v0_A03	756132	761239	BnaA03T0013400ZY	0	-	0	0	5107	0.0000000
zheyou73v0_A03	763228	764967	BnaA03T0013500ZY	0	-	0	0	1739	0.0000000
zheyou73v0_A03	769117	770678	BnaA03T0013600ZY	0	-	0	0	1561	0.0000000
zheyou73v0_A03	796324	797711	BnaA03T0013700ZY	0	+	0	0	1387	0.0000000
zheyou73v0_A03	798607	803134	BnaA03T0013800ZY	0	+	0	0	4527	0.0000000
zheyou73v0_A03	808420	811489	BnaA03T0013900ZY	0	-	0	0	3069	0.0000000
zheyou73v0_A03	811641	813600	BnaA03T0014000ZY	0	-	0	0	1959	0.0000000
zheyou73v0_A03	814352	816407	BnaA03T0014100ZY	0	+	0	0	2055	0.0000000
zheyou73v0_A03	820659	821163	BnaA03T0014200ZY	0	-	0	0	504	0.0000000
zheyou73v0_A03	822687	824336	BnaA03T0014300ZY	0	+	0	0	1649	0.0000000
zheyou73v0_A03	824830	829775	BnaA03T0014400ZY	0	-	0	0	4945	0.0000000
zheyou73v0_A03	836237	836450	BnaA03T0014500ZY	0	-	0	0	213	0.0000000
zheyou73v0_A03	839439	843348	BnaA03T0014600ZY	0	+	0	0	3909	0.0000000
zheyou73v0_A03	845732	846039	BnaA03T0014700ZY	0	+	0	0	307	0.0000000
zheyou73v0_A03	846526	847634	BnaA03T0014800ZY	0	-	0	0	1108	0.0000000
zheyou73v0_A03	848413	851748	BnaA03T0014900ZY	0	-	0	0	3335	0.0000000
zheyou73v0_A03	852264	853939	BnaA03T0015000ZY	0	-	0	0	1675	0.0000000
zheyou73v0_A03	854982	855798	BnaA03T0015100ZY	0	-	0	0	816	0.0000000
zheyou73v0_A03	860700	864364	BnaA03T0015200ZY	0	-	0	0	3664	0.0000000
zheyou73v0_A03	865052	865711	BnaA03T0015300ZY	0	-	0	0	659	0.0000000
zheyou73v0_A03	867976	868768	BnaA03T0015400ZY	0	-	0	0	792	0.0000000
zheyou73v0_A03	871582	878795	BnaA03T0015500ZY	0	+	0	0	7213	0.0000000
zheyou73v0_A03	875693	878687	BnaA03T0015500ZY.1	0	+	0	0	2994	0.0000000
zheyou73v0_A03	879904	881354	BnaA03T0015600ZY	0	+	0	0	1450	0.0000000
zheyou73v0_A03	882789	883612	BnaA03T0015700ZY	0	-	0	0	823	0.0000000
zheyou73v0_A03	885193	886132	BnaA03T0015800ZY	0	-	0	0	939	0.0000000
zheyou73v0_A03	887508	888752	BnaA03T0015900ZY	0	-	0	0	1244	0.0000000
zheyou73v0_A03	890879	891290	BnaA03T0016000ZY	0	-	0	0	411	0.0000000
zheyou73v0_A03	893287	896568	BnaA03T0016100ZY	0	+	0	0	3281	0.0000000
zheyou73v0_A03	897451	898009	BnaA03T0016200ZY	0	-	0	0	558	0.0000000
zheyou73v0_A03	901405	905172	BnaA03T0016300ZY	0	-	0	0	3767	0.0000000
zheyou73v0_A03	912424	918782	BnaA03T0016400ZY	0	-	0	0	6358	0.0000000
zheyou73v0_A03	920513	922462	BnaA03T0016500ZY	0	-	0	0	1949	0.0000000
zheyou73v0_A03	924557	925573	BnaA03T0016600ZY	0	-	0	0	1016	0.0000000
zheyou73v0_A03	928677	929435	BnaA03T0016700ZY	0	-	0	0	758	0.0000000
zheyou73v0_A03	933681	947003	BnaA03T0016800ZY	0	-	0	0	13322	0.0000000
zheyou73v0_A03	949359	952051	BnaA03T0016900ZY	0	-	0	0	2692	0.0000000
zheyou73v0_A03	952419	953731	BnaA03T0017000ZY	0	+	0	0	1312	0.0000000
zheyou73v0_A03	953099	960107	BnaA03T0017100ZY	0	-	0	0	7008	0.0000000
zheyou73v0_A03	961292	962548	BnaA03T0017200ZY	0	+	0	0	1256	0.0000000
zheyou73v0_A03	961292	967500	BnaA03T0017300ZY	0	-	0	0	6208	0.0000000
zheyou73v0_A03	961292	967429	BnaA03T0017300ZY.1	0	-	0	0	6137	0.0000000
zheyou73v0_A03	968152	972565	BnaA03T0017400ZY	0	-	0	0	4413	0.0000000
zheyou73v0_A03	969367	972565	BnaA03T0017400ZY.1	0	-	0	0	3198	0.0000000
zheyou73v0_A03	973552	976237	BnaA03T0017500ZY	0	+	0	0	2685	0.0000000
zheyou73v0_A03	973552	976237	BnaA03T0017500ZY.1	0	+	0	0	2685	0.0000000
zheyou73v0_A03	978337	979682	BnaA03T0017600ZY	0	+	0	0	1345	0.0000000
zheyou73v0_A03	980568	983214	BnaA03T0017700ZY	0	+	0	0	2646	0.0000000
zheyou73v0_A03	983862	984771	BnaA03T0017800ZY	0	+	0	0	909	0.0000000
zheyou73v0_A03	985263	987601	BnaA03T0017900ZY	0	-	0	0	2338	0.0000000
zheyou73v0_A03	988457	990580	BnaA03T0018000ZY	0	+	0	0	2123	0.0000000
zheyou73v0_A03	990687	992167	BnaA03T0018100ZY	0	-	0	0	1480	0.0000000
zheyou73v0_A03	992877	993892	BnaA03T0018200ZY	0	-	0	0	1015	0.0000000
zheyou73v0_A03	1001186	1001831	BnaA03T0018300ZY	0	-	0	0	645	0.0000000
zheyou73v0_A03	1003924	1004350	BnaA03T0018400ZY	0	+	0	0	426	0.0000000
zheyou73v0_A03	1004552	1005847	BnaA03T0018500ZY	0	-	0	0	1295	0.0000000
zheyou73v0_A03	1008414	1011361	BnaA03T0018600ZY	0	+	0	0	2947	0.0000000
zheyou73v0_A03	1014609	1017147	BnaA03T0018700ZY	0	+	0	0	2538	0.0000000
zheyou73v0_A03	1020590	1025868	BnaA03T0018800ZY	0	-	0	0	5278	0.0000000
zheyou73v0_A03	1027406	1030484	BnaA03T0018900ZY	0	+	0	0	3078	0.0000000
zheyou73v0_A03	1027406	1030904	BnaA03T0018900ZY.1	0	+	0	0	3498	0.0000000
zheyou73v0_A03	1027406	1030904	BnaA03T0018900ZY.2	0	+	0	0	3498	0.0000000
zheyou73v0_A03	1027406	1030484	BnaA03T0018900ZY.3	0	+	0	0	3078	0.0000000
zheyou73v0_A03	1027406	1029972	BnaA03T0018900ZY.4	0	+	0	0	2566	0.0000000
zheyou73v0_A03	1027406	1028887	BnaA03T0018900ZY.5	0	+	0	0	1481	0.0000000
zheyou73v0_A03	1034005	1035270	BnaA03T0019000ZY	0	-	0	0	1265	0.0000000
zheyou73v0_A03	1036167	1037845	BnaA03T0019100ZY	0	+	0	0	1678	0.0000000
zheyou73v0_A03	1037988	1039222	BnaA03T0019200ZY	0	-	0	0	1234	0.0000000
zheyou73v0_A03	1041894	1044502	BnaA03T0019300ZY	0	+	0	0	2608	0.0000000
zheyou73v0_A03	1046034	1048266	BnaA03T0019400ZY	0	-	0	0	2232	0.0000000
zheyou73v0_A03	1062003	1063199	BnaA03T0019500ZY	0	-	0	0	1196	0.0000000
zheyou73v0_A03	1064577	1065255	BnaA03T0019600ZY	0	-	0	0	678	0.0000000
zheyou73v0_A03	1065634	1067760	BnaA03T0019700ZY	0	-	0	0	2126	0.0000000
zheyou73v0_A03	1067983	1069531	BnaA03T0019800ZY	0	-	0	0	1548	0.0000000
zheyou73v0_A03	1070185	1070963	BnaA03T0019900ZY	0	+	0	0	778	0.0000000
zheyou73v0_A03	1079000	1079663	BnaA03T0020000ZY	0	+	0	0	663	0.0000000
zheyou73v0_A03	1081936	1086690	BnaA03T0020100ZY	0	+	0	0	4754	0.0000000
zheyou73v0_A03	1085824	1086682	BnaA03T0020200ZY	0	-	0	0	858	0.0000000
zheyou73v0_A03	1093887	1094166	BnaA03T0020300ZY	0	-	0	0	279	0.0000000
zheyou73v0_A03	1095856	1096445	BnaA03T0020400ZY	0	-	0	0	589	0.0000000
zheyou73v0_A03	1102885	1104642	BnaA03T0020500ZY	0	-	0	0	1757	0.0000000
zheyou73v0_A03	1106693	1108840	BnaA03T0020600ZY	0	-	0	0	2147	0.0000000
zheyou73v0_A03	1128331	1133158	BnaA03T0020700ZY	0	+	0	0	4827	0.0000000
zheyou73v0_A03	1128331	1133158	BnaA03T0020700ZY.1	0	+	0	0	4827	0.0000000
zheyou73v0_A03	1128331	1133158	BnaA03T0020700ZY.2	0	+	0	0	4827	0.0000000
zheyou73v0_A03	1135539	1142445	BnaA03T0020800ZY	0	-	0	0	6906	0.0000000
zheyou73v0_A03	1144497	1146203	BnaA03T0020900ZY	0	-	0	0	1706	0.0000000
zheyou73v0_A03	1149528	1153385	BnaA03T0021000ZY	0	-	0	0	3857	0.0000000
zheyou73v0_A03	1155745	1157116	BnaA03T0021100ZY	0	+	0	0	1371	0.0000000
zheyou73v0_A03	1172582	1177210	BnaA03T0021200ZY	0	-	0	0	4628	0.0000000
zheyou73v0_A03	1183359	1188323	BnaA03T0021300ZY	0	-	0	0	4964	0.0000000
zheyou73v0_A03	1188985	1194998	BnaA03T0021400ZY	0	+	0	0	6013	0.0000000
zheyou73v0_A03	1195630	1198302	BnaA03T0021500ZY	0	-	0	0	2672	0.0000000
zheyou73v0_A03	1203040	1204767	BnaA03T0021600ZY	0	-	0	0	1727	0.0000000
zheyou73v0_A03	1207591	1208193	BnaA03T0021700ZY	0	-	0	0	602	0.0000000
zheyou73v0_A03	1210443	1213562	BnaA03T0021800ZY	0	-	0	0	3119	0.0000000
zheyou73v0_A03	1214979	1222010	BnaA03T0021900ZY	0	+	0	0	7031	0.0000000
zheyou73v0_A03	1214979	1222010	BnaA03T0021900ZY.1	0	+	0	0	7031	0.0000000
zheyou73v0_A03	1223073	1224753	BnaA03T0022000ZY	0	-	0	0	1680	0.0000000
zheyou73v0_A03	1236542	1239675	BnaA03T0022100ZY	0	+	0	0	3133	0.0000000
zheyou73v0_A03	1240613	1242273	BnaA03T0022200ZY	0	+	0	0	1660	0.0000000
zheyou73v0_A03	1246872	1257842	BnaA03T0022300ZY	0	-	0	0	10970	0.0000000
zheyou73v0_A03	1258556	1259995	BnaA03T0022400ZY	0	+	0	0	1439	0.0000000
zheyou73v0_A03	1261060	1262229	BnaA03T0022500ZY	0	+	0	0	1169	0.0000000
zheyou73v0_A03	1263593	1266355	BnaA03T0022600ZY	0	+	0	0	2762	0.0000000
zheyou73v0_A03	1267660	1271958	BnaA03T0022700ZY	0	+	0	0	4298	0.0000000
zheyou73v0_A03	1274956	1276614	BnaA03T0022800ZY	0	+	0	0	1658	0.0000000
zheyou73v0_A03	1277141	1278436	BnaA03T0022900ZY	0	+	0	0	1295	0.0000000
zheyou73v0_A03	1279489	1279900	BnaA03T0023000ZY	0	+	0	0	411	0.0000000
zheyou73v0_A03	1280721	1281420	BnaA03T0023100ZY	0	+	0	0	699	0.0000000
zheyou73v0_A03	1281503	1282317	BnaA03T0023200ZY	0	-	0	0	814	0.0000000
zheyou73v0_A03	1284201	1285593	BnaA03T0023300ZY	0	+	0	0	1392	0.0000000
zheyou73v0_A03	1287765	1288786	BnaA03T0023400ZY	0	+	0	0	1021	0.0000000
zheyou73v0_A03	1292349	1292898	BnaA03T0023500ZY	0	-	0	0	549	0.0000000
zheyou73v0_A03	1294364	1294943	BnaA03T0023600ZY	0	+	0	0	579	0.0000000
zheyou73v0_A03	1299808	1301350	BnaA03T0023700ZY	0	-	0	0	1542	0.0000000
zheyou73v0_A03	1303623	1304294	BnaA03T0023800ZY	0	-	0	0	671	0.0000000
zheyou73v0_A03	1308368	1310084	BnaA03T0023900ZY	0	-	0	0	1716	0.0000000
zheyou73v0_A03	1314418	1315390	BnaA03T0024000ZY	0	+	0	0	972	0.0000000
zheyou73v0_A03	1315817	1316237	BnaA03T0024100ZY	0	+	0	0	420	0.0000000
zheyou73v0_A03	1317643	1318943	BnaA03T0024200ZY	0	-	0	0	1300	0.0000000
zheyou73v0_A03	1320553	1321271	BnaA03T0024300ZY	0	+	0	0	718	0.0000000
zheyou73v0_A03	1326409	1327145	BnaA03T0024400ZY	0	+	0	0	736	0.0000000
zheyou73v0_A03	1337459	1340097	BnaA03T0024500ZY	0	-	0	0	2638	0.0000000
zheyou73v0_A03	1340467	1342004	BnaA03T0024600ZY.1	0	+	0	0	1537	0.0000000
zheyou73v0_A03	1340942	1342004	BnaA03T0024600ZY	0	+	0	0	1062	0.0000000
zheyou73v0_A03	1342169	1343853	BnaA03T0024700ZY	0	-	0	0	1684	0.0000000
zheyou73v0_A03	1346570	1348875	BnaA03T0024800ZY	0	+	0	0	2305	0.0000000
zheyou73v0_A03	1351309	1352517	BnaA03T0024900ZY	0	-	0	0	1208	0.0000000
zheyou73v0_A03	1358122	1359273	BnaA03T0025000ZY	0	-	0	0	1151	0.0000000
zheyou73v0_A03	1362779	1363298	BnaA03T0025100ZY	0	-	0	0	519	0.0000000
zheyou73v0_A03	1364750	1365707	BnaA03T0025200ZY	0	+	0	0	957	0.0000000
zheyou73v0_A03	1373450	1374404	BnaA03T0025300ZY	0	+	0	0	954	0.0000000
zheyou73v0_A03	1381818	1383306	BnaA03T0025400ZY	0	+	0	0	1488	0.0000000
zheyou73v0_A03	1383452	1384028	BnaA03T0025500ZY	0	+	0	0	576	0.0000000
zheyou73v0_A03	1384480	1390561	BnaA03T0025600ZY	0	+	0	0	6081	0.0000000
zheyou73v0_A03	1437449	1438207	BnaA03T0025700ZY	0	-	0	0	758	0.0000000
zheyou73v0_A03	1439138	1440296	BnaA03T0025800ZY	0	-	0	0	1158	0.0000000
zheyou73v0_A03	1441347	1442868	BnaA03T0025900ZY	0	-	0	0	1521	0.0000000
zheyou73v0_A03	1443885	1444408	BnaA03T0026000ZY	0	+	0	0	523	0.0000000
zheyou73v0_A03	1444681	1447245	BnaA03T0026100ZY	0	+	0	0	2564	0.0000000
zheyou73v0_A03	1447353	1451039	BnaA03T0026200ZY	0	-	0	0	3686	0.0000000
zheyou73v0_A03	1463867	1464700	BnaA03T0026300ZY	0	-	0	0	833	0.0000000
zheyou73v0_A03	1501099	1503381	BnaA03T0026400ZY	0	+	0	0	2282	0.0000000
zheyou73v0_A03	1503968	1504329	BnaA03T0026500ZY	0	-	0	0	361	0.0000000
zheyou73v0_A03	1510608	1511427	BnaA03T0026600ZY	0	+	0	0	819	0.0000000
zheyou73v0_A03	1510608	1511081	BnaA03T0026600ZY.1	0	+	0	0	473	0.0000000
zheyou73v0_A03	1514342	1515179	BnaA03T0026700ZY	0	-	0	0	837	0.0000000
zheyou73v0_A03	1515975	1517128	BnaA03T0026800ZY	0	+	0	0	1153	0.0000000
zheyou73v0_A03	1520504	1521112	BnaA03T0026900ZY	0	+	0	0	608	0.0000000
zheyou73v0_A03	1529064	1529644	BnaA03T0027000ZY	0	-	0	0	580	0.0000000
zheyou73v0_A03	1530504	1532588	BnaA03T0027100ZY.1	0	+	0	0	2084	0.0000000
zheyou73v0_A03	1530812	1532588	BnaA03T0027100ZY	0	+	0	0	1776	0.0000000
zheyou73v0_A03	1536682	1538207	BnaA03T0027200ZY	0	+	0	0	1525	0.0000000
zheyou73v0_A03	1538991	1539800	BnaA03T0027300ZY	0	+	0	0	809	0.0000000
zheyou73v0_A03	1539940	1541686	BnaA03T0027400ZY	0	-	0	0	1746	0.0000000
zheyou73v0_A03	1542406	1544849	BnaA03T0027500ZY	0	-	0	0	2443	0.0000000
zheyou73v0_A03	1551503	1552890	BnaA03T0027600ZY	0	+	0	0	1387	0.0000000
zheyou73v0_A03	1553933	1556025	BnaA03T0027700ZY	0	+	0	0	2092	0.0000000
zheyou73v0_A03	1553933	1556025	BnaA03T0027700ZY.1	0	+	0	0	2092	0.0000000
zheyou73v0_A03	1556426	1556968	BnaA03T0027800ZY	0	+	0	0	542	0.0000000
zheyou73v0_A03	1557844	1559264	BnaA03T0027900ZY	0	+	0	0	1420	0.0000000
zheyou73v0_A03	1567317	1573589	BnaA03T0028000ZY	0	+	0	0	6272	0.0000000
zheyou73v0_A03	1573876	1575186	BnaA03T0028100ZY	0	-	0	0	1310	0.0000000
zheyou73v0_A03	1575828	1577388	BnaA03T0028200ZY	0	+	0	0	1560	0.0000000
zheyou73v0_A03	1578603	1579771	BnaA03T0028300ZY	0	-	0	0	1168	0.0000000
zheyou73v0_A03	1580009	1581029	BnaA03T0028400ZY	0	-	0	0	1020	0.0000000
zheyou73v0_A03	1581487	1583492	BnaA03T0028500ZY	0	-	0	0	2005	0.0000000
zheyou73v0_A03	1589409	1590008	BnaA03T0028600ZY	0	+	0	0	599	0.0000000
zheyou73v0_A03	1590947	1591508	BnaA03T0028700ZY	0	-	0	0	561	0.0000000
zheyou73v0_A03	1592911	1595587	BnaA03T0028800ZY	0	-	0	0	2676	0.0000000
zheyou73v0_A03	1600105	1600992	BnaA03T0028900ZY	0	+	0	0	887	0.0000000
zheyou73v0_A03	1601739	1602919	BnaA03T0029000ZY	0	+	0	0	1180	0.0000000
zheyou73v0_A03	1603616	1604581	BnaA03T0029100ZY	0	-	0	0	965	0.0000000
zheyou73v0_A03	1611222	1611414	BnaA03T0029200ZY	0	-	0	0	192	0.0000000
zheyou73v0_A03	1619121	1619909	BnaA03T0029300ZY	0	+	0	0	788	0.0000000
zheyou73v0_A03	1623371	1627811	BnaA03T0029400ZY	0	+	0	0	4440	0.0000000
zheyou73v0_A03	1628325	1630425	BnaA03T0029500ZY	0	+	0	0	2100	0.0000000
zheyou73v0_A03	1630658	1632629	BnaA03T0029600ZY	0	+	0	0	1971	0.0000000
zheyou73v0_A03	1637581	1639901	BnaA03T0029700ZY	0	+	0	0	2320	0.0000000
zheyou73v0_A03	1638034	1639901	BnaA03T0029700ZY.1	0	+	0	0	1867	0.0000000
zheyou73v0_A03	1640152	1643907	BnaA03T0029800ZY	0	-	0	0	3755	0.0000000
zheyou73v0_A03	1644022	1645032	BnaA03T0029900ZY	0	-	0	0	1010	0.0000000
zheyou73v0_A03	1649323	1651378	BnaA03T0030000ZY	0	-	0	0	2055	0.0000000
zheyou73v0_A03	1652568	1654629	BnaA03T0030100ZY	0	+	0	0	2061	0.0000000
zheyou73v0_A03	1655187	1658634	BnaA03T0030200ZY	0	-	0	0	3447	0.0000000
zheyou73v0_A03	1659613	1660798	BnaA03T0030300ZY	0	+	0	0	1185	0.0000000
zheyou73v0_A03	1664449	1665280	BnaA03T0030400ZY	0	+	0	0	831	0.0000000
zheyou73v0_A03	1666601	1668709	BnaA03T0030500ZY	0	+	0	0	2108	0.0000000
zheyou73v0_A03	1670589	1671042	BnaA03T0030600ZY	0	+	0	0	453	0.0000000
zheyou73v0_A03	1671454	1672682	BnaA03T0030700ZY	0	-	0	0	1228	0.0000000
zheyou73v0_A03	1672969	1674724	BnaA03T0030800ZY	0	-	0	0	1755	0.0000000
zheyou73v0_A03	1675258	1677034	BnaA03T0030900ZY	0	-	0	0	1776	0.0000000
zheyou73v0_A03	1678765	1681744	BnaA03T0031000ZY	0	+	0	0	2979	0.0000000
zheyou73v0_A03	1681996	1682651	BnaA03T0031100ZY	0	-	0	0	655	0.0000000
zheyou73v0_A03	1688203	1691538	BnaA03T0031200ZY	0	-	0	0	3335	0.0000000
zheyou73v0_A03	1698451	1701293	BnaA03T0031300ZY	0	+	0	0	2842	0.0000000
zheyou73v0_A03	1708859	1711746	BnaA03T0031400ZY	0	+	0	0	2887	0.0000000
zheyou73v0_A03	1714324	1719405	BnaA03T0031500ZY	0	-	0	0	5081	0.0000000
zheyou73v0_A03	1720919	1725455	BnaA03T0031600ZY	0	-	0	0	4536	0.0000000
zheyou73v0_A03	1730418	1730601	BnaA03T0031700ZY	0	+	0	0	183	0.0000000
zheyou73v0_A03	1735734	1737230	BnaA03T0031800ZY	0	+	0	0	1496	0.0000000
zheyou73v0_A03	1737814	1741193	BnaA03T0031900ZY	0	-	0	0	3379	0.0000000
zheyou73v0_A03	1742427	1744498	BnaA03T0032000ZY	0	-	0	0	2071	0.0000000
zheyou73v0_A03	1747715	1749794	BnaA03T0032100ZY	0	-	0	0	2079	0.0000000
zheyou73v0_A03	1762273	1763521	BnaA03T0032200ZY	0	-	0	0	1248	0.0000000
zheyou73v0_A03	1766796	1767504	BnaA03T0032300ZY	0	-	0	0	708	0.0000000
zheyou73v0_A03	1767884	1768319	BnaA03T0032400ZY	0	+	0	0	435	0.0000000
zheyou73v0_A03	1768698	1769760	BnaA03T0032500ZY	0	-	0	0	1062	0.0000000
zheyou73v0_A03	1769778	1770083	BnaA03T0032600ZY	0	-	0	0	305	0.0000000
zheyou73v0_A03	1783873	1786580	BnaA03T0032700ZY	0	-	0	0	2707	0.0000000
zheyou73v0_A03	1788073	1788811	BnaA03T0032800ZY	0	+	0	0	738	0.0000000
zheyou73v0_A03	1792428	1792965	BnaA03T0032900ZY	0	+	0	0	537	0.0000000
zheyou73v0_A03	1793906	1797175	BnaA03T0033000ZY	0	+	0	0	3269	0.0000000
zheyou73v0_A03	1800661	1808149	BnaA03T0033100ZY	0	+	0	0	7488	0.0000000
zheyou73v0_A03	1808664	1808988	BnaA03T0033200ZY	0	+	0	0	324	0.0000000
zheyou73v0_A03	1810155	1810908	BnaA03T0033300ZY	0	+	0	0	753	0.0000000
zheyou73v0_A03	1813817	1814156	BnaA03T0033400ZY	0	+	0	0	339	0.0000000
zheyou73v0_A03	1819155	1820045	BnaA03T0033500ZY	0	+	0	0	890	0.0000000
zheyou73v0_A03	1820757	1826619	BnaA03T0033600ZY.2	0	-	0	0	5862	0.0000000
zheyou73v0_A03	1823230	1826619	BnaA03T0033600ZY	0	-	0	0	3389	0.0000000
zheyou73v0_A03	1823230	1826619	BnaA03T0033600ZY.1	0	-	0	0	3389	0.0000000
zheyou73v0_A03	1829422	1842203	BnaA03T0033700ZY	0	-	0	0	12781	0.0000000
zheyou73v0_A03	1842236	1845263	BnaA03T0033800ZY	0	+	0	0	3027	0.0000000
zheyou73v0_A03	1842236	1845263	BnaA03T0033800ZY.1	0	+	0	0	3027	0.0000000
zheyou73v0_A03	1846517	1849044	BnaA03T0033900ZY	0	+	0	0	2527	0.0000000
zheyou73v0_A03	1857172	1860018	BnaA03T0034000ZY	0	+	0	0	2846	0.0000000
zheyou73v0_A03	1858571	1860390	BnaA03T0034000ZY.1	0	+	0	0	1819	0.0000000
zheyou73v0_A03	1860750	1864879	BnaA03T0034100ZY	0	-	0	0	4129	0.0000000
zheyou73v0_A03	1867563	1870484	BnaA03T0034200ZY.1	0	+	0	0	2921	0.0000000
zheyou73v0_A03	1867734	1870620	BnaA03T0034200ZY	0	+	0	0	2886	0.0000000
zheyou73v0_A03	1870809	1871476	BnaA03T0034300ZY	0	+	0	0	667	0.0000000
zheyou73v0_A03	1878698	1879100	BnaA03T0034400ZY	0	+	0	0	402	0.0000000
zheyou73v0_A03	1880475	1881555	BnaA03T0034500ZY	0	+	0	0	1080	0.0000000
zheyou73v0_A03	1882343	1884853	BnaA03T0034600ZY	0	+	0	0	2510	0.0000000
zheyou73v0_A03	1887367	1889859	BnaA03T0034700ZY	0	-	0	0	2492	0.0000000
zheyou73v0_A03	1890394	1893499	BnaA03T0034800ZY	0	-	0	0	3105	0.0000000
zheyou73v0_A03	1894418	1894915	BnaA03T0034900ZY	0	+	0	0	497	0.0000000
zheyou73v0_A03	1896674	1898547	BnaA03T0035000ZY	0	+	0	0	1873	0.0000000
zheyou73v0_A03	1899329	1899990	BnaA03T0035100ZY	0	-	0	0	661	0.0000000
zheyou73v0_A03	1908511	1911672	BnaA03T0035200ZY	0	+	0	0	3161	0.0000000
zheyou73v0_A03	1908511	1911672	BnaA03T0035200ZY.1	0	+	0	0	3161	0.0000000
zheyou73v0_A03	1912804	1914274	BnaA03T0035300ZY	0	-	0	0	1470	0.0000000
zheyou73v0_A03	1915736	1917513	BnaA03T0035400ZY	0	+	0	0	1777	0.0000000
zheyou73v0_A03	1917666	1920631	BnaA03T0035500ZY	0	-	0	0	2965	0.0000000
zheyou73v0_A03	1920927	1921960	BnaA03T0035600ZY	0	-	0	0	1033	0.0000000
zheyou73v0_A03	1922374	1926120	BnaA03T0035700ZY	0	-	0	0	3746	0.0000000
zheyou73v0_A03	1926939	1933323	BnaA03T0035800ZY	0	-	0	0	6384	0.0000000
zheyou73v0_A03	1939170	1941788	BnaA03T0035900ZY	0	-	0	0	2618	0.0000000
zheyou73v0_A03	1942149	1942849	BnaA03T0036000ZY	0	+	0	0	700	0.0000000
zheyou73v0_A03	1943340	1944128	BnaA03T0036100ZY	0	-	0	0	788	0.0000000
zheyou73v0_A03	1957407	1962279	BnaA03T0036200ZY	0	+	0	0	4872	0.0000000
zheyou73v0_A03	1965226	1966108	BnaA03T0036300ZY	0	+	0	0	882	0.0000000
zheyou73v0_A03	1966659	1968226	BnaA03T0036400ZY	0	+	0	0	1567	0.0000000
zheyou73v0_A03	1967761	1970097	BnaA03T0036500ZY	0	-	0	0	2336	0.0000000
zheyou73v0_A03	1967761	1970097	BnaA03T0036500ZY.1	0	-	0	0	2336	0.0000000
zheyou73v0_A03	1971258	1972650	BnaA03T0036600ZY	0	-	0	0	1392	0.0000000
zheyou73v0_A03	1971258	1972446	BnaA03T0036600ZY.1	0	-	0	0	1188	0.0000000
zheyou73v0_A03	1972983	1974945	BnaA03T0036700ZY	0	-	0	0	1962	0.0000000
zheyou73v0_A03	1976929	1980657	BnaA03T0036800ZY.1	0	+	0	0	3728	0.0000000
zheyou73v0_A03	1977233	1980657	BnaA03T0036800ZY	0	+	0	0	3424	0.0000000
zheyou73v0_A03	1980980	1982268	BnaA03T0036900ZY	0	+	0	0	1288	0.0000000
zheyou73v0_A03	1982492	1984890	BnaA03T0037000ZY	0	+	0	0	2398	0.0000000
zheyou73v0_A03	1987180	1988113	BnaA03T0037100ZY	0	+	0	0	933	0.0000000
zheyou73v0_A03	1993152	1996330	BnaA03T0037200ZY	0	-	0	0	3178	0.0000000
zheyou73v0_A03	1993152	1996330	BnaA03T0037200ZY.1	0	-	0	0	3178	0.0000000
zheyou73v0_A03	1996256	1996553	BnaA03T0037300ZY	0	+	0	0	297	0.0000000
zheyou73v0_A03	1999826	2004018	BnaA03T0037400ZY	0	+	0	0	4192	0.0000000
zheyou73v0_A03	2004713	2006998	BnaA03T0037500ZY	0	-	0	0	2285	0.0000000
zheyou73v0_A03	2009288	2009908	BnaA03T0037600ZY	0	+	0	0	620	0.0000000
zheyou73v0_A03	2011303	2012524	BnaA03T0037700ZY	0	-	0	0	1221	0.0000000
zheyou73v0_A03	2016700	2018677	BnaA03T0037800ZY	0	+	0	0	1977	0.0000000
zheyou73v0_A03	2019211	2022512	BnaA03T0037900ZY	0	-	0	0	3301	0.0000000
zheyou73v0_A03	2028093	2030514	BnaA03T0038000ZY	0	-	0	0	2421	0.0000000
zheyou73v0_A03	2031368	2033378	BnaA03T0038100ZY	0	-	0	0	2010	0.0000000
zheyou73v0_A03	2033411	2040608	BnaA03T0038200ZY	0	+	0	0	7197	0.0000000
zheyou73v0_A03	2040919	2041791	BnaA03T0038300ZY	0	+	0	0	872	0.0000000
zheyou73v0_A03	2042362	2044799	BnaA03T0038400ZY	0	-	0	0	2437	0.0000000
zheyou73v0_A03	2048200	2048953	BnaA03T0038500ZY	0	+	0	0	753	0.0000000
zheyou73v0_A03	2049918	2051403	BnaA03T0038600ZY	0	-	0	0	1485	0.0000000
zheyou73v0_A03	2051815	2053075	BnaA03T0038700ZY	0	-	0	0	1260	0.0000000
zheyou73v0_A03	2053867	2054314	BnaA03T0038800ZY	0	+	0	0	447	0.0000000
zheyou73v0_A03	2057820	2059989	BnaA03T0038900ZY	0	+	0	0	2169	0.0000000
zheyou73v0_A03	2057820	2059989	BnaA03T0038900ZY.1	0	+	0	0	2169	0.0000000
zheyou73v0_A03	2060605	2062339	BnaA03T0039000ZY	0	-	0	0	1734	0.0000000
zheyou73v0_A03	2062837	2067647	BnaA03T0039100ZY	0	-	0	0	4810	0.0000000
zheyou73v0_A03	2068217	2070099	BnaA03T0039200ZY	0	+	0	0	1882	0.0000000
zheyou73v0_A03	2071972	2074715	BnaA03T0039300ZY	0	+	0	0	2743	0.0000000
zheyou73v0_A03	2075013	2077668	BnaA03T0039400ZY	0	-	0	0	2655	0.0000000
zheyou73v0_A03	2077947	2079697	BnaA03T0039500ZY	0	+	0	0	1750	0.0000000
zheyou73v0_A03	2088006	2089646	BnaA03T0039600ZY	0	-	0	0	1640	0.0000000
zheyou73v0_A03	2092475	2093271	BnaA03T0039700ZY	0	-	0	0	796	0.0000000
zheyou73v0_A03	2095979	2096756	BnaA03T0039800ZY	0	+	0	0	777	0.0000000
zheyou73v0_A03	2096773	2096968	BnaA03T0039900ZY	0	+	0	0	195	0.0000000
zheyou73v0_A03	2099343	2099955	BnaA03T0040000ZY	0	+	0	0	612	0.0000000
zheyou73v0_A03	2106419	2109301	BnaA03T0040100ZY	0	+	0	0	2882	0.0000000
zheyou73v0_A03	2106839	2109301	BnaA03T0040100ZY.1	0	+	0	0	2462	0.0000000
zheyou73v0_A03	2109537	2111364	BnaA03T0040200ZY	0	-	0	0	1827	0.0000000
zheyou73v0_A03	2114854	2125627	BnaA03T0040300ZY	0	+	0	0	10773	0.0000000
zheyou73v0_A03	2128401	2128719	BnaA03T0040400ZY	0	-	0	0	318	0.0000000
zheyou73v0_A03	2129838	2130102	BnaA03T0040500ZY	0	-	0	0	264	0.0000000
zheyou73v0_A03	2137978	2140744	BnaA03T0040600ZY	0	+	0	0	2766	0.0000000
zheyou73v0_A03	2144307	2145322	BnaA03T0040700ZY	0	-	0	0	1015	0.0000000
zheyou73v0_A03	2145488	2147370	BnaA03T0040800ZY	0	-	0	0	1882	0.0000000
zheyou73v0_A03	2147985	2150426	BnaA03T0040900ZY	0	-	0	0	2441	0.0000000
zheyou73v0_A03	2151862	2154944	BnaA03T0041000ZY	0	-	0	0	3082	0.0000000
zheyou73v0_A03	2151862	2154611	BnaA03T0041000ZY.1	0	-	0	0	2749	0.0000000
zheyou73v0_A03	2157891	2161432	BnaA03T0041100ZY	0	-	0	0	3541	0.0000000
zheyou73v0_A03	2162001	2164219	BnaA03T0041200ZY	0	-	0	0	2218	0.0000000
zheyou73v0_A03	2164484	2166653	BnaA03T0041300ZY	0	+	0	0	2169	0.0000000
zheyou73v0_A03	2168279	2170444	BnaA03T0041400ZY	0	-	0	0	2165	0.0000000
zheyou73v0_A03	2171776	2173900	BnaA03T0041500ZY	0	+	0	0	2124	0.0000000
zheyou73v0_A03	2176387	2178447	BnaA03T0041600ZY	0	+	0	0	2060	0.0000000
zheyou73v0_A03	2179204	2185483	BnaA03T0041700ZY	0	-	0	0	6279	0.0000000
zheyou73v0_A03	2185781	2187410	BnaA03T0041800ZY	0	+	0	0	1629	0.0000000
zheyou73v0_A03	2187352	2188726	BnaA03T0041900ZY	0	-	0	0	1374	0.0000000
zheyou73v0_A03	2193657	2194326	BnaA03T0042000ZY	0	-	0	0	669	0.0000000
zheyou73v0_A03	2195474	2197668	BnaA03T0042100ZY	0	-	0	0	2194	0.0000000
zheyou73v0_A03	2199822	2200803	BnaA03T0042200ZY	0	-	0	0	981	0.0000000
zheyou73v0_A03	2201652	2203892	BnaA03T0042300ZY	0	+	0	0	2240	0.0000000
zheyou73v0_A03	2204129	2205096	BnaA03T0042400ZY	0	-	0	0	967	0.0000000
zheyou73v0_A03	2205524	2206511	BnaA03T0042500ZY	0	+	0	0	987	0.0000000
zheyou73v0_A03	2208147	2209232	BnaA03T0042600ZY	0	-	0	0	1085	0.0000000
zheyou73v0_A03	2209624	2211226	BnaA03T0042700ZY	0	+	0	0	1602	0.0000000
zheyou73v0_A03	2216115	2219101	BnaA03T0042800ZY	0	-	0	0	2986	0.0000000
zheyou73v0_A03	2221055	2222660	BnaA03T0042900ZY	0	+	0	0	1605	0.0000000
zheyou73v0_A03	2225550	2231301	BnaA03T0043000ZY	0	+	0	0	5751	0.0000000
zheyou73v0_A03	2231484	2232360	BnaA03T0043100ZY	0	+	0	0	876	0.0000000
zheyou73v0_A03	2234900	2236733	BnaA03T0043200ZY	0	-	0	0	1833	0.0000000
zheyou73v0_A03	2240831	2241584	BnaA03T0043300ZY	0	+	0	0	753	0.0000000
zheyou73v0_A03	2242905	2243608	BnaA03T0043400ZY	0	+	0	0	703	0.0000000
zheyou73v0_A03	2248785	2249289	BnaA03T0043500ZY	0	-	0	0	504	0.0000000
zheyou73v0_A03	2253990	2254738	BnaA03T0043600ZY	0	-	0	0	748	0.0000000
zheyou73v0_A03	2255989	2256631	BnaA03T0043700ZY	0	-	0	0	642	0.0000000
zheyou73v0_A03	2257061	2258419	BnaA03T0043800ZY	0	-	0	0	1358	0.0000000
zheyou73v0_A03	2259193	2261652	BnaA03T0043900ZY	0	+	0	0	2459	0.0000000
zheyou73v0_A03	2261976	2263726	BnaA03T0044000ZY	0	-	0	0	1750	0.0000000
zheyou73v0_A03	2266844	2267887	BnaA03T0044100ZY	0	-	0	0	1043	0.0000000
zheyou73v0_A03	2268458	2269248	BnaA03T0044200ZY	0	-	0	0	790	0.0000000
zheyou73v0_A03	2278330	2281331	BnaA03T0044300ZY	0	-	0	0	3001	0.0000000
zheyou73v0_A03	2282374	2291331	BnaA03T0044400ZY	0	-	0	0	8957	0.0000000
zheyou73v0_A03	2282374	2291255	BnaA03T0044400ZY.1	0	-	0	0	8881	0.0000000
zheyou73v0_A03	2282374	2291255	BnaA03T0044400ZY.2	0	-	0	0	8881	0.0000000
zheyou73v0_A03	2293348	2296964	BnaA03T0044500ZY	0	+	0	0	3616	0.0000000
zheyou73v0_A03	2297319	2297946	BnaA03T0044600ZY	0	-	0	0	627	0.0000000
zheyou73v0_A03	2298550	2300103	BnaA03T0044700ZY	0	-	0	0	1553	0.0000000
zheyou73v0_A03	2301047	2301674	BnaA03T0044800ZY	0	-	0	0	627	0.0000000
zheyou73v0_A03	2304498	2306999	BnaA03T0044900ZY	0	-	0	0	2501	0.0000000
zheyou73v0_A03	2308855	2311103	BnaA03T0045000ZY	0	+	0	0	2248	0.0000000
zheyou73v0_A03	2312191	2314427	BnaA03T0045100ZY	0	-	0	0	2236	0.0000000
zheyou73v0_A03	2330109	2332433	BnaA03T0045200ZY	0	-	0	0	2324	0.0000000
zheyou73v0_A03	2335127	2335949	BnaA03T0045300ZY	0	-	0	0	822	0.0000000
zheyou73v0_A03	2341295	2343822	BnaA03T0045400ZY	0	+	0	0	2527	0.0000000
zheyou73v0_A03	2345191	2348552	BnaA03T0045500ZY	0	+	0	0	3361	0.0000000
zheyou73v0_A03	2351165	2356593	BnaA03T0045600ZY	0	+	0	0	5428	0.0000000
zheyou73v0_A03	2380758	2382777	BnaA03T0045700ZY	0	-	0	0	2019	0.0000000
zheyou73v0_A03	2380758	2382777	BnaA03T0045700ZY.1	0	-	0	0	2019	0.0000000
zheyou73v0_A03	2380758	2382777	BnaA03T0045700ZY.2	0	-	0	0	2019	0.0000000
zheyou73v0_A03	2385724	2386780	BnaA03T0045800ZY	0	+	0	0	1056	0.0000000
zheyou73v0_A03	2388688	2389768	BnaA03T0045900ZY	0	-	0	0	1080	0.0000000
zheyou73v0_A03	2391378	2393377	BnaA03T0046000ZY	0	-	0	0	1999	0.0000000
zheyou73v0_A03	2394069	2395798	BnaA03T0046100ZY	0	+	0	0	1729	0.0000000
zheyou73v0_A03	2396259	2397080	BnaA03T0046200ZY	0	+	0	0	821	0.0000000
zheyou73v0_A03	2397104	2399312	BnaA03T0046300ZY	0	-	0	0	2208	0.0000000
zheyou73v0_A03	2400148	2404993	BnaA03T0046400ZY	0	+	0	0	4845	0.0000000
zheyou73v0_A03	2408462	2409791	BnaA03T0046500ZY	0	-	0	0	1329	0.0000000
zheyou73v0_A03	2418724	2422951	BnaA03T0046600ZY	0	+	0	0	4227	0.0000000
zheyou73v0_A03	2424879	2426551	BnaA03T0046700ZY	0	+	0	0	1672	0.0000000
zheyou73v0_A03	2426818	2428138	BnaA03T0046800ZY	0	-	0	0	1320	0.0000000
zheyou73v0_A03	2430459	2434569	BnaA03T0046900ZY	0	+	0	0	4110	0.0000000
zheyou73v0_A03	2438567	2439555	BnaA03T0047000ZY	0	+	0	0	988	0.0000000
zheyou73v0_A03	2451117	2456065	BnaA03T0047100ZY	0	-	0	0	4948	0.0000000
zheyou73v0_A03	2459994	2464143	BnaA03T0047200ZY	0	-	0	0	4149	0.0000000
zheyou73v0_A03	2467232	2468925	BnaA03T0047300ZY	0	+	0	0	1693	0.0000000
zheyou73v0_A03	2476640	2478613	BnaA03T0047400ZY	0	+	0	0	1973	0.0000000
zheyou73v0_A03	2493482	2494488	BnaA03T0047500ZY	0	-	0	0	1006	0.0000000
zheyou73v0_A03	2495643	2502182	BnaA03T0047600ZY	0	+	0	0	6539	0.0000000
zheyou73v0_A03	2503410	2504410	BnaA03T0047700ZY	0	-	0	0	1000	0.0000000
zheyou73v0_A03	2505998	2507204	BnaA03T0047800ZY	0	-	0	0	1206	0.0000000
zheyou73v0_A03	2508799	2509537	BnaA03T0047900ZY	0	-	0	0	738	0.0000000
zheyou73v0_A03	2518295	2519336	BnaA03T0048000ZY	0	-	0	0	1041	0.0000000
zheyou73v0_A03	2519485	2520422	BnaA03T0048100ZY	0	+	0	0	937	0.0000000
zheyou73v0_A03	2520903	2521084	BnaA03T0048200ZY	0	+	0	0	181	0.0000000
zheyou73v0_A03	2521139	2522444	BnaA03T0048300ZY	0	+	0	0	1305	0.0000000
zheyou73v0_A03	2522450	2530068	BnaA03T0048400ZY	0	-	0	0	7618	0.0000000
zheyou73v0_A03	2538245	2540150	BnaA03T0048500ZY	0	+	0	0	1905	0.0000000
zheyou73v0_A03	2538245	2540150	BnaA03T0048500ZY.1	0	+	0	0	1905	0.0000000
zheyou73v0_A03	2544070	2545245	BnaA03T0048600ZY	0	+	0	0	1175	0.0000000
zheyou73v0_A03	2545521	2546770	BnaA03T0048700ZY	0	-	0	0	1249	0.0000000
zheyou73v0_A03	2546904	2554037	BnaA03T0048800ZY	0	-	0	0	7133	0.0000000
zheyou73v0_A03	2560593	2563181	BnaA03T0048900ZY	0	+	0	0	2588	0.0000000
zheyou73v0_A03	2563467	2570203	BnaA03T0049000ZY	0	-	0	0	6736	0.0000000
zheyou73v0_A03	2572204	2573629	BnaA03T0049100ZY	0	-	0	0	1425	0.0000000
zheyou73v0_A03	2581273	2582796	BnaA03T0049200ZY	0	+	0	0	1523	0.0000000
zheyou73v0_A03	2586450	2586941	BnaA03T0049300ZY	0	-	0	0	491	0.0000000
zheyou73v0_A03	2587798	2590207	BnaA03T0049400ZY	0	-	0	0	2409	0.0000000
zheyou73v0_A03	2587798	2590012	BnaA03T0049400ZY.1	0	-	0	0	2214	0.0000000
zheyou73v0_A03	2590631	2594586	BnaA03T0049500ZY	0	-	0	0	3955	0.0000000
zheyou73v0_A03	2590631	2593743	BnaA03T0049500ZY.1	0	-	0	0	3112	0.0000000
zheyou73v0_A03	2597642	2600459	BnaA03T0049600ZY	0	+	0	0	2817	0.0000000
zheyou73v0_A03	2600783	2601524	BnaA03T0049700ZY	0	-	0	0	741	0.0000000
zheyou73v0_A03	2601804	2602350	BnaA03T0049800ZY	0	+	0	0	546	0.0000000
zheyou73v0_A03	2602522	2603235	BnaA03T0049900ZY	0	+	0	0	713	0.0000000
zheyou73v0_A03	2605961	2606973	BnaA03T0050000ZY	0	+	0	0	1012	0.0000000
zheyou73v0_A03	2609248	2611978	BnaA03T0050100ZY	0	+	0	0	2730	0.0000000
zheyou73v0_A03	2613001	2616166	BnaA03T0050200ZY	0	-	0	0	3165	0.0000000
zheyou73v0_A03	2613001	2616166	BnaA03T0050200ZY.1	0	-	0	0	3165	0.0000000
zheyou73v0_A03	2613001	2616166	BnaA03T0050200ZY.2	0	-	0	0	3165	0.0000000
zheyou73v0_A03	2628500	2629707	BnaA03T0050300ZY	0	+	0	0	1207	0.0000000
zheyou73v0_A03	2630329	2630581	BnaA03T0050400ZY	0	+	0	0	252	0.0000000
zheyou73v0_A03	2632267	2632681	BnaA03T0050500ZY	0	-	0	0	414	0.0000000
zheyou73v0_A03	2636353	2638534	BnaA03T0050600ZY	0	-	0	0	2181	0.0000000
zheyou73v0_A03	2638890	2641079	BnaA03T0050700ZY	0	-	0	0	2189	0.0000000
zheyou73v0_A03	2642961	2644710	BnaA03T0050800ZY	0	-	0	0	1749	0.0000000
zheyou73v0_A03	2646803	2648525	BnaA03T0050900ZY	0	+	0	0	1722	0.0000000
zheyou73v0_A03	2649829	2650965	BnaA03T0051000ZY	0	-	0	0	1136	0.0000000
zheyou73v0_A03	2652966	2656702	BnaA03T0051100ZY	0	+	0	0	3736	0.0000000
zheyou73v0_A03	2656915	2659431	BnaA03T0051200ZY	0	-	0	0	2516	0.0000000
zheyou73v0_A03	2661857	2664642	BnaA03T0051300ZY	0	+	0	0	2785	0.0000000
zheyou73v0_A03	2665624	2667612	BnaA03T0051400ZY	0	+	0	0	1988	0.0000000
zheyou73v0_A03	2667903	2669505	BnaA03T0051500ZY	0	-	0	0	1602	0.0000000
zheyou73v0_A03	2671313	2672908	BnaA03T0051600ZY	0	+	0	0	1595	0.0000000
zheyou73v0_A03	2674232	2675033	BnaA03T0051700ZY	0	+	0	0	801	0.0000000
zheyou73v0_A03	2675330	2677148	BnaA03T0051800ZY	0	+	0	0	1818	0.0000000
zheyou73v0_A03	2675691	2677148	BnaA03T0051800ZY.1	0	+	0	0	1457	0.0000000
zheyou73v0_A03	2679633	2685487	BnaA03T0051900ZY	0	-	0	0	5854	0.0000000
zheyou73v0_A03	2679633	2685487	BnaA03T0051900ZY.1	0	-	0	0	5854	0.0000000
zheyou73v0_A03	2688137	2693162	BnaA03T0052000ZY	0	+	0	0	5025	0.0000000
zheyou73v0_A03	2693429	2695064	BnaA03T0052100ZY	0	-	0	0	1635	0.0000000
zheyou73v0_A03	2695641	2696439	BnaA03T0052200ZY	0	-	0	0	798	0.0000000
zheyou73v0_A03	2696901	2699223	BnaA03T0052300ZY	0	-	0	0	2322	0.0000000
zheyou73v0_A03	2696901	2699223	BnaA03T0052300ZY.1	0	-	0	0	2322	0.0000000
zheyou73v0_A03	2707580	2707919	BnaA03T0052400ZY	0	-	0	0	339	0.0000000
zheyou73v0_A03	2711193	2711763	BnaA03T0052500ZY	0	-	0	0	570	0.0000000
zheyou73v0_A03	2718771	2719407	BnaA03T0052600ZY	0	-	0	0	636	0.0000000
zheyou73v0_A03	2719635	2724615	BnaA03T0052700ZY	0	-	0	0	4980	0.0000000
zheyou73v0_A03	2719635	2724615	BnaA03T0052700ZY.1	0	-	0	0	4980	0.0000000
zheyou73v0_A03	2726425	2728127	BnaA03T0052800ZY	0	+	0	0	1702	0.0000000
zheyou73v0_A03	2727850	2730403	BnaA03T0052900ZY	0	-	0	0	2553	0.0000000
zheyou73v0_A03	2731224	2733415	BnaA03T0053000ZY	0	-	0	0	2191	0.0000000
zheyou73v0_A03	2734713	2737036	BnaA03T0053100ZY	0	-	0	0	2323	0.0000000
zheyou73v0_A03	2741074	2742768	BnaA03T0053200ZY	0	+	0	0	1694	0.0000000
zheyou73v0_A03	2746315	2750173	BnaA03T0053300ZY	0	-	0	0	3858	0.0000000
zheyou73v0_A03	2750354	2753017	BnaA03T0053400ZY	0	-	0	0	2663	0.0000000
zheyou73v0_A03	2754739	2760299	BnaA03T0053500ZY	0	+	0	0	5560	0.0000000
zheyou73v0_A03	2760727	2767277	BnaA03T0053600ZY	0	+	0	0	6550	0.0000000
zheyou73v0_A03	2767498	2768802	BnaA03T0053700ZY	0	+	0	0	1304	0.0000000
zheyou73v0_A03	2770825	2772838	BnaA03T0053800ZY	0	+	0	0	2013	0.0000000
zheyou73v0_A03	2772850	2775805	BnaA03T0053900ZY	0	-	0	0	2955	0.0000000
zheyou73v0_A03	2776590	2778730	BnaA03T0054000ZY	0	+	0	0	2140	0.0000000
zheyou73v0_A03	2776590	2778730	BnaA03T0054000ZY.1	0	+	0	0	2140	0.0000000
zheyou73v0_A03	2781740	2785487	BnaA03T0054100ZY	0	-	0	0	3747	0.0000000
zheyou73v0_A03	2781740	2785487	BnaA03T0054100ZY.1	0	-	0	0	3747	0.0000000
zheyou73v0_A03	2786063	2786903	BnaA03T0054200ZY	0	-	0	0	840	0.0000000
zheyou73v0_A03	2787993	2790737	BnaA03T0054300ZY	0	-	0	0	2744	0.0000000
zheyou73v0_A03	2791473	2794264	BnaA03T0054400ZY	0	+	0	0	2791	0.0000000
zheyou73v0_A03	2795029	2796390	BnaA03T0054500ZY	0	-	0	0	1361	0.0000000
zheyou73v0_A03	2801234	2803730	BnaA03T0054600ZY	0	+	0	0	2496	0.0000000
zheyou73v0_A03	2809172	2811432	BnaA03T0054700ZY	0	-	0	0	2260	0.0000000
zheyou73v0_A03	2809172	2811432	BnaA03T0054700ZY.1	0	-	0	0	2260	0.0000000
zheyou73v0_A03	2811773	2812716	BnaA03T0054800ZY	0	-	0	0	943	0.0000000
zheyou73v0_A03	2815136	2817361	BnaA03T0054900ZY	0	-	0	0	2225	0.0000000
zheyou73v0_A03	2817519	2821272	BnaA03T0055000ZY	0	+	0	0	3753	0.0000000
zheyou73v0_A03	2821383	2822586	BnaA03T0055100ZY	0	+	0	0	1203	0.0000000
zheyou73v0_A03	2824804	2826475	BnaA03T0055200ZY	0	-	0	0	1671	0.0000000
zheyou73v0_A03	2826993	2827464	BnaA03T0055300ZY	0	-	0	0	471	0.0000000
zheyou73v0_A03	2827986	2828731	BnaA03T0055400ZY	0	-	0	0	745	0.0000000
zheyou73v0_A03	2829323	2830559	BnaA03T0055500ZY	0	-	0	0	1236	0.0000000
zheyou73v0_A03	2831512	2835431	BnaA03T0055600ZY	0	+	0	0	3919	0.0000000
zheyou73v0_A03	2838944	2842128	BnaA03T0055700ZY	0	+	0	0	3184	0.0000000
zheyou73v0_A03	2842363	2843509	BnaA03T0055800ZY	0	-	0	0	1146	0.0000000
zheyou73v0_A03	2845790	2847432	BnaA03T0055900ZY	0	-	0	0	1642	0.0000000
zheyou73v0_A03	2848252	2848981	BnaA03T0056000ZY	0	+	0	0	729	0.0000000
zheyou73v0_A03	2854646	2856841	BnaA03T0056100ZY	0	+	0	0	2195	0.0000000
zheyou73v0_A03	2857318	2859277	BnaA03T0056200ZY	0	-	0	0	1959	0.0000000
zheyou73v0_A03	2866814	2867129	BnaA03T0056300ZY	0	+	0	0	315	0.0000000
zheyou73v0_A03	2871508	2873246	BnaA03T0056400ZY	0	+	0	0	1738	0.0000000
zheyou73v0_A03	2874346	2875535	BnaA03T0056500ZY	0	-	0	0	1189	0.0000000
zheyou73v0_A03	2877532	2879744	BnaA03T0056600ZY	0	-	0	0	2212	0.0000000
zheyou73v0_A03	2877532	2879744	BnaA03T0056600ZY.1	0	-	0	0	2212	0.0000000
zheyou73v0_A03	2882865	2888288	BnaA03T0056700ZY	0	+	0	0	5423	0.0000000
zheyou73v0_A03	2892265	2892520	BnaA03T0056800ZY	0	+	0	0	255	0.0000000
zheyou73v0_A03	2893818	2896770	BnaA03T0056900ZY	0	-	0	0	2952	0.0000000
zheyou73v0_A03	2897223	2898667	BnaA03T0057000ZY	0	+	0	0	1444	0.0000000
zheyou73v0_A03	2899236	2899839	BnaA03T0057100ZY	0	+	0	0	603	0.0000000
zheyou73v0_A03	2901519	2906047	BnaA03T0057200ZY	0	+	0	0	4528	0.0000000
zheyou73v0_A03	2907805	2911358	BnaA03T0057300ZY	0	+	0	0	3553	0.0000000
zheyou73v0_A03	2912851	2915202	BnaA03T0057400ZY	0	+	0	0	2351	0.0000000
zheyou73v0_A03	2914360	2917238	BnaA03T0057500ZY	0	-	0	0	2878	0.0000000
zheyou73v0_A03	2918128	2920254	BnaA03T0057600ZY	0	-	0	0	2126	0.0000000
zheyou73v0_A03	2924109	2926303	BnaA03T0057700ZY	0	+	0	0	2194	0.0000000
zheyou73v0_A03	2930151	2931731	BnaA03T0057800ZY	0	-	0	0	1580	0.0000000
zheyou73v0_A03	2930151	2931731	BnaA03T0057800ZY.1	0	-	0	0	1580	0.0000000
zheyou73v0_A03	2932182	2932692	BnaA03T0057900ZY	0	+	0	0	510	0.0000000
zheyou73v0_A03	2934927	2936191	BnaA03T0058000ZY	0	+	0	0	1264	0.0000000
zheyou73v0_A03	2936709	2939938	BnaA03T0058100ZY	0	-	0	0	3229	0.0000000
zheyou73v0_A03	2940745	2942125	BnaA03T0058200ZY	0	+	0	0	1380	0.0000000
zheyou73v0_A03	2947030	2950173	BnaA03T0058300ZY	0	-	0	0	3143	0.0000000
zheyou73v0_A03	2950758	2955418	BnaA03T0058400ZY	0	-	0	0	4660	0.0000000
zheyou73v0_A03	2956775	2958462	BnaA03T0058500ZY	0	+	0	0	1687	0.0000000
zheyou73v0_A03	2965443	2966612	BnaA03T0058600ZY	0	+	0	0	1169	0.0000000
zheyou73v0_A03	2967661	2969246	BnaA03T0058700ZY	0	-	0	0	1585	0.0000000
zheyou73v0_A03	2969575	2975431	BnaA03T0058800ZY	0	+	0	0	5856	0.0000000
zheyou73v0_A03	2979190	2981026	BnaA03T0058900ZY	0	-	0	0	1836	0.0000000
zheyou73v0_A03	2981620	2982278	BnaA03T0059000ZY	0	-	0	0	658	0.0000000
zheyou73v0_A03	2987511	2990141	BnaA03T0059100ZY	0	-	0	0	2630	0.0000000
zheyou73v0_A03	2994280	2994842	BnaA03T0059200ZY	0	-	0	0	562	0.0000000
zheyou73v0_A03	2996404	2998105	BnaA03T0059300ZY	0	-	0	0	1701	0.0000000
zheyou73v0_A03	2999967	3006378	BnaA03T0059400ZY	0	-	0	0	6411	0.0000000
zheyou73v0_A03	3006712	3008673	BnaA03T0059500ZY	0	-	0	0	1961	0.0000000
zheyou73v0_A03	3009134	3013097	BnaA03T0059600ZY	0	+	0	0	3963	0.0000000
zheyou73v0_A03	3017610	3018753	BnaA03T0059700ZY	0	-	0	0	1143	0.0000000
zheyou73v0_A03	3018959	3022918	BnaA03T0059800ZY	0	-	0	0	3959	0.0000000
zheyou73v0_A03	3031920	3035984	BnaA03T0059900ZY	0	+	0	0	4064	0.0000000
zheyou73v0_A03	3036705	3042825	BnaA03T0060000ZY	0	+	0	0	6120	0.0000000
zheyou73v0_A03	3040891	3041351	BnaA03T0060100ZY	0	-	0	0	460	0.0000000
zheyou73v0_A03	3041916	3042278	BnaA03T0060200ZY	0	-	0	0	362	0.0000000
zheyou73v0_A03	3047801	3051073	BnaA03T0060300ZY	0	+	0	0	3272	0.0000000
zheyou73v0_A03	3052104	3053312	BnaA03T0060400ZY	0	-	0	0	1208	0.0000000
zheyou73v0_A03	3061746	3062994	BnaA03T0060500ZY	0	+	0	0	1248	0.0000000
zheyou73v0_A03	3062490	3063918	BnaA03T0060600ZY	0	-	0	0	1428	0.0000000
zheyou73v0_A03	3064068	3067263	BnaA03T0060700ZY	0	+	0	0	3195	0.0000000
zheyou73v0_A03	3064068	3067263	BnaA03T0060700ZY.1	0	+	0	0	3195	0.0000000
zheyou73v0_A03	3064068	3067263	BnaA03T0060700ZY.2	0	+	0	0	3195	0.0000000
zheyou73v0_A03	3075437	3078093	BnaA03T0060800ZY	0	+	0	0	2656	0.0000000
zheyou73v0_A03	3078601	3078772	BnaA03T0060900ZY	0	+	0	0	171	0.0000000
zheyou73v0_A03	3078784	3079018	BnaA03T0061000ZY	0	+	0	0	234	0.0000000
zheyou73v0_A03	3080671	3082018	BnaA03T0061100ZY	0	+	0	0	1347	0.0000000
zheyou73v0_A03	3084241	3085444	BnaA03T0061200ZY	0	+	0	0	1203	0.0000000
zheyou73v0_A03	3086120	3089110	BnaA03T0061300ZY	0	-	0	0	2990	0.0000000
zheyou73v0_A03	3089848	3092483	BnaA03T0061400ZY	0	+	0	0	2635	0.0000000
zheyou73v0_A03	3093759	3095704	BnaA03T0061500ZY	0	+	0	0	1945	0.0000000
zheyou73v0_A03	3110109	3111842	BnaA03T0061600ZY	0	-	0	0	1733	0.0000000
zheyou73v0_A03	3110109	3111842	BnaA03T0061600ZY.1	0	-	0	0	1733	0.0000000
zheyou73v0_A03	3127360	3128476	BnaA03T0061700ZY	0	+	0	0	1116	0.0000000
zheyou73v0_A03	3128681	3129467	BnaA03T0061800ZY	0	-	0	0	786	0.0000000
zheyou73v0_A03	3137782	3140219	BnaA03T0061900ZY	0	+	0	0	2437	0.0000000
zheyou73v0_A03	3143686	3145607	BnaA03T0062000ZY	0	-	0	0	1921	0.0000000
zheyou73v0_A03	3145617	3146037	BnaA03T0062100ZY	0	+	0	0	420	0.0000000
zheyou73v0_A03	3146295	3146604	BnaA03T0062200ZY	0	+	0	0	309	0.0000000
zheyou73v0_A03	3146748	3147213	BnaA03T0062300ZY	0	+	0	0	465	0.0000000
zheyou73v0_A03	3152113	3153369	BnaA03T0062400ZY	0	+	0	0	1256	0.0000000
zheyou73v0_A03	3156781	3158111	BnaA03T0062500ZY	0	+	0	0	1330	0.0000000
zheyou73v0_A03	3173320	3177975	BnaA03T0062600ZY	0	+	0	0	4655	0.0000000
zheyou73v0_A03	3178461	3181644	BnaA03T0062700ZY	0	-	0	0	3183	0.0000000
zheyou73v0_A03	3184792	3186062	BnaA03T0062800ZY	0	+	0	0	1270	0.0000000
zheyou73v0_A03	3191748	3191910	BnaA03T0062900ZY	0	-	0	0	162	0.0000000
zheyou73v0_A03	3192583	3199151	BnaA03T0063000ZY	0	-	0	0	6568	0.0000000
zheyou73v0_A03	3212081	3215659	BnaA03T0063100ZY	0	+	0	0	3578	0.0000000
zheyou73v0_A03	3217404	3219035	BnaA03T0063200ZY	0	-	0	0	1631	0.0000000
zheyou73v0_A03	3219413	3220578	BnaA03T0063300ZY	0	-	0	0	1165	0.0000000
zheyou73v0_A03	3221215	3224106	BnaA03T0063400ZY	0	-	0	0	2891	0.0000000
zheyou73v0_A03	3225590	3227868	BnaA03T0063500ZY	0	-	0	0	2278	0.0000000
zheyou73v0_A03	3228444	3232101	BnaA03T0063600ZY	0	+	0	0	3657	0.0000000
zheyou73v0_A03	3232523	3234729	BnaA03T0063700ZY	0	+	0	0	2206	0.0000000
zheyou73v0_A03	3242070	3246422	BnaA03T0063800ZY	0	+	0	0	4352	0.0000000
zheyou73v0_A03	3246617	3249631	BnaA03T0063900ZY.1	0	-	0	0	3014	0.0000000
zheyou73v0_A03	3246681	3249631	BnaA03T0063900ZY	0	-	0	0	2950	0.0000000
zheyou73v0_A03	3246681	3249631	BnaA03T0063900ZY.2	0	-	0	0	2950	0.0000000
zheyou73v0_A03	3262463	3266592	BnaA03T0064000ZY	0	+	0	0	4129	0.0000000
zheyou73v0_A03	3269919	3270937	BnaA03T0064100ZY	0	-	0	0	1018	0.0000000
zheyou73v0_A03	3271424	3272193	BnaA03T0064200ZY	0	-	0	0	769	0.0000000
zheyou73v0_A03	3273042	3273780	BnaA03T0064300ZY	0	-	0	0	738	0.0000000
zheyou73v0_A03	3274914	3277627	BnaA03T0064400ZY	0	+	0	0	2713	0.0000000
zheyou73v0_A03	3292884	3298976	BnaA03T0064500ZY	0	+	0	0	6092	0.0000000
zheyou73v0_A03	3299329	3300444	BnaA03T0064600ZY	0	+	0	0	1115	0.0000000
zheyou73v0_A03	3302848	3311524	BnaA03T0064700ZY	0	-	0	0	8676	0.0000000
zheyou73v0_A03	3312807	3316057	BnaA03T0064800ZY	0	+	0	0	3250	0.0000000
zheyou73v0_A03	3316262	3318063	BnaA03T0064900ZY	0	-	0	0	1801	0.0000000
zheyou73v0_A03	3319842	3321491	BnaA03T0065000ZY	0	+	0	0	1649	0.0000000
zheyou73v0_A03	3322615	3323925	BnaA03T0065100ZY	0	+	0	0	1310	0.0000000
zheyou73v0_A03	3325213	3325724	BnaA03T0065200ZY	0	+	0	0	511	0.0000000
zheyou73v0_A03	3336205	3337764	BnaA03T0065300ZY	0	+	0	0	1559	0.0000000
zheyou73v0_A03	3338124	3339167	BnaA03T0065400ZY	0	-	0	0	1043	0.0000000
zheyou73v0_A03	3339380	3341274	BnaA03T0065500ZY	0	-	0	0	1894	0.0000000
zheyou73v0_A03	3345253	3348056	BnaA03T0065600ZY	0	+	0	0	2803	0.0000000
zheyou73v0_A03	3348560	3351242	BnaA03T0065700ZY	0	+	0	0	2682	0.0000000
zheyou73v0_A03	3351622	3352974	BnaA03T0065800ZY	0	-	0	0	1352	0.0000000
zheyou73v0_A03	3353696	3358114	BnaA03T0065900ZY	0	-	0	0	4418	0.0000000
zheyou73v0_A03	3358371	3360695	BnaA03T0066000ZY	0	-	0	0	2324	0.0000000
zheyou73v0_A03	3358371	3360695	BnaA03T0066000ZY.1	0	-	0	0	2324	0.0000000
zheyou73v0_A03	3358371	3359805	BnaA03T0066000ZY.2	0	-	0	0	1434	0.0000000
zheyou73v0_A03	3363534	3366034	BnaA03T0066100ZY	0	-	0	0	2500	0.0000000
zheyou73v0_A03	3370696	3371789	BnaA03T0066200ZY	0	+	0	0	1093	0.0000000
zheyou73v0_A03	3373527	3375188	BnaA03T0066300ZY	0	+	0	0	1661	0.0000000
zheyou73v0_A03	3375502	3376954	BnaA03T0066400ZY	0	-	0	0	1452	0.0000000
zheyou73v0_A03	3377826	3378597	BnaA03T0066500ZY	0	+	0	0	771	0.0000000
zheyou73v0_A03	3378677	3383580	BnaA03T0066600ZY	0	+	0	0	4903	0.0000000
zheyou73v0_A03	3385297	3385789	BnaA03T0066700ZY	0	-	0	0	492	0.0000000
zheyou73v0_A03	3392480	3393238	BnaA03T0066800ZY	0	+	0	0	758	0.0000000
zheyou73v0_A03	3400000	3400669	BnaA03T0066900ZY	0	-	0	0	669	0.0000000
zheyou73v0_A03	3407253	3410589	BnaA03T0067000ZY	0	-	0	0	3336	0.0000000
zheyou73v0_A03	3411250	3411820	BnaA03T0067100ZY	0	-	0	0	570	0.0000000
zheyou73v0_A03	3414485	3416248	BnaA03T0067200ZY	0	-	0	0	1763	0.0000000
zheyou73v0_A03	3418618	3419313	BnaA03T0067300ZY	0	-	0	0	695	0.0000000
zheyou73v0_A03	3419832	3422000	BnaA03T0067400ZY	0	+	0	0	2168	0.0000000
zheyou73v0_A03	3423373	3424683	BnaA03T0067500ZY	0	+	0	0	1310	0.0000000
zheyou73v0_A03	3426952	3427423	BnaA03T0067600ZY	0	-	0	0	471	0.0000000
zheyou73v0_A03	3454828	3456365	BnaA03T0067700ZY	0	-	0	0	1537	0.0000000
zheyou73v0_A03	3460367	3460835	BnaA03T0067800ZY	0	-	0	0	468	0.0000000
zheyou73v0_A03	3466031	3469370	BnaA03T0067900ZY	0	-	0	0	3339	0.0000000
zheyou73v0_A03	3470895	3472762	BnaA03T0068000ZY	0	-	0	0	1867	0.0000000
zheyou73v0_A03	3477474	3479661	BnaA03T0068100ZY	0	+	0	0	2187	0.0000000
zheyou73v0_A03	3479927	3480547	BnaA03T0068200ZY	0	-	0	0	620	0.0000000
zheyou73v0_A03	3480812	3482896	BnaA03T0068300ZY	0	+	0	0	2084	0.0000000
zheyou73v0_A03	3501238	3501697	BnaA03T0068400ZY	0	+	0	0	459	0.0000000
zheyou73v0_A03	3502811	3505659	BnaA03T0068500ZY	0	+	0	0	2848	0.0000000
zheyou73v0_A03	3505763	3508179	BnaA03T0068600ZY	0	-	0	0	2416	0.0000000
zheyou73v0_A03	3506484	3508179	BnaA03T0068600ZY.1	0	-	0	0	1695	0.0000000
zheyou73v0_A03	3509354	3509971	BnaA03T0068700ZY	0	+	0	0	617	0.0000000
zheyou73v0_A03	3510708	3512803	BnaA03T0068800ZY	0	-	0	0	2095	0.0000000
zheyou73v0_A03	3513412	3513935	BnaA03T0068900ZY	0	-	0	0	523	0.0000000
zheyou73v0_A03	3531417	3533627	BnaA03T0069000ZY	0	+	0	0	2210	0.0000000
zheyou73v0_A03	3533638	3534205	BnaA03T0069100ZY	0	+	0	0	567	0.0000000
zheyou73v0_A03	3534156	3537608	BnaA03T0069200ZY	0	-	0	0	3452	0.0000000
zheyou73v0_A03	3534156	3537608	BnaA03T0069200ZY.1	0	-	0	0	3452	0.0000000
zheyou73v0_A03	3589405	3591359	BnaA03T0069300ZY	0	-	0	0	1954	0.0000000
zheyou73v0_A03	3591612	3597097	BnaA03T0069400ZY	0	-	0	0	5485	0.0000000
zheyou73v0_A03	3598123	3605203	BnaA03T0069500ZY	0	+	0	0	7080	0.0000000
zheyou73v0_A03	3598123	3605203	BnaA03T0069500ZY.1	0	+	0	0	7080	0.0000000
zheyou73v0_A03	3605629	3607269	BnaA03T0069600ZY	0	-	0	0	1640	0.0000000
zheyou73v0_A03	3608113	3610419	BnaA03T0069700ZY	0	-	0	0	2306	0.0000000
zheyou73v0_A03	3612954	3613630	BnaA03T0069800ZY	0	-	0	0	676	0.0000000
zheyou73v0_A03	3615055	3617283	BnaA03T0069900ZY	0	-	0	0	2228	0.0000000
zheyou73v0_A03	3620567	3623000	BnaA03T0070000ZY	0	+	0	0	2433	0.0000000
zheyou73v0_A03	3622999	3625610	BnaA03T0070100ZY	0	-	0	0	2611	0.0000000
zheyou73v0_A03	3625751	3627902	BnaA03T0070200ZY	0	-	0	0	2151	0.0000000
zheyou73v0_A03	3625751	3627902	BnaA03T0070200ZY.1	0	-	0	0	2151	0.0000000
zheyou73v0_A03	3625751	3627902	BnaA03T0070200ZY.2	0	-	0	0	2151	0.0000000
zheyou73v0_A03	3631320	3633269	BnaA03T0070300ZY	0	-	0	0	1949	0.0000000
zheyou73v0_A03	3637042	3639158	BnaA03T0070400ZY	0	-	0	0	2116	0.0000000
zheyou73v0_A03	3639579	3643276	BnaA03T0070500ZY	0	-	0	0	3697	0.0000000
zheyou73v0_A03	3643798	3645940	BnaA03T0070600ZY	0	-	0	0	2142	0.0000000
zheyou73v0_A03	3648572	3650424	BnaA03T0070700ZY	0	-	0	0	1852	0.0000000
zheyou73v0_A03	3651562	3655557	BnaA03T0070800ZY	0	+	0	0	3995	0.0000000
zheyou73v0_A03	3657305	3659653	BnaA03T0070900ZY	0	+	0	0	2348	0.0000000
zheyou73v0_A03	3658971	3662498	BnaA03T0071000ZY	0	-	0	0	3527	0.0000000
zheyou73v0_A03	3663713	3664723	BnaA03T0071100ZY	0	-	0	0	1010	0.0000000
zheyou73v0_A03	3665214	3667670	BnaA03T0071200ZY	0	-	0	0	2456	0.0000000
zheyou73v0_A03	3668741	3672179	BnaA03T0071300ZY	0	+	0	0	3438	0.0000000
zheyou73v0_A03	3672642	3673877	BnaA03T0071400ZY	0	+	0	0	1235	0.0000000
zheyou73v0_A03	3674168	3675416	BnaA03T0071500ZY	0	-	0	0	1248	0.0000000
zheyou73v0_A03	3674168	3675416	BnaA03T0071500ZY.1	0	-	0	0	1248	0.0000000
zheyou73v0_A03	3677979	3678819	BnaA03T0071600ZY	0	-	0	0	840	0.0000000
zheyou73v0_A03	3680358	3684995	BnaA03T0071700ZY	0	+	0	0	4637	0.0000000
zheyou73v0_A03	3684934	3687074	BnaA03T0071800ZY	0	-	0	0	2140	0.0000000
zheyou73v0_A03	3688090	3690155	BnaA03T0071900ZY	0	-	0	0	2065	0.0000000
zheyou73v0_A03	3700383	3702973	BnaA03T0072000ZY	0	+	0	0	2590	0.0000000
zheyou73v0_A03	3703641	3705629	BnaA03T0072100ZY	0	-	0	0	1988	0.0000000
zheyou73v0_A03	3720287	3721568	BnaA03T0072200ZY	0	+	0	0	1281	0.0000000
zheyou73v0_A03	3737862	3739742	BnaA03T0072300ZY	0	+	0	0	1880	0.0000000
zheyou73v0_A03	3737862	3739742	BnaA03T0072300ZY.1	0	+	0	0	1880	0.0000000
zheyou73v0_A03	3737862	3739122	BnaA03T0072300ZY.2	0	+	0	0	1260	0.0000000
zheyou73v0_A03	3737862	3739742	BnaA03T0072300ZY.3	0	+	0	0	1880	0.0000000
zheyou73v0_A03	3737862	3739742	BnaA03T0072300ZY.4	0	+	0	0	1880	0.0000000
zheyou73v0_A03	3739992	3740172	BnaA03T0072400ZY	0	-	0	0	180	0.0000000
zheyou73v0_A03	3746940	3747505	BnaA03T0072500ZY	0	-	0	0	565	0.0000000
zheyou73v0_A03	3747585	3747969	BnaA03T0072600ZY	0	-	0	0	384	0.0000000
zheyou73v0_A03	3748348	3749017	BnaA03T0072700ZY	0	-	0	0	669	0.0000000
zheyou73v0_A03	3752710	3760409	BnaA03T0072800ZY	0	+	0	0	7699	0.0000000
zheyou73v0_A03	3761788	3763200	BnaA03T0072900ZY	0	-	0	0	1412	0.0000000
zheyou73v0_A03	3763973	3769413	BnaA03T0073000ZY	0	-	0	0	5440	0.0000000
zheyou73v0_A03	3795546	3799363	BnaA03T0073100ZY	0	+	0	0	3817	0.0000000
zheyou73v0_A03	3804062	3806343	BnaA03T0073200ZY	0	-	0	0	2281	0.0000000
zheyou73v0_A03	3806781	3808519	BnaA03T0073300ZY	0	-	0	0	1738	0.0000000
zheyou73v0_A03	3809013	3810791	BnaA03T0073400ZY	0	-	0	0	1778	0.0000000
zheyou73v0_A03	3810926	3812407	BnaA03T0073500ZY.1	0	-	0	0	1481	0.0000000
zheyou73v0_A03	3810943	3812407	BnaA03T0073500ZY	0	-	0	0	1464	0.0000000
zheyou73v0_A03	3813267	3816089	BnaA03T0073600ZY	0	+	0	0	2822	0.0000000
zheyou73v0_A03	3813267	3816089	BnaA03T0073600ZY.1	0	+	0	0	2822	0.0000000
zheyou73v0_A03	3816087	3820679	BnaA03T0073700ZY	0	-	0	0	4592	0.0000000
zheyou73v0_A03	3816087	3820679	BnaA03T0073700ZY.1	0	-	0	0	4592	0.0000000
zheyou73v0_A03	3821947	3826880	BnaA03T0073800ZY	0	+	0	0	4933	0.0000000
zheyou73v0_A03	3828868	3836571	BnaA03T0073900ZY	0	+	0	0	7703	0.0000000
zheyou73v0_A03	3836973	3840830	BnaA03T0074000ZY	0	-	0	0	3857	0.0000000
zheyou73v0_A03	3844378	3845563	BnaA03T0074100ZY	0	+	0	0	1185	0.0000000
zheyou73v0_A03	3846532	3848347	BnaA03T0074200ZY	0	+	0	0	1815	0.0000000
zheyou73v0_A03	3848745	3848973	BnaA03T0074300ZY	0	-	0	0	228	0.0000000
zheyou73v0_A03	3849891	3855039	BnaA03T0074400ZY	0	-	0	0	5148	0.0000000
zheyou73v0_A03	3858715	3860614	BnaA03T0074500ZY	0	+	0	0	1899	0.0000000
zheyou73v0_A03	3861264	3864555	BnaA03T0074600ZY	0	-	0	0	3291	0.0000000
zheyou73v0_A03	3866110	3869335	BnaA03T0074700ZY	0	-	0	0	3225	0.0000000
zheyou73v0_A03	3872566	3874934	BnaA03T0074800ZY	0	+	0	0	2368	0.0000000
zheyou73v0_A03	3877409	3880599	BnaA03T0074900ZY	0	+	0	0	3190	0.0000000
zheyou73v0_A03	3880689	3882540	BnaA03T0075000ZY	0	-	0	0	1851	0.0000000
zheyou73v0_A03	3883152	3885536	BnaA03T0075100ZY	0	-	0	0	2384	0.0000000
zheyou73v0_A03	3883152	3885736	BnaA03T0075100ZY.1	0	-	0	0	2584	0.0000000
zheyou73v0_A03	3886383	3888095	BnaA03T0075200ZY	0	+	0	0	1712	0.0000000
zheyou73v0_A03	3893457	3896124	BnaA03T0075300ZY	0	+	0	0	2667	0.0000000
zheyou73v0_A03	3893457	3896755	BnaA03T0075300ZY.1	0	+	0	0	3298	0.0000000
zheyou73v0_A03	3897154	3899920	BnaA03T0075400ZY	0	-	0	0	2766	0.0000000
zheyou73v0_A03	3902566	3903586	BnaA03T0075500ZY	0	-	0	0	1020	0.0000000
zheyou73v0_A03	3904106	3905042	BnaA03T0075600ZY	0	-	0	0	936	0.0000000
zheyou73v0_A03	3907918	3908557	BnaA03T0075700ZY	0	-	0	0	639	0.0000000
zheyou73v0_A03	3912172	3913646	BnaA03T0075800ZY	0	-	0	0	1474	0.0000000
zheyou73v0_A03	3917629	3921046	BnaA03T0075900ZY	0	-	0	0	3417	0.0000000
zheyou73v0_A03	3921733	3925716	BnaA03T0076000ZY	0	+	0	0	3983	0.0000000
zheyou73v0_A03	3926196	3931738	BnaA03T0076100ZY	0	+	0	0	5542	0.0000000
zheyou73v0_A03	3931936	3934059	BnaA03T0076200ZY	0	-	0	0	2123	0.0000000
zheyou73v0_A03	3935121	3936593	BnaA03T0076300ZY	0	+	0	0	1472	0.0000000
zheyou73v0_A03	3939453	3939981	BnaA03T0076400ZY	0	+	0	0	528	0.0000000
zheyou73v0_A03	3955297	3955565	BnaA03T0076500ZY	0	-	0	0	268	0.0000000
zheyou73v0_A03	3956767	3958337	BnaA03T0076600ZY	0	+	0	0	1570	0.0000000
zheyou73v0_A03	3959399	3962356	BnaA03T0076700ZY	0	-	0	0	2957	0.0000000
zheyou73v0_A03	3962670	3965231	BnaA03T0076800ZY	0	+	0	0	2561	0.0000000
zheyou73v0_A03	3967635	3968978	BnaA03T0076900ZY	0	-	0	0	1343	0.0000000
zheyou73v0_A03	3975709	3976120	BnaA03T0077000ZY	0	+	0	0	411	0.0000000
zheyou73v0_A03	3984375	3985986	BnaA03T0077100ZY	0	+	0	0	1611	0.0000000
zheyou73v0_A03	3987871	3988282	BnaA03T0077200ZY	0	+	0	0	411	0.0000000
zheyou73v0_A03	3991093	3993126	BnaA03T0077300ZY	0	+	0	0	2033	0.0000000
zheyou73v0_A03	4007601	4010580	BnaA03T0077400ZY	0	+	0	0	2979	0.0000000
zheyou73v0_A03	4011572	4013188	BnaA03T0077500ZY	0	+	0	0	1616	0.0000000
zheyou73v0_A03	4013235	4014591	BnaA03T0077600ZY	0	-	0	0	1356	0.0000000
zheyou73v0_A03	4015317	4020738	BnaA03T0077700ZY	0	-	0	0	5421	0.0000000
zheyou73v0_A03	4026417	4029994	BnaA03T0077800ZY	0	+	0	0	3577	0.0000000
zheyou73v0_A03	4030216	4031509	BnaA03T0077900ZY	0	-	0	0	1293	0.0000000
zheyou73v0_A03	4034324	4036502	BnaA03T0078000ZY	0	-	0	0	2178	0.0000000
zheyou73v0_A03	4044164	4045030	BnaA03T0078100ZY	0	-	0	0	866	0.0000000
zheyou73v0_A03	4045183	4047995	BnaA03T0078200ZY	0	+	0	0	2812	0.0000000
zheyou73v0_A03	4049341	4051262	BnaA03T0078300ZY	0	+	0	0	1921	0.0000000
zheyou73v0_A03	4051647	4052403	BnaA03T0078400ZY	0	-	0	0	756	0.0000000
zheyou73v0_A03	4053895	4054200	BnaA03T0078500ZY	0	-	0	0	305	0.0000000
zheyou73v0_A03	4059403	4060610	BnaA03T0078600ZY	0	+	0	0	1207	0.0000000
zheyou73v0_A03	4062708	4064640	BnaA03T0078700ZY	0	-	0	0	1932	0.0000000
zheyou73v0_A03	4068376	4069145	BnaA03T0078800ZY	0	+	0	0	769	0.0000000
zheyou73v0_A03	4070140	4071273	BnaA03T0078900ZY	0	-	0	0	1133	0.0000000
zheyou73v0_A03	4076514	4077246	BnaA03T0079000ZY	0	-	0	0	732	0.0000000
zheyou73v0_A03	4078100	4083666	BnaA03T0079100ZY	0	-	0	0	5566	0.0000000
zheyou73v0_A03	4085142	4088098	BnaA03T0079200ZY	0	+	0	0	2956	0.0000000
zheyou73v0_A03	4088779	4090167	BnaA03T0079300ZY	0	-	0	0	1388	0.0000000
zheyou73v0_A03	4092572	4094442	BnaA03T0079400ZY	0	+	0	0	1870	0.0000000
zheyou73v0_A03	4095792	4096305	BnaA03T0079500ZY	0	-	0	0	513	0.0000000
zheyou73v0_A03	4102185	4103912	BnaA03T0079600ZY	0	-	0	0	1727	0.0000000
zheyou73v0_A03	4106394	4107536	BnaA03T0079700ZY	0	-	0	0	1142	0.0000000
zheyou73v0_A03	4109465	4112651	BnaA03T0079800ZY	0	-	0	0	3186	0.0000000
zheyou73v0_A03	4114902	4119855	BnaA03T0079900ZY	0	-	0	0	4953	0.0000000
zheyou73v0_A03	4120350	4123431	BnaA03T0080000ZY	0	-	0	0	3081	0.0000000
zheyou73v0_A03	4124041	4126431	BnaA03T0080100ZY	0	-	0	0	2390	0.0000000
zheyou73v0_A03	4127400	4128881	BnaA03T0080200ZY	0	+	0	0	1481	0.0000000
zheyou73v0_A03	4128731	4129531	BnaA03T0080300ZY	0	-	0	0	800	0.0000000
zheyou73v0_A03	4129632	4133761	BnaA03T0080400ZY	0	-	0	0	4129	0.0000000
zheyou73v0_A03	4136106	4136615	BnaA03T0080500ZY	0	-	0	0	509	0.0000000
zheyou73v0_A03	4138265	4138529	BnaA03T0080600ZY	0	+	0	0	264	0.0000000
zheyou73v0_A03	4139678	4142064	BnaA03T0080700ZY	0	+	0	0	2386	0.0000000
zheyou73v0_A03	4142117	4143767	BnaA03T0080800ZY	0	-	0	0	1650	0.0000000
zheyou73v0_A03	4147365	4149594	BnaA03T0080900ZY	0	+	0	0	2229	0.0000000
zheyou73v0_A03	4150303	4154559	BnaA03T0081000ZY	0	+	0	0	4256	0.0000000
zheyou73v0_A03	4155140	4157272	BnaA03T0081100ZY	0	+	0	0	2132	0.0000000
zheyou73v0_A03	4158913	4163908	BnaA03T0081200ZY	0	+	0	0	4995	0.0000000
zheyou73v0_A03	4164118	4164298	BnaA03T0081300ZY	0	-	0	0	180	0.0000000
zheyou73v0_A03	4164805	4166675	BnaA03T0081400ZY	0	+	0	0	1870	0.0000000
zheyou73v0_A03	4166950	4171142	BnaA03T0081500ZY	0	-	0	0	4192	0.0000000
zheyou73v0_A03	4172128	4178404	BnaA03T0081600ZY	0	-	0	0	6276	0.0000000
zheyou73v0_A03	4180969	4194256	BnaA03T0081700ZY	0	+	0	0	13287	0.0000000
zheyou73v0_A03	4194840	4197102	BnaA03T0081800ZY	0	+	0	0	2262	0.0000000
zheyou73v0_A03	4197558	4199756	BnaA03T0081900ZY	0	+	0	0	2198	0.0000000
zheyou73v0_A03	4197558	4199756	BnaA03T0081900ZY.1	0	+	0	0	2198	0.0000000
zheyou73v0_A03	4201157	4202992	BnaA03T0082000ZY	0	+	0	0	1835	0.0000000
zheyou73v0_A03	4204202	4204899	BnaA03T0082100ZY	0	-	0	0	697	0.0000000
zheyou73v0_A03	4209238	4211588	BnaA03T0082200ZY	0	+	0	0	2350	0.0000000
zheyou73v0_A03	4212009	4214503	BnaA03T0082300ZY	0	+	0	0	2494	0.0000000
zheyou73v0_A03	4216662	4218403	BnaA03T0082400ZY	0	-	0	0	1741	0.0000000
zheyou73v0_A03	4234146	4235163	BnaA03T0082500ZY	0	-	0	0	1017	0.0000000
zheyou73v0_A03	4237955	4242146	BnaA03T0082600ZY	0	-	0	0	4191	0.0000000
zheyou73v0_A03	4243480	4244736	BnaA03T0082700ZY	0	-	0	0	1256	0.0000000
zheyou73v0_A03	4245547	4246197	BnaA03T0082800ZY	0	-	0	0	650	0.0000000
zheyou73v0_A03	4249561	4250733	BnaA03T0082900ZY	0	+	0	0	1172	0.0000000
zheyou73v0_A03	4249561	4250733	BnaA03T0082900ZY.1	0	+	0	0	1172	0.0000000
zheyou73v0_A03	4251502	4252193	BnaA03T0083000ZY	0	-	0	0	691	0.0000000
zheyou73v0_A03	4254482	4254976	BnaA03T0083100ZY	0	+	0	0	494	0.0000000
zheyou73v0_A03	4255988	4259514	BnaA03T0083200ZY	0	+	0	0	3526	0.0000000
zheyou73v0_A03	4255988	4259592	BnaA03T0083200ZY.1	0	+	0	0	3604	0.0000000
zheyou73v0_A03	4260394	4261145	BnaA03T0083300ZY	0	+	0	0	751	0.0000000
zheyou73v0_A03	4264477	4265720	BnaA03T0083400ZY	0	+	0	0	1243	0.0000000
zheyou73v0_A03	4272887	4273783	BnaA03T0083500ZY.1	0	+	0	0	896	0.0000000
zheyou73v0_A03	4272953	4273783	BnaA03T0083500ZY	0	+	0	0	830	0.0000000
zheyou73v0_A03	4272953	4273783	BnaA03T0083500ZY.2	0	+	0	0	830	0.0000000
zheyou73v0_A03	4275200	4276173	BnaA03T0083600ZY	0	-	0	0	973	0.0000000
zheyou73v0_A03	4283817	4285218	BnaA03T0083700ZY	0	+	0	0	1401	0.0000000
zheyou73v0_A03	4285902	4288252	BnaA03T0083800ZY	0	+	0	0	2350	0.0000000
zheyou73v0_A03	4288289	4289013	BnaA03T0083900ZY	0	-	0	0	724	0.0000000
zheyou73v0_A03	4290319	4293400	BnaA03T0084000ZY	0	-	0	0	3081	0.0000000
zheyou73v0_A03	4297666	4300301	BnaA03T0084100ZY	0	-	0	0	2635	0.0000000
zheyou73v0_A03	4302268	4304253	BnaA03T0084200ZY	0	-	0	0	1985	0.0000000
zheyou73v0_A03	4305790	4307634	BnaA03T0084300ZY	0	+	0	0	1844	0.0000000
zheyou73v0_A03	4307866	4310687	BnaA03T0084400ZY	0	-	0	0	2821	0.0000000
zheyou73v0_A03	4311691	4312313	BnaA03T0084500ZY	0	+	0	0	622	0.0000000
zheyou73v0_A03	4313056	4315330	BnaA03T0084600ZY	0	+	0	0	2274	0.0000000
zheyou73v0_A03	4317510	4318242	BnaA03T0084700ZY	0	+	0	0	732	0.0000000
zheyou73v0_A03	4321602	4322206	BnaA03T0084800ZY	0	-	0	0	604	0.0000000
zheyou73v0_A03	4328928	4329516	BnaA03T0084900ZY	0	+	0	0	588	0.0000000
zheyou73v0_A03	4335235	4335502	BnaA03T0085000ZY	0	-	0	0	267	0.0000000
zheyou73v0_A03	4358208	4358984	BnaA03T0085100ZY	0	+	0	0	776	0.0000000
zheyou73v0_A03	4360402	4361855	BnaA03T0085200ZY	0	-	0	0	1453	0.0000000
zheyou73v0_A03	4384952	4389431	BnaA03T0085300ZY	0	+	0	0	4479	0.0000000
zheyou73v0_A03	4394205	4403678	BnaA03T0085400ZY	0	-	0	0	9473	0.0000000
zheyou73v0_A03	4404461	4406429	BnaA03T0085500ZY	0	+	0	0	1968	0.0000000
zheyou73v0_A03	4416509	4417474	BnaA03T0085600ZY	0	-	0	0	965	0.0000000
zheyou73v0_A03	4418766	4420973	BnaA03T0085700ZY	0	+	0	0	2207	0.0000000
zheyou73v0_A03	4423282	4467332	BnaA03T0085800ZY	0	-	0	0	44050	0.0000000
zheyou73v0_A03	4435038	4435581	BnaA03T0085900ZY	0	+	0	0	543	0.0000000
zheyou73v0_A03	4436969	4437449	BnaA03T0086000ZY	0	-	0	0	480	0.0000000
zheyou73v0_A03	4438244	4440890	BnaA03T0086100ZY	0	+	0	0	2646	0.0000000
zheyou73v0_A03	4442225	4443434	BnaA03T0086200ZY	0	-	0	0	1209	0.0000000
zheyou73v0_A03	4456595	4457208	BnaA03T0086300ZY	0	+	0	0	613	0.0000000
zheyou73v0_A03	4457244	4458480	BnaA03T0086400ZY	0	-	0	0	1236	0.0000000
zheyou73v0_A03	4458907	4460549	BnaA03T0086500ZY	0	+	0	0	1642	0.0000000
zheyou73v0_A03	4473850	4475264	BnaA03T0086600ZY	0	+	0	0	1414	0.0000000
zheyou73v0_A03	4476251	4477181	BnaA03T0086700ZY	0	+	0	0	930	0.0000000
zheyou73v0_A03	4477815	4479968	BnaA03T0086800ZY	0	-	0	0	2153	0.0000000
zheyou73v0_A03	4482149	4485069	BnaA03T0086900ZY	0	+	0	0	2920	0.0000000
zheyou73v0_A03	4489106	4489313	BnaA03T0087000ZY	0	+	0	0	207	0.0000000
zheyou73v0_A03	4504736	4505321	BnaA03T0087100ZY	0	+	0	0	585	0.0000000
zheyou73v0_A03	4508212	4508797	BnaA03T0087200ZY	0	+	0	0	585	0.0000000
zheyou73v0_A03	4509405	4509792	BnaA03T0087300ZY	0	+	0	0	387	0.0000000
zheyou73v0_A03	4509826	4510882	BnaA03T0087400ZY	0	+	0	0	1056	0.0000000
zheyou73v0_A03	4511966	4512770	BnaA03T0087500ZY	0	-	0	0	804	0.0000000
zheyou73v0_A03	4515014	4515311	BnaA03T0087600ZY	0	-	0	0	297	0.0000000
zheyou73v0_A03	4516000	4517510	BnaA03T0087700ZY	0	+	0	0	1510	0.0000000
zheyou73v0_A03	4523094	4526801	BnaA03T0087800ZY	0	+	0	0	3707	0.0000000
zheyou73v0_A03	4528186	4529508	BnaA03T0087900ZY	0	+	0	0	1322	0.0000000
zheyou73v0_A03	4529604	4530696	BnaA03T0088000ZY	0	+	0	0	1092	0.0000000
zheyou73v0_A03	4536045	4539234	BnaA03T0088100ZY	0	+	0	0	3189	0.0000000
zheyou73v0_A03	4536045	4539234	BnaA03T0088100ZY.1	0	+	0	0	3189	0.0000000
zheyou73v0_A03	4540635	4541542	BnaA03T0088200ZY	0	+	0	0	907	0.0000000
zheyou73v0_A03	4549918	4552263	BnaA03T0088300ZY	0	+	0	0	2345	0.0000000
zheyou73v0_A03	4549918	4552263	BnaA03T0088300ZY.1	0	+	0	0	2345	0.0000000
zheyou73v0_A03	4552683	4556184	BnaA03T0088400ZY	0	-	0	0	3501	0.0000000
zheyou73v0_A03	4559291	4560846	BnaA03T0088500ZY	0	-	0	0	1555	0.0000000
zheyou73v0_A03	4559291	4560846	BnaA03T0088500ZY.1	0	-	0	0	1555	0.0000000
zheyou73v0_A03	4563135	4564692	BnaA03T0088600ZY	0	+	0	0	1557	0.0000000
zheyou73v0_A03	4565356	4568478	BnaA03T0088700ZY	0	+	0	0	3122	0.0000000
zheyou73v0_A03	4573688	4575259	BnaA03T0088800ZY	0	+	0	0	1571	0.0000000
zheyou73v0_A03	4576345	4581636	BnaA03T0088900ZY	0	-	0	0	5291	0.0000000
zheyou73v0_A03	4576345	4581636	BnaA03T0088900ZY.1	0	-	0	0	5291	0.0000000
zheyou73v0_A03	4585585	4587570	BnaA03T0089000ZY	0	-	0	0	1985	0.0000000
zheyou73v0_A03	4589119	4589904	BnaA03T0089100ZY	0	-	0	0	785	0.0000000
zheyou73v0_A03	4590494	4595763	BnaA03T0089200ZY	0	+	0	0	5269	0.0000000
zheyou73v0_A03	4590494	4595763	BnaA03T0089200ZY.1	0	+	0	0	5269	0.0000000
zheyou73v0_A03	4621796	4629690	BnaA03T0089300ZY	0	-	0	0	7894	0.0000000
zheyou73v0_A03	4629964	4634072	BnaA03T0089400ZY	0	+	0	0	4108	0.0000000
zheyou73v0_A03	4633972	4635836	BnaA03T0089500ZY	0	-	0	0	1864	0.0000000
zheyou73v0_A03	4664476	4666305	BnaA03T0089600ZY	0	-	0	0	1829	0.0000000
zheyou73v0_A03	4667108	4668348	BnaA03T0089700ZY	0	-	0	0	1240	0.0000000
zheyou73v0_A03	4669365	4671679	BnaA03T0089800ZY	0	-	0	0	2314	0.0000000
zheyou73v0_A03	4678222	4680202	BnaA03T0089900ZY	0	+	0	0	1980	0.0000000
zheyou73v0_A03	4680604	4682529	BnaA03T0090000ZY	0	+	0	0	1925	0.0000000
zheyou73v0_A03	4683189	4684029	BnaA03T0090100ZY	0	+	0	0	840	0.0000000
zheyou73v0_A03	4683991	4685229	BnaA03T0090200ZY	0	-	0	0	1238	0.0000000
zheyou73v0_A03	4686147	4686722	BnaA03T0090300ZY	0	+	0	0	575	0.0000000
zheyou73v0_A03	4687770	4690204	BnaA03T0090400ZY	0	-	0	0	2434	0.0000000
zheyou73v0_A03	4691491	4694613	BnaA03T0090500ZY	0	-	0	0	3122	0.0000000
zheyou73v0_A03	4699283	4701368	BnaA03T0090600ZY	0	+	0	0	2085	0.0000000
zheyou73v0_A03	4702139	4703036	BnaA03T0090700ZY	0	+	0	0	897	0.0000000
zheyou73v0_A03	4703358	4708628	BnaA03T0090800ZY	0	-	0	0	5270	0.0000000
zheyou73v0_A03	4706802	4708628	BnaA03T0090800ZY.2	0	-	0	0	1826	0.0000000
zheyou73v0_A03	4707088	4708628	BnaA03T0090800ZY.1	0	-	0	0	1540	0.0000000
zheyou73v0_A03	4730169	4732009	BnaA03T0090900ZY	0	-	0	0	1840	0.0000000
zheyou73v0_A03	4730169	4732009	BnaA03T0090900ZY.1	0	-	0	0	1840	0.0000000
zheyou73v0_A03	4732316	4733465	BnaA03T0091000ZY	0	-	0	0	1149	0.0000000
zheyou73v0_A03	4732316	4733465	BnaA03T0091000ZY.1	0	-	0	0	1149	0.0000000
zheyou73v0_A03	4733586	4739422	BnaA03T0091100ZY	0	-	0	0	5836	0.0000000
zheyou73v0_A03	4733586	4737305	BnaA03T0091100ZY.1	0	-	0	0	3719	0.0000000
zheyou73v0_A03	4740974	4746663	BnaA03T0091200ZY	0	+	0	0	5689	0.0000000
zheyou73v0_A03	4748132	4751308	BnaA03T0091300ZY	0	+	0	0	3176	0.0000000
zheyou73v0_A03	4752034	4753481	BnaA03T0091400ZY	0	+	0	0	1447	0.0000000
zheyou73v0_A03	4761434	4769525	BnaA03T0091500ZY	0	+	0	0	8091	0.0000000
zheyou73v0_A03	4774150	4775676	BnaA03T0091600ZY	0	+	0	0	1526	0.0000000
zheyou73v0_A03	4777841	4779836	BnaA03T0091700ZY	0	-	0	0	1995	0.0000000
zheyou73v0_A03	4785497	4785818	BnaA03T0091800ZY	0	+	0	0	321	0.0000000
zheyou73v0_A03	4792396	4792718	BnaA03T0091900ZY	0	+	0	0	322	0.0000000
zheyou73v0_A03	4796755	4797287	BnaA03T0092000ZY	0	+	0	0	532	0.0000000
zheyou73v0_A03	4797925	4798416	BnaA03T0092100ZY	0	+	0	0	491	0.0000000
zheyou73v0_A03	4802686	4804274	BnaA03T0092200ZY	0	+	0	0	1588	0.0000000
zheyou73v0_A03	4808192	4808812	BnaA03T0092300ZY	0	+	0	0	620	0.0000000
zheyou73v0_A03	4813553	4813831	BnaA03T0092400ZY	0	+	0	0	278	0.0000000
zheyou73v0_A03	4815780	4817894	BnaA03T0092500ZY	0	-	0	0	2114	0.0000000
zheyou73v0_A03	4818924	4821040	BnaA03T0092600ZY	0	+	0	0	2116	0.0000000
zheyou73v0_A03	4827651	4830071	BnaA03T0092700ZY	0	+	0	0	2420	0.0000000
zheyou73v0_A03	4830853	4833357	BnaA03T0092800ZY	0	+	0	0	2504	0.0000000
zheyou73v0_A03	4834731	4835145	BnaA03T0092900ZY	0	-	0	0	414	0.0000000
zheyou73v0_A03	4836383	4837755	BnaA03T0093000ZY	0	+	0	0	1372	0.0000000
zheyou73v0_A03	4838154	4840511	BnaA03T0093100ZY	0	+	0	0	2357	0.0000000
zheyou73v0_A03	4840871	4841282	BnaA03T0093200ZY	0	-	0	0	411	0.0000000
zheyou73v0_A03	4841760	4842383	BnaA03T0093300ZY	0	+	0	0	623	0.0000000
zheyou73v0_A03	4843057	4845458	BnaA03T0093400ZY	0	-	0	0	2401	0.0000000
zheyou73v0_A03	4846766	4854502	BnaA03T0093500ZY	0	+	0	0	7736	0.0000000
zheyou73v0_A03	4846766	4854502	BnaA03T0093500ZY.1	0	+	0	0	7736	0.0000000
zheyou73v0_A03	4868073	4872119	BnaA03T0093600ZY	0	+	0	0	4046	0.0000000
zheyou73v0_A03	4890281	4892787	BnaA03T0093700ZY	0	-	0	0	2506	0.0000000
zheyou73v0_A03	4893608	4896676	BnaA03T0093800ZY	0	-	0	0	3068	0.0000000
zheyou73v0_A03	4899450	4899837	BnaA03T0093900ZY	0	-	0	0	387	0.0000000
zheyou73v0_A03	4901155	4903637	BnaA03T0094000ZY	0	-	0	0	2482	0.0000000
zheyou73v0_A03	4905206	4912756	BnaA03T0094100ZY	0	-	0	0	7550	0.0000000
zheyou73v0_A03	4921758	4925073	BnaA03T0094200ZY	0	-	0	0	3315	0.0000000
zheyou73v0_A03	4927740	4933120	BnaA03T0094300ZY	0	+	0	0	5380	0.0000000
zheyou73v0_A03	4932577	4934384	BnaA03T0094400ZY	0	-	0	0	1807	0.0000000
zheyou73v0_A03	4939641	4943098	BnaA03T0094500ZY	0	-	0	0	3457	0.0000000
zheyou73v0_A03	4947994	4951975	BnaA03T0094600ZY	0	-	0	0	3981	0.0000000
zheyou73v0_A03	4953773	4956428	BnaA03T0094700ZY	0	+	0	0	2655	0.0000000
zheyou73v0_A03	4962918	5006535	BnaA03T0094800ZY	0	+	0	0	43617	0.0000000
zheyou73v0_A03	4962918	5006175	BnaA03T0094800ZY.1	0	+	0	0	43257	0.0000000
zheyou73v0_A03	5006657	5011676	BnaA03T0094900ZY	0	-	0	0	5019	0.0000000
zheyou73v0_A03	5006657	5011186	BnaA03T0094900ZY.1	0	-	0	0	4529	0.0000000
zheyou73v0_A03	5012538	5016060	BnaA03T0095000ZY	0	+	0	0	3522	0.0000000
zheyou73v0_A03	5016901	5017342	BnaA03T0095100ZY	0	-	0	0	441	0.0000000
zheyou73v0_A03	5026368	5032703	BnaA03T0095200ZY	0	-	0	0	6335	0.0000000
zheyou73v0_A03	5039333	5039765	BnaA03T0095300ZY	0	+	0	0	432	0.0000000
zheyou73v0_A03	5042735	5043131	BnaA03T0095400ZY	0	-	0	0	396	0.0000000
zheyou73v0_A03	5043725	5044986	BnaA03T0095500ZY	0	+	0	0	1261	0.0000000
zheyou73v0_A03	5045303	5046375	BnaA03T0095600ZY	0	-	0	0	1072	0.0000000
zheyou73v0_A03	5048212	5049502	BnaA03T0095700ZY	0	-	0	0	1290	0.0000000
zheyou73v0_A03	5051658	5053414	BnaA03T0095800ZY	0	-	0	0	1756	0.0000000
zheyou73v0_A03	5054472	5056337	BnaA03T0095900ZY	0	-	0	0	1865	0.0000000
zheyou73v0_A03	5058589	5060553	BnaA03T0096000ZY	0	-	0	0	1964	0.0000000
zheyou73v0_A03	5063496	5065725	BnaA03T0096100ZY	0	-	0	0	2229	0.0000000
zheyou73v0_A03	5063496	5065745	BnaA03T0096100ZY.1	0	-	0	0	2249	0.0000000
zheyou73v0_A03	5067663	5070463	BnaA03T0096200ZY	0	-	0	0	2800	0.0000000
zheyou73v0_A03	5073655	5075613	BnaA03T0096300ZY	0	+	0	0	1958	0.0000000
zheyou73v0_A03	5076296	5078240	BnaA03T0096400ZY	0	-	0	0	1944	0.0000000
zheyou73v0_A03	5079314	5079833	BnaA03T0096500ZY	0	+	0	0	519	0.0000000
zheyou73v0_A03	5081913	5083017	BnaA03T0096600ZY	0	-	0	0	1104	0.0000000
zheyou73v0_A03	5084062	5089154	BnaA03T0096700ZY	0	-	0	0	5092	0.0000000
zheyou73v0_A03	5084914	5089154	BnaA03T0096700ZY.1	0	-	0	0	4240	0.0000000
zheyou73v0_A03	5090508	5095716	BnaA03T0096800ZY	0	+	0	0	5208	0.0000000
zheyou73v0_A03	5098147	5100032	BnaA03T0096900ZY	0	+	0	0	1885	0.0000000
zheyou73v0_A03	5101407	5106034	BnaA03T0097000ZY	0	+	0	0	4627	0.0000000
zheyou73v0_A03	5101407	5106034	BnaA03T0097000ZY.1	0	+	0	0	4627	0.0000000
zheyou73v0_A03	5108715	5113857	BnaA03T0097100ZY	0	+	0	0	5142	0.0000000
zheyou73v0_A03	5122479	5122860	BnaA03T0097200ZY	0	+	0	0	381	0.0000000
zheyou73v0_A03	5122966	5124079	BnaA03T0097300ZY	0	+	0	0	1113	0.0000000
zheyou73v0_A03	5128215	5130274	BnaA03T0097400ZY	0	+	0	0	2059	0.0000000
zheyou73v0_A03	5128215	5130274	BnaA03T0097400ZY.1	0	+	0	0	2059	0.0000000
zheyou73v0_A03	5133640	5134233	BnaA03T0097500ZY	0	-	0	0	593	0.0000000
zheyou73v0_A03	5156097	5157426	BnaA03T0097600ZY	0	-	0	0	1329	0.0000000
zheyou73v0_A03	5164093	5164654	BnaA03T0097700ZY	0	-	0	0	561	0.0000000
zheyou73v0_A03	5165074	5169567	BnaA03T0097800ZY	0	-	0	0	4493	0.0000000
zheyou73v0_A03	5169905	5175474	BnaA03T0097900ZY	0	-	0	0	5569	0.0000000
zheyou73v0_A03	5176057	5179097	BnaA03T0098000ZY	0	+	0	0	3040	0.0000000
zheyou73v0_A03	5182720	5184687	BnaA03T0098100ZY	0	-	0	0	1967	0.0000000
zheyou73v0_A03	5199877	5207077	BnaA03T0098200ZY	0	-	0	0	7200	0.0000000
zheyou73v0_A03	5208281	5208584	BnaA03T0098300ZY	0	-	0	0	303	0.0000000
zheyou73v0_A03	5214893	5218526	BnaA03T0098400ZY	0	-	0	0	3633	0.0000000
zheyou73v0_A03	5219539	5220175	BnaA03T0098500ZY	0	-	0	0	636	0.0000000
zheyou73v0_A03	5221136	5226298	BnaA03T0098600ZY	0	-	0	0	5162	0.0000000
zheyou73v0_A03	5228869	5232722	BnaA03T0098700ZY	0	+	0	0	3853	0.0000000
zheyou73v0_A03	5233115	5233892	BnaA03T0098800ZY	0	-	0	0	777	0.0000000
zheyou73v0_A03	5234072	5235713	BnaA03T0098900ZY	0	+	0	0	1641	0.0000000
zheyou73v0_A03	5236134	5237966	BnaA03T0099000ZY	0	-	0	0	1832	0.0000000
zheyou73v0_A03	5238523	5245449	BnaA03T0099100ZY	0	-	0	0	6926	0.0000000
zheyou73v0_A03	5250765	5255296	BnaA03T0099200ZY	0	-	0	0	4531	0.0000000
zheyou73v0_A03	5257302	5257641	BnaA03T0099300ZY	0	-	0	0	339	0.0000000
zheyou73v0_A03	5275225	5276703	BnaA03T0099400ZY	0	+	0	0	1478	0.0000000
zheyou73v0_A03	5285721	5288364	BnaA03T0099500ZY	0	+	0	0	2643	0.0000000
zheyou73v0_A03	5289913	5290909	BnaA03T0099600ZY	0	-	0	0	996	0.0000000
zheyou73v0_A03	5306008	5309031	BnaA03T0099700ZY	0	+	0	0	3023	0.0000000
zheyou73v0_A03	5309308	5310091	BnaA03T0099800ZY	0	-	0	0	783	0.0000000
zheyou73v0_A03	5315395	5315584	BnaA03T0099900ZY	0	-	0	0	189	0.0000000
zheyou73v0_A03	5323521	5326443	BnaA03T0100000ZY	0	+	0	0	2922	0.0000000
zheyou73v0_A03	5329207	5331562	BnaA03T0100100ZY	0	+	0	0	2355	0.0000000
zheyou73v0_A03	5360496	5360991	BnaA03T0100200ZY	0	-	0	0	495	0.0000000
zheyou73v0_A03	5361182	5362182	BnaA03T0100300ZY	0	-	0	0	1000	0.0000000
zheyou73v0_A03	5362412	5362643	BnaA03T0100400ZY	0	-	0	0	231	0.0000000
zheyou73v0_A03	5366471	5367986	BnaA03T0100500ZY	0	+	0	0	1515	0.0000000
zheyou73v0_A03	5389489	5389660	BnaA03T0100600ZY	0	-	0	0	171	0.0000000
zheyou73v0_A03	5401866	5404411	BnaA03T0100700ZY	0	+	0	0	2545	0.0000000
zheyou73v0_A03	5404387	5407397	BnaA03T0100800ZY	0	-	0	0	3010	0.0000000
zheyou73v0_A03	5412022	5412451	BnaA03T0100900ZY	0	-	0	0	429	0.0000000
zheyou73v0_A03	5419048	5424745	BnaA03T0101000ZY	0	-	0	0	5697	0.0000000
zheyou73v0_A03	5425028	5427444	BnaA03T0101100ZY	0	+	0	0	2416	0.0000000
zheyou73v0_A03	5428034	5433824	BnaA03T0101200ZY	0	+	0	0	5790	0.0000000
zheyou73v0_A03	5436731	5440067	BnaA03T0101300ZY	0	+	0	0	3336	0.0000000
zheyou73v0_A03	5484593	5485970	BnaA03T0101400ZY	0	+	0	0	1377	0.0000000
zheyou73v0_A03	5486916	5487526	BnaA03T0101500ZY	0	+	0	0	610	0.0000000
zheyou73v0_A03	5487781	5490289	BnaA03T0101600ZY	0	-	0	0	2508	0.0000000
zheyou73v0_A03	5491057	5491784	BnaA03T0101700ZY	0	+	0	0	727	0.0000000
zheyou73v0_A03	5496965	5498348	BnaA03T0101800ZY	0	-	0	0	1383	0.0000000
zheyou73v0_A03	5515973	5516627	BnaA03T0101900ZY	0	+	0	0	654	0.0000000
zheyou73v0_A03	5518445	5519472	BnaA03T0102000ZY	0	-	0	0	1027	0.0000000
zheyou73v0_A03	5520509	5523174	BnaA03T0102100ZY	0	+	0	0	2665	0.0000000
zheyou73v0_A03	5522806	5525646	BnaA03T0102200ZY	0	-	0	0	2840	0.0000000
zheyou73v0_A03	5527518	5528852	BnaA03T0102300ZY	0	-	0	0	1334	0.0000000
zheyou73v0_A03	5529047	5531713	BnaA03T0102400ZY	0	+	0	0	2666	0.0000000
zheyou73v0_A03	5532472	5534436	BnaA03T0102500ZY	0	+	0	0	1964	0.0000000
zheyou73v0_A03	5535144	5536466	BnaA03T0102600ZY	0	+	0	0	1322	0.0000000
zheyou73v0_A03	5537523	5540305	BnaA03T0102700ZY	0	-	0	0	2782	0.0000000
zheyou73v0_A03	5545440	5552841	BnaA03T0102800ZY	0	+	0	0	7401	0.0000000
zheyou73v0_A03	5553494	5555470	BnaA03T0102900ZY	0	-	0	0	1976	0.0000000
zheyou73v0_A03	5565399	5572907	BnaA03T0103000ZY	0	+	0	0	7508	0.0000000
zheyou73v0_A03	5574799	5576166	BnaA03T0103100ZY	0	+	0	0	1367	0.0000000
zheyou73v0_A03	5580904	5583422	BnaA03T0103200ZY	0	+	0	0	2518	0.0000000
zheyou73v0_A03	5583474	5583630	BnaA03T0103300ZY	0	+	0	0	156	0.0000000
zheyou73v0_A03	5584143	5586888	BnaA03T0103400ZY	0	-	0	0	2745	0.0000000
zheyou73v0_A03	5596452	5598688	BnaA03T0103500ZY	0	-	0	0	2236	0.0000000
zheyou73v0_A03	5600222	5602045	BnaA03T0103600ZY	0	-	0	0	1823	0.0000000
zheyou73v0_A03	5611589	5618658	BnaA03T0103700ZY	0	-	0	0	7069	0.0000000
zheyou73v0_A03	5634302	5636550	BnaA03T0103800ZY	0	-	0	0	2248	0.0000000
zheyou73v0_A03	5634302	5636550	BnaA03T0103800ZY.1	0	-	0	0	2248	0.0000000
zheyou73v0_A03	5639916	5642067	BnaA03T0103900ZY	0	+	0	0	2151	0.0000000
zheyou73v0_A03	5642922	5643687	BnaA03T0104000ZY	0	+	0	0	765	0.0000000
zheyou73v0_A03	5647889	5648653	BnaA03T0104100ZY	0	+	0	0	764	0.0000000
zheyou73v0_A03	5649146	5652761	BnaA03T0104200ZY	0	-	0	0	3615	0.0000000
zheyou73v0_A03	5654571	5655276	BnaA03T0104300ZY	0	-	0	0	705	0.0000000
zheyou73v0_A03	5658704	5660915	BnaA03T0104400ZY	0	+	0	0	2211	0.0000000
zheyou73v0_A03	5661274	5663742	BnaA03T0104500ZY	0	-	0	0	2468	0.0000000
zheyou73v0_A03	5664323	5669690	BnaA03T0104600ZY	0	-	0	0	5367	0.0000000
zheyou73v0_A03	5669943	5671438	BnaA03T0104700ZY	0	+	0	0	1495	0.0000000
zheyou73v0_A03	5672526	5673250	BnaA03T0104800ZY	0	+	0	0	724	0.0000000
zheyou73v0_A03	5673708	5675220	BnaA03T0104900ZY	0	-	0	0	1512	0.0000000
zheyou73v0_A03	5677096	5682473	BnaA03T0105000ZY	0	+	0	0	5377	0.0000000
zheyou73v0_A03	5682817	5686061	BnaA03T0105100ZY	0	+	0	0	3244	0.0000000
zheyou73v0_A03	5687464	5691844	BnaA03T0105200ZY	0	+	0	0	4380	0.0000000
zheyou73v0_A03	5692407	5698454	BnaA03T0105300ZY	0	-	0	0	6047	0.0000000
zheyou73v0_A03	5692407	5698368	BnaA03T0105300ZY.1	0	-	0	0	5961	0.0000000
zheyou73v0_A03	5702761	5704501	BnaA03T0105400ZY	0	-	0	0	1740	0.0000000
zheyou73v0_A03	5707225	5711695	BnaA03T0105500ZY	0	-	0	0	4470	0.0000000
zheyou73v0_A03	5712761	5718111	BnaA03T0105600ZY	0	+	0	0	5350	0.0000000
zheyou73v0_A03	5719748	5722097	BnaA03T0105700ZY	0	+	0	0	2349	0.0000000
zheyou73v0_A03	5722087	5724030	BnaA03T0105800ZY	0	-	0	0	1943	0.0000000
zheyou73v0_A03	5728332	5730586	BnaA03T0105900ZY	0	+	0	0	2254	0.0000000
zheyou73v0_A03	5730908	5731673	BnaA03T0106000ZY	0	-	0	0	765	0.0000000
zheyou73v0_A03	5732048	5738440	BnaA03T0106100ZY	0	-	0	0	6392	0.0000000
zheyou73v0_A03	5740732	5745062	BnaA03T0106200ZY	0	+	0	0	4330	0.0000000
zheyou73v0_A03	5748812	5749770	BnaA03T0106300ZY	0	+	0	0	958	0.0000000
zheyou73v0_A03	5750124	5751999	BnaA03T0106400ZY	0	-	0	0	1875	0.0000000
zheyou73v0_A03	5755854	5756226	BnaA03T0106500ZY	0	+	0	0	372	0.0000000
zheyou73v0_A03	5757503	5759121	BnaA03T0106600ZY	0	-	0	0	1618	0.0000000
zheyou73v0_A03	5759607	5760805	BnaA03T0106700ZY	0	+	0	0	1198	0.0000000
zheyou73v0_A03	5763259	5765657	BnaA03T0106800ZY	0	+	0	0	2398	0.0000000
zheyou73v0_A03	5763412	5765657	BnaA03T0106800ZY.1	0	+	0	0	2245	0.0000000
zheyou73v0_A03	5773564	5774703	BnaA03T0106900ZY	0	-	0	0	1139	0.0000000
zheyou73v0_A03	5779358	5783592	BnaA03T0107000ZY	0	+	0	0	4234	0.0000000
zheyou73v0_A03	5783907	5784934	BnaA03T0107100ZY	0	-	0	0	1027	0.0000000
zheyou73v0_A03	5787413	5790276	BnaA03T0107200ZY	0	-	0	0	2863	0.0000000
zheyou73v0_A03	5791212	5791449	BnaA03T0107300ZY	0	-	0	0	237	0.0000000
zheyou73v0_A03	5794036	5807171	BnaA03T0107400ZY	0	+	0	0	13135	0.0000000
zheyou73v0_A03	5807761	5811072	BnaA03T0107500ZY	0	+	0	0	3311	0.0000000
zheyou73v0_A03	5811394	5812661	BnaA03T0107600ZY	0	-	0	0	1267	0.0000000
zheyou73v0_A03	5811394	5812751	BnaA03T0107600ZY.1	0	-	0	0	1357	0.0000000
zheyou73v0_A03	5813901	5814605	BnaA03T0107700ZY	0	+	0	0	704	0.0000000
zheyou73v0_A03	5815316	5817564	BnaA03T0107800ZY	0	-	0	0	2248	0.0000000
zheyou73v0_A03	5819142	5820599	BnaA03T0107900ZY	0	+	0	0	1457	0.0000000
zheyou73v0_A03	5821894	5822923	BnaA03T0108000ZY	0	+	0	0	1029	0.0000000
zheyou73v0_A03	5823252	5824250	BnaA03T0108100ZY	0	-	0	0	998	0.0000000
zheyou73v0_A03	5824301	5825799	BnaA03T0108200ZY	0	-	0	0	1498	0.0000000
zheyou73v0_A03	5826060	5828992	BnaA03T0108300ZY	0	-	0	0	2932	0.0000000
zheyou73v0_A03	5829196	5830415	BnaA03T0108400ZY	0	+	0	0	1219	0.0000000
zheyou73v0_A03	5829238	5830415	BnaA03T0108400ZY.1	0	+	0	0	1177	0.0000000
zheyou73v0_A03	5830763	5831452	BnaA03T0108500ZY	0	+	0	0	689	0.0000000
zheyou73v0_A03	5841002	5841978	BnaA03T0108600ZY	0	+	0	0	976	0.0000000
zheyou73v0_A03	5843424	5851116	BnaA03T0108700ZY	0	+	0	0	7692	0.0000000
zheyou73v0_A03	5857964	5860619	BnaA03T0108800ZY	0	+	0	0	2655	0.0000000
zheyou73v0_A03	5857964	5860619	BnaA03T0108800ZY.1	0	+	0	0	2655	0.0000000
zheyou73v0_A03	5860814	5865147	BnaA03T0108900ZY	0	-	0	0	4333	0.0000000
zheyou73v0_A03	5873627	5875832	BnaA03T0109000ZY	0	-	0	0	2205	0.0000000
zheyou73v0_A03	5878407	5879906	BnaA03T0109100ZY	0	-	0	0	1499	0.0000000
zheyou73v0_A03	5878407	5879906	BnaA03T0109100ZY.1	0	-	0	0	1499	0.0000000
zheyou73v0_A03	5895404	5896797	BnaA03T0109200ZY	0	+	0	0	1393	0.0000000
zheyou73v0_A03	5897736	5902049	BnaA03T0109300ZY	0	+	0	0	4313	0.0000000
zheyou73v0_A03	5897736	5902049	BnaA03T0109300ZY.1	0	+	0	0	4313	0.0000000
zheyou73v0_A03	5902976	5904845	BnaA03T0109400ZY	0	-	0	0	1869	0.0000000
zheyou73v0_A03	5910888	5911392	BnaA03T0109500ZY	0	-	0	0	504	0.0000000
zheyou73v0_A03	5918707	5920121	BnaA03T0109600ZY	0	+	0	0	1414	0.0000000
zheyou73v0_A03	5927483	5937232	BnaA03T0109700ZY	0	-	0	0	9749	0.0000000
zheyou73v0_A03	5938762	5941167	BnaA03T0109800ZY	0	-	0	0	2405	0.0000000
zheyou73v0_A03	5942888	5946792	BnaA03T0109900ZY	0	+	0	0	3904	0.0000000
zheyou73v0_A03	5942888	5946792	BnaA03T0109900ZY.1	0	+	0	0	3904	0.0000000
zheyou73v0_A03	5950516	5952087	BnaA03T0110000ZY	0	+	0	0	1571	0.0000000
zheyou73v0_A03	5953165	5954320	BnaA03T0110100ZY	0	-	0	0	1155	0.0000000
zheyou73v0_A03	5958406	5962985	BnaA03T0110200ZY	0	-	0	0	4579	0.0000000
zheyou73v0_A03	5969627	5970436	BnaA03T0110300ZY	0	-	0	0	809	0.0000000
zheyou73v0_A03	5974047	5976394	BnaA03T0110400ZY	0	-	0	0	2347	0.0000000
zheyou73v0_A03	5977095	5978364	BnaA03T0110500ZY	0	-	0	0	1269	0.0000000
zheyou73v0_A03	5983776	5984232	BnaA03T0110600ZY	0	-	0	0	456	0.0000000
zheyou73v0_A03	5990381	5995803	BnaA03T0110700ZY	0	+	0	0	5422	0.0000000
zheyou73v0_A03	5993051	5995694	BnaA03T0110700ZY.1	0	+	0	0	2643	0.0000000
zheyou73v0_A03	5996933	5998238	BnaA03T0110800ZY	0	+	0	0	1305	0.0000000
zheyou73v0_A03	6000252	6004302	BnaA03T0110900ZY	0	+	0	0	4050	0.0000000
zheyou73v0_A03	6004739	6005581	BnaA03T0111000ZY	0	-	0	0	842	0.0000000
zheyou73v0_A03	6008207	6009149	BnaA03T0111100ZY	0	-	0	0	942	0.0000000
zheyou73v0_A03	6010257	6012500	BnaA03T0111200ZY	0	+	0	0	2243	0.0000000
zheyou73v0_A03	6013112	6013617	BnaA03T0111300ZY	0	-	0	0	505	0.0000000
zheyou73v0_A03	6017376	6021506	BnaA03T0111400ZY	0	-	0	0	4130	0.0000000
zheyou73v0_A03	6029531	6036151	BnaA03T0111500ZY	0	-	0	0	6620	0.0000000
zheyou73v0_A03	6039893	6041869	BnaA03T0111600ZY	0	-	0	0	1976	0.0000000
zheyou73v0_A03	6043897	6047431	BnaA03T0111700ZY	0	-	0	0	3534	0.0000000
zheyou73v0_A03	6048360	6048892	BnaA03T0111800ZY	0	-	0	0	532	0.0000000
zheyou73v0_A03	6051696	6060521	BnaA03T0111900ZY	0	-	0	0	8825	0.0000000
zheyou73v0_A03	6060916	6062265	BnaA03T0112000ZY	0	+	0	0	1349	0.0000000
zheyou73v0_A03	6061600	6064535	BnaA03T0112100ZY	0	-	0	0	2935	0.0000000
zheyou73v0_A03	6065517	6066836	BnaA03T0112200ZY	0	+	0	0	1319	0.0000000
zheyou73v0_A03	6065517	6071602	BnaA03T0112300ZY.1	0	-	0	0	6085	0.0000000
zheyou73v0_A03	6065577	6071602	BnaA03T0112300ZY	0	-	0	0	6025	0.0000000
zheyou73v0_A03	6072000	6076978	BnaA03T0112400ZY	0	-	0	0	4978	0.0000000
zheyou73v0_A03	6073726	6076978	BnaA03T0112400ZY.1	0	-	0	0	3252	0.0000000
zheyou73v0_A03	6077638	6080380	BnaA03T0112500ZY	0	+	0	0	2742	0.0000000
zheyou73v0_A03	6080943	6082299	BnaA03T0112600ZY	0	+	0	0	1356	0.0000000
zheyou73v0_A03	6085991	6088334	BnaA03T0112700ZY	0	-	0	0	2343	0.0000000
zheyou73v0_A03	6091265	6093614	BnaA03T0112800ZY	0	+	0	0	2349	0.0000000
zheyou73v0_A03	6094193	6095102	BnaA03T0112900ZY	0	+	0	0	909	0.0000000
zheyou73v0_A03	6095771	6096349	BnaA03T0113000ZY	0	-	0	0	578	0.0000000
zheyou73v0_A03	6097741	6099495	BnaA03T0113100ZY	0	-	0	0	1754	0.0000000
zheyou73v0_A03	6101762	6103919	BnaA03T0113200ZY	0	+	0	0	2157	0.0000000
zheyou73v0_A03	6104318	6105614	BnaA03T0113300ZY	0	-	0	0	1296	0.0000000
zheyou73v0_A03	6122217	6124077	BnaA03T0113400ZY	0	-	0	0	1860	0.0000000
zheyou73v0_A03	6131009	6131642	BnaA03T0113500ZY	0	-	0	0	633	0.0000000
zheyou73v0_A03	6134165	6135537	BnaA03T0113600ZY	0	-	0	0	1372	0.0000000
zheyou73v0_A03	6142878	6144252	BnaA03T0113700ZY	0	-	0	0	1374	0.0000000
zheyou73v0_A03	6147364	6150528	BnaA03T0113800ZY	0	+	0	0	3164	0.0000000
zheyou73v0_A03	6147364	6150541	BnaA03T0113800ZY.1	0	+	0	0	3177	0.0000000
zheyou73v0_A03	6152553	6154405	BnaA03T0113900ZY	0	+	0	0	1852	0.0000000
zheyou73v0_A03	6155516	6156909	BnaA03T0114000ZY	0	+	0	0	1393	0.0000000
zheyou73v0_A03	6158552	6159022	BnaA03T0114100ZY	0	-	0	0	470	0.0000000
zheyou73v0_A03	6160264	6161464	BnaA03T0114200ZY	0	+	0	0	1200	0.0000000
zheyou73v0_A03	6161963	6163323	BnaA03T0114300ZY	0	-	0	0	1360	0.0000000
zheyou73v0_A03	6163739	6169055	BnaA03T0114400ZY	0	-	0	0	5316	0.0000000
zheyou73v0_A03	6170702	6171888	BnaA03T0114500ZY	0	-	0	0	1186	0.0000000
zheyou73v0_A03	6173114	6174794	BnaA03T0114600ZY	0	+	0	0	1680	0.0000000
zheyou73v0_A03	6174935	6177108	BnaA03T0114700ZY	0	-	0	0	2173	0.0000000
zheyou73v0_A03	6174935	6177108	BnaA03T0114700ZY.1	0	-	0	0	2173	0.0000000
zheyou73v0_A03	6179266	6180540	BnaA03T0114800ZY	0	+	0	0	1274	0.0000000
zheyou73v0_A03	6181609	6193300	BnaA03T0114900ZY	0	-	0	0	11691	0.0000000
zheyou73v0_A03	6217848	6218105	BnaA03T0115000ZY	0	-	0	0	257	0.0000000
zheyou73v0_A03	6218516	6220631	BnaA03T0115100ZY	0	-	0	0	2115	0.0000000
zheyou73v0_A03	6224613	6227058	BnaA03T0115200ZY	0	+	0	0	2445	0.0000000
zheyou73v0_A03	6228964	6229147	BnaA03T0115300ZY	0	-	0	0	183	0.0000000
zheyou73v0_A03	6230764	6231406	BnaA03T0115400ZY	0	-	0	0	642	0.0000000
zheyou73v0_A03	6234097	6238749	BnaA03T0115500ZY	0	+	0	0	4652	0.0000000
zheyou73v0_A03	6237883	6238741	BnaA03T0115600ZY	0	-	0	0	858	0.0000000
zheyou73v0_A03	6243476	6243758	BnaA03T0115700ZY	0	-	0	0	282	0.0000000
zheyou73v0_A03	6246576	6248021	BnaA03T0115800ZY	0	-	0	0	1445	0.0000000
zheyou73v0_A03	6246576	6248021	BnaA03T0115800ZY.1	0	-	0	0	1445	0.0000000
zheyou73v0_A03	6248498	6251199	BnaA03T0115900ZY	0	-	0	0	2701	0.0000000
zheyou73v0_A03	6253291	6255538	BnaA03T0116000ZY	0	-	0	0	2247	0.0000000
zheyou73v0_A03	6278833	6279567	BnaA03T0116100ZY	0	-	0	0	734	0.0000000
zheyou73v0_A03	6295672	6300348	BnaA03T0116200ZY	0	+	0	0	4676	0.0000000
zheyou73v0_A03	6295672	6300348	BnaA03T0116200ZY.1	0	+	0	0	4676	0.0000000
zheyou73v0_A03	6300970	6308530	BnaA03T0116300ZY	0	-	0	0	7560	0.0000000
zheyou73v0_A03	6310234	6315684	BnaA03T0116400ZY	0	-	0	0	5450	0.0000000
zheyou73v0_A03	6316091	6318308	BnaA03T0116500ZY	0	-	0	0	2217	0.0000000
zheyou73v0_A03	6319456	6320293	BnaA03T0116600ZY	0	+	0	0	837	0.0000000
zheyou73v0_A03	6324186	6327680	BnaA03T0116700ZY	0	-	0	0	3494	0.0000000
zheyou73v0_A03	6329388	6333509	BnaA03T0116800ZY	0	-	0	0	4121	0.0000000
zheyou73v0_A03	6337361	6338915	BnaA03T0116900ZY	0	-	0	0	1554	0.0000000
zheyou73v0_A03	6344910	6346417	BnaA03T0117000ZY	0	+	0	0	1507	0.0000000
zheyou73v0_A03	6344910	6345919	BnaA03T0117000ZY.1	0	+	0	0	1009	0.0000000
zheyou73v0_A03	6351270	6352660	BnaA03T0117100ZY	0	+	0	0	1390	0.0000000
zheyou73v0_A03	6353109	6353847	BnaA03T0117200ZY	0	-	0	0	738	0.0000000
zheyou73v0_A03	6355511	6357126	BnaA03T0117300ZY	0	-	0	0	1615	0.0000000
zheyou73v0_A03	6358775	6370461	BnaA03T0117400ZY	0	-	0	0	11686	0.0000000
zheyou73v0_A03	6372180	6373652	BnaA03T0117500ZY	0	-	0	0	1472	0.0000000
zheyou73v0_A03	6375143	6376850	BnaA03T0117600ZY	0	-	0	0	1707	0.0000000
zheyou73v0_A03	6375143	6376850	BnaA03T0117600ZY.1	0	-	0	0	1707	0.0000000
zheyou73v0_A03	6377794	6384120	BnaA03T0117700ZY	0	-	0	0	6326	0.0000000
zheyou73v0_A03	6396585	6401511	BnaA03T0117800ZY	0	-	0	0	4926	0.0000000
zheyou73v0_A03	6401977	6404601	BnaA03T0117900ZY	0	+	0	0	2624	0.0000000
zheyou73v0_A03	6408777	6411594	BnaA03T0118000ZY	0	-	0	0	2817	0.0000000
zheyou73v0_A03	6413699	6414502	BnaA03T0118100ZY	0	-	0	0	803	0.0000000
zheyou73v0_A03	6428944	6431606	BnaA03T0118200ZY	0	-	0	0	2662	0.0000000
zheyou73v0_A03	6436892	6437400	BnaA03T0118300ZY	0	+	0	0	508	0.0000000
zheyou73v0_A03	6443346	6443855	BnaA03T0118400ZY	0	+	0	0	509	0.0000000
zheyou73v0_A03	6451212	6451749	BnaA03T0118500ZY	0	-	0	0	537	0.0000000
zheyou73v0_A03	6458731	6461899	BnaA03T0118600ZY	0	-	0	0	3168	0.0000000
zheyou73v0_A03	6463312	6465676	BnaA03T0118700ZY	0	+	0	0	2364	0.0000000
zheyou73v0_A03	6466711	6468398	BnaA03T0118800ZY	0	-	0	0	1687	0.0000000
zheyou73v0_A03	6485319	6487492	BnaA03T0118900ZY	0	+	0	0	2173	0.0000000
zheyou73v0_A03	6488430	6490057	BnaA03T0119000ZY	0	+	0	0	1627	0.0000000
zheyou73v0_A03	6517673	6524354	BnaA03T0119100ZY	0	+	0	0	6681	0.0000000
zheyou73v0_A03	6524907	6529741	BnaA03T0119200ZY	0	+	0	0	4834	0.0000000
zheyou73v0_A03	6530290	6534594	BnaA03T0119300ZY	0	+	0	0	4304	0.0000000
zheyou73v0_A03	6537960	6539603	BnaA03T0119400ZY	0	+	0	0	1643	0.0000000
zheyou73v0_A03	6540162	6541356	BnaA03T0119500ZY	0	+	0	0	1194	0.0000000
zheyou73v0_A03	6542372	6542789	BnaA03T0119600ZY	0	+	0	0	417	0.0000000
zheyou73v0_A03	6544569	6545906	BnaA03T0119700ZY	0	-	0	0	1337	0.0000000
zheyou73v0_A03	6548013	6549415	BnaA03T0119800ZY	0	+	0	0	1402	0.0000000
zheyou73v0_A03	6551388	6552395	BnaA03T0119900ZY	0	+	0	0	1007	0.0000000
zheyou73v0_A03	6557295	6557835	BnaA03T0120000ZY	0	-	0	0	540	0.0000000
zheyou73v0_A03	6560968	6561568	BnaA03T0120100ZY	0	+	0	0	600	0.0000000
zheyou73v0_A03	6566753	6567597	BnaA03T0120200ZY	0	+	0	0	844	0.0000000
zheyou73v0_A03	6567799	6569872	BnaA03T0120300ZY	0	-	0	0	2073	0.0000000
zheyou73v0_A03	6572840	6573471	BnaA03T0120400ZY	0	+	0	0	631	0.0000000
zheyou73v0_A03	6573571	6575259	BnaA03T0120500ZY	0	-	0	0	1688	0.0000000
zheyou73v0_A03	6584357	6584780	BnaA03T0120600ZY	0	-	0	0	423	0.0000000
zheyou73v0_A03	6589596	6594392	BnaA03T0120700ZY	0	-	0	0	4796	0.0000000
zheyou73v0_A03	6602872	6604926	BnaA03T0120800ZY	0	+	0	0	2054	0.0000000
zheyou73v0_A03	6609023	6611225	BnaA03T0120900ZY	0	-	0	0	2202	0.0000000
zheyou73v0_A03	6619838	6620275	BnaA03T0121000ZY	0	-	0	0	437	0.0000000
zheyou73v0_A03	6620653	6621268	BnaA03T0121100ZY	0	-	0	0	615	0.0000000
zheyou73v0_A03	6622118	6623700	BnaA03T0121200ZY.2	0	+	0	0	1582	0.0000000
zheyou73v0_A03	6622771	6624274	BnaA03T0121200ZY	0	+	0	0	1503	0.0000000
zheyou73v0_A03	6622771	6624274	BnaA03T0121200ZY.1	0	+	0	0	1503	0.0000000
zheyou73v0_A03	6623985	6624493	BnaA03T0121300ZY	0	-	0	0	508	0.0000000
zheyou73v0_A03	6625985	6629095	BnaA03T0121400ZY	0	-	0	0	3110	0.0000000
zheyou73v0_A03	6631181	6632653	BnaA03T0121500ZY	0	-	0	0	1472	0.0000000
zheyou73v0_A03	6633772	6637364	BnaA03T0121600ZY	0	+	0	0	3592	0.0000000
zheyou73v0_A03	6645790	6647316	BnaA03T0121700ZY	0	-	0	0	1526	0.0000000
zheyou73v0_A03	6653000	6654760	BnaA03T0121800ZY	0	-	0	0	1760	0.0000000
zheyou73v0_A03	6653000	6654760	BnaA03T0121800ZY.1	0	-	0	0	1760	0.0000000
zheyou73v0_A03	6653000	6654676	BnaA03T0121800ZY.2	0	-	0	0	1676	0.0000000
zheyou73v0_A03	6658433	6658805	BnaA03T0121900ZY	0	-	0	0	372	0.0000000
zheyou73v0_A03	6662671	6663628	BnaA03T0122000ZY	0	+	0	0	957	0.0000000
zheyou73v0_A03	6664268	6670355	BnaA03T0122100ZY	0	-	0	0	6087	0.0000000
zheyou73v0_A03	6671321	6672275	BnaA03T0122200ZY	0	+	0	0	954	0.0000000
zheyou73v0_A03	6673250	6677205	BnaA03T0122300ZY	0	-	0	0	3955	0.0000000
zheyou73v0_A03	6679692	6681945	BnaA03T0122400ZY	0	+	0	0	2253	0.0000000
zheyou73v0_A03	6687334	6688438	BnaA03T0122500ZY	0	+	0	0	1104	0.0000000
zheyou73v0_A03	6688978	6689776	BnaA03T0122600ZY	0	+	0	0	798	0.0000000
zheyou73v0_A03	6696324	6698344	BnaA03T0122700ZY	0	-	0	0	2020	0.0000000
zheyou73v0_A03	6701650	6704005	BnaA03T0122800ZY	0	+	0	0	2355	0.0000000
zheyou73v0_A03	6704015	6706202	BnaA03T0122900ZY	0	-	0	0	2187	0.0000000
zheyou73v0_A03	6708027	6708750	BnaA03T0123000ZY	0	-	0	0	723	0.0000000
zheyou73v0_A03	6709645	6710917	BnaA03T0123100ZY	0	-	0	0	1272	0.0000000
zheyou73v0_A03	6709645	6710917	BnaA03T0123100ZY.1	0	-	0	0	1272	0.0000000
zheyou73v0_A03	6711906	6712793	BnaA03T0123200ZY	0	-	0	0	887	0.0000000
zheyou73v0_A03	6714332	6715123	BnaA03T0123300ZY	0	+	0	0	791	0.0000000
zheyou73v0_A03	6715239	6719559	BnaA03T0123400ZY	0	+	0	0	4320	0.0000000
zheyou73v0_A03	6720093	6726729	BnaA03T0123500ZY	0	-	0	0	6636	0.0000000
zheyou73v0_A03	6728673	6730322	BnaA03T0123600ZY	0	+	0	0	1649	0.0000000
zheyou73v0_A03	6728673	6730322	BnaA03T0123600ZY.1	0	+	0	0	1649	0.0000000
zheyou73v0_A03	6735426	6737309	BnaA03T0123700ZY	0	+	0	0	1883	0.0000000
zheyou73v0_A03	6740050	6742796	BnaA03T0123800ZY	0	+	0	0	2746	0.0000000
zheyou73v0_A03	6747413	6750212	BnaA03T0123900ZY	0	+	0	0	2799	0.0000000
zheyou73v0_A03	6758374	6759481	BnaA03T0124000ZY	0	-	0	0	1107	0.0000000
zheyou73v0_A03	6759598	6762432	BnaA03T0124100ZY	0	-	0	0	2834	0.0000000
zheyou73v0_A03	6767801	6768782	BnaA03T0124200ZY	0	+	0	0	981	0.0000000
zheyou73v0_A03	6770101	6770992	BnaA03T0124300ZY	0	-	0	0	891	0.0000000
zheyou73v0_A03	6777058	6777889	BnaA03T0124400ZY	0	-	0	0	831	0.0000000
zheyou73v0_A03	6778882	6779710	BnaA03T0124500ZY	0	-	0	0	828	0.0000000
zheyou73v0_A03	6780333	6781467	BnaA03T0124600ZY	0	+	0	0	1134	0.0000000
zheyou73v0_A03	6788234	6789426	BnaA03T0124700ZY	0	+	0	0	1192	0.0000000
zheyou73v0_A03	6814181	6816752	BnaA03T0124800ZY	0	-	0	0	2571	0.0000000
zheyou73v0_A03	6823314	6825220	BnaA03T0124900ZY	0	+	0	0	1906	0.0000000
zheyou73v0_A03	6826155	6829701	BnaA03T0125000ZY	0	-	0	0	3546	0.0000000
zheyou73v0_A03	6832170	6835250	BnaA03T0125100ZY	0	-	0	0	3080	0.0000000
zheyou73v0_A03	6836880	6837948	BnaA03T0125200ZY	0	-	0	0	1068	0.0000000
zheyou73v0_A03	6838946	6840957	BnaA03T0125300ZY	0	-	0	0	2011	0.0000000
zheyou73v0_A03	6842757	6843776	BnaA03T0125400ZY	0	-	0	0	1019	0.0000000
zheyou73v0_A03	6845611	6846352	BnaA03T0125500ZY	0	-	0	0	741	0.0000000
zheyou73v0_A03	6857826	6858307	BnaA03T0125600ZY	0	+	0	0	481	0.0000000
zheyou73v0_A03	6861100	6863050	BnaA03T0125700ZY	0	+	0	0	1950	0.0000000
zheyou73v0_A03	6866117	6866912	BnaA03T0125800ZY	0	+	0	0	795	0.0000000
zheyou73v0_A03	6868802	6869490	BnaA03T0125900ZY	0	-	0	0	688	0.0000000
zheyou73v0_A03	6870505	6870967	BnaA03T0126000ZY	0	+	0	0	462	0.0000000
zheyou73v0_A03	6871983	6875465	BnaA03T0126100ZY	0	-	0	0	3482	0.0000000
zheyou73v0_A03	6877497	6878414	BnaA03T0126200ZY	0	-	0	0	917	0.0000000
zheyou73v0_A03	6883942	6884333	BnaA03T0126300ZY	0	-	0	0	391	0.0000000
zheyou73v0_A03	6885295	6888433	BnaA03T0126400ZY	0	-	0	0	3138	0.0000000
zheyou73v0_A03	6889180	6892571	BnaA03T0126500ZY	0	-	0	0	3391	0.0000000
zheyou73v0_A03	6893199	6894521	BnaA03T0126600ZY	0	-	0	0	1322	0.0000000
zheyou73v0_A03	6893199	6894521	BnaA03T0126600ZY.1	0	-	0	0	1322	0.0000000
zheyou73v0_A03	6896756	6898343	BnaA03T0126700ZY	0	+	0	0	1587	0.0000000
zheyou73v0_A03	6898695	6899083	BnaA03T0126800ZY	0	-	0	0	388	0.0000000
zheyou73v0_A03	6900255	6903880	BnaA03T0126900ZY	0	-	0	0	3625	0.0000000
zheyou73v0_A03	6905241	6906528	BnaA03T0127000ZY	0	-	0	0	1287	0.0000000
zheyou73v0_A03	6907423	6909322	BnaA03T0127100ZY	0	-	0	0	1899	0.0000000
zheyou73v0_A03	6912026	6912602	BnaA03T0127200ZY	0	+	0	0	576	0.0000000
zheyou73v0_A03	6919243	6919652	BnaA03T0127300ZY	0	-	0	0	409	0.0000000
zheyou73v0_A03	6919921	6922183	BnaA03T0127400ZY	0	+	0	0	2262	0.0000000
zheyou73v0_A03	6919921	6922183	BnaA03T0127400ZY.1	0	+	0	0	2262	0.0000000
zheyou73v0_A03	6923579	6925138	BnaA03T0127500ZY	0	+	0	0	1559	0.0000000
zheyou73v0_A03	6925261	6926377	BnaA03T0127600ZY	0	-	0	0	1116	0.0000000
zheyou73v0_A03	6925261	6926198	BnaA03T0127600ZY.1	0	-	0	0	937	0.0000000
zheyou73v0_A03	6937035	6938814	BnaA03T0127700ZY	0	+	0	0	1779	0.0000000
zheyou73v0_A03	6942187	6945363	BnaA03T0127800ZY	0	-	0	0	3176	0.0000000
zheyou73v0_A03	6946769	6948792	BnaA03T0127900ZY	0	+	0	0	2023	0.0000000
zheyou73v0_A03	6949360	6950877	BnaA03T0128000ZY	0	-	0	0	1517	0.0000000
zheyou73v0_A03	6955955	6957974	BnaA03T0128100ZY	0	-	0	0	2019	0.0000000
zheyou73v0_A03	6960253	6960883	BnaA03T0128200ZY	0	+	0	0	630	0.0000000
zheyou73v0_A03	6962210	6964884	BnaA03T0128300ZY	0	+	0	0	2674	0.0000000
zheyou73v0_A03	6965300	6966652	BnaA03T0128400ZY	0	-	0	0	1352	0.0000000
zheyou73v0_A03	6969441	6972968	BnaA03T0128500ZY	0	+	0	0	3527	0.0000000
zheyou73v0_A03	6972722	6974656	BnaA03T0128600ZY	0	-	0	0	1934	0.0000000
zheyou73v0_A03	6976825	6977130	BnaA03T0128700ZY	0	+	0	0	305	0.0000000
zheyou73v0_A03	6979298	6980531	BnaA03T0128800ZY	0	+	0	0	1233	0.0000000
zheyou73v0_A03	6981131	6982435	BnaA03T0128900ZY	0	-	0	0	1304	0.0000000
zheyou73v0_A03	6982769	6999195	BnaA03T0129000ZY	0	-	0	0	16426	0.0000000
zheyou73v0_A03	6999724	7000291	BnaA03T0129100ZY	0	+	0	0	567	0.0000000
zheyou73v0_A03	7007445	7008486	BnaA03T0129200ZY	0	-	0	0	1041	0.0000000
zheyou73v0_A03	7010674	7013424	BnaA03T0129300ZY	0	-	0	0	2750	0.0000000
zheyou73v0_A03	7020481	7026536	BnaA03T0129400ZY	0	+	0	0	6055	0.0000000
zheyou73v0_A03	7031888	7034888	BnaA03T0129500ZY	0	+	0	0	3000	0.0000000
zheyou73v0_A03	7038378	7040421	BnaA03T0129600ZY	0	+	0	0	2043	0.0000000
zheyou73v0_A03	7041096	7051012	BnaA03T0129700ZY	0	-	0	0	9916	0.0000000
zheyou73v0_A03	7052335	7053964	BnaA03T0129800ZY	0	+	0	0	1629	0.0000000
zheyou73v0_A03	7055740	7056066	BnaA03T0129900ZY	0	-	0	0	326	0.0000000
zheyou73v0_A03	7056860	7058960	BnaA03T0130000ZY	0	-	0	0	2100	0.0000000
zheyou73v0_A03	7060109	7060476	BnaA03T0130100ZY	0	+	0	0	367	0.0000000
zheyou73v0_A03	7061150	7063356	BnaA03T0130200ZY	0	+	0	0	2206	0.0000000
zheyou73v0_A03	7063577	7067610	BnaA03T0130300ZY	0	-	0	0	4033	0.0000000
zheyou73v0_A03	7067751	7073649	BnaA03T0130400ZY	0	-	0	0	5898	0.0000000
zheyou73v0_A03	7075251	7079180	BnaA03T0130500ZY	0	-	0	0	3929	0.0000000
zheyou73v0_A03	7079876	7080928	BnaA03T0130600ZY	0	+	0	0	1052	0.0000000
zheyou73v0_A03	7081109	7084160	BnaA03T0130700ZY	0	-	0	0	3051	0.0000000
zheyou73v0_A03	7084814	7086224	BnaA03T0130800ZY	0	-	0	0	1410	0.0000000
zheyou73v0_A03	7087130	7089689	BnaA03T0130900ZY	0	-	0	0	2559	0.0000000
zheyou73v0_A03	7091958	7099375	BnaA03T0131000ZY	0	-	0	0	7417	0.0000000
zheyou73v0_A03	7092123	7094445	BnaA03T0131100ZY	0	+	0	0	2322	0.0000000
zheyou73v0_A03	7100602	7101881	BnaA03T0131200ZY	0	-	0	0	1279	0.0000000
zheyou73v0_A03	7104638	7108134	BnaA03T0131300ZY	0	+	0	0	3496	0.0000000
zheyou73v0_A03	7108479	7113103	BnaA03T0131400ZY.1	0	-	0	0	4624	0.0000000
zheyou73v0_A03	7109440	7113103	BnaA03T0131400ZY	0	-	0	0	3663	0.0000000
zheyou73v0_A03	7113355	7117118	BnaA03T0131500ZY	0	+	0	0	3763	0.0000000
zheyou73v0_A03	7118974	7121326	BnaA03T0131600ZY	0	-	0	0	2352	0.0000000
zheyou73v0_A03	7121618	7125400	BnaA03T0131700ZY	0	+	0	0	3782	0.0000000
zheyou73v0_A03	7126772	7127676	BnaA03T0131800ZY	0	-	0	0	904	0.0000000
zheyou73v0_A03	7132167	7133523	BnaA03T0131900ZY	0	-	0	0	1356	0.0000000
zheyou73v0_A03	7132167	7133523	BnaA03T0131900ZY.1	0	-	0	0	1356	0.0000000
zheyou73v0_A03	7132167	7133353	BnaA03T0131900ZY.2	0	-	0	0	1186	0.0000000
zheyou73v0_A03	7133953	7135768	BnaA03T0132000ZY	0	+	0	0	1815	0.0000000
zheyou73v0_A03	7136089	7137790	BnaA03T0132100ZY	0	+	0	0	1701	0.0000000
zheyou73v0_A03	7138191	7138435	BnaA03T0132200ZY	0	+	0	0	244	0.0000000
zheyou73v0_A03	7138729	7140672	BnaA03T0132300ZY	0	+	0	0	1943	0.0000000
zheyou73v0_A03	7141240	7142595	BnaA03T0132400ZY	0	+	0	0	1355	0.0000000
zheyou73v0_A03	7143382	7147371	BnaA03T0132500ZY	0	-	0	0	3989	0.0000000
zheyou73v0_A03	7148081	7148608	BnaA03T0132600ZY	0	+	0	0	527	0.0000000
zheyou73v0_A03	7149154	7152860	BnaA03T0132700ZY	0	-	0	0	3706	0.0000000
zheyou73v0_A03	7154082	7157649	BnaA03T0132800ZY	0	-	0	0	3567	0.0000000
zheyou73v0_A03	7158953	7160175	BnaA03T0132900ZY	0	+	0	0	1222	0.0000000
zheyou73v0_A03	7163426	7164039	BnaA03T0133000ZY	0	+	0	0	613	0.0000000
zheyou73v0_A03	7171295	7171526	BnaA03T0133100ZY	0	-	0	0	231	0.0000000
zheyou73v0_A03	7176806	7178836	BnaA03T0133200ZY	0	-	0	0	2030	0.0000000
zheyou73v0_A03	7179247	7181860	BnaA03T0133300ZY	0	+	0	0	2613	0.0000000
zheyou73v0_A03	7183408	7184492	BnaA03T0133400ZY	0	+	0	0	1084	0.0000000
zheyou73v0_A03	7190848	7191728	BnaA03T0133500ZY	0	+	0	0	880	0.0000000
zheyou73v0_A03	7198250	7199973	BnaA03T0133600ZY	0	+	0	0	1723	0.0000000
zheyou73v0_A03	7200878	7201911	BnaA03T0133700ZY	0	-	0	0	1033	0.0000000
zheyou73v0_A03	7202572	7205081	BnaA03T0133800ZY	0	+	0	0	2509	0.0000000
zheyou73v0_A03	7207229	7208843	BnaA03T0133900ZY	0	-	0	0	1614	0.0000000
zheyou73v0_A03	7216048	7220512	BnaA03T0134000ZY	0	-	0	0	4464	0.0000000
zheyou73v0_A03	7216048	7220512	BnaA03T0134000ZY.1	0	-	0	0	4464	0.0000000
zheyou73v0_A03	7223043	7227318	BnaA03T0134100ZY	0	+	0	0	4275	0.0000000
zheyou73v0_A03	7227955	7230484	BnaA03T0134200ZY	0	+	0	0	2529	0.0000000
zheyou73v0_A03	7233371	7233824	BnaA03T0134300ZY	0	-	0	0	453	0.0000000
zheyou73v0_A03	7239873	7241667	BnaA03T0134400ZY	0	+	0	0	1794	0.0000000
zheyou73v0_A03	7247468	7248915	BnaA03T0134500ZY	0	+	0	0	1447	0.0000000
zheyou73v0_A03	7249594	7252112	BnaA03T0134600ZY	0	+	0	0	2518	0.0000000
zheyou73v0_A03	7252906	7254521	BnaA03T0134700ZY	0	+	0	0	1615	0.0000000
zheyou73v0_A03	7256542	7258938	BnaA03T0134800ZY	0	-	0	0	2396	0.0000000
zheyou73v0_A03	7261890	7262798	BnaA03T0134900ZY	0	+	0	0	908	0.0000000
zheyou73v0_A03	7265929	7268566	BnaA03T0135000ZY	0	+	0	0	2637	0.0000000
zheyou73v0_A03	7277002	7278918	BnaA03T0135100ZY	0	-	0	0	1916	0.0000000
zheyou73v0_A03	7282061	7284502	BnaA03T0135200ZY	0	+	0	0	2441	0.0000000
zheyou73v0_A03	7285143	7287372	BnaA03T0135300ZY	0	-	0	0	2229	0.0000000
zheyou73v0_A03	7289336	7294050	BnaA03T0135400ZY	0	-	0	0	4714	0.0000000
zheyou73v0_A03	7294923	7297274	BnaA03T0135500ZY	0	+	0	0	2351	0.0000000
zheyou73v0_A03	7298216	7300445	BnaA03T0135600ZY	0	-	0	0	2229	0.0000000
zheyou73v0_A03	7301494	7303307	BnaA03T0135700ZY	0	+	0	0	1813	0.0000000
zheyou73v0_A03	7307595	7309952	BnaA03T0135800ZY	0	-	0	0	2357	0.0000000
zheyou73v0_A03	7316246	7318913	BnaA03T0135900ZY	0	-	0	0	2667	0.0000000
zheyou73v0_A03	7316246	7318913	BnaA03T0135900ZY.1	0	-	0	0	2667	0.0000000
zheyou73v0_A03	7321941	7324843	BnaA03T0136000ZY	0	-	0	0	2902	0.0000000
zheyou73v0_A03	7327123	7327726	BnaA03T0136100ZY	0	+	0	0	603	0.0000000
zheyou73v0_A03	7334715	7336452	BnaA03T0136200ZY	0	+	0	0	1737	0.0000000
zheyou73v0_A03	7341191	7344744	BnaA03T0136300ZY	0	-	0	0	3553	0.0000000
zheyou73v0_A03	7346932	7347865	BnaA03T0136400ZY	0	+	0	0	933	0.0000000
zheyou73v0_A03	7348216	7351493	BnaA03T0136500ZY	0	-	0	0	3277	0.0000000
zheyou73v0_A03	7354173	7356758	BnaA03T0136600ZY	0	-	0	0	2585	0.0000000
zheyou73v0_A03	7358152	7361274	BnaA03T0136700ZY	0	-	0	0	3122	0.0000000
zheyou73v0_A03	7358623	7361274	BnaA03T0136700ZY.1	0	-	0	0	2651	0.0000000
zheyou73v0_A03	7362467	7363662	BnaA03T0136800ZY	0	+	0	0	1195	0.0000000
zheyou73v0_A03	7362467	7363662	BnaA03T0136800ZY.1	0	+	0	0	1195	0.0000000
zheyou73v0_A03	7396027	7396507	BnaA03T0136900ZY	0	+	0	0	480	0.0000000
zheyou73v0_A03	7397786	7401118	BnaA03T0137000ZY	0	-	0	0	3332	0.0000000
zheyou73v0_A03	7424804	7426605	BnaA03T0137100ZY	0	+	0	0	1801	0.0000000
zheyou73v0_A03	7429118	7430580	BnaA03T0137200ZY	0	-	0	0	1462	0.0000000
zheyou73v0_A03	7429118	7430580	BnaA03T0137200ZY.1	0	-	0	0	1462	0.0000000
zheyou73v0_A03	7436657	7438187	BnaA03T0137300ZY	0	-	0	0	1530	0.0000000
zheyou73v0_A03	7438967	7440665	BnaA03T0137400ZY	0	-	0	0	1698	0.0000000
zheyou73v0_A03	7441743	7443204	BnaA03T0137500ZY	0	-	0	0	1461	0.0000000
zheyou73v0_A03	7449962	7451679	BnaA03T0137600ZY	0	+	0	0	1717	0.0000000
zheyou73v0_A03	7452106	7455116	BnaA03T0137700ZY	0	-	0	0	3010	0.0000000
zheyou73v0_A03	7455938	7458741	BnaA03T0137800ZY	0	+	0	0	2803	0.0000000
zheyou73v0_A03	7458970	7460288	BnaA03T0137900ZY	0	+	0	0	1318	0.0000000
zheyou73v0_A03	7461035	7463472	BnaA03T0138000ZY	0	-	0	0	2437	0.0000000
zheyou73v0_A03	7464301	7466287	BnaA03T0138100ZY	0	+	0	0	1986	0.0000000
zheyou73v0_A03	7468856	7469471	BnaA03T0138200ZY	0	+	0	0	615	0.0000000
zheyou73v0_A03	7469780	7472891	BnaA03T0138300ZY	0	-	0	0	3111	0.0000000
zheyou73v0_A03	7473320	7476015	BnaA03T0138400ZY	0	-	0	0	2695	0.0000000
zheyou73v0_A03	7480582	7481291	BnaA03T0138500ZY	0	+	0	0	709	0.0000000
zheyou73v0_A03	7482153	7484205	BnaA03T0138600ZY	0	+	0	0	2052	0.0000000
zheyou73v0_A03	7488559	7489727	BnaA03T0138700ZY	0	+	0	0	1168	0.0000000
zheyou73v0_A03	7492756	7493029	BnaA03T0138800ZY	0	-	0	0	273	0.0000000
zheyou73v0_A03	7509352	7512253	BnaA03T0138900ZY	0	-	0	0	2901	0.0000000
zheyou73v0_A03	7514633	7520296	BnaA03T0139000ZY	0	+	0	0	5663	0.0000000
zheyou73v0_A03	7522482	7525052	BnaA03T0139100ZY	0	-	0	0	2570	0.0000000
zheyou73v0_A03	7526639	7528019	BnaA03T0139200ZY	0	+	0	0	1380	0.0000000
zheyou73v0_A03	7529479	7530895	BnaA03T0139300ZY	0	+	0	0	1416	0.0000000
zheyou73v0_A03	7535819	7537189	BnaA03T0139400ZY	0	+	0	0	1370	0.0000000
zheyou73v0_A03	7538840	7541449	BnaA03T0139500ZY	0	+	0	0	2609	0.0000000
zheyou73v0_A03	7542242	7545927	BnaA03T0139600ZY	0	+	0	0	3685	0.0000000
zheyou73v0_A03	7550507	7552487	BnaA03T0139700ZY	0	-	0	0	1980	0.0000000
zheyou73v0_A03	7556876	7561361	BnaA03T0139800ZY	0	+	0	0	4485	0.0000000
zheyou73v0_A03	7556876	7561361	BnaA03T0139800ZY.1	0	+	0	0	4485	0.0000000
zheyou73v0_A03	7562958	7565818	BnaA03T0139900ZY	0	+	0	0	2860	0.0000000
zheyou73v0_A03	7566216	7568026	BnaA03T0140000ZY	0	-	0	0	1810	0.0000000
zheyou73v0_A03	7572272	7573334	BnaA03T0140100ZY	0	-	0	0	1062	0.0000000
zheyou73v0_A03	7580549	7581038	BnaA03T0140200ZY	0	-	0	0	489	0.0000000
zheyou73v0_A03	7581565	7583197	BnaA03T0140300ZY	0	-	0	0	1632	0.0000000
zheyou73v0_A03	7583943	7586461	BnaA03T0140400ZY	0	-	0	0	2518	0.0000000
zheyou73v0_A03	7593879	7599207	BnaA03T0140500ZY	0	-	0	0	5328	0.0000000
zheyou73v0_A03	7600204	7603966	BnaA03T0140600ZY	0	-	0	0	3762	0.0000000
zheyou73v0_A03	7607002	7608872	BnaA03T0140700ZY.1	0	+	0	0	1870	0.0000000
zheyou73v0_A03	7607128	7608850	BnaA03T0140700ZY	0	+	0	0	1722	0.0000000
zheyou73v0_A03	7609151	7610191	BnaA03T0140800ZY	0	-	0	0	1040	0.0000000
zheyou73v0_A03	7613567	7615289	BnaA03T0140900ZY	0	+	0	0	1722	0.0000000
zheyou73v0_A03	7615590	7616630	BnaA03T0141000ZY	0	-	0	0	1040	0.0000000
zheyou73v0_A03	7620650	7624602	BnaA03T0141100ZY	0	+	0	0	3952	0.0000000
zheyou73v0_A03	7621357	7624602	BnaA03T0141100ZY.1	0	+	0	0	3245	0.0000000
zheyou73v0_A03	7628689	7633003	BnaA03T0141200ZY	0	+	0	0	4314	0.0000000
zheyou73v0_A03	7633985	7635143	BnaA03T0141300ZY	0	-	0	0	1158	0.0000000
zheyou73v0_A03	7636057	7637486	BnaA03T0141400ZY	0	-	0	0	1429	0.0000000
zheyou73v0_A03	7638841	7641805	BnaA03T0141500ZY	0	-	0	0	2964	0.0000000
zheyou73v0_A03	7642471	7647590	BnaA03T0141600ZY	0	-	0	0	5119	0.0000000
zheyou73v0_A03	7648030	7650613	BnaA03T0141700ZY	0	-	0	0	2583	0.0000000
zheyou73v0_A03	7651713	7654121	BnaA03T0141800ZY	0	-	0	0	2408	0.0000000
zheyou73v0_A03	7655309	7657922	BnaA03T0141900ZY	0	+	0	0	2613	0.0000000
zheyou73v0_A03	7658005	7659644	BnaA03T0142000ZY	0	-	0	0	1639	0.0000000
zheyou73v0_A03	7658005	7659644	BnaA03T0142000ZY.1	0	-	0	0	1639	0.0000000
zheyou73v0_A03	7662139	7663796	BnaA03T0142100ZY	0	-	0	0	1657	0.0000000
zheyou73v0_A03	7667265	7669833	BnaA03T0142200ZY	0	+	0	0	2568	0.0000000
zheyou73v0_A03	7670918	7672543	BnaA03T0142300ZY	0	+	0	0	1625	0.0000000
zheyou73v0_A03	7677141	7679215	BnaA03T0142400ZY	0	+	0	0	2074	0.0000000
zheyou73v0_A03	7679593	7681614	BnaA03T0142500ZY	0	-	0	0	2021	0.0000000
zheyou73v0_A03	7683491	7686113	BnaA03T0142600ZY	0	-	0	0	2622	0.0000000
zheyou73v0_A03	7686394	7694527	BnaA03T0142700ZY	0	-	0	0	8133	0.0000000
zheyou73v0_A03	7695209	7696648	BnaA03T0142800ZY	0	+	0	0	1439	0.0000000
zheyou73v0_A03	7696881	7697414	BnaA03T0142900ZY	0	-	0	0	533	0.0000000
zheyou73v0_A03	7698110	7701054	BnaA03T0143000ZY	0	-	0	0	2944	0.0000000
zheyou73v0_A03	7708099	7708744	BnaA03T0143100ZY	0	+	0	0	645	0.0000000
zheyou73v0_A03	7708826	7711639	BnaA03T0143200ZY	0	-	0	0	2813	0.0000000
zheyou73v0_A03	7715755	7716052	BnaA03T0143300ZY	0	+	0	0	297	0.0000000
zheyou73v0_A03	7716803	7718816	BnaA03T0143400ZY	0	+	0	0	2013	0.0000000
zheyou73v0_A03	7719933	7721914	BnaA03T0143500ZY	0	-	0	0	1981	0.0000000
zheyou73v0_A03	7722800	7723586	BnaA03T0143600ZY	0	-	0	0	786	0.0000000
zheyou73v0_A03	7724213	7725918	BnaA03T0143700ZY	0	+	0	0	1705	0.0000000
zheyou73v0_A03	7726175	7728615	BnaA03T0143800ZY	0	+	0	0	2440	0.0000000
zheyou73v0_A03	7729435	7731465	BnaA03T0143900ZY	0	-	0	0	2030	0.0000000
zheyou73v0_A03	7732528	7735021	BnaA03T0144000ZY	0	-	0	0	2493	0.0000000
zheyou73v0_A03	7740200	7741406	BnaA03T0144100ZY	0	+	0	0	1206	0.0000000
zheyou73v0_A03	7748137	7750493	BnaA03T0144200ZY	0	+	0	0	2356	0.0000000
zheyou73v0_A03	7752763	7754749	BnaA03T0144300ZY	0	-	0	0	1986	0.0000000
zheyou73v0_A03	7756695	7758299	BnaA03T0144400ZY	0	+	0	0	1604	0.0000000
zheyou73v0_A03	7759346	7761760	BnaA03T0144500ZY	0	-	0	0	2414	0.0000000
zheyou73v0_A03	7762836	7765199	BnaA03T0144600ZY	0	+	0	0	2363	0.0000000
zheyou73v0_A03	7765256	7765517	BnaA03T0144700ZY	0	-	0	0	261	0.0000000
zheyou73v0_A03	7767122	7775645	BnaA03T0144800ZY	0	-	0	0	8523	0.0000000
zheyou73v0_A03	7779475	7783594	BnaA03T0144900ZY	0	+	0	0	4119	0.0000000
zheyou73v0_A03	7785612	7786632	BnaA03T0145000ZY	0	+	0	0	1020	0.0000000
zheyou73v0_A03	7788227	7789268	BnaA03T0145100ZY	0	+	0	0	1041	0.0000000
zheyou73v0_A03	7790842	7791901	BnaA03T0145200ZY	0	+	0	0	1059	0.0000000
zheyou73v0_A03	7793609	7794143	BnaA03T0145300ZY	0	+	0	0	534	0.0000000
zheyou73v0_A03	7797831	7798744	BnaA03T0145400ZY	0	+	0	0	913	0.0000000
zheyou73v0_A03	7799440	7805948	BnaA03T0145500ZY	0	-	0	0	6508	0.0000000
zheyou73v0_A03	7806599	7807616	BnaA03T0145600ZY	0	+	0	0	1017	0.0000000
zheyou73v0_A03	7808598	7820244	BnaA03T0145700ZY	0	-	0	0	11646	0.0000000
zheyou73v0_A03	7823219	7823690	BnaA03T0145800ZY	0	-	0	0	471	0.0000000
zheyou73v0_A03	7833337	7834693	BnaA03T0145900ZY	0	+	0	0	1356	0.0000000
zheyou73v0_A03	7838571	7841978	BnaA03T0146000ZY	0	-	0	0	3407	0.0000000
zheyou73v0_A03	7842766	7847189	BnaA03T0146100ZY	0	-	0	0	4423	0.0000000
zheyou73v0_A03	7849968	7851673	BnaA03T0146200ZY	0	-	0	0	1705	0.0000000
zheyou73v0_A03	7854221	7856313	BnaA03T0146300ZY	0	-	0	0	2092	0.0000000
zheyou73v0_A03	7861465	7864062	BnaA03T0146400ZY	0	-	0	0	2597	0.0000000
zheyou73v0_A03	7869514	7871595	BnaA03T0146500ZY	0	+	0	0	2081	0.0000000
zheyou73v0_A03	7872735	7874931	BnaA03T0146600ZY	0	-	0	0	2196	0.0000000
zheyou73v0_A03	7878212	7879165	BnaA03T0146700ZY	0	-	0	0	953	0.0000000
zheyou73v0_A03	7881652	7882241	BnaA03T0146800ZY	0	-	0	0	589	0.0000000
zheyou73v0_A03	7884395	7885132	BnaA03T0146900ZY	0	+	0	0	737	0.0000000
zheyou73v0_A03	7886104	7887249	BnaA03T0147000ZY	0	+	0	0	1145	0.0000000
zheyou73v0_A03	7891417	7893745	BnaA03T0147100ZY	0	-	0	0	2328	0.0000000
zheyou73v0_A03	7907089	7908932	BnaA03T0147200ZY	0	-	0	0	1843	0.0000000
zheyou73v0_A03	7910339	7913522	BnaA03T0147300ZY	0	+	0	0	3183	0.0000000
zheyou73v0_A03	7914197	7916258	BnaA03T0147400ZY	0	-	0	0	2061	0.0000000
zheyou73v0_A03	7918980	7922286	BnaA03T0147500ZY	0	+	0	0	3306	0.0000000
zheyou73v0_A03	7918980	7922286	BnaA03T0147500ZY.1	0	+	0	0	3306	0.0000000
zheyou73v0_A03	7923644	7925481	BnaA03T0147600ZY	0	+	0	0	1837	0.0000000
zheyou73v0_A03	7928150	7929987	BnaA03T0147700ZY	0	+	0	0	1837	0.0000000
zheyou73v0_A03	7935363	7936658	BnaA03T0147800ZY	0	+	0	0	1295	0.0000000
zheyou73v0_A03	7937056	7938594	BnaA03T0147900ZY	0	-	0	0	1538	0.0000000
zheyou73v0_A03	7941767	7944890	BnaA03T0148000ZY	0	+	0	0	3123	0.0000000
zheyou73v0_A03	7944917	7946136	BnaA03T0148100ZY	0	-	0	0	1219	0.0000000
zheyou73v0_A03	7961202	7962623	BnaA03T0148200ZY	0	+	0	0	1421	0.0000000
zheyou73v0_A03	7964736	7965561	BnaA03T0148300ZY	0	+	0	0	825	0.0000000
zheyou73v0_A03	7965653	7966110	BnaA03T0148400ZY	0	-	0	0	457	0.0000000
zheyou73v0_A03	7966230	7968598	BnaA03T0148500ZY	0	-	0	0	2368	0.0000000
zheyou73v0_A03	7974464	7975024	BnaA03T0148600ZY	0	-	0	0	560	0.0000000
zheyou73v0_A03	7980358	7981876	BnaA03T0148700ZY	0	-	0	0	1518	0.0000000
zheyou73v0_A03	7984210	7985697	BnaA03T0148800ZY	0	+	0	0	1487	0.0000000
zheyou73v0_A03	7998943	8001304	BnaA03T0148900ZY	0	+	0	0	2361	0.0000000
zheyou73v0_A03	8010896	8012833	BnaA03T0149000ZY	0	-	0	0	1937	0.0000000
zheyou73v0_A03	8016222	8018945	BnaA03T0149100ZY	0	+	0	0	2723	0.0000000
zheyou73v0_A03	8020012	8021288	BnaA03T0149200ZY	0	-	0	0	1276	0.0000000
zheyou73v0_A03	8027798	8029319	BnaA03T0149300ZY	0	-	0	0	1521	0.0000000
zheyou73v0_A03	8031133	8048883	BnaA03T0149400ZY	0	+	0	0	17750	0.0000000
zheyou73v0_A03	8062839	8064674	BnaA03T0149500ZY	0	+	0	0	1835	0.0000000
zheyou73v0_A03	8067439	8067831	BnaA03T0149600ZY	0	-	0	0	392	0.0000000
zheyou73v0_A03	8067439	8067831	BnaA03T0149600ZY.1	0	-	0	0	392	0.0000000
zheyou73v0_A03	8071625	8073006	BnaA03T0149700ZY	0	+	0	0	1381	0.0000000
zheyou73v0_A03	8091205	8091748	BnaA03T0149800ZY	0	-	0	0	543	0.0000000
zheyou73v0_A03	8099437	8105660	BnaA03T0149900ZY	0	+	0	0	6223	0.0000000
zheyou73v0_A03	8105322	8105577	BnaA03T0150000ZY	0	-	0	0	255	0.0000000
zheyou73v0_A03	8110588	8112801	BnaA03T0150100ZY	0	-	0	0	2213	0.0000000
zheyou73v0_A03	8110588	8112801	BnaA03T0150100ZY.1	0	-	0	0	2213	0.0000000
zheyou73v0_A03	8118487	8119280	BnaA03T0150200ZY	0	+	0	0	793	0.0000000
zheyou73v0_A03	8120405	8122735	BnaA03T0150300ZY	0	+	0	0	2330	0.0000000
zheyou73v0_A03	8123269	8123733	BnaA03T0150400ZY	0	+	0	0	464	0.0000000
zheyou73v0_A03	8125607	8126951	BnaA03T0150500ZY	0	+	0	0	1344	0.0000000
zheyou73v0_A03	8128714	8130058	BnaA03T0150600ZY	0	+	0	0	1344	0.0000000
zheyou73v0_A03	8131037	8132096	BnaA03T0150700ZY	0	+	0	0	1059	0.0000000
zheyou73v0_A03	8139182	8149558	BnaA03T0150800ZY	0	-	0	0	10376	0.0000000
zheyou73v0_A03	8152416	8153836	BnaA03T0150900ZY	0	+	0	0	1420	0.0000000
zheyou73v0_A03	8154988	8155682	BnaA03T0151000ZY	0	-	0	0	694	0.0000000
zheyou73v0_A03	8155964	8156888	BnaA03T0151100ZY	0	-	0	0	924	0.0000000
zheyou73v0_A03	8157143	8158284	BnaA03T0151200ZY	0	+	0	0	1141	0.0000000
zheyou73v0_A03	8159800	8162942	BnaA03T0151300ZY	0	+	0	0	3142	0.0000000
zheyou73v0_A03	8163611	8165983	BnaA03T0151400ZY	0	-	0	0	2372	0.0000000
zheyou73v0_A03	8172104	8173109	BnaA03T0151500ZY	0	-	0	0	1005	0.0000000
zheyou73v0_A03	8184023	8184371	BnaA03T0151600ZY	0	-	0	0	348	0.0000000
zheyou73v0_A03	8202530	8203452	BnaA03T0151700ZY	0	-	0	0	922	0.0000000
zheyou73v0_A03	8203762	8206938	BnaA03T0151800ZY	0	+	0	0	3176	0.0000000
zheyou73v0_A03	8203762	8206938	BnaA03T0151800ZY.1	0	+	0	0	3176	0.0000000
zheyou73v0_A03	8209892	8211392	BnaA03T0151900ZY	0	-	0	0	1500	0.0000000
zheyou73v0_A03	8215278	8217175	BnaA03T0152000ZY	0	-	0	0	1897	0.0000000
zheyou73v0_A03	8218432	8219000	BnaA03T0152100ZY	0	-	0	0	568	0.0000000
zheyou73v0_A03	8220529	8221147	BnaA03T0152200ZY	0	-	0	0	618	0.0000000
zheyou73v0_A03	8222224	8222380	BnaA03T0152300ZY	0	+	0	0	156	0.0000000
zheyou73v0_A03	8222973	8225140	BnaA03T0152400ZY	0	-	0	0	2167	0.0000000
zheyou73v0_A03	8226803	8229553	BnaA03T0152500ZY	0	+	0	0	2750	0.0000000
zheyou73v0_A03	8230948	8234406	BnaA03T0152600ZY	0	-	0	0	3458	0.0000000
zheyou73v0_A03	8236356	8239716	BnaA03T0152700ZY	0	-	0	0	3360	0.0000000
zheyou73v0_A03	8251739	8254362	BnaA03T0152800ZY	0	+	0	0	2623	0.0000000
zheyou73v0_A03	8256688	8265585	BnaA03T0152900ZY	0	-	0	0	8897	0.0000000
zheyou73v0_A03	8274067	8277074	BnaA03T0153000ZY	0	+	0	0	3007	0.0000000
zheyou73v0_A03	8282129	8286619	BnaA03T0153100ZY	0	+	0	0	4490	0.0000000
zheyou73v0_A03	8287260	8289506	BnaA03T0153200ZY	0	-	0	0	2246	0.0000000
zheyou73v0_A03	8301575	8303152	BnaA03T0153300ZY	0	-	0	0	1577	0.0000000
zheyou73v0_A03	8305693	8306371	BnaA03T0153400ZY	0	+	0	0	678	0.0000000
zheyou73v0_A03	8309177	8310287	BnaA03T0153500ZY	0	+	0	0	1110	0.0000000
zheyou73v0_A03	8310291	8313373	BnaA03T0153600ZY	0	-	0	0	3082	0.0000000
zheyou73v0_A03	8314426	8315842	BnaA03T0153700ZY	0	-	0	0	1416	0.0000000
zheyou73v0_A03	8317429	8319554	BnaA03T0153800ZY	0	+	0	0	2125	0.0000000
zheyou73v0_A03	8322519	8323920	BnaA03T0153900ZY	0	+	0	0	1401	0.0000000
zheyou73v0_A03	8337419	8338621	BnaA03T0154000ZY	0	+	0	0	1202	0.0000000
zheyou73v0_A03	8354459	8361592	BnaA03T0154100ZY	0	+	0	0	7133	0.0000000
zheyou73v0_A03	8364671	8365619	BnaA03T0154200ZY	0	+	0	0	948	0.0000000
zheyou73v0_A03	8367467	8368866	BnaA03T0154300ZY	0	-	0	0	1399	0.0000000
zheyou73v0_A03	8371321	8371955	BnaA03T0154400ZY	0	+	0	0	634	0.0000000
zheyou73v0_A03	8373065	8373693	BnaA03T0154500ZY	0	-	0	0	628	0.0000000
zheyou73v0_A03	8374053	8375646	BnaA03T0154600ZY	0	-	0	0	1593	0.0000000
zheyou73v0_A03	8389420	8391615	BnaA03T0154700ZY	0	+	0	0	2195	0.0000000
zheyou73v0_A03	8394474	8398284	BnaA03T0154800ZY	0	-	0	0	3810	0.0000000
zheyou73v0_A03	8405544	8405712	BnaA03T0154900ZY	0	+	0	0	168	0.0000000
zheyou73v0_A03	8409848	8412805	BnaA03T0155000ZY	0	+	0	0	2957	0.0000000
zheyou73v0_A03	8413146	8413666	BnaA03T0155100ZY	0	+	0	0	520	0.0000000
zheyou73v0_A03	8415413	8417686	BnaA03T0155200ZY	0	-	0	0	2273	0.0000000
zheyou73v0_A03	8423542	8424648	BnaA03T0155300ZY	0	+	0	0	1106	0.0000000
zheyou73v0_A03	8425777	8429229	BnaA03T0155400ZY	0	-	0	0	3452	0.0000000
zheyou73v0_A03	8425777	8429229	BnaA03T0155400ZY.1	0	-	0	0	3452	0.0000000
zheyou73v0_A03	8434157	8436995	BnaA03T0155500ZY	0	-	0	0	2838	0.0000000
zheyou73v0_A03	8440377	8441394	BnaA03T0155600ZY	0	+	0	0	1017	0.0000000
zheyou73v0_A03	8442583	8443538	BnaA03T0155700ZY	0	-	0	0	955	0.0000000
zheyou73v0_A03	8489205	8490517	BnaA03T0155800ZY	0	+	0	0	1312	0.0000000
zheyou73v0_A03	8499051	8499489	BnaA03T0155900ZY	0	+	0	0	438	0.0000000
zheyou73v0_A03	8500790	8502080	BnaA03T0156000ZY	0	-	0	0	1290	0.0000000
zheyou73v0_A03	8511124	8515706	BnaA03T0156100ZY	0	+	0	0	4582	0.0000000
zheyou73v0_A03	8519349	8520670	BnaA03T0156200ZY	0	+	0	0	1321	0.0000000
zheyou73v0_A03	8526435	8528155	BnaA03T0156300ZY	0	-	0	0	1720	0.0000000
zheyou73v0_A03	8533410	8536316	BnaA03T0156400ZY	0	-	0	0	2906	0.0000000
zheyou73v0_A03	8537582	8538386	BnaA03T0156500ZY	0	-	0	0	804	0.0000000
zheyou73v0_A03	8539945	8542247	BnaA03T0156600ZY	0	+	0	0	2302	0.0000000
zheyou73v0_A03	8542845	8544364	BnaA03T0156700ZY	0	+	0	0	1519	0.0000000
zheyou73v0_A03	8546356	8547032	BnaA03T0156800ZY	0	+	0	0	676	0.0000000
zheyou73v0_A03	8552229	8559545	BnaA03T0156900ZY	0	+	0	0	7316	0.0000000
zheyou73v0_A03	8559807	8567838	BnaA03T0157000ZY	0	-	0	0	8031	0.0000000
zheyou73v0_A03	8572922	8574412	BnaA03T0157100ZY	0	-	0	0	1490	0.0000000
zheyou73v0_A03	8572922	8574412	BnaA03T0157100ZY.1	0	-	0	0	1490	0.0000000
zheyou73v0_A03	8575869	8578515	BnaA03T0157200ZY	0	-	0	0	2646	0.0000000
zheyou73v0_A03	8585913	8589105	BnaA03T0157300ZY	0	+	0	0	3192	0.0000000
zheyou73v0_A03	8589237	8589705	BnaA03T0157400ZY	0	+	0	0	468	0.0000000
zheyou73v0_A03	8597870	8600309	BnaA03T0157500ZY	0	-	0	0	2439	0.0000000
zheyou73v0_A03	8603909	8607194	BnaA03T0157600ZY	0	+	0	0	3285	0.0000000
zheyou73v0_A03	8608749	8610642	BnaA03T0157700ZY	0	-	0	0	1893	0.0000000
zheyou73v0_A03	8615229	8616770	BnaA03T0157800ZY	0	-	0	0	1541	0.0000000
zheyou73v0_A03	8615563	8616770	BnaA03T0157800ZY.1	0	-	0	0	1207	0.0000000
zheyou73v0_A03	8618603	8621884	BnaA03T0157900ZY	0	+	0	0	3281	0.0000000
zheyou73v0_A03	8623003	8628955	BnaA03T0158000ZY	0	+	0	0	5952	0.0000000
zheyou73v0_A03	8630594	8631553	BnaA03T0158100ZY	0	+	0	0	959	0.0000000
zheyou73v0_A03	8631597	8632989	BnaA03T0158200ZY	0	-	0	0	1392	0.0000000
zheyou73v0_A03	8636095	8637541	BnaA03T0158300ZY	0	-	0	0	1446	0.0000000
zheyou73v0_A03	8638873	8639915	BnaA03T0158400ZY	0	-	0	0	1042	0.0000000
zheyou73v0_A03	8640508	8642300	BnaA03T0158500ZY	0	+	0	0	1792	0.0000000
zheyou73v0_A03	8642861	8643476	BnaA03T0158600ZY	0	+	0	0	615	0.0000000
zheyou73v0_A03	8647085	8647379	BnaA03T0158700ZY	0	-	0	0	294	0.0000000
zheyou73v0_A03	8652410	8656152	BnaA03T0158800ZY	0	+	0	0	3742	0.0000000
zheyou73v0_A03	8656892	8658356	BnaA03T0158900ZY	0	+	0	0	1464	0.0000000
zheyou73v0_A03	8658723	8660502	BnaA03T0159000ZY	0	-	0	0	1779	0.0000000
zheyou73v0_A03	8666665	8670537	BnaA03T0159100ZY	0	-	0	0	3872	0.0000000
zheyou73v0_A03	8678249	8679767	BnaA03T0159200ZY	0	+	0	0	1518	0.0000000
zheyou73v0_A03	8685312	8688864	BnaA03T0159300ZY	0	+	0	0	3552	0.0000000
zheyou73v0_A03	8689888	8691971	BnaA03T0159400ZY	0	+	0	0	2083	0.0000000
zheyou73v0_A03	8692588	8694209	BnaA03T0159500ZY	0	-	0	0	1621	0.0000000
zheyou73v0_A03	8702269	8704536	BnaA03T0159600ZY	0	-	0	0	2267	0.0000000
zheyou73v0_A03	8702269	8704536	BnaA03T0159600ZY.1	0	-	0	0	2267	0.0000000
zheyou73v0_A03	8702269	8704536	BnaA03T0159600ZY.2	0	-	0	0	2267	0.0000000
zheyou73v0_A03	8702269	8704536	BnaA03T0159600ZY.3	0	-	0	0	2267	0.0000000
zheyou73v0_A03	8710982	8711689	BnaA03T0159700ZY	0	+	0	0	707	0.0000000
zheyou73v0_A03	8713277	8714444	BnaA03T0159800ZY	0	+	0	0	1167	0.0000000
zheyou73v0_A03	8715358	8717768	BnaA03T0159900ZY	0	+	0	0	2410	0.0000000
zheyou73v0_A03	8717761	8718406	BnaA03T0160000ZY	0	-	0	0	645	0.0000000
zheyou73v0_A03	8719442	8722506	BnaA03T0160100ZY	0	+	0	0	3064	0.0000000
zheyou73v0_A03	8723025	8731223	BnaA03T0160200ZY	0	-	0	0	8198	0.0000000
zheyou73v0_A03	8733200	8734889	BnaA03T0160300ZY	0	+	0	0	1689	0.0000000
zheyou73v0_A03	8736311	8739405	BnaA03T0160400ZY	0	+	0	0	3094	0.0000000
zheyou73v0_A03	8749254	8752034	BnaA03T0160500ZY	0	+	0	0	2780	0.0000000
zheyou73v0_A03	8749369	8752034	BnaA03T0160500ZY.1	0	+	0	0	2665	0.0000000
zheyou73v0_A03	8754400	8756523	BnaA03T0160600ZY	0	-	0	0	2123	0.0000000
zheyou73v0_A03	8756982	8758663	BnaA03T0160700ZY	0	-	0	0	1681	0.0000000
zheyou73v0_A03	8759395	8761599	BnaA03T0160800ZY	0	-	0	0	2204	0.0000000
zheyou73v0_A03	8763613	8765707	BnaA03T0160900ZY	0	-	0	0	2094	0.0000000
zheyou73v0_A03	8774601	8775581	BnaA03T0161000ZY	0	+	0	0	980	0.0000000
zheyou73v0_A03	8775921	8784906	BnaA03T0161100ZY	0	-	0	0	8985	0.0000000
zheyou73v0_A03	8786699	8787816	BnaA03T0161200ZY	0	+	0	0	1117	0.0000000
zheyou73v0_A03	8788300	8790653	BnaA03T0161300ZY	0	+	0	0	2353	0.0000000
zheyou73v0_A03	8792698	8793547	BnaA03T0161400ZY	0	-	0	0	849	0.0000000
zheyou73v0_A03	8797263	8799060	BnaA03T0161500ZY	0	-	0	0	1797	0.0000000
zheyou73v0_A03	8799573	8800541	BnaA03T0161600ZY	0	-	0	0	968	0.0000000
zheyou73v0_A03	8801304	8802516	BnaA03T0161700ZY	0	-	0	0	1212	0.0000000
zheyou73v0_A03	8803487	8806959	BnaA03T0161800ZY	0	-	0	0	3472	0.0000000
zheyou73v0_A03	8808285	8810010	BnaA03T0161900ZY	0	+	0	0	1725	0.0000000
zheyou73v0_A03	8810312	8812687	BnaA03T0162000ZY	0	-	0	0	2375	0.0000000
zheyou73v0_A03	8816657	8817456	BnaA03T0162100ZY	0	+	0	0	799	0.0000000
zheyou73v0_A03	8830730	8831092	BnaA03T0162200ZY	0	-	0	0	362	0.0000000
zheyou73v0_A03	8833175	8834132	BnaA03T0162300ZY	0	-	0	0	957	0.0000000
zheyou73v0_A03	8834389	8836768	BnaA03T0162400ZY.1	0	+	0	0	2379	0.0000000
zheyou73v0_A03	8834497	8836768	BnaA03T0162400ZY	0	+	0	0	2271	0.0000000
zheyou73v0_A03	8837322	8839175	BnaA03T0162500ZY	0	-	0	0	1853	0.0000000
zheyou73v0_A03	8841162	8844781	BnaA03T0162600ZY	0	+	0	0	3619	0.0000000
zheyou73v0_A03	8845052	8848652	BnaA03T0162700ZY	0	+	0	0	3600	0.0000000
zheyou73v0_A03	8850717	8853962	BnaA03T0162800ZY	0	-	0	0	3245	0.0000000
zheyou73v0_A03	8858731	8860808	BnaA03T0162900ZY	0	+	0	0	2077	0.0000000
zheyou73v0_A03	8865139	8869052	BnaA03T0163000ZY	0	-	0	0	3913	0.0000000
zheyou73v0_A03	8877944	8878556	BnaA03T0163100ZY	0	-	0	0	612	0.0000000
zheyou73v0_A03	8879899	8881261	BnaA03T0163200ZY	0	-	0	0	1362	0.0000000
zheyou73v0_A03	8881322	8884043	BnaA03T0163300ZY	0	-	0	0	2721	0.0000000
zheyou73v0_A03	8885226	8887862	BnaA03T0163400ZY	0	+	0	0	2636	0.0000000
zheyou73v0_A03	8887726	8890155	BnaA03T0163500ZY	0	-	0	0	2429	0.0000000
zheyou73v0_A03	8890688	8892603	BnaA03T0163600ZY	0	-	0	0	1915	0.0000000
zheyou73v0_A03	8892831	8894797	BnaA03T0163700ZY	0	-	0	0	1966	0.0000000
zheyou73v0_A03	8895034	8896535	BnaA03T0163800ZY	0	+	0	0	1501	0.0000000
zheyou73v0_A03	8895034	8896535	BnaA03T0163800ZY.1	0	+	0	0	1501	0.0000000
zheyou73v0_A03	8904935	8906728	BnaA03T0163900ZY	0	+	0	0	1793	0.0000000
zheyou73v0_A03	8906904	8909124	BnaA03T0164000ZY	0	-	0	0	2220	0.0000000
zheyou73v0_A03	8910069	8914907	BnaA03T0164100ZY	0	-	0	0	4838	0.0000000
zheyou73v0_A03	8918994	8924116	BnaA03T0164200ZY	0	+	0	0	5122	0.0000000
zheyou73v0_A03	8933965	8935580	BnaA03T0164300ZY	0	+	0	0	1615	0.0000000
zheyou73v0_A03	8936223	8937688	BnaA03T0164400ZY	0	+	0	0	1465	0.0000000
zheyou73v0_A03	8937877	8938678	BnaA03T0164500ZY	0	-	0	0	801	0.0000000
zheyou73v0_A03	8947206	8949808	BnaA03T0164600ZY	0	-	0	0	2602	0.0000000
zheyou73v0_A03	8952364	8953425	BnaA03T0164700ZY	0	-	0	0	1061	0.0000000
zheyou73v0_A03	8955052	8959285	BnaA03T0164800ZY	0	+	0	0	4233	0.0000000
zheyou73v0_A03	8959488	8961586	BnaA03T0164900ZY	0	+	0	0	2098	0.0000000
zheyou73v0_A03	8966302	8967795	BnaA03T0165000ZY	0	+	0	0	1493	0.0000000
zheyou73v0_A03	8983768	8985730	BnaA03T0165100ZY	0	+	0	0	1962	0.0000000
zheyou73v0_A03	8986930	8988227	BnaA03T0165200ZY	0	+	0	0	1297	0.0000000
zheyou73v0_A03	8990119	8992892	BnaA03T0165300ZY	0	+	0	0	2773	0.0000000
zheyou73v0_A03	8993219	8996446	BnaA03T0165400ZY	0	-	0	0	3227	0.0000000
zheyou73v0_A03	8998037	9000737	BnaA03T0165500ZY	0	-	0	0	2700	0.0000000
zheyou73v0_A03	9006359	9008068	BnaA03T0165600ZY	0	-	0	0	1709	0.0000000
zheyou73v0_A03	9009440	9009847	BnaA03T0165700ZY	0	+	0	0	407	0.0000000
zheyou73v0_A03	9018480	9020208	BnaA03T0165800ZY	0	+	0	0	1728	0.0000000
zheyou73v0_A03	9020921	9025055	BnaA03T0165900ZY	0	-	0	0	4134	0.0000000
zheyou73v0_A03	9028133	9028661	BnaA03T0166000ZY	0	-	0	0	528	0.0000000
zheyou73v0_A03	9039309	9041493	BnaA03T0166100ZY	0	+	0	0	2184	0.0000000
zheyou73v0_A03	9039309	9041493	BnaA03T0166100ZY.1	0	+	0	0	2184	0.0000000
zheyou73v0_A03	9043416	9045045	BnaA03T0166200ZY	0	+	0	0	1629	0.0000000
zheyou73v0_A03	9048816	9050937	BnaA03T0166300ZY	0	+	0	0	2121	0.0000000
zheyou73v0_A03	9053830	9054434	BnaA03T0166400ZY	0	-	0	0	604	0.0000000
zheyou73v0_A03	9056827	9060687	BnaA03T0166500ZY	0	-	0	0	3860	0.0000000
zheyou73v0_A03	9070201	9073540	BnaA03T0166600ZY	0	-	0	0	3339	0.0000000
zheyou73v0_A03	9070201	9073540	BnaA03T0166600ZY.1	0	-	0	0	3339	0.0000000
zheyou73v0_A03	9070201	9073540	BnaA03T0166600ZY.2	0	-	0	0	3339	0.0000000
zheyou73v0_A03	9074149	9075244	BnaA03T0166700ZY	0	-	0	0	1095	0.0000000
zheyou73v0_A03	9078295	9079352	BnaA03T0166800ZY	0	+	0	0	1057	0.0000000
zheyou73v0_A03	9090868	9095750	BnaA03T0166900ZY	0	+	0	0	4882	0.0000000
zheyou73v0_A03	9099512	9100913	BnaA03T0167000ZY	0	+	0	0	1401	0.0000000
zheyou73v0_A03	9108503	9113577	BnaA03T0167100ZY	0	+	0	0	5074	0.0000000
zheyou73v0_A03	9114545	9116626	BnaA03T0167200ZY	0	+	0	0	2081	0.0000000
zheyou73v0_A03	9128688	9134262	BnaA03T0167300ZY	0	+	0	0	5574	0.0000000
zheyou73v0_A03	9142511	9147106	BnaA03T0167400ZY	0	-	0	0	4595	0.0000000
zheyou73v0_A03	9149944	9150762	BnaA03T0167500ZY	0	+	0	0	818	0.0000000
zheyou73v0_A03	9153888	9155602	BnaA03T0167600ZY	0	+	0	0	1714	0.0000000
zheyou73v0_A03	9153888	9155602	BnaA03T0167600ZY.1	0	+	0	0	1714	0.0000000
zheyou73v0_A03	9155687	9156502	BnaA03T0167700ZY	0	+	0	0	815	0.0000000
zheyou73v0_A03	9156822	9157270	BnaA03T0167800ZY	0	-	0	0	448	0.0000000
zheyou73v0_A03	9156822	9157270	BnaA03T0167800ZY.1	0	-	0	0	448	0.0000000
zheyou73v0_A03	9160654	9161647	BnaA03T0167900ZY	0	+	0	0	993	0.0000000
zheyou73v0_A03	9164190	9164517	BnaA03T0168000ZY	0	-	0	0	327	0.0000000
zheyou73v0_A03	9166348	9167509	BnaA03T0168100ZY	0	-	0	0	1161	0.0000000
zheyou73v0_A03	9170762	9171293	BnaA03T0168200ZY	0	+	0	0	531	0.0000000
zheyou73v0_A03	9172671	9178688	BnaA03T0168300ZY	0	-	0	0	6017	0.0000000
zheyou73v0_A03	9180220	9181073	BnaA03T0168400ZY	0	-	0	0	853	0.0000000
zheyou73v0_A03	9185460	9187731	BnaA03T0168500ZY	0	+	0	0	2271	0.0000000
zheyou73v0_A03	9190133	9192229	BnaA03T0168600ZY	0	-	0	0	2096	0.0000000
zheyou73v0_A03	9198825	9201163	BnaA03T0168700ZY	0	-	0	0	2338	0.0000000
zheyou73v0_A03	9204404	9205825	BnaA03T0168800ZY	0	-	0	0	1421	0.0000000
zheyou73v0_A03	9209928	9211644	BnaA03T0168900ZY	0	-	0	0	1716	0.0000000
zheyou73v0_A03	9219583	9220571	BnaA03T0169000ZY	0	-	0	0	988	0.0000000
zheyou73v0_A03	9222887	9223869	BnaA03T0169100ZY	0	+	0	0	982	0.0000000
zheyou73v0_A03	9224272	9230451	BnaA03T0169200ZY	0	+	0	0	6179	0.0000000
zheyou73v0_A03	9231110	9231797	BnaA03T0169300ZY	0	+	0	0	687	0.0000000
zheyou73v0_A03	9235125	9237110	BnaA03T0169400ZY	0	-	0	0	1985	0.0000000
zheyou73v0_A03	9235125	9237110	BnaA03T0169400ZY.1	0	-	0	0	1985	0.0000000
zheyou73v0_A03	9239738	9240610	BnaA03T0169500ZY	0	+	0	0	872	0.0000000
zheyou73v0_A03	9241747	9242743	BnaA03T0169600ZY	0	-	0	0	996	0.0000000
zheyou73v0_A03	9244601	9248167	BnaA03T0169700ZY	0	-	0	0	3566	0.0000000
zheyou73v0_A03	9251704	9256552	BnaA03T0169800ZY	0	-	0	0	4848	0.0000000
zheyou73v0_A03	9259304	9263951	BnaA03T0169900ZY	0	-	0	0	4647	0.0000000
zheyou73v0_A03	9266411	9269314	BnaA03T0170000ZY	0	-	0	0	2903	0.0000000
zheyou73v0_A03	9273162	9274582	BnaA03T0170100ZY	0	+	0	0	1420	0.0000000
zheyou73v0_A03	9279167	9280371	BnaA03T0170200ZY	0	+	0	0	1204	0.0000000
zheyou73v0_A03	9287716	9288528	BnaA03T0170300ZY	0	+	0	0	812	0.0000000
zheyou73v0_A03	9289073	9290305	BnaA03T0170400ZY	0	-	0	0	1232	0.0000000
zheyou73v0_A03	9291013	9295551	BnaA03T0170500ZY	0	-	0	0	4538	0.0000000
zheyou73v0_A03	9296211	9299118	BnaA03T0170600ZY	0	-	0	0	2907	0.0000000
zheyou73v0_A03	9301133	9302934	BnaA03T0170700ZY	0	+	0	0	1801	0.0000000
zheyou73v0_A03	9314347	9316681	BnaA03T0170800ZY	0	-	0	0	2334	0.0000000
zheyou73v0_A03	9329382	9331802	BnaA03T0170900ZY	0	+	0	0	2420	0.0000000
zheyou73v0_A03	9329382	9331802	BnaA03T0170900ZY.1	0	+	0	0	2420	0.0000000
zheyou73v0_A03	9333746	9334612	BnaA03T0171000ZY	0	+	0	0	866	0.0000000
zheyou73v0_A03	9336190	9337329	BnaA03T0171100ZY	0	+	0	0	1139	0.0000000
zheyou73v0_A03	9337774	9339072	BnaA03T0171200ZY	0	-	0	0	1298	0.0000000
zheyou73v0_A03	9344064	9346116	BnaA03T0171300ZY	0	+	0	0	2052	0.0000000
zheyou73v0_A03	9355842	9358606	BnaA03T0171400ZY	0	+	0	0	2764	0.0000000
zheyou73v0_A03	9359613	9362565	BnaA03T0171500ZY	0	-	0	0	2952	0.0000000
zheyou73v0_A03	9367722	9373120	BnaA03T0171600ZY	0	+	0	0	5398	0.0000000
zheyou73v0_A03	9372858	9374054	BnaA03T0171700ZY	0	+	0	0	1196	0.0000000
zheyou73v0_A03	9375017	9375269	BnaA03T0171800ZY	0	+	0	0	252	0.0000000
zheyou73v0_A03	9375438	9375957	BnaA03T0171900ZY	0	-	0	0	519	0.0000000
zheyou73v0_A03	9377117	9377777	BnaA03T0172000ZY	0	+	0	0	660	0.0000000
zheyou73v0_A03	9378271	9383664	BnaA03T0172100ZY	0	-	0	0	5393	0.0000000
zheyou73v0_A03	9395176	9395761	BnaA03T0172200ZY	0	+	0	0	585	0.0000000
zheyou73v0_A03	9402075	9403875	BnaA03T0172300ZY	0	-	0	0	1800	0.0000000
zheyou73v0_A03	9404044	9408157	BnaA03T0172400ZY	0	-	0	0	4113	0.0000000
zheyou73v0_A03	9404044	9408157	BnaA03T0172400ZY.1	0	-	0	0	4113	0.0000000
zheyou73v0_A03	9409915	9412166	BnaA03T0172500ZY	0	-	0	0	2251	0.0000000
zheyou73v0_A03	9409915	9412166	BnaA03T0172500ZY.1	0	-	0	0	2251	0.0000000
zheyou73v0_A03	9409915	9412166	BnaA03T0172500ZY.2	0	-	0	0	2251	0.0000000
zheyou73v0_A03	9409915	9412166	BnaA03T0172500ZY.3	0	-	0	0	2251	0.0000000
zheyou73v0_A03	9415268	9416985	BnaA03T0172600ZY	0	+	0	0	1717	0.0000000
zheyou73v0_A03	9420352	9421821	BnaA03T0172700ZY	0	-	0	0	1469	0.0000000
zheyou73v0_A03	9431034	9432013	BnaA03T0172800ZY	0	-	0	0	979	0.0000000
zheyou73v0_A03	9438895	9441780	BnaA03T0172900ZY	0	-	0	0	2885	0.0000000
zheyou73v0_A03	9443214	9445368	BnaA03T0173000ZY	0	+	0	0	2154	0.0000000
zheyou73v0_A03	9448657	9450751	BnaA03T0173100ZY	0	+	0	0	2094	0.0000000
zheyou73v0_A03	9454008	9456985	BnaA03T0173200ZY	0	-	0	0	2977	0.0000000
zheyou73v0_A03	9455373	9457178	BnaA03T0173200ZY.1	0	-	0	0	1805	0.0000000
zheyou73v0_A03	9455373	9457178	BnaA03T0173200ZY.2	0	-	0	0	1805	0.0000000
zheyou73v0_A03	9466384	9466999	BnaA03T0173300ZY	0	+	0	0	615	0.0000000
zheyou73v0_A03	9467060	9469551	BnaA03T0173400ZY	0	-	0	0	2491	0.0000000
zheyou73v0_A03	9471752	9473606	BnaA03T0173500ZY	0	-	0	0	1854	0.0000000
zheyou73v0_A03	9475818	9477826	BnaA03T0173600ZY	0	-	0	0	2008	0.0000000
zheyou73v0_A03	9479315	9481765	BnaA03T0173700ZY	0	-	0	0	2450	0.0000000
zheyou73v0_A03	9482005	9483130	BnaA03T0173800ZY	0	+	0	0	1125	0.0000000
zheyou73v0_A03	9483738	9484680	BnaA03T0173900ZY	0	+	0	0	942	0.0000000
zheyou73v0_A03	9485075	9487309	BnaA03T0174000ZY	0	+	0	0	2234	0.0000000
zheyou73v0_A03	9487219	9491470	BnaA03T0174100ZY	0	-	0	0	4251	0.0000000
zheyou73v0_A03	9492857	9495943	BnaA03T0174200ZY	0	+	0	0	3086	0.0000000
zheyou73v0_A03	9496694	9497173	BnaA03T0174300ZY	0	-	0	0	479	0.0000000
zheyou73v0_A03	9506228	9507969	BnaA03T0174400ZY	0	-	0	0	1741	0.0000000
zheyou73v0_A03	9514647	9515775	BnaA03T0174500ZY	0	+	0	0	1128	0.0000000
zheyou73v0_A03	9516028	9517946	BnaA03T0174600ZY	0	-	0	0	1918	0.0000000
zheyou73v0_A03	9520517	9520775	BnaA03T0174700ZY	0	+	0	0	258	0.0000000
zheyou73v0_A03	9522192	9522549	BnaA03T0174800ZY	0	+	0	0	357	0.0000000
zheyou73v0_A03	9527494	9527797	BnaA03T0174900ZY	0	+	0	0	303	0.0000000
zheyou73v0_A03	9530386	9532147	BnaA03T0175000ZY	0	+	0	0	1761	0.0000000
zheyou73v0_A03	9532425	9535868	BnaA03T0175100ZY	0	-	0	0	3443	0.0000000
zheyou73v0_A03	9537524	9539120	BnaA03T0175200ZY	0	-	0	0	1596	0.0000000
zheyou73v0_A03	9540607	9542172	BnaA03T0175300ZY	0	+	0	0	1565	0.0000000
zheyou73v0_A03	9546212	9553761	BnaA03T0175400ZY	0	+	0	0	7549	0.0000000
zheyou73v0_A03	9553901	9555168	BnaA03T0175500ZY	0	-	0	0	1267	0.0000000
zheyou73v0_A03	9557676	9559101	BnaA03T0175600ZY	0	-	0	0	1425	0.0000000
zheyou73v0_A03	9565451	9568076	BnaA03T0175700ZY	0	-	0	0	2625	0.0000000
zheyou73v0_A03	9569151	9573374	BnaA03T0175800ZY	0	-	0	0	4223	0.0000000
zheyou73v0_A03	9578344	9580641	BnaA03T0175900ZY	0	+	0	0	2297	0.0000000
zheyou73v0_A03	9582418	9584111	BnaA03T0176000ZY	0	+	0	0	1693	0.0000000
zheyou73v0_A03	9584234	9588751	BnaA03T0176100ZY	0	-	0	0	4517	0.0000000
zheyou73v0_A03	9584234	9588751	BnaA03T0176100ZY.1	0	-	0	0	4517	0.0000000
zheyou73v0_A03	9585390	9588751	BnaA03T0176100ZY.2	0	-	0	0	3361	0.0000000
zheyou73v0_A03	9590420	9594499	BnaA03T0176200ZY	0	+	0	0	4079	0.0000000
zheyou73v0_A03	9594651	9596719	BnaA03T0176300ZY	0	-	0	0	2068	0.0000000
zheyou73v0_A03	9599611	9605023	BnaA03T0176400ZY	0	-	0	0	5412	0.0000000
zheyou73v0_A03	9605805	9610718	BnaA03T0176500ZY	0	-	0	0	4913	0.0000000
zheyou73v0_A03	9617966	9620663	BnaA03T0176600ZY	0	-	0	0	2697	0.0000000
zheyou73v0_A03	9624317	9633168	BnaA03T0176700ZY	0	+	0	0	8851	0.0000000
zheyou73v0_A03	9634684	9642242	BnaA03T0176800ZY	0	-	0	0	7558	0.0000000
zheyou73v0_A03	9643159	9648666	BnaA03T0176900ZY	0	-	0	0	5507	0.0000000
zheyou73v0_A03	9650731	9651910	BnaA03T0177000ZY	0	+	0	0	1179	0.0000000
zheyou73v0_A03	9652512	9653928	BnaA03T0177100ZY	0	-	0	0	1416	0.0000000
zheyou73v0_A03	9656965	9658104	BnaA03T0177200ZY	0	-	0	0	1139	0.0000000
zheyou73v0_A03	9659048	9663723	BnaA03T0177300ZY	0	-	0	0	4675	0.0000000
zheyou73v0_A03	9667916	9670374	BnaA03T0177400ZY	0	+	0	0	2458	0.0000000
zheyou73v0_A03	9671501	9672623	BnaA03T0177500ZY	0	+	0	0	1122	0.0000000
zheyou73v0_A03	9677171	9678088	BnaA03T0177600ZY	0	-	0	0	917	0.0000000
zheyou73v0_A03	9678815	9681182	BnaA03T0177700ZY	0	-	0	0	2367	0.0000000
zheyou73v0_A03	9685421	9687724	BnaA03T0177800ZY	0	+	0	0	2303	0.0000000
zheyou73v0_A03	9688674	9689175	BnaA03T0177900ZY	0	-	0	0	501	0.0000000
zheyou73v0_A03	9689945	9698217	BnaA03T0178000ZY	0	-	0	0	8272	0.0000000
zheyou73v0_A03	9689945	9698015	BnaA03T0178000ZY.1	0	-	0	0	8070	0.0000000
zheyou73v0_A03	9700297	9701328	BnaA03T0178100ZY	0	-	0	0	1031	0.0000000
zheyou73v0_A03	9701452	9705930	BnaA03T0178200ZY	0	-	0	0	4478	0.0000000
zheyou73v0_A03	9711980	9713090	BnaA03T0178300ZY	0	+	0	0	1110	0.0000000
zheyou73v0_A03	9714254	9716121	BnaA03T0178400ZY	0	-	0	0	1867	0.0000000
zheyou73v0_A03	9714254	9716121	BnaA03T0178400ZY.1	0	-	0	0	1867	0.0000000
zheyou73v0_A03	9719801	9723957	BnaA03T0178500ZY	0	+	0	0	4156	0.0000000
zheyou73v0_A03	9731935	9733780	BnaA03T0178600ZY	0	+	0	0	1845	0.0000000
zheyou73v0_A03	9734250	9737662	BnaA03T0178700ZY	0	-	0	0	3412	0.0000000
zheyou73v0_A03	9739468	9740323	BnaA03T0178800ZY	0	+	0	0	855	0.0000000
zheyou73v0_A03	9749620	9750637	BnaA03T0178900ZY	0	-	0	0	1017	0.0000000
zheyou73v0_A03	9753161	9761317	BnaA03T0179000ZY	0	+	0	0	8156	0.0000000
zheyou73v0_A03	9763157	9765082	BnaA03T0179100ZY	0	+	0	0	1925	0.0000000
zheyou73v0_A03	9765963	9767256	BnaA03T0179200ZY	0	-	0	0	1293	0.0000000
zheyou73v0_A03	9768843	9773949	BnaA03T0179300ZY	0	+	0	0	5106	0.0000000
zheyou73v0_A03	9774733	9776365	BnaA03T0179400ZY	0	+	0	0	1632	0.0000000
zheyou73v0_A03	9777263	9780078	BnaA03T0179500ZY	0	+	0	0	2815	0.0000000
zheyou73v0_A03	9780129	9781802	BnaA03T0179600ZY	0	+	0	0	1673	0.0000000
zheyou73v0_A03	9780978	9781802	BnaA03T0179600ZY.1	0	+	0	0	824	0.0000000
zheyou73v0_A03	9782528	9785411	BnaA03T0179700ZY	0	+	0	0	2883	0.0000000
zheyou73v0_A03	9790367	9791336	BnaA03T0179800ZY	0	-	0	0	969	0.0000000
zheyou73v0_A03	9799541	9802254	BnaA03T0179900ZY	0	+	0	0	2713	0.0000000
zheyou73v0_A03	9803063	9803585	BnaA03T0180000ZY	0	+	0	0	522	0.0000000
zheyou73v0_A03	9804803	9810639	BnaA03T0180100ZY	0	-	0	0	5836	0.0000000
zheyou73v0_A03	9811457	9813869	BnaA03T0180200ZY	0	+	0	0	2412	0.0000000
zheyou73v0_A03	9814465	9815626	BnaA03T0180300ZY	0	-	0	0	1161	0.0000000
zheyou73v0_A03	9819229	9819814	BnaA03T0180400ZY	0	-	0	0	585	0.0000000
zheyou73v0_A03	9822181	9822709	BnaA03T0180500ZY	0	+	0	0	528	0.0000000
zheyou73v0_A03	9824292	9826320	BnaA03T0180600ZY	0	+	0	0	2028	0.0000000
zheyou73v0_A03	9840647	9841654	BnaA03T0180700ZY	0	+	0	0	1007	0.0000000
zheyou73v0_A03	9842590	9843278	BnaA03T0180800ZY	0	-	0	0	688	0.0000000
zheyou73v0_A03	9846521	9848618	BnaA03T0180900ZY	0	+	0	0	2097	0.0000000
zheyou73v0_A03	9860067	9864729	BnaA03T0181000ZY	0	+	0	0	4662	0.0000000
zheyou73v0_A03	9869120	9871321	BnaA03T0181100ZY	0	+	0	0	2201	0.0000000
zheyou73v0_A03	9889713	9890453	BnaA03T0181200ZY	0	-	0	0	740	0.0000000
zheyou73v0_A03	9895604	9899558	BnaA03T0181300ZY	0	-	0	0	3954	0.0000000
zheyou73v0_A03	9902239	9902486	BnaA03T0181400ZY	0	+	0	0	247	0.0000000
zheyou73v0_A03	9910608	9913009	BnaA03T0181500ZY	0	+	0	0	2401	0.0000000
zheyou73v0_A03	9914118	9917762	BnaA03T0181600ZY	0	+	0	0	3644	0.0000000
zheyou73v0_A03	9923763	9925667	BnaA03T0181700ZY	0	-	0	0	1904	0.0000000
zheyou73v0_A03	9927099	9930529	BnaA03T0181800ZY	0	-	0	0	3430	0.0000000
zheyou73v0_A03	9939045	9940635	BnaA03T0181900ZY	0	+	0	0	1590	0.0000000
zheyou73v0_A03	9943709	9944807	BnaA03T0182000ZY	0	+	0	0	1098	0.0000000
zheyou73v0_A03	9945818	9949265	BnaA03T0182100ZY	0	-	0	0	3447	0.0000000
zheyou73v0_A03	9949832	9950211	BnaA03T0182200ZY	0	+	0	0	379	0.0000000
zheyou73v0_A03	9950626	9955917	BnaA03T0182300ZY	0	-	0	0	5291	0.0000000
zheyou73v0_A03	9961222	9962943	BnaA03T0182400ZY	0	+	0	0	1721	0.0000000
zheyou73v0_A03	9962951	9964656	BnaA03T0182500ZY	0	-	0	0	1705	0.0000000
zheyou73v0_A03	9967168	9967612	BnaA03T0182600ZY	0	-	0	0	444	0.0000000
zheyou73v0_A03	9977054	9978697	BnaA03T0182700ZY	0	+	0	0	1643	0.0000000
zheyou73v0_A03	9979283	9980904	BnaA03T0182800ZY	0	-	0	0	1621	0.0000000
zheyou73v0_A03	9982806	9984084	BnaA03T0182900ZY	0	+	0	0	1278	0.0000000
zheyou73v0_A03	9982806	9984084	BnaA03T0182900ZY.1	0	+	0	0	1278	0.0000000
zheyou73v0_A03	9985962	9987831	BnaA03T0183000ZY	0	+	0	0	1869	0.0000000
zheyou73v0_A03	9989233	9993567	BnaA03T0183100ZY	0	+	0	0	4334	0.0000000
zheyou73v0_A03	9994392	9995532	BnaA03T0183200ZY	0	-	0	0	1140	0.0000000
zheyou73v0_A03	9997073	10004750	BnaA03T0183300ZY	0	+	0	0	7677	0.0000000
zheyou73v0_A03	10006662	10006857	BnaA03T0183400ZY	0	-	0	0	195	0.0000000
zheyou73v0_A03	10016114	10017390	BnaA03T0183500ZY	0	+	0	0	1276	0.0000000
zheyou73v0_A03	10018572	10019213	BnaA03T0183600ZY	0	+	0	0	641	0.0000000
zheyou73v0_A03	10022024	10024261	BnaA03T0183700ZY	0	+	0	0	2237	0.0000000
zheyou73v0_A03	10024890	10025637	BnaA03T0183800ZY	0	-	0	0	747	0.0000000
zheyou73v0_A03	10029897	10031565	BnaA03T0183900ZY	0	+	0	0	1668	0.0000000
zheyou73v0_A03	10031556	10033754	BnaA03T0184000ZY	0	-	0	0	2198	0.0000000
zheyou73v0_A03	10033943	10035563	BnaA03T0184100ZY	0	+	0	0	1620	0.0000000
zheyou73v0_A03	10038606	10039362	BnaA03T0184200ZY	0	+	0	0	756	0.0000000
zheyou73v0_A03	10041946	10042162	BnaA03T0184300ZY	0	+	0	0	216	0.0000000
zheyou73v0_A03	10047499	10048563	BnaA03T0184400ZY	0	+	0	0	1064	0.0000000
zheyou73v0_A03	10048860	10050780	BnaA03T0184500ZY	0	-	0	0	1920	0.0000000
zheyou73v0_A03	10053643	10054858	BnaA03T0184600ZY	0	+	0	0	1215	0.0000000
zheyou73v0_A03	10058564	10059245	BnaA03T0184700ZY	0	-	0	0	681	0.0000000
zheyou73v0_A03	10059439	10059742	BnaA03T0184800ZY	0	-	0	0	303	0.0000000
zheyou73v0_A03	10063716	10064714	BnaA03T0184900ZY	0	+	0	0	998	0.0000000
zheyou73v0_A03	10067088	10067885	BnaA03T0185000ZY.1	0	-	0	0	797	0.0000000
zheyou73v0_A03	10067351	10067885	BnaA03T0185000ZY	0	-	0	0	534	0.0000000
zheyou73v0_A03	10069228	10074187	BnaA03T0185100ZY	0	-	0	0	4959	0.0000000
zheyou73v0_A03	10075336	10076713	BnaA03T0185200ZY	0	-	0	0	1377	0.0000000
zheyou73v0_A03	10084553	10086126	BnaA03T0185300ZY	0	-	0	0	1573	0.0000000
zheyou73v0_A03	10098878	10099319	BnaA03T0185400ZY	0	-	0	0	441	0.0000000
zheyou73v0_A03	10103047	10104454	BnaA03T0185500ZY	0	+	0	0	1407	0.0000000
zheyou73v0_A03	10104955	10107623	BnaA03T0185600ZY	0	-	0	0	2668	0.0000000
zheyou73v0_A03	10109771	10113871	BnaA03T0185700ZY	0	-	0	0	4100	0.0000000
zheyou73v0_A03	10122214	10125699	BnaA03T0185800ZY	0	-	0	0	3485	0.0000000
zheyou73v0_A03	10128678	10131860	BnaA03T0185900ZY	0	+	0	0	3182	0.0000000
zheyou73v0_A03	10133343	10134681	BnaA03T0186000ZY	0	+	0	0	1338	0.0000000
zheyou73v0_A03	10146641	10151860	BnaA03T0186100ZY	0	+	0	0	5219	0.0000000
zheyou73v0_A03	10152480	10152810	BnaA03T0186200ZY	0	-	0	0	330	0.0000000
zheyou73v0_A03	10154826	10157096	BnaA03T0186300ZY	0	+	0	0	2270	0.0000000
zheyou73v0_A03	10157633	10161768	BnaA03T0186400ZY	0	-	0	0	4135	0.0000000
zheyou73v0_A03	10162089	10162825	BnaA03T0186500ZY	0	-	0	0	736	0.0000000
zheyou73v0_A03	10164395	10164833	BnaA03T0186600ZY	0	+	0	0	438	0.0000000
zheyou73v0_A03	10168295	10174625	BnaA03T0186700ZY	0	+	0	0	6330	0.0000000
zheyou73v0_A03	10175991	10182629	BnaA03T0186800ZY	0	+	0	0	6638	0.0000000
zheyou73v0_A03	10188044	10194693	BnaA03T0186900ZY	0	+	0	0	6649	0.0000000
zheyou73v0_A03	10194789	10195063	BnaA03T0187000ZY	0	-	0	0	274	0.0000000
zheyou73v0_A03	10197021	10201122	BnaA03T0187100ZY	0	+	0	0	4101	0.0000000
zheyou73v0_A03	10197021	10201122	BnaA03T0187100ZY.1	0	+	0	0	4101	0.0000000
zheyou73v0_A03	10200472	10201593	BnaA03T0187200ZY	0	-	0	0	1121	0.0000000
zheyou73v0_A03	10204722	10205285	BnaA03T0187300ZY	0	+	0	0	563	0.0000000
zheyou73v0_A03	10208129	10209215	BnaA03T0187400ZY	0	-	0	0	1086	0.0000000
zheyou73v0_A03	10213768	10215491	BnaA03T0187500ZY	0	+	0	0	1723	0.0000000
zheyou73v0_A03	10220349	10222576	BnaA03T0187600ZY	0	+	0	0	2227	0.0000000
zheyou73v0_A03	10222539	10224750	BnaA03T0187700ZY	0	-	0	0	2211	0.0000000
zheyou73v0_A03	10226251	10226732	BnaA03T0187800ZY	0	+	0	0	481	0.0000000
zheyou73v0_A03	10228294	10231139	BnaA03T0187900ZY	0	+	0	0	2845	0.0000000
zheyou73v0_A03	10231521	10233958	BnaA03T0188000ZY	0	-	0	0	2437	0.0000000
zheyou73v0_A03	10235108	10235525	BnaA03T0188100ZY	0	-	0	0	417	0.0000000
zheyou73v0_A03	10241482	10252637	BnaA03T0188200ZY	0	-	0	0	11155	0.0000000
zheyou73v0_A03	10256224	10257434	BnaA03T0188300ZY	0	+	0	0	1210	0.0000000
zheyou73v0_A03	10257709	10259083	BnaA03T0188400ZY	0	-	0	0	1374	0.0000000
zheyou73v0_A03	10262056	10265630	BnaA03T0188500ZY	0	+	0	0	3574	0.0000000
zheyou73v0_A03	10265921	10267425	BnaA03T0188600ZY	0	+	0	0	1504	0.0000000
zheyou73v0_A03	10267554	10271011	BnaA03T0188700ZY	0	-	0	0	3457	0.0000000
zheyou73v0_A03	10275046	10278817	BnaA03T0188800ZY	0	+	0	0	3771	0.0000000
zheyou73v0_A03	10280052	10280322	BnaA03T0188900ZY	0	-	0	0	270	0.0000000
zheyou73v0_A03	10290391	10291857	BnaA03T0189000ZY	0	+	0	0	1466	0.0000000
zheyou73v0_A03	10298783	10299740	BnaA03T0189100ZY	0	+	0	0	957	0.0000000
zheyou73v0_A03	10301971	10304274	BnaA03T0189200ZY	0	+	0	0	2303	0.0000000
zheyou73v0_A03	10302235	10304274	BnaA03T0189200ZY.1	0	+	0	0	2039	0.0000000
zheyou73v0_A03	10305241	10305574	BnaA03T0189300ZY	0	+	0	0	333	0.0000000
zheyou73v0_A03	10306520	10307369	BnaA03T0189400ZY	0	+	0	0	849	0.0000000
zheyou73v0_A03	10308770	10311511	BnaA03T0189500ZY	0	-	0	0	2741	0.0000000
zheyou73v0_A03	10319378	10324561	BnaA03T0189600ZY	0	+	0	0	5183	0.0000000
zheyou73v0_A03	10324745	10325298	BnaA03T0189700ZY	0	-	0	0	553	0.0000000
zheyou73v0_A03	10327455	10327960	BnaA03T0189800ZY	0	+	0	0	505	0.0000000
zheyou73v0_A03	10328965	10330584	BnaA03T0189900ZY	0	-	0	0	1619	0.0000000
zheyou73v0_A03	10332575	10333231	BnaA03T0190000ZY	0	+	0	0	656	0.0000000
zheyou73v0_A03	10334801	10335959	BnaA03T0190100ZY	0	-	0	0	1158	0.0000000
zheyou73v0_A03	10336547	10338750	BnaA03T0190200ZY	0	-	0	0	2203	0.0000000
zheyou73v0_A03	10341735	10344140	BnaA03T0190300ZY	0	+	0	0	2405	0.0000000
zheyou73v0_A03	10346635	10347949	BnaA03T0190400ZY	0	+	0	0	1314	0.0000000
zheyou73v0_A03	10348599	10349151	BnaA03T0190500ZY	0	-	0	0	552	0.0000000
zheyou73v0_A03	10349803	10352226	BnaA03T0190600ZY	0	+	0	0	2423	0.0000000
zheyou73v0_A03	10349803	10352226	BnaA03T0190600ZY.1	0	+	0	0	2423	0.0000000
zheyou73v0_A03	10358277	10359099	BnaA03T0190700ZY	0	+	0	0	822	0.0000000
zheyou73v0_A03	10362322	10363582	BnaA03T0190800ZY	0	-	0	0	1260	0.0000000
zheyou73v0_A03	10369960	10370452	BnaA03T0190900ZY	0	+	0	0	492	0.0000000
zheyou73v0_A03	10371187	10372158	BnaA03T0191000ZY	0	+	0	0	971	0.0000000
zheyou73v0_A03	10373318	10376342	BnaA03T0191100ZY	0	-	0	0	3024	0.0000000
zheyou73v0_A03	10373318	10376342	BnaA03T0191100ZY.1	0	-	0	0	3024	0.0000000
zheyou73v0_A03	10373318	10376342	BnaA03T0191100ZY.2	0	-	0	0	3024	0.0000000
zheyou73v0_A03	10377015	10378593	BnaA03T0191200ZY	0	+	0	0	1578	0.0000000
zheyou73v0_A03	10378710	10380106	BnaA03T0191300ZY	0	-	0	0	1396	0.0000000
zheyou73v0_A03	10390011	10390272	BnaA03T0191400ZY	0	-	0	0	261	0.0000000
zheyou73v0_A03	10393483	10394815	BnaA03T0191500ZY	0	+	0	0	1332	0.0000000
zheyou73v0_A03	10395452	10399669	BnaA03T0191600ZY	0	-	0	0	4217	0.0000000
zheyou73v0_A03	10403547	10417837	BnaA03T0191700ZY	0	+	0	0	14290	0.0000000
zheyou73v0_A03	10418755	10420615	BnaA03T0191800ZY	0	-	0	0	1860	0.0000000
zheyou73v0_A03	10425680	10428209	BnaA03T0191900ZY	0	+	0	0	2529	0.0000000
zheyou73v0_A03	10428667	10429015	BnaA03T0192000ZY	0	-	0	0	348	0.0000000
zheyou73v0_A03	10429711	10431526	BnaA03T0192100ZY	0	-	0	0	1815	0.0000000
zheyou73v0_A03	10433506	10436806	BnaA03T0192200ZY	0	+	0	0	3300	0.0000000
zheyou73v0_A03	10440049	10440676	BnaA03T0192300ZY	0	+	0	0	627	0.0000000
zheyou73v0_A03	10446829	10448152	BnaA03T0192400ZY	0	+	0	0	1323	0.0000000
zheyou73v0_A03	10448730	10449253	BnaA03T0192500ZY	0	+	0	0	523	0.0000000
zheyou73v0_A03	10449978	10451293	BnaA03T0192600ZY	0	+	0	0	1315	0.0000000
zheyou73v0_A03	10451545	10453484	BnaA03T0192700ZY	0	+	0	0	1939	0.0000000
zheyou73v0_A03	10454258	10457220	BnaA03T0192800ZY	0	+	0	0	2962	0.0000000
zheyou73v0_A03	10457604	10459957	BnaA03T0192900ZY	0	+	0	0	2353	0.0000000
zheyou73v0_A03	10463168	10464889	BnaA03T0193000ZY	0	+	0	0	1721	0.0000000
zheyou73v0_A03	10466759	10467311	BnaA03T0193100ZY	0	+	0	0	552	0.0000000
zheyou73v0_A03	10475168	10477424	BnaA03T0193200ZY	0	+	0	0	2256	0.0000000
zheyou73v0_A03	10479415	10482334	BnaA03T0193300ZY	0	-	0	0	2919	0.0000000
zheyou73v0_A03	10485317	10486451	BnaA03T0193400ZY	0	+	0	0	1134	0.0000000
zheyou73v0_A03	10489132	10490257	BnaA03T0193500ZY	0	+	0	0	1125	0.0000000
zheyou73v0_A03	10490861	10491521	BnaA03T0193600ZY	0	-	0	0	660	0.0000000
zheyou73v0_A03	10493201	10493729	BnaA03T0193700ZY	0	-	0	0	528	0.0000000
zheyou73v0_A03	10498368	10498866	BnaA03T0193800ZY	0	-	0	0	498	0.0000000
zheyou73v0_A03	10505428	10510157	BnaA03T0193900ZY	0	+	0	0	4729	0.0000000
zheyou73v0_A03	10505428	10510157	BnaA03T0193900ZY.1	0	+	0	0	4729	0.0000000
zheyou73v0_A03	10514501	10516871	BnaA03T0194000ZY	0	-	0	0	2370	0.0000000
zheyou73v0_A03	10517251	10526430	BnaA03T0194100ZY	0	-	0	0	9179	0.0000000
zheyou73v0_A03	10545554	10545893	BnaA03T0194200ZY	0	+	0	0	339	0.0000000
zheyou73v0_A03	10547208	10550203	BnaA03T0194300ZY	0	+	0	0	2995	0.0000000
zheyou73v0_A03	10550629	10555510	BnaA03T0194400ZY	0	-	0	0	4881	0.0000000
zheyou73v0_A03	10557917	10559347	BnaA03T0194500ZY	0	-	0	0	1430	0.0000000
zheyou73v0_A03	10562714	10563706	BnaA03T0194600ZY	0	+	0	0	992	0.0000000
zheyou73v0_A03	10578918	10579975	BnaA03T0194700ZY	0	+	0	0	1057	0.0000000
zheyou73v0_A03	10581004	10581444	BnaA03T0194800ZY	0	+	0	0	440	0.0000000
zheyou73v0_A03	10587544	10590707	BnaA03T0194900ZY	0	-	0	0	3163	0.0000000
zheyou73v0_A03	10592324	10592665	BnaA03T0195000ZY	0	-	0	0	341	0.0000000
zheyou73v0_A03	10601453	10601930	BnaA03T0195100ZY	0	-	0	0	477	0.0000000
zheyou73v0_A03	10608063	10609942	BnaA03T0195200ZY	0	-	0	0	1879	0.0000000
zheyou73v0_A03	10611396	10613103	BnaA03T0195300ZY	0	+	0	0	1707	0.0000000
zheyou73v0_A03	10615732	10617246	BnaA03T0195400ZY	0	-	0	0	1514	0.0000000
zheyou73v0_A03	10615732	10617246	BnaA03T0195400ZY.1	0	-	0	0	1514	0.0000000
zheyou73v0_A03	10620880	10622827	BnaA03T0195500ZY	0	-	0	0	1947	0.0000000
zheyou73v0_A03	10627186	10628456	BnaA03T0195600ZY	0	+	0	0	1270	0.0000000
zheyou73v0_A03	10631368	10635427	BnaA03T0195700ZY	0	+	0	0	4059	0.0000000
zheyou73v0_A03	10636907	10639016	BnaA03T0195800ZY	0	+	0	0	2109	0.0000000
zheyou73v0_A03	10639465	10639627	BnaA03T0195900ZY	0	+	0	0	162	0.0000000
zheyou73v0_A03	10644777	10651723	BnaA03T0196000ZY	0	+	0	0	6946	0.0000000
zheyou73v0_A03	10652034	10654452	BnaA03T0196100ZY	0	-	0	0	2418	0.0000000
zheyou73v0_A03	10669131	10670336	BnaA03T0196200ZY	0	+	0	0	1205	0.0000000
zheyou73v0_A03	10672650	10674303	BnaA03T0196300ZY	0	+	0	0	1653	0.0000000
zheyou73v0_A03	10691779	10694806	BnaA03T0196400ZY	0	+	0	0	3027	0.0000000
zheyou73v0_A03	10695166	10695334	BnaA03T0196500ZY	0	+	0	0	168	0.0000000
zheyou73v0_A03	10697113	10697677	BnaA03T0196600ZY	0	-	0	0	564	0.0000000
zheyou73v0_A03	10700699	10702080	BnaA03T0196700ZY	0	-	0	0	1381	0.0000000
zheyou73v0_A03	10709090	10711868	BnaA03T0196800ZY	0	-	0	0	2778	0.0000000
zheyou73v0_A03	10716666	10718595	BnaA03T0196900ZY	0	-	0	0	1929	0.0000000
zheyou73v0_A03	10729285	10731670	BnaA03T0197000ZY	0	+	0	0	2385	0.0000000
zheyou73v0_A03	10732336	10733427	BnaA03T0197100ZY	0	-	0	0	1091	0.0000000
zheyou73v0_A03	10733781	10735319	BnaA03T0197200ZY	0	+	0	0	1538	0.0000000
zheyou73v0_A03	10736450	10737542	BnaA03T0197300ZY	0	+	0	0	1092	0.0000000
zheyou73v0_A03	10753448	10753664	BnaA03T0197400ZY	0	-	0	0	216	0.0000000
zheyou73v0_A03	10755096	10756751	BnaA03T0197500ZY	0	-	0	0	1655	0.0000000
zheyou73v0_A03	10766673	10768525	BnaA03T0197600ZY	0	-	0	0	1852	0.0000000
zheyou73v0_A03	10777581	10778982	BnaA03T0197700ZY	0	+	0	0	1401	0.0000000
zheyou73v0_A03	10796333	10801893	BnaA03T0197800ZY	0	+	0	0	5560	0.0000000
zheyou73v0_A03	10803593	10804785	BnaA03T0197900ZY	0	-	0	0	1192	0.0000000
zheyou73v0_A03	10806765	10808439	BnaA03T0198000ZY	0	+	0	0	1674	0.0000000
zheyou73v0_A03	10826533	10826695	BnaA03T0198100ZY	0	-	0	0	162	0.0000000
zheyou73v0_A03	10828613	10828883	BnaA03T0198200ZY	0	-	0	0	270	0.0000000
zheyou73v0_A03	10830232	10831902	BnaA03T0198300ZY	0	+	0	0	1670	0.0000000
zheyou73v0_A03	10832958	10834866	BnaA03T0198400ZY	0	+	0	0	1908	0.0000000
zheyou73v0_A03	10839296	10839671	BnaA03T0198500ZY	0	+	0	0	375	0.0000000
zheyou73v0_A03	10843454	10848201	BnaA03T0198600ZY	0	+	0	0	4747	0.0000000
zheyou73v0_A03	10849092	10851098	BnaA03T0198700ZY	0	+	0	0	2006	0.0000000
zheyou73v0_A03	10851412	10853316	BnaA03T0198800ZY	0	-	0	0	1904	0.0000000
zheyou73v0_A03	10862322	10864207	BnaA03T0198900ZY	0	-	0	0	1885	0.0000000
zheyou73v0_A03	10874888	10877932	BnaA03T0199000ZY	0	-	0	0	3044	0.0000000
zheyou73v0_A03	10874888	10877932	BnaA03T0199000ZY.1	0	-	0	0	3044	0.0000000
zheyou73v0_A03	10879783	10881154	BnaA03T0199100ZY	0	-	0	0	1371	0.0000000
zheyou73v0_A03	10885201	10885875	BnaA03T0199200ZY	0	+	0	0	674	0.0000000
zheyou73v0_A03	10886315	10887153	BnaA03T0199300ZY	0	-	0	0	838	0.0000000
zheyou73v0_A03	10889362	10890680	BnaA03T0199400ZY	0	+	0	0	1318	0.0000000
zheyou73v0_A03	10889362	10890680	BnaA03T0199400ZY.1	0	+	0	0	1318	0.0000000
zheyou73v0_A03	10899336	10900273	BnaA03T0199500ZY	0	+	0	0	937	0.0000000
zheyou73v0_A03	10900810	10903689	BnaA03T0199600ZY	0	-	0	0	2879	0.0000000
zheyou73v0_A03	10918055	10919752	BnaA03T0199700ZY	0	-	0	0	1697	0.0000000
zheyou73v0_A03	10920898	10923405	BnaA03T0199800ZY	0	-	0	0	2507	0.0000000
zheyou73v0_A03	10923791	10926681	BnaA03T0199900ZY	0	+	0	0	2890	0.0000000
zheyou73v0_A03	10926900	10928366	BnaA03T0200000ZY	0	+	0	0	1466	0.0000000
zheyou73v0_A03	10930264	10931927	BnaA03T0200100ZY	0	+	0	0	1663	0.0000000
zheyou73v0_A03	10932082	10933643	BnaA03T0200200ZY	0	-	0	0	1561	0.0000000
zheyou73v0_A03	10934129	10935618	BnaA03T0200300ZY	0	-	0	0	1489	0.0000000
zheyou73v0_A03	10934129	10935618	BnaA03T0200300ZY.1	0	-	0	0	1489	0.0000000
zheyou73v0_A03	10934129	10935618	BnaA03T0200300ZY.2	0	-	0	0	1489	0.0000000
zheyou73v0_A03	10934129	10935618	BnaA03T0200300ZY.3	0	-	0	0	1489	0.0000000
zheyou73v0_A03	10936655	10939250	BnaA03T0200400ZY	0	-	0	0	2595	0.0000000
zheyou73v0_A03	10936655	10939250	BnaA03T0200400ZY.1	0	-	0	0	2595	0.0000000
zheyou73v0_A03	10936655	10939250	BnaA03T0200400ZY.2	0	-	0	0	2595	0.0000000
zheyou73v0_A03	10936655	10939250	BnaA03T0200400ZY.3	0	-	0	0	2595	0.0000000
zheyou73v0_A03	10947310	10948324	BnaA03T0200500ZY	0	+	0	0	1014	0.0000000
zheyou73v0_A03	10982596	10983501	BnaA03T0200600ZY	0	-	0	0	905	0.0000000
zheyou73v0_A03	10985912	10986458	BnaA03T0200700ZY	0	+	0	0	546	0.0000000
zheyou73v0_A03	10992017	10995019	BnaA03T0200800ZY	0	+	0	0	3002	0.0000000
zheyou73v0_A03	10995441	10998192	BnaA03T0200900ZY	0	-	0	0	2751	0.0000000
zheyou73v0_A03	11009481	11011233	BnaA03T0201000ZY	0	+	0	0	1752	0.0000000
zheyou73v0_A03	11014308	11015194	BnaA03T0201100ZY	0	+	0	0	886	0.0000000
zheyou73v0_A03	11015381	11017894	BnaA03T0201200ZY	0	-	0	0	2513	0.0000000
zheyou73v0_A03	11018400	11018820	BnaA03T0201300ZY	0	-	0	0	420	0.0000000
zheyou73v0_A03	11021011	11022023	BnaA03T0201400ZY	0	+	0	0	1012	0.0000000
zheyou73v0_A03	11027238	11028427	BnaA03T0201500ZY	0	+	0	0	1189	0.0000000
zheyou73v0_A03	11030502	11034165	BnaA03T0201600ZY	0	-	0	0	3663	0.0000000
zheyou73v0_A03	11038421	11040751	BnaA03T0201700ZY	0	+	0	0	2330	0.0000000
zheyou73v0_A03	11040846	11042607	BnaA03T0201800ZY	0	-	0	0	1761	0.0000000
zheyou73v0_A03	11045380	11046026	BnaA03T0201900ZY	0	-	0	0	646	0.0000000
zheyou73v0_A03	11060553	11063116	BnaA03T0202000ZY	0	+	0	0	2563	0.0000000
zheyou73v0_A03	11065879	11071030	BnaA03T0202100ZY	0	+	0	0	5151	0.0000000
zheyou73v0_A03	11071138	11074372	BnaA03T0202200ZY	0	-	0	0	3234	0.0000000
zheyou73v0_A03	11078330	11080521	BnaA03T0202300ZY	0	-	0	0	2191	0.0000000
zheyou73v0_A03	11089043	11089758	BnaA03T0202400ZY	0	+	0	0	715	0.0000000
zheyou73v0_A03	11090015	11090285	BnaA03T0202500ZY	0	+	0	0	270	0.0000000
zheyou73v0_A03	11095684	11096316	BnaA03T0202600ZY	0	+	0	0	632	0.0000000
zheyou73v0_A03	11099074	11100563	BnaA03T0202700ZY	0	-	0	0	1489	0.0000000
zheyou73v0_A03	11118184	11118886	BnaA03T0202800ZY	0	-	0	0	702	0.0000000
zheyou73v0_A03	11130330	11134206	BnaA03T0202900ZY	0	+	0	0	3876	0.0000000
zheyou73v0_A03	11134463	11136827	BnaA03T0203000ZY	0	+	0	0	2364	0.0000000
zheyou73v0_A03	11138323	11139070	BnaA03T0203100ZY	0	+	0	0	747	0.0000000
zheyou73v0_A03	11139271	11141588	BnaA03T0203200ZY	0	-	0	0	2317	0.0000000
zheyou73v0_A03	11142416	11144857	BnaA03T0203300ZY	0	-	0	0	2441	0.0000000
zheyou73v0_A03	11147865	11148923	BnaA03T0203400ZY	0	-	0	0	1058	0.0000000
zheyou73v0_A03	11153207	11154524	BnaA03T0203500ZY	0	-	0	0	1317	0.0000000
zheyou73v0_A03	11163238	11163841	BnaA03T0203600ZY	0	+	0	0	603	0.0000000
zheyou73v0_A03	11163698	11169251	BnaA03T0203700ZY	0	-	0	0	5553	0.0000000
zheyou73v0_A03	11165762	11169251	BnaA03T0203700ZY.1	0	-	0	0	3489	0.0000000
zheyou73v0_A03	11173328	11175471	BnaA03T0203800ZY	0	+	0	0	2143	0.0000000
zheyou73v0_A03	11179087	11183864	BnaA03T0203900ZY	0	-	0	0	4777	0.0000000
zheyou73v0_A03	11187291	11188722	BnaA03T0204000ZY	0	-	0	0	1431	0.0000000
zheyou73v0_A03	11189472	11192772	BnaA03T0204100ZY	0	+	0	0	3300	0.0000000
zheyou73v0_A03	11200775	11203496	BnaA03T0204200ZY	0	+	0	0	2721	0.0000000
zheyou73v0_A03	11208919	11220692	BnaA03T0204300ZY	0	+	0	0	11773	0.0000000
zheyou73v0_A03	11208919	11220692	BnaA03T0204300ZY.1	0	+	0	0	11773	0.0000000
zheyou73v0_A03	11223890	11225799	BnaA03T0204400ZY	0	+	0	0	1909	0.0000000
zheyou73v0_A03	11228800	11230244	BnaA03T0204500ZY	0	+	0	0	1444	0.0000000
zheyou73v0_A03	11232996	11235731	BnaA03T0204600ZY	0	+	0	0	2735	0.0000000
zheyou73v0_A03	11232996	11235731	BnaA03T0204600ZY.1	0	+	0	0	2735	0.0000000
zheyou73v0_A03	11247168	11249969	BnaA03T0204700ZY	0	-	0	0	2801	0.0000000
zheyou73v0_A03	11260812	11262265	BnaA03T0204800ZY	0	+	0	0	1453	0.0000000
zheyou73v0_A03	11265482	11267156	BnaA03T0204900ZY	0	-	0	0	1674	0.0000000
zheyou73v0_A03	11268511	11272424	BnaA03T0205000ZY	0	+	0	0	3913	0.0000000
zheyou73v0_A03	11274572	11274755	BnaA03T0205100ZY	0	-	0	0	183	0.0000000
zheyou73v0_A03	11277906	11297139	BnaA03T0205200ZY	0	-	0	0	19233	0.0000000
zheyou73v0_A03	11297143	11297383	BnaA03T0205300ZY	0	-	0	0	240	0.0000000
zheyou73v0_A03	11300140	11301180	BnaA03T0205400ZY	0	+	0	0	1040	0.0000000
zheyou73v0_A03	11307721	11310134	BnaA03T0205500ZY	0	+	0	0	2413	0.0000000
zheyou73v0_A03	11343687	11344781	BnaA03T0205600ZY	0	-	0	0	1094	0.0000000
zheyou73v0_A03	11352283	11355253	BnaA03T0205700ZY	0	+	0	0	2970	0.0000000
zheyou73v0_A03	11356540	11357438	BnaA03T0205800ZY	0	-	0	0	898	0.0000000
zheyou73v0_A03	11358252	11360244	BnaA03T0205900ZY	0	-	0	0	1992	0.0000000
zheyou73v0_A03	11363442	11365376	BnaA03T0206000ZY	0	+	0	0	1934	0.0000000
zheyou73v0_A03	11369664	11372712	BnaA03T0206100ZY	0	+	0	0	3048	0.0000000
zheyou73v0_A03	11375576	11378027	BnaA03T0206200ZY	0	+	0	0	2451	0.0000000
zheyou73v0_A03	11378837	11379290	BnaA03T0206300ZY	0	+	0	0	453	0.0000000
zheyou73v0_A03	11381030	11382922	BnaA03T0206400ZY	0	-	0	0	1892	0.0000000
zheyou73v0_A03	11383809	11385405	BnaA03T0206500ZY	0	-	0	0	1596	0.0000000
zheyou73v0_A03	11388221	11389199	BnaA03T0206600ZY	0	+	0	0	978	0.0000000
zheyou73v0_A03	11388221	11389199	BnaA03T0206600ZY.1	0	+	0	0	978	0.0000000
zheyou73v0_A03	11390289	11392543	BnaA03T0206700ZY	0	+	0	0	2254	0.0000000
zheyou73v0_A03	11392592	11393642	BnaA03T0206800ZY	0	-	0	0	1050	0.0000000
zheyou73v0_A03	11395870	11396892	BnaA03T0206900ZY	0	-	0	0	1022	0.0000000
zheyou73v0_A03	11401367	11403191	BnaA03T0207000ZY	0	-	0	0	1824	0.0000000
zheyou73v0_A03	11406257	11407762	BnaA03T0207100ZY	0	+	0	0	1505	0.0000000
zheyou73v0_A03	11408190	11409822	BnaA03T0207200ZY	0	-	0	0	1632	0.0000000
zheyou73v0_A03	11413567	11417928	BnaA03T0207300ZY	0	+	0	0	4361	0.0000000
zheyou73v0_A03	11419604	11422276	BnaA03T0207400ZY	0	-	0	0	2672	0.0000000
zheyou73v0_A03	11425534	11427079	BnaA03T0207500ZY	0	+	0	0	1545	0.0000000
zheyou73v0_A03	11427594	11429648	BnaA03T0207600ZY	0	-	0	0	2054	0.0000000
zheyou73v0_A03	11432123	11440946	BnaA03T0207700ZY	0	+	0	0	8823	0.0000000
zheyou73v0_A03	11443100	11444682	BnaA03T0207800ZY	0	+	0	0	1582	0.0000000
zheyou73v0_A03	11445962	11446947	BnaA03T0207900ZY	0	-	0	0	985	0.0000000
zheyou73v0_A03	11451977	11452951	BnaA03T0208000ZY	0	-	0	0	974	0.0000000
zheyou73v0_A03	11456952	11460588	BnaA03T0208100ZY	0	-	0	0	3636	0.0000000
zheyou73v0_A03	11456952	11460588	BnaA03T0208100ZY.1	0	-	0	0	3636	0.0000000
zheyou73v0_A03	11461194	11463561	BnaA03T0208200ZY	0	-	0	0	2367	0.0000000
zheyou73v0_A03	11467549	11469402	BnaA03T0208300ZY	0	-	0	0	1853	0.0000000
zheyou73v0_A03	11469741	11470519	BnaA03T0208400ZY	0	-	0	0	778	0.0000000
zheyou73v0_A03	11471076	11471837	BnaA03T0208500ZY	0	-	0	0	761	0.0000000
zheyou73v0_A03	11475554	11477702	BnaA03T0208600ZY	0	+	0	0	2148	0.0000000
zheyou73v0_A03	11477813	11479036	BnaA03T0208700ZY	0	-	0	0	1223	0.0000000
zheyou73v0_A03	11482023	11483518	BnaA03T0208800ZY	0	-	0	0	1495	0.0000000
zheyou73v0_A03	11484313	11486182	BnaA03T0208900ZY	0	-	0	0	1869	0.0000000
zheyou73v0_A03	11489146	11490872	BnaA03T0209000ZY	0	+	0	0	1726	0.0000000
zheyou73v0_A03	11489667	11490872	BnaA03T0209000ZY.1	0	+	0	0	1205	0.0000000
zheyou73v0_A03	11491214	11494519	BnaA03T0209100ZY	0	+	0	0	3305	0.0000000
zheyou73v0_A03	11494721	11495315	BnaA03T0209200ZY	0	-	0	0	594	0.0000000
zheyou73v0_A03	11497952	11500941	BnaA03T0209300ZY	0	+	0	0	2989	0.0000000
zheyou73v0_A03	11497952	11500941	BnaA03T0209300ZY.1	0	+	0	0	2989	0.0000000
zheyou73v0_A03	11501419	11501743	BnaA03T0209400ZY	0	-	0	0	324	0.0000000
zheyou73v0_A03	11503038	11504547	BnaA03T0209500ZY	0	+	0	0	1509	0.0000000
zheyou73v0_A03	11504730	11505824	BnaA03T0209600ZY	0	-	0	0	1094	0.0000000
zheyou73v0_A03	11507032	11508681	BnaA03T0209700ZY	0	+	0	0	1649	0.0000000
zheyou73v0_A03	11511715	11513144	BnaA03T0209800ZY	0	+	0	0	1429	0.0000000
zheyou73v0_A03	11514764	11517920	BnaA03T0209900ZY	0	+	0	0	3156	0.0000000
zheyou73v0_A03	11519717	11520305	BnaA03T0210000ZY	0	-	0	0	588	0.0000000
zheyou73v0_A03	11522554	11524876	BnaA03T0210100ZY	0	+	0	0	2322	0.0000000
zheyou73v0_A03	11525971	11527212	BnaA03T0210200ZY	0	+	0	0	1241	0.0000000
zheyou73v0_A03	11527541	11529935	BnaA03T0210300ZY	0	+	0	0	2394	0.0000000
zheyou73v0_A03	11530282	11530624	BnaA03T0210400ZY	0	-	0	0	342	0.0000000
zheyou73v0_A03	11531318	11534119	BnaA03T0210500ZY	0	-	0	0	2801	0.0000000
zheyou73v0_A03	11535974	11538239	BnaA03T0210600ZY	0	-	0	0	2265	0.0000000
zheyou73v0_A03	11545181	11548660	BnaA03T0210700ZY	0	+	0	0	3479	0.0000000
zheyou73v0_A03	11545181	11548660	BnaA03T0210700ZY.1	0	+	0	0	3479	0.0000000
zheyou73v0_A03	11573178	11575854	BnaA03T0210800ZY	0	+	0	0	2676	0.0000000
zheyou73v0_A03	11587003	11590241	BnaA03T0210900ZY	0	+	0	0	3238	0.0000000
zheyou73v0_A03	11587003	11590241	BnaA03T0210900ZY.1	0	+	0	0	3238	0.0000000
zheyou73v0_A03	11590817	11591914	BnaA03T0211000ZY	0	+	0	0	1097	0.0000000
zheyou73v0_A03	11592603	11595203	BnaA03T0211100ZY	0	-	0	0	2600	0.0000000
zheyou73v0_A03	11596270	11611109	BnaA03T0211200ZY	0	-	0	0	14839	0.0000000
zheyou73v0_A03	11612732	11613245	BnaA03T0211300ZY	0	-	0	0	513	0.0000000
zheyou73v0_A03	11616050	11617771	BnaA03T0211400ZY	0	+	0	0	1721	0.0000000
zheyou73v0_A03	11618354	11620120	BnaA03T0211500ZY	0	-	0	0	1766	0.0000000
zheyou73v0_A03	11618354	11620120	BnaA03T0211500ZY.1	0	-	0	0	1766	0.0000000
zheyou73v0_A03	11621569	11623674	BnaA03T0211600ZY	0	-	0	0	2105	0.0000000
zheyou73v0_A03	11624095	11624788	BnaA03T0211700ZY	0	-	0	0	693	0.0000000
zheyou73v0_A03	11634709	11637025	BnaA03T0211800ZY	0	-	0	0	2316	0.0000000
zheyou73v0_A03	11641464	11645200	BnaA03T0211900ZY	0	+	0	0	3736	0.0000000
zheyou73v0_A03	11647115	11652652	BnaA03T0212000ZY	0	-	0	0	5537	0.0000000
zheyou73v0_A03	11653350	11653739	BnaA03T0212100ZY	0	-	0	0	389	0.0000000
zheyou73v0_A03	11662152	11664892	BnaA03T0212200ZY	0	-	0	0	2740	0.0000000
zheyou73v0_A03	11665552	11665952	BnaA03T0212300ZY	0	-	0	0	400	0.0000000
zheyou73v0_A03	11676746	11677169	BnaA03T0212400ZY	0	-	0	0	423	0.0000000
zheyou73v0_A03	11677606	11680410	BnaA03T0212500ZY	0	-	0	0	2804	0.0000000
zheyou73v0_A03	11681002	11681473	BnaA03T0212600ZY	0	-	0	0	471	0.0000000
zheyou73v0_A03	11690578	11692986	BnaA03T0212700ZY	0	-	0	0	2408	0.0000000
zheyou73v0_A03	11703566	11706237	BnaA03T0212800ZY	0	-	0	0	2671	0.0000000
zheyou73v0_A03	11711826	11719028	BnaA03T0212900ZY	0	-	0	0	7202	0.0000000
zheyou73v0_A03	11720737	11721145	BnaA03T0213000ZY	0	-	0	0	408	0.0000000
zheyou73v0_A03	11724113	11724661	BnaA03T0213100ZY	0	+	0	0	548	0.0000000
zheyou73v0_A03	11725358	11726752	BnaA03T0213200ZY	0	+	0	0	1394	0.0000000
zheyou73v0_A03	11726582	11729720	BnaA03T0213300ZY	0	-	0	0	3138	0.0000000
zheyou73v0_A03	11731771	11734311	BnaA03T0213400ZY	0	-	0	0	2540	0.0000000
zheyou73v0_A03	11731771	11734311	BnaA03T0213400ZY.1	0	-	0	0	2540	0.0000000
zheyou73v0_A03	11734449	11735189	BnaA03T0213500ZY	0	-	0	0	740	0.0000000
zheyou73v0_A03	11735849	11736206	BnaA03T0213600ZY	0	+	0	0	357	0.0000000
zheyou73v0_A03	11737860	11740984	BnaA03T0213700ZY	0	-	0	0	3124	0.0000000
zheyou73v0_A03	11743012	11747104	BnaA03T0213800ZY	0	-	0	0	4092	0.0000000
zheyou73v0_A03	11749880	11752963	BnaA03T0213900ZY	0	+	0	0	3083	0.0000000
zheyou73v0_A03	11754348	11755278	BnaA03T0214000ZY	0	+	0	0	930	0.0000000
zheyou73v0_A03	11754831	11757527	BnaA03T0214100ZY	0	-	0	0	2696	0.0000000
zheyou73v0_A03	11754831	11757527	BnaA03T0214100ZY.1	0	-	0	0	2696	0.0000000
zheyou73v0_A03	11758705	11759674	BnaA03T0214200ZY	0	+	0	0	969	0.0000000
zheyou73v0_A03	11760460	11766547	BnaA03T0214300ZY	0	-	0	0	6087	0.0000000
zheyou73v0_A03	11771765	11774276	BnaA03T0214400ZY	0	-	0	0	2511	0.0000000
zheyou73v0_A03	11774631	11777331	BnaA03T0214500ZY	0	-	0	0	2700	0.0000000
zheyou73v0_A03	11777744	11780046	BnaA03T0214600ZY	0	-	0	0	2302	0.0000000
zheyou73v0_A03	11783093	11785221	BnaA03T0214700ZY	0	+	0	0	2128	0.0000000
zheyou73v0_A03	11786501	11788085	BnaA03T0214800ZY	0	-	0	0	1584	0.0000000
zheyou73v0_A03	11794308	11796217	BnaA03T0214900ZY	0	-	0	0	1909	0.0000000
zheyou73v0_A03	11797288	11797978	BnaA03T0215000ZY	0	-	0	0	690	0.0000000
zheyou73v0_A03	11800206	11802696	BnaA03T0215100ZY	0	-	0	0	2490	0.0000000
zheyou73v0_A03	11800206	11802637	BnaA03T0215100ZY.1	0	-	0	0	2431	0.0000000
zheyou73v0_A03	11803742	11807103	BnaA03T0215200ZY	0	-	0	0	3361	0.0000000
zheyou73v0_A03	11814352	11814991	BnaA03T0215300ZY	0	-	0	0	639	0.0000000
zheyou73v0_A03	11819616	11820174	BnaA03T0215400ZY	0	-	0	0	558	0.0000000
zheyou73v0_A03	11823584	11833319	BnaA03T0215500ZY	0	+	0	0	9735	0.0000000
zheyou73v0_A03	11824145	11833319	BnaA03T0215500ZY.1	0	+	0	0	9174	0.0000000
zheyou73v0_A03	11834059	11837950	BnaA03T0215600ZY	0	-	0	0	3891	0.0000000
zheyou73v0_A03	11844290	11846535	BnaA03T0215700ZY	0	-	0	0	2245	0.0000000
zheyou73v0_A03	11846942	11847875	BnaA03T0215800ZY	0	+	0	0	933	0.0000000
zheyou73v0_A03	11848359	11852533	BnaA03T0215900ZY	0	-	0	0	4174	0.0000000
zheyou73v0_A03	11856411	11858434	BnaA03T0216000ZY	0	+	0	0	2023	0.0000000
zheyou73v0_A03	11865688	11867955	BnaA03T0216100ZY	0	+	0	0	2267	0.0000000
zheyou73v0_A03	11871465	11872731	BnaA03T0216200ZY	0	+	0	0	1266	0.0000000
zheyou73v0_A03	11873077	11875354	BnaA03T0216300ZY	0	+	0	0	2277	0.0000000
zheyou73v0_A03	11875246	11878227	BnaA03T0216400ZY	0	-	0	0	2981	0.0000000
zheyou73v0_A03	11878975	11880563	BnaA03T0216500ZY	0	-	0	0	1588	0.0000000
zheyou73v0_A03	11881376	11883309	BnaA03T0216600ZY	0	-	0	0	1933	0.0000000
zheyou73v0_A03	11884022	11885532	BnaA03T0216700ZY	0	-	0	0	1510	0.0000000
zheyou73v0_A03	11890383	11891028	BnaA03T0216800ZY	0	+	0	0	645	0.0000000
zheyou73v0_A03	11891352	11891628	BnaA03T0216900ZY	0	+	0	0	276	0.0000000
zheyou73v0_A03	11901353	11903348	BnaA03T0217000ZY	0	-	0	0	1995	0.0000000
zheyou73v0_A03	11905765	11908055	BnaA03T0217100ZY	0	+	0	0	2290	0.0000000
zheyou73v0_A03	11909925	11911782	BnaA03T0217200ZY	0	+	0	0	1857	0.0000000
zheyou73v0_A03	11909925	11911782	BnaA03T0217200ZY.1	0	+	0	0	1857	0.0000000
zheyou73v0_A03	11914728	11923045	BnaA03T0217300ZY	0	+	0	0	8317	0.0000000
zheyou73v0_A03	11923585	11925215	BnaA03T0217400ZY	0	+	0	0	1630	0.0000000
zheyou73v0_A03	11925547	11928525	BnaA03T0217500ZY	0	-	0	0	2978	0.0000000
zheyou73v0_A03	11929939	11930663	BnaA03T0217600ZY	0	-	0	0	724	0.0000000
zheyou73v0_A03	11933130	11933832	BnaA03T0217700ZY	0	-	0	0	702	0.0000000
zheyou73v0_A03	11934363	11937027	BnaA03T0217800ZY	0	-	0	0	2664	0.0000000
zheyou73v0_A03	11939311	11943138	BnaA03T0217900ZY	0	+	0	0	3827	0.0000000
zheyou73v0_A03	11939311	11940142	BnaA03T0217900ZY.1	0	+	0	0	831	0.0000000
zheyou73v0_A03	11945034	11945758	BnaA03T0218000ZY	0	+	0	0	724	0.0000000
zheyou73v0_A03	11960741	11964586	BnaA03T0218100ZY	0	+	0	0	3845	0.0000000
zheyou73v0_A03	11966305	11968658	BnaA03T0218200ZY	0	+	0	0	2353	0.0000000
zheyou73v0_A03	11969963	11974083	BnaA03T0218300ZY	0	+	0	0	4120	0.0000000
zheyou73v0_A03	11969963	11973997	BnaA03T0218300ZY.1	0	+	0	0	4034	0.0000000
zheyou73v0_A03	11974270	11974640	BnaA03T0218400ZY	0	-	0	0	370	0.0000000
zheyou73v0_A03	11979146	11984307	BnaA03T0218500ZY	0	+	0	0	5161	0.0000000
zheyou73v0_A03	11993832	11998011	BnaA03T0218600ZY	0	+	0	0	4179	0.0000000
zheyou73v0_A03	12000058	12003818	BnaA03T0218700ZY	0	+	0	0	3760	0.0000000
zheyou73v0_A03	12005737	12006721	BnaA03T0218800ZY	0	-	0	0	984	0.0000000
zheyou73v0_A03	12016437	12017730	BnaA03T0218900ZY	0	-	0	0	1293	0.0000000
zheyou73v0_A03	12032186	12032462	BnaA03T0219000ZY	0	-	0	0	276	0.0000000
zheyou73v0_A03	12046363	12049256	BnaA03T0219100ZY	0	-	0	0	2893	0.0000000
zheyou73v0_A03	12050118	12052717	BnaA03T0219200ZY	0	-	0	0	2599	0.0000000
zheyou73v0_A03	12053653	12055427	BnaA03T0219300ZY	0	+	0	0	1774	0.0000000
zheyou73v0_A03	12058797	12059658	BnaA03T0219400ZY	0	-	0	0	861	0.0000000
zheyou73v0_A03	12073933	12076467	BnaA03T0219500ZY	0	+	0	0	2534	0.0000000
zheyou73v0_A03	12078770	12080165	BnaA03T0219600ZY	0	-	0	0	1395	0.0000000
zheyou73v0_A03	12083153	12084167	BnaA03T0219700ZY	0	-	0	0	1014	0.0000000
zheyou73v0_A03	12088363	12090073	BnaA03T0219800ZY	0	+	0	0	1710	0.0000000
zheyou73v0_A03	12095012	12095318	BnaA03T0219900ZY	0	+	0	0	306	0.0000000
zheyou73v0_A03	12098819	12100110	BnaA03T0220000ZY	0	-	0	0	1291	0.0000000
zheyou73v0_A03	12101037	12102801	BnaA03T0220100ZY	0	-	0	0	1764	0.0000000
zheyou73v0_A03	12105744	12108015	BnaA03T0220200ZY	0	-	0	0	2271	0.0000000
zheyou73v0_A03	12111832	12114352	BnaA03T0220300ZY	0	+	0	0	2520	0.0000000
zheyou73v0_A03	12111832	12114352	BnaA03T0220300ZY.1	0	+	0	0	2520	0.0000000
zheyou73v0_A03	12114455	12116159	BnaA03T0220400ZY	0	-	0	0	1704	0.0000000
zheyou73v0_A03	12117115	12119491	BnaA03T0220500ZY	0	-	0	0	2376	0.0000000
zheyou73v0_A03	12120697	12122359	BnaA03T0220600ZY	0	+	0	0	1662	0.0000000
zheyou73v0_A03	12120697	12122359	BnaA03T0220600ZY.1	0	+	0	0	1662	0.0000000
zheyou73v0_A03	12124268	12126821	BnaA03T0220700ZY	0	+	0	0	2553	0.0000000
zheyou73v0_A03	12127026	12132068	BnaA03T0220800ZY	0	-	0	0	5042	0.0000000
zheyou73v0_A03	12134789	12136745	BnaA03T0220900ZY	0	+	0	0	1956	0.0000000
zheyou73v0_A03	12138553	12141740	BnaA03T0221000ZY	0	-	0	0	3187	0.0000000
zheyou73v0_A03	12149648	12150216	BnaA03T0221100ZY	0	+	0	0	568	0.0000000
zheyou73v0_A03	12153425	12158218	BnaA03T0221200ZY	0	-	0	0	4793	0.0000000
zheyou73v0_A03	12159330	12160903	BnaA03T0221300ZY	0	-	0	0	1573	0.0000000
zheyou73v0_A03	12161329	12163223	BnaA03T0221400ZY	0	+	0	0	1894	0.0000000
zheyou73v0_A03	12163556	12163850	BnaA03T0221500ZY	0	+	0	0	294	0.0000000
zheyou73v0_A03	12164263	12166245	BnaA03T0221600ZY	0	+	0	0	1982	0.0000000
zheyou73v0_A03	12166701	12169681	BnaA03T0221700ZY	0	-	0	0	2980	0.0000000
zheyou73v0_A03	12175324	12177861	BnaA03T0221800ZY	0	-	0	0	2537	0.0000000
zheyou73v0_A03	12187328	12189826	BnaA03T0221900ZY	0	-	0	0	2498	0.0000000
zheyou73v0_A03	12190660	12197294	BnaA03T0222000ZY	0	+	0	0	6634	0.0000000
zheyou73v0_A03	12207729	12208800	BnaA03T0222100ZY	0	+	0	0	1071	0.0000000
zheyou73v0_A03	12214740	12217870	BnaA03T0222200ZY	0	+	0	0	3130	0.0000000
zheyou73v0_A03	12222786	12223441	BnaA03T0222300ZY	0	+	0	0	655	0.0000000
zheyou73v0_A03	12224750	12228008	BnaA03T0222400ZY	0	-	0	0	3258	0.0000000
zheyou73v0_A03	12232582	12233501	BnaA03T0222500ZY	0	+	0	0	919	0.0000000
zheyou73v0_A03	12234242	12237511	BnaA03T0222600ZY	0	+	0	0	3269	0.0000000
zheyou73v0_A03	12240109	12250297	BnaA03T0222700ZY	0	+	0	0	10188	0.0000000
zheyou73v0_A03	12242215	12250297	BnaA03T0222700ZY.1	0	+	0	0	8082	0.0000000
zheyou73v0_A03	12252324	12252689	BnaA03T0222800ZY	0	-	0	0	365	0.0000000
zheyou73v0_A03	12258598	12259118	BnaA03T0222900ZY	0	-	0	0	520	0.0000000
zheyou73v0_A03	12263833	12264412	BnaA03T0223000ZY	0	+	0	0	579	0.0000000
zheyou73v0_A03	12265426	12276218	BnaA03T0223100ZY	0	-	0	0	10792	0.0000000
zheyou73v0_A03	12279122	12281623	BnaA03T0223200ZY	0	+	0	0	2501	0.0000000
zheyou73v0_A03	12287284	12288776	BnaA03T0223300ZY	0	+	0	0	1492	0.0000000
zheyou73v0_A03	12291841	12293411	BnaA03T0223400ZY	0	+	0	0	1570	0.0000000
zheyou73v0_A03	12293800	12294358	BnaA03T0223500ZY	0	-	0	0	558	0.0000000
zheyou73v0_A03	12295418	12297004	BnaA03T0223600ZY	0	+	0	0	1586	0.0000000
zheyou73v0_A03	12297861	12300116	BnaA03T0223700ZY	0	-	0	0	2255	0.0000000
zheyou73v0_A03	12302299	12306809	BnaA03T0223800ZY	0	-	0	0	4510	0.0000000
zheyou73v0_A03	12310171	12311093	BnaA03T0223900ZY	0	+	0	0	922	0.0000000
zheyou73v0_A03	12310171	12311093	BnaA03T0223900ZY.1	0	+	0	0	922	0.0000000
zheyou73v0_A03	12310171	12311093	BnaA03T0223900ZY.2	0	+	0	0	922	0.0000000
zheyou73v0_A03	12311393	12314144	BnaA03T0224000ZY	0	+	0	0	2751	0.0000000
zheyou73v0_A03	12335254	12337890	BnaA03T0224100ZY	0	+	0	0	2636	0.0000000
zheyou73v0_A03	12337744	12339393	BnaA03T0224200ZY	0	-	0	0	1649	0.0000000
zheyou73v0_A03	12340719	12343718	BnaA03T0224300ZY.1	0	+	0	0	2999	0.0000000
zheyou73v0_A03	12340719	12343718	BnaA03T0224300ZY.2	0	+	0	0	2999	0.0000000
zheyou73v0_A03	12340719	12343718	BnaA03T0224300ZY.3	0	+	0	0	2999	0.0000000
zheyou73v0_A03	12340719	12343526	BnaA03T0224300ZY.4	0	+	0	0	2807	0.0000000
zheyou73v0_A03	12340729	12343526	BnaA03T0224300ZY	0	+	0	0	2797	0.0000000
zheyou73v0_A03	12343917	12346116	BnaA03T0224400ZY	0	-	0	0	2199	0.0000000
zheyou73v0_A03	12352159	12353177	BnaA03T0224500ZY	0	+	0	0	1018	0.0000000
zheyou73v0_A03	12355050	12357571	BnaA03T0224600ZY	0	-	0	0	2521	0.0000000
zheyou73v0_A03	12359946	12363037	BnaA03T0224700ZY	0	+	0	0	3091	0.0000000
zheyou73v0_A03	12363130	12375228	BnaA03T0224800ZY	0	-	0	0	12098	0.0000000
zheyou73v0_A03	12376843	12379312	BnaA03T0224900ZY	0	-	0	0	2469	0.0000000
zheyou73v0_A03	12380935	12387062	BnaA03T0225000ZY	0	-	0	0	6127	0.0000000
zheyou73v0_A03	12388458	12399935	BnaA03T0225100ZY	0	-	0	0	11477	0.0000000
zheyou73v0_A03	12400428	12401661	BnaA03T0225200ZY	0	+	0	0	1233	0.0000000
zheyou73v0_A03	12401916	12404353	BnaA03T0225300ZY	0	-	0	0	2437	0.0000000
zheyou73v0_A03	12405511	12406608	BnaA03T0225400ZY	0	+	0	0	1097	0.0000000
zheyou73v0_A03	12408711	12410116	BnaA03T0225500ZY	0	-	0	0	1405	0.0000000
zheyou73v0_A03	12413138	12415835	BnaA03T0225600ZY	0	+	0	0	2697	0.0000000
zheyou73v0_A03	12419461	12419647	BnaA03T0225700ZY	0	+	0	0	186	0.0000000
zheyou73v0_A03	12427053	12427800	BnaA03T0225800ZY	0	+	0	0	747	0.0000000
zheyou73v0_A03	12430091	12431627	BnaA03T0225900ZY	0	-	0	0	1536	0.0000000
zheyou73v0_A03	12431896	12440246	BnaA03T0226000ZY	0	-	0	0	8350	0.0000000
zheyou73v0_A03	12440973	12443889	BnaA03T0226100ZY	0	-	0	0	2916	0.0000000
zheyou73v0_A03	12444394	12446656	BnaA03T0226200ZY	0	-	0	0	2262	0.0000000
zheyou73v0_A03	12447836	12449399	BnaA03T0226300ZY	0	-	0	0	1563	0.0000000
zheyou73v0_A03	12453179	12455127	BnaA03T0226400ZY	0	+	0	0	1948	0.0000000
zheyou73v0_A03	12453179	12455127	BnaA03T0226400ZY.1	0	+	0	0	1948	0.0000000
zheyou73v0_A03	12457408	12458227	BnaA03T0226500ZY	0	+	0	0	819	0.0000000
zheyou73v0_A03	12458357	12460126	BnaA03T0226600ZY	0	-	0	0	1769	0.0000000
zheyou73v0_A03	12458357	12460126	BnaA03T0226600ZY.1	0	-	0	0	1769	0.0000000
zheyou73v0_A03	12474566	12475539	BnaA03T0226700ZY	0	-	0	0	973	0.0000000
zheyou73v0_A03	12480547	12481193	BnaA03T0226800ZY	0	-	0	0	646	0.0000000
zheyou73v0_A03	12481527	12481898	BnaA03T0226900ZY	0	+	0	0	371	0.0000000
zheyou73v0_A03	12486513	12487383	BnaA03T0227000ZY	0	+	0	0	870	0.0000000
zheyou73v0_A03	12496565	12499694	BnaA03T0227100ZY	0	-	0	0	3129	0.0000000
zheyou73v0_A03	12502328	12503284	BnaA03T0227200ZY	0	+	0	0	956	0.0000000
zheyou73v0_A03	12503580	12507603	BnaA03T0227300ZY	0	-	0	0	4023	0.0000000
zheyou73v0_A03	12518969	12520788	BnaA03T0227400ZY	0	+	0	0	1819	0.0000000
zheyou73v0_A03	12530974	12534622	BnaA03T0227500ZY	0	-	0	0	3648	0.0000000
zheyou73v0_A03	12551737	12554494	BnaA03T0227600ZY	0	-	0	0	2757	0.0000000
zheyou73v0_A03	12555208	12556028	BnaA03T0227700ZY	0	-	0	0	820	0.0000000
zheyou73v0_A03	12563040	12564138	BnaA03T0227800ZY	0	-	0	0	1098	0.0000000
zheyou73v0_A03	12566661	12567380	BnaA03T0227900ZY	0	-	0	0	719	0.0000000
zheyou73v0_A03	12573876	12576792	BnaA03T0228000ZY	0	+	0	0	2916	0.0000000
zheyou73v0_A03	12576778	12578819	BnaA03T0228100ZY	0	-	0	0	2041	0.0000000
zheyou73v0_A03	12592415	12592952	BnaA03T0228200ZY	0	+	0	0	537	0.0000000
zheyou73v0_A03	12596466	12598014	BnaA03T0228300ZY	0	-	0	0	1548	0.0000000
zheyou73v0_A03	12599911	12600805	BnaA03T0228400ZY	0	+	0	0	894	0.0000000
zheyou73v0_A03	12603164	12605191	BnaA03T0228500ZY	0	-	0	0	2027	0.0000000
zheyou73v0_A03	12603164	12605191	BnaA03T0228500ZY.1	0	-	0	0	2027	0.0000000
zheyou73v0_A03	12605423	12606634	BnaA03T0228600ZY	0	+	0	0	1211	0.0000000
zheyou73v0_A03	12607587	12608150	BnaA03T0228700ZY	0	+	0	0	563	0.0000000
zheyou73v0_A03	12610395	12612607	BnaA03T0228800ZY	0	+	0	0	2212	0.0000000
zheyou73v0_A03	12613251	12613437	BnaA03T0228900ZY	0	+	0	0	186	0.0000000
zheyou73v0_A03	12615455	12615837	BnaA03T0229000ZY	0	-	0	0	382	0.0000000
zheyou73v0_A03	12619230	12623451	BnaA03T0229100ZY	0	-	0	0	4221	0.0000000
zheyou73v0_A03	12629078	12634877	BnaA03T0229200ZY	0	+	0	0	5799	0.0000000
zheyou73v0_A03	12635808	12636365	BnaA03T0229300ZY	0	-	0	0	557	0.0000000
zheyou73v0_A03	12643618	12648027	BnaA03T0229400ZY	0	+	0	0	4409	0.0000000
zheyou73v0_A03	12648683	12650220	BnaA03T0229500ZY	0	+	0	0	1537	0.0000000
zheyou73v0_A03	12652251	12654322	BnaA03T0229600ZY	0	-	0	0	2071	0.0000000
zheyou73v0_A03	12658536	12660494	BnaA03T0229700ZY	0	+	0	0	1958	0.0000000
zheyou73v0_A03	12658536	12660494	BnaA03T0229700ZY.1	0	+	0	0	1958	0.0000000
zheyou73v0_A03	12665669	12668245	BnaA03T0229800ZY	0	+	0	0	2576	0.0000000
zheyou73v0_A03	12674867	12676041	BnaA03T0229900ZY	0	+	0	0	1174	0.0000000
zheyou73v0_A03	12677448	12680618	BnaA03T0230000ZY	0	-	0	0	3170	0.0000000
zheyou73v0_A03	12677448	12679977	BnaA03T0230000ZY.1	0	-	0	0	2529	0.0000000
zheyou73v0_A03	12683556	12684454	BnaA03T0230100ZY	0	+	0	0	898	0.0000000
zheyou73v0_A03	12685184	12686991	BnaA03T0230200ZY	0	+	0	0	1807	0.0000000
zheyou73v0_A03	12694353	12696035	BnaA03T0230300ZY	0	+	0	0	1682	0.0000000
zheyou73v0_A03	12698352	12700902	BnaA03T0230400ZY	0	-	0	0	2550	0.0000000
zheyou73v0_A03	12718046	12721637	BnaA03T0230500ZY	0	+	0	0	3591	0.0000000
zheyou73v0_A03	12723749	12728189	BnaA03T0230600ZY	0	+	0	0	4440	0.0000000
zheyou73v0_A03	12728560	12730626	BnaA03T0230700ZY	0	-	0	0	2066	0.0000000
zheyou73v0_A03	12731634	12733781	BnaA03T0230800ZY	0	+	0	0	2147	0.0000000
zheyou73v0_A03	12735546	12737872	BnaA03T0230900ZY	0	+	0	0	2326	0.0000000
zheyou73v0_A03	12738283	12740364	BnaA03T0231000ZY	0	-	0	0	2081	0.0000000
zheyou73v0_A03	12738283	12740364	BnaA03T0231000ZY.1	0	-	0	0	2081	0.0000000
zheyou73v0_A03	12740455	12744158	BnaA03T0231100ZY	0	-	0	0	3703	0.0000000
zheyou73v0_A03	12744460	12747192	BnaA03T0231200ZY	0	+	0	0	2732	0.0000000
zheyou73v0_A03	12748604	12749048	BnaA03T0231300ZY	0	-	0	0	444	0.0000000
zheyou73v0_A03	12750774	12751807	BnaA03T0231400ZY	0	-	0	0	1033	0.0000000
zheyou73v0_A03	12759145	12761854	BnaA03T0231500ZY	0	-	0	0	2709	0.0000000
zheyou73v0_A03	12766569	12767268	BnaA03T0231600ZY	0	+	0	0	699	0.0000000
zheyou73v0_A03	12767232	12769333	BnaA03T0231700ZY	0	-	0	0	2101	0.0000000
zheyou73v0_A03	12769433	12771759	BnaA03T0231800ZY	0	-	0	0	2326	0.0000000
zheyou73v0_A03	12772032	12773892	BnaA03T0231900ZY	0	+	0	0	1860	0.0000000
zheyou73v0_A03	12774750	12775245	BnaA03T0232000ZY	0	+	0	0	495	0.0000000
zheyou73v0_A03	12777760	12780243	BnaA03T0232100ZY	0	-	0	0	2483	0.0000000
zheyou73v0_A03	12777760	12780243	BnaA03T0232100ZY.1	0	-	0	0	2483	0.0000000
zheyou73v0_A03	12782403	12784519	BnaA03T0232200ZY	0	-	0	0	2116	0.0000000
zheyou73v0_A03	12788551	12789774	BnaA03T0232300ZY	0	+	0	0	1223	0.0000000
zheyou73v0_A03	12788551	12789774	BnaA03T0232300ZY.1	0	+	0	0	1223	0.0000000
zheyou73v0_A03	12792092	12793371	BnaA03T0232400ZY	0	+	0	0	1279	0.0000000
zheyou73v0_A03	12801349	12802707	BnaA03T0232500ZY	0	-	0	0	1358	0.0000000
zheyou73v0_A03	12805362	12806660	BnaA03T0232600ZY	0	-	0	0	1298	0.0000000
zheyou73v0_A03	12807709	12813713	BnaA03T0232700ZY	0	+	0	0	6004	0.0000000
zheyou73v0_A03	12814991	12817500	BnaA03T0232800ZY	0	+	0	0	2509	0.0000000
zheyou73v0_A03	12819232	12820900	BnaA03T0232900ZY	0	-	0	0	1668	0.0000000
zheyou73v0_A03	12837210	12838670	BnaA03T0233000ZY	0	-	0	0	1460	0.0000000
zheyou73v0_A03	12842533	12843847	BnaA03T0233100ZY	0	-	0	0	1314	0.0000000
zheyou73v0_A03	12853592	12853766	BnaA03T0233200ZY	0	-	0	0	174	0.0000000
zheyou73v0_A03	12857432	12859113	BnaA03T0233300ZY	0	-	0	0	1681	0.0000000
zheyou73v0_A03	12859604	12860828	BnaA03T0233400ZY	0	-	0	0	1224	0.0000000
zheyou73v0_A03	12861148	12869569	BnaA03T0233500ZY	0	+	0	0	8421	0.0000000
zheyou73v0_A03	12870157	12872125	BnaA03T0233600ZY	0	+	0	0	1968	0.0000000
zheyou73v0_A03	12873013	12874993	BnaA03T0233700ZY	0	+	0	0	1980	0.0000000
zheyou73v0_A03	12880074	12882399	BnaA03T0233800ZY	0	+	0	0	2325	0.0000000
zheyou73v0_A03	12883882	12884604	BnaA03T0233900ZY	0	-	0	0	722	0.0000000
zheyou73v0_A03	12885624	12885906	BnaA03T0234000ZY	0	-	0	0	282	0.0000000
zheyou73v0_A03	12887150	12888001	BnaA03T0234100ZY	0	-	0	0	851	0.0000000
zheyou73v0_A03	12889537	12890740	BnaA03T0234200ZY	0	-	0	0	1203	0.0000000
zheyou73v0_A03	12891691	12893850	BnaA03T0234300ZY	0	+	0	0	2159	0.0000000
zheyou73v0_A03	12895039	12898044	BnaA03T0234400ZY	0	+	0	0	3005	0.0000000
zheyou73v0_A03	12902144	12905301	BnaA03T0234500ZY	0	+	0	0	3157	0.0000000
zheyou73v0_A03	12902144	12904263	BnaA03T0234500ZY.1	0	+	0	0	2119	0.0000000
zheyou73v0_A03	12911567	12913201	BnaA03T0234600ZY	0	+	0	0	1634	0.0000000
zheyou73v0_A03	12918638	12922110	BnaA03T0234700ZY	0	+	0	0	3472	0.0000000
zheyou73v0_A03	12922815	12923269	BnaA03T0234800ZY	0	+	0	0	454	0.0000000
zheyou73v0_A03	12946698	12951991	BnaA03T0234900ZY	0	-	0	0	5293	0.0000000
zheyou73v0_A03	12955234	12956043	BnaA03T0235000ZY	0	-	0	0	809	0.0000000
zheyou73v0_A03	12957751	12959758	BnaA03T0235100ZY	0	-	0	0	2007	0.0000000
zheyou73v0_A03	12959978	12961997	BnaA03T0235200ZY	0	-	0	0	2019	0.0000000
zheyou73v0_A03	12962246	12964052	BnaA03T0235300ZY	0	+	0	0	1806	0.0000000
zheyou73v0_A03	12967301	12968055	BnaA03T0235400ZY	0	+	0	0	754	0.0000000
zheyou73v0_A03	12970147	12970454	BnaA03T0235500ZY	0	+	0	0	307	0.0000000
zheyou73v0_A03	12970838	12972878	BnaA03T0235600ZY	0	-	0	0	2040	0.0000000
zheyou73v0_A03	12973710	12975385	BnaA03T0235700ZY	0	+	0	0	1675	0.0000000
zheyou73v0_A03	12975797	12981579	BnaA03T0235800ZY	0	+	0	0	5782	0.0000000
zheyou73v0_A03	12986086	12986993	BnaA03T0235900ZY	0	+	0	0	907	0.0000000
zheyou73v0_A03	12987165	12988196	BnaA03T0236000ZY	0	-	0	0	1031	0.0000000
zheyou73v0_A03	12996166	12997478	BnaA03T0236100ZY	0	+	0	0	1312	0.0000000
zheyou73v0_A03	12999267	13001894	BnaA03T0236200ZY	0	+	0	0	2627	0.0000000
zheyou73v0_A03	13003680	13006207	BnaA03T0236300ZY	0	-	0	0	2527	0.0000000
zheyou73v0_A03	13006637	13008376	BnaA03T0236400ZY	0	+	0	0	1739	0.0000000
zheyou73v0_A03	13008759	13010706	BnaA03T0236500ZY	0	+	0	0	1947	0.0000000
zheyou73v0_A03	13013707	13014384	BnaA03T0236600ZY	0	+	0	0	677	0.0000000
zheyou73v0_A03	13026071	13028253	BnaA03T0236700ZY	0	+	0	0	2182	0.0000000
zheyou73v0_A03	13029115	13029735	BnaA03T0236800ZY	0	+	0	0	620	0.0000000
zheyou73v0_A03	13033650	13034184	BnaA03T0236900ZY	0	+	0	0	534	0.0000000
zheyou73v0_A03	13042364	13042817	BnaA03T0237000ZY	0	+	0	0	453	0.0000000
zheyou73v0_A03	13045607	13049333	BnaA03T0237100ZY	0	+	0	0	3726	0.0000000
zheyou73v0_A03	13050703	13051486	BnaA03T0237200ZY	0	+	0	0	783	0.0000000
zheyou73v0_A03	13051524	13052339	BnaA03T0237300ZY	0	-	0	0	815	0.0000000
zheyou73v0_A03	13054790	13057349	BnaA03T0237400ZY	0	-	0	0	2559	0.0000000
zheyou73v0_A03	13054790	13057349	BnaA03T0237400ZY.1	0	-	0	0	2559	0.0000000
zheyou73v0_A03	13054790	13057349	BnaA03T0237400ZY.2	0	-	0	0	2559	0.0000000
zheyou73v0_A03	13058146	13060067	BnaA03T0237500ZY	0	-	0	0	1921	0.0000000
zheyou73v0_A03	13062284	13063864	BnaA03T0237600ZY	0	-	0	0	1580	0.0000000
zheyou73v0_A03	13064207	13065026	BnaA03T0237700ZY	0	+	0	0	819	0.0000000
zheyou73v0_A03	13065243	13067453	BnaA03T0237800ZY	0	+	0	0	2210	0.0000000
zheyou73v0_A03	13070337	13071135	BnaA03T0237900ZY	0	+	0	0	798	0.0000000
zheyou73v0_A03	13072075	13074060	BnaA03T0238000ZY	0	-	0	0	1985	0.0000000
zheyou73v0_A03	13072075	13074060	BnaA03T0238000ZY.1	0	-	0	0	1985	0.0000000
zheyou73v0_A03	13074418	13076426	BnaA03T0238100ZY	0	-	0	0	2008	0.0000000
zheyou73v0_A03	13077643	13078719	BnaA03T0238200ZY	0	-	0	0	1076	0.0000000
zheyou73v0_A03	13085179	13085605	BnaA03T0238300ZY	0	-	0	0	426	0.0000000
zheyou73v0_A03	13096246	13098211	BnaA03T0238400ZY	0	+	0	0	1965	0.0000000
zheyou73v0_A03	13099270	13100512	BnaA03T0238500ZY	0	-	0	0	1242	0.0000000
zheyou73v0_A03	13103592	13107403	BnaA03T0238600ZY	0	-	0	0	3811	0.0000000
zheyou73v0_A03	13117920	13119001	BnaA03T0238700ZY	0	+	0	0	1081	0.0000000
zheyou73v0_A03	13133323	13136301	BnaA03T0238800ZY	0	-	0	0	2978	0.0000000
zheyou73v0_A03	13142865	13143792	BnaA03T0238900ZY	0	+	0	0	927	0.0000000
zheyou73v0_A03	13145224	13146632	BnaA03T0239000ZY	0	+	0	0	1408	0.0000000
zheyou73v0_A03	13147380	13150842	BnaA03T0239100ZY	0	-	0	0	3462	0.0000000
zheyou73v0_A03	13153962	13154883	BnaA03T0239200ZY	0	+	0	0	921	0.0000000
zheyou73v0_A03	13158655	13159995	BnaA03T0239300ZY	0	+	0	0	1340	0.0000000
zheyou73v0_A03	13161137	13163157	BnaA03T0239400ZY	0	+	0	0	2020	0.0000000
zheyou73v0_A03	13161137	13162041	BnaA03T0239400ZY.1	0	+	0	0	904	0.0000000
zheyou73v0_A03	13163410	13165452	BnaA03T0239500ZY	0	+	0	0	2042	0.0000000
zheyou73v0_A03	13167847	13169665	BnaA03T0239600ZY	0	-	0	0	1818	0.0000000
zheyou73v0_A03	13176793	13177987	BnaA03T0239700ZY	0	+	0	0	1194	0.0000000
zheyou73v0_A03	13176793	13177987	BnaA03T0239700ZY.1	0	+	0	0	1194	0.0000000
zheyou73v0_A03	13179592	13180237	BnaA03T0239800ZY	0	+	0	0	645	0.0000000
zheyou73v0_A03	13184168	13186446	BnaA03T0239900ZY	0	-	0	0	2278	0.0000000
zheyou73v0_A03	13198694	13199646	BnaA03T0240000ZY	0	-	0	0	952	0.0000000
zheyou73v0_A03	13201204	13204087	BnaA03T0240100ZY	0	-	0	0	2883	0.0000000
zheyou73v0_A03	13205704	13206281	BnaA03T0240200ZY	0	+	0	0	577	0.0000000
zheyou73v0_A03	13209637	13212854	BnaA03T0240300ZY	0	-	0	0	3217	0.0000000
zheyou73v0_A03	13215866	13216677	BnaA03T0240400ZY	0	-	0	0	811	0.0000000
zheyou73v0_A03	13222519	13224394	BnaA03T0240500ZY	0	-	0	0	1875	0.0000000
zheyou73v0_A03	13225181	13227646	BnaA03T0240600ZY	0	+	0	0	2465	0.0000000
zheyou73v0_A03	13228376	13232139	BnaA03T0240700ZY	0	-	0	0	3763	0.0000000
zheyou73v0_A03	13228727	13230035	BnaA03T0240800ZY	0	+	0	0	1308	0.0000000
zheyou73v0_A03	13232502	13235190	BnaA03T0240900ZY	0	-	0	0	2688	0.0000000
zheyou73v0_A03	13248781	13249022	BnaA03T0241000ZY	0	-	0	0	241	0.0000000
zheyou73v0_A03	13249289	13250447	BnaA03T0241100ZY	0	+	0	0	1158	0.0000000
zheyou73v0_A03	13253788	13254168	BnaA03T0241200ZY	0	-	0	0	380	0.0000000
zheyou73v0_A03	13258206	13260062	BnaA03T0241300ZY	0	+	0	0	1856	0.0000000
zheyou73v0_A03	13261338	13263487	BnaA03T0241400ZY	0	+	0	0	2149	0.0000000
zheyou73v0_A03	13261338	13263487	BnaA03T0241400ZY.1	0	+	0	0	2149	0.0000000
zheyou73v0_A03	13263804	13264926	BnaA03T0241500ZY	0	-	0	0	1122	0.0000000
zheyou73v0_A03	13270260	13272759	BnaA03T0241600ZY	0	+	0	0	2499	0.0000000
zheyou73v0_A03	13270260	13272759	BnaA03T0241600ZY.1	0	+	0	0	2499	0.0000000
zheyou73v0_A03	13280811	13285540	BnaA03T0241700ZY	0	+	0	0	4729	0.0000000
zheyou73v0_A03	13286881	13290417	BnaA03T0241800ZY	0	-	0	0	3536	0.0000000
zheyou73v0_A03	13286881	13290417	BnaA03T0241800ZY.1	0	-	0	0	3536	0.0000000
zheyou73v0_A03	13297499	13300933	BnaA03T0241900ZY	0	-	0	0	3434	0.0000000
zheyou73v0_A03	13304406	13306079	BnaA03T0242000ZY	0	-	0	0	1673	0.0000000
zheyou73v0_A03	13307185	13308988	BnaA03T0242100ZY	0	-	0	0	1803	0.0000000
zheyou73v0_A03	13309352	13310254	BnaA03T0242200ZY	0	+	0	0	902	0.0000000
zheyou73v0_A03	13310637	13311570	BnaA03T0242300ZY	0	+	0	0	933	0.0000000
zheyou73v0_A03	13312311	13313055	BnaA03T0242400ZY	0	+	0	0	744	0.0000000
zheyou73v0_A03	13313058	13313946	BnaA03T0242500ZY	0	+	0	0	888	0.0000000
zheyou73v0_A03	13314224	13316496	BnaA03T0242600ZY	0	-	0	0	2272	0.0000000
zheyou73v0_A03	13316798	13318654	BnaA03T0242700ZY.1	0	+	0	0	1856	0.0000000
zheyou73v0_A03	13316979	13318654	BnaA03T0242700ZY	0	+	0	0	1675	0.0000000
zheyou73v0_A03	13319060	13319713	BnaA03T0242800ZY	0	-	0	0	653	0.0000000
zheyou73v0_A03	13328701	13331259	BnaA03T0242900ZY	0	+	0	0	2558	0.0000000
zheyou73v0_A03	13331224	13332137	BnaA03T0243000ZY	0	-	0	0	913	0.0000000
zheyou73v0_A03	13335301	13339921	BnaA03T0243100ZY	0	-	0	0	4620	0.0000000
zheyou73v0_A03	13340285	13341374	BnaA03T0243200ZY	0	-	0	0	1089	0.0000000
zheyou73v0_A03	13346014	13348359	BnaA03T0243300ZY	0	-	0	0	2345	0.0000000
zheyou73v0_A03	13352699	13353333	BnaA03T0243400ZY	0	+	0	0	634	0.0000000
zheyou73v0_A03	13353270	13354411	BnaA03T0243500ZY.1	0	-	0	0	1141	0.0000000
zheyou73v0_A03	13353648	13354411	BnaA03T0243500ZY	0	-	0	0	763	0.0000000
zheyou73v0_A03	13355014	13363287	BnaA03T0243600ZY	0	+	0	0	8273	0.0000000
zheyou73v0_A03	13363734	13364872	BnaA03T0243700ZY	0	-	0	0	1138	0.0000000
zheyou73v0_A03	13366251	13367235	BnaA03T0243800ZY	0	-	0	0	984	0.0000000
zheyou73v0_A03	13367702	13369715	BnaA03T0243900ZY	0	-	0	0	2013	0.0000000
zheyou73v0_A03	13372376	13374074	BnaA03T0244000ZY	0	+	0	0	1698	0.0000000
zheyou73v0_A03	13374889	13375983	BnaA03T0244100ZY	0	+	0	0	1094	0.0000000
zheyou73v0_A03	13379186	13380457	BnaA03T0244200ZY	0	+	0	0	1271	0.0000000
zheyou73v0_A03	13381241	13383346	BnaA03T0244300ZY	0	+	0	0	2105	0.0000000
zheyou73v0_A03	13381241	13383346	BnaA03T0244300ZY.1	0	+	0	0	2105	0.0000000
zheyou73v0_A03	13385255	13387421	BnaA03T0244400ZY	0	+	0	0	2166	0.0000000
zheyou73v0_A03	13390400	13391147	BnaA03T0244500ZY	0	+	0	0	747	0.0000000
zheyou73v0_A03	13398217	13398618	BnaA03T0244600ZY	0	+	0	0	401	0.0000000
zheyou73v0_A03	13399055	13399744	BnaA03T0244700ZY	0	-	0	0	689	0.0000000
zheyou73v0_A03	13402872	13407364	BnaA03T0244800ZY	0	-	0	0	4492	0.0000000
zheyou73v0_A03	13412259	13415194	BnaA03T0244900ZY	0	+	0	0	2935	0.0000000
zheyou73v0_A03	13416672	13417144	BnaA03T0245000ZY	0	+	0	0	472	0.0000000
zheyou73v0_A03	13418470	13419699	BnaA03T0245100ZY	0	-	0	0	1229	0.0000000
zheyou73v0_A03	13429220	13430330	BnaA03T0245200ZY	0	-	0	0	1110	0.0000000
zheyou73v0_A03	13432332	13434602	BnaA03T0245300ZY	0	+	0	0	2270	0.0000000
zheyou73v0_A03	13436849	13437204	BnaA03T0245400ZY	0	+	0	0	355	0.0000000
zheyou73v0_A03	13437257	13437866	BnaA03T0245500ZY	0	+	0	0	609	0.0000000
zheyou73v0_A03	13438724	13439501	BnaA03T0245600ZY	0	+	0	0	777	0.0000000
zheyou73v0_A03	13439513	13440875	BnaA03T0245700ZY	0	-	0	0	1362	0.0000000
zheyou73v0_A03	13440905	13441641	BnaA03T0245800ZY	0	-	0	0	736	0.0000000
zheyou73v0_A03	13441647	13443322	BnaA03T0245900ZY	0	-	0	0	1675	0.0000000
zheyou73v0_A03	13443808	13444654	BnaA03T0246000ZY	0	-	0	0	846	0.0000000
zheyou73v0_A03	13449443	13451583	BnaA03T0246100ZY	0	+	0	0	2140	0.0000000
zheyou73v0_A03	13453449	13454134	BnaA03T0246200ZY	0	+	0	0	685	0.0000000
zheyou73v0_A03	13469405	13471024	BnaA03T0246300ZY	0	+	0	0	1619	0.0000000
zheyou73v0_A03	13472794	13475093	BnaA03T0246400ZY	0	+	0	0	2299	0.0000000
zheyou73v0_A03	13482783	13484360	BnaA03T0246500ZY	0	+	0	0	1577	0.0000000
zheyou73v0_A03	13486291	13486959	BnaA03T0246600ZY	0	+	0	0	668	0.0000000
zheyou73v0_A03	13487715	13489126	BnaA03T0246700ZY	0	-	0	0	1411	0.0000000
zheyou73v0_A03	13487715	13489126	BnaA03T0246700ZY.1	0	-	0	0	1411	0.0000000
zheyou73v0_A03	13490504	13492659	BnaA03T0246800ZY	0	-	0	0	2155	0.0000000
zheyou73v0_A03	13500042	13502306	BnaA03T0246900ZY	0	-	0	0	2264	0.0000000
zheyou73v0_A03	13508804	13509653	BnaA03T0247000ZY	0	-	0	0	849	0.0000000
zheyou73v0_A03	13511492	13513627	BnaA03T0247100ZY	0	-	0	0	2135	0.0000000
zheyou73v0_A03	13514230	13515188	BnaA03T0247200ZY	0	-	0	0	958	0.0000000
zheyou73v0_A03	13516128	13517218	BnaA03T0247300ZY	0	-	0	0	1090	0.0000000
zheyou73v0_A03	13518747	13521715	BnaA03T0247400ZY	0	-	0	0	2968	0.0000000
zheyou73v0_A03	13535853	13536942	BnaA03T0247500ZY	0	+	0	0	1089	0.0000000
zheyou73v0_A03	13539476	13541066	BnaA03T0247600ZY	0	+	0	0	1590	0.0000000
zheyou73v0_A03	13540600	13544235	BnaA03T0247700ZY	0	-	0	0	3635	0.0000000
zheyou73v0_A03	13544885	13547728	BnaA03T0247800ZY	0	+	0	0	2843	0.0000000
zheyou73v0_A03	13550720	13555864	BnaA03T0247900ZY	0	+	0	0	5144	0.0000000
zheyou73v0_A03	13556133	13556460	BnaA03T0248000ZY	0	-	0	0	327	0.0000000
zheyou73v0_A03	13556483	13558833	BnaA03T0248100ZY	0	-	0	0	2350	0.0000000
zheyou73v0_A03	13562790	13565399	BnaA03T0248200ZY	0	+	0	0	2609	0.0000000
zheyou73v0_A03	13567215	13567806	BnaA03T0248300ZY	0	+	0	0	591	0.0000000
zheyou73v0_A03	13568923	13569419	BnaA03T0248400ZY	0	+	0	0	496	0.0000000
zheyou73v0_A03	13569646	13570324	BnaA03T0248500ZY	0	+	0	0	678	0.0000000
zheyou73v0_A03	13570548	13571802	BnaA03T0248600ZY	0	+	0	0	1254	0.0000000
zheyou73v0_A03	13574867	13577926	BnaA03T0248700ZY	0	+	0	0	3059	0.0000000
zheyou73v0_A03	13578604	13580919	BnaA03T0248800ZY	0	+	0	0	2315	0.0000000
zheyou73v0_A03	13582059	13583553	BnaA03T0248900ZY	0	+	0	0	1494	0.0000000
zheyou73v0_A03	13583858	13586039	BnaA03T0249000ZY	0	+	0	0	2181	0.0000000
zheyou73v0_A03	13583858	13586116	BnaA03T0249000ZY.1	0	+	0	0	2258	0.0000000
zheyou73v0_A03	13588258	13589699	BnaA03T0249100ZY	0	+	0	0	1441	0.0000000
zheyou73v0_A03	13589913	13592406	BnaA03T0249200ZY	0	-	0	0	2493	0.0000000
zheyou73v0_A03	13589913	13592406	BnaA03T0249200ZY.1	0	-	0	0	2493	0.0000000
zheyou73v0_A03	13597201	13598379	BnaA03T0249300ZY	0	-	0	0	1178	0.0000000
zheyou73v0_A03	13601866	13602975	BnaA03T0249400ZY	0	+	0	0	1109	0.0000000
zheyou73v0_A03	13606039	13607463	BnaA03T0249500ZY	0	-	0	0	1424	0.0000000
zheyou73v0_A03	13610149	13610687	BnaA03T0249600ZY	0	-	0	0	538	0.0000000
zheyou73v0_A03	13620619	13623308	BnaA03T0249700ZY	0	+	0	0	2689	0.0000000
zheyou73v0_A03	13623568	13626078	BnaA03T0249800ZY	0	-	0	0	2510	0.0000000
zheyou73v0_A03	13626391	13627597	BnaA03T0249900ZY	0	-	0	0	1206	0.0000000
zheyou73v0_A03	13628308	13630783	BnaA03T0250000ZY	0	+	0	0	2475	0.0000000
zheyou73v0_A03	13634402	13635157	BnaA03T0250100ZY	0	+	0	0	755	0.0000000
zheyou73v0_A03	13637335	13638067	BnaA03T0250200ZY	0	-	0	0	732	0.0000000
zheyou73v0_A03	13638547	13644224	BnaA03T0250300ZY	0	-	0	0	5677	0.0000000
zheyou73v0_A03	13647281	13648007	BnaA03T0250400ZY	0	+	0	0	726	0.0000000
zheyou73v0_A03	13648815	13650401	BnaA03T0250500ZY	0	-	0	0	1586	0.0000000
zheyou73v0_A03	13651309	13651747	BnaA03T0250600ZY	0	-	0	0	438	0.0000000
zheyou73v0_A03	13652495	13659085	BnaA03T0250700ZY	0	-	0	0	6590	0.0000000
zheyou73v0_A03	13652495	13659025	BnaA03T0250700ZY.1	0	-	0	0	6530	0.0000000
zheyou73v0_A03	13652495	13659025	BnaA03T0250700ZY.2	0	-	0	0	6530	0.0000000
zheyou73v0_A03	13661478	13662419	BnaA03T0250800ZY	0	+	0	0	941	0.0000000
zheyou73v0_A03	13667970	13669687	BnaA03T0250900ZY	0	+	0	0	1717	0.0000000
zheyou73v0_A03	13672362	13673025	BnaA03T0251000ZY	0	-	0	0	663	0.0000000
zheyou73v0_A03	13680495	13681068	BnaA03T0251100ZY	0	+	0	0	573	0.0000000
zheyou73v0_A03	13683608	13687736	BnaA03T0251200ZY	0	+	0	0	4128	0.0000000
zheyou73v0_A03	13687951	13690621	BnaA03T0251300ZY	0	-	0	0	2670	0.0000000
zheyou73v0_A03	13701030	13701531	BnaA03T0251400ZY	0	+	0	0	501	0.0000000
zheyou73v0_A03	13705990	13708145	BnaA03T0251500ZY	0	-	0	0	2155	0.0000000
zheyou73v0_A03	13720220	13720682	BnaA03T0251600ZY	0	+	0	0	462	0.0000000
zheyou73v0_A03	13721595	13721937	BnaA03T0251700ZY	0	-	0	0	342	0.0000000
zheyou73v0_A03	13722794	13723311	BnaA03T0251800ZY	0	-	0	0	517	0.0000000
zheyou73v0_A03	13725187	13726227	BnaA03T0251900ZY	0	-	0	0	1040	0.0000000
zheyou73v0_A03	13735175	13736190	BnaA03T0252000ZY	0	-	0	0	1015	0.0000000
zheyou73v0_A03	13737134	13739032	BnaA03T0252100ZY	0	-	0	0	1898	0.0000000
zheyou73v0_A03	13750313	13752965	BnaA03T0252200ZY	0	+	0	0	2652	0.0000000
zheyou73v0_A03	13750313	13752965	BnaA03T0252200ZY.1	0	+	0	0	2652	0.0000000
zheyou73v0_A03	13753544	13754768	BnaA03T0252300ZY	0	-	0	0	1224	0.0000000
zheyou73v0_A03	13755936	13757111	BnaA03T0252400ZY	0	-	0	0	1175	0.0000000
zheyou73v0_A03	13769069	13775070	BnaA03T0252500ZY	0	+	0	0	6001	0.0000000
zheyou73v0_A03	13798893	13804324	BnaA03T0252600ZY	0	-	0	0	5431	0.0000000
zheyou73v0_A03	13814331	13815947	BnaA03T0252700ZY	0	+	0	0	1616	0.0000000
zheyou73v0_A03	13819620	13820857	BnaA03T0252800ZY	0	+	0	0	1237	0.0000000
zheyou73v0_A03	13824649	13829011	BnaA03T0252900ZY	0	+	0	0	4362	0.0000000
zheyou73v0_A03	13830023	13834083	BnaA03T0253000ZY	0	+	0	0	4060	0.0000000
zheyou73v0_A03	13837269	13838555	BnaA03T0253100ZY	0	-	0	0	1286	0.0000000
zheyou73v0_A03	13846866	13847913	BnaA03T0253200ZY	0	-	0	0	1047	0.0000000
zheyou73v0_A03	13854408	13854982	BnaA03T0253300ZY	0	+	0	0	574	0.0000000
zheyou73v0_A03	13862392	13863068	BnaA03T0253400ZY	0	+	0	0	676	0.0000000
zheyou73v0_A03	13869328	13870429	BnaA03T0253500ZY	0	-	0	0	1101	0.0000000
zheyou73v0_A03	13887169	13889713	BnaA03T0253600ZY	0	+	0	0	2544	0.0000000
zheyou73v0_A03	13893271	13901694	BnaA03T0253700ZY	0	-	0	0	8423	0.0000000
zheyou73v0_A03	13901715	13902629	BnaA03T0253800ZY	0	+	0	0	914	0.0000000
zheyou73v0_A03	13904855	13905473	BnaA03T0253900ZY	0	-	0	0	618	0.0000000
zheyou73v0_A03	13906879	13907707	BnaA03T0254000ZY	0	+	0	0	828	0.0000000
zheyou73v0_A03	13909342	13911730	BnaA03T0254100ZY	0	-	0	0	2388	0.0000000
zheyou73v0_A03	13913439	13914354	BnaA03T0254200ZY	0	+	0	0	915	0.0000000
zheyou73v0_A03	13917584	13918575	BnaA03T0254300ZY	0	+	0	0	991	0.0000000
zheyou73v0_A03	13917584	13918575	BnaA03T0254300ZY.1	0	+	0	0	991	0.0000000
zheyou73v0_A03	13920767	13922807	BnaA03T0254400ZY	0	-	0	0	2040	0.0000000
zheyou73v0_A03	13937261	13938174	BnaA03T0254500ZY	0	+	0	0	913	0.0000000
zheyou73v0_A03	13943255	13945639	BnaA03T0254600ZY	0	+	0	0	2384	0.0000000
zheyou73v0_A03	13943255	13945639	BnaA03T0254600ZY.1	0	+	0	0	2384	0.0000000
zheyou73v0_A03	13947517	13948376	BnaA03T0254700ZY	0	+	0	0	859	0.0000000
zheyou73v0_A03	13948554	13949580	BnaA03T0254800ZY	0	-	0	0	1026	0.0000000
zheyou73v0_A03	13953615	13957780	BnaA03T0254900ZY	0	+	0	0	4165	0.0000000
zheyou73v0_A03	13958374	13959137	BnaA03T0255000ZY	0	-	0	0	763	0.0000000
zheyou73v0_A03	13960150	13960681	BnaA03T0255100ZY	0	-	0	0	531	0.0000000
zheyou73v0_A03	13962637	13963286	BnaA03T0255200ZY	0	+	0	0	649	0.0000000
zheyou73v0_A03	13963643	13963901	BnaA03T0255300ZY	0	+	0	0	258	0.0000000
zheyou73v0_A03	13968610	13969898	BnaA03T0255400ZY	0	+	0	0	1288	0.0000000
zheyou73v0_A03	13971712	13973445	BnaA03T0255500ZY	0	+	0	0	1733	0.0000000
zheyou73v0_A03	13971712	13973445	BnaA03T0255500ZY.1	0	+	0	0	1733	0.0000000
zheyou73v0_A03	13974910	13977152	BnaA03T0255600ZY	0	+	0	0	2242	0.0000000
zheyou73v0_A03	13983025	13984277	BnaA03T0255700ZY	0	+	0	0	1252	0.0000000
zheyou73v0_A03	13985125	13987130	BnaA03T0255800ZY	0	-	0	0	2005	0.0000000
zheyou73v0_A03	13985125	13987130	BnaA03T0255800ZY.1	0	-	0	0	2005	0.0000000
zheyou73v0_A03	13988691	13989378	BnaA03T0255900ZY	0	-	0	0	687	0.0000000
zheyou73v0_A03	13993825	13996585	BnaA03T0256000ZY	0	-	0	0	2760	0.0000000
zheyou73v0_A03	13998249	13999154	BnaA03T0256100ZY	0	-	0	0	905	0.0000000
zheyou73v0_A03	14002559	14016617	BnaA03T0256200ZY	0	+	0	0	14058	0.0000000
zheyou73v0_A03	14021725	14022701	BnaA03T0256300ZY	0	+	0	0	976	0.0000000
zheyou73v0_A03	14029457	14031386	BnaA03T0256400ZY	0	+	0	0	1929	0.0000000
zheyou73v0_A03	14032407	14035992	BnaA03T0256500ZY	0	+	0	0	3585	0.0000000
zheyou73v0_A03	14044827	14045769	BnaA03T0256600ZY	0	-	0	0	942	0.0000000
zheyou73v0_A03	14053951	14055061	BnaA03T0256700ZY	0	+	0	0	1110	0.0000000
zheyou73v0_A03	14058205	14060531	BnaA03T0256800ZY	0	+	0	0	2326	0.0000000
zheyou73v0_A03	14070967	14073541	BnaA03T0256900ZY	0	+	0	0	2574	0.0000000
zheyou73v0_A03	14075703	14077614	BnaA03T0257000ZY	0	+	0	0	1911	0.0000000
zheyou73v0_A03	14078302	14079718	BnaA03T0257100ZY	0	-	0	0	1416	0.0000000
zheyou73v0_A03	14085311	14087020	BnaA03T0257200ZY	0	+	0	0	1709	0.0000000
zheyou73v0_A03	14087538	14091207	BnaA03T0257300ZY	0	+	0	0	3669	0.0000000
zheyou73v0_A03	14096844	14099302	BnaA03T0257400ZY	0	+	0	0	2458	0.0000000
zheyou73v0_A03	14096844	14098831	BnaA03T0257400ZY.2	0	+	0	0	1987	0.0000000
zheyou73v0_A03	14097071	14099455	BnaA03T0257400ZY.1	0	+	0	0	2384	0.0000000
zheyou73v0_A03	14099660	14110582	BnaA03T0257500ZY	0	-	0	0	10922	0.0000000
zheyou73v0_A03	14110837	14112657	BnaA03T0257600ZY	0	-	0	0	1820	0.0000000
zheyou73v0_A03	14115655	14118953	BnaA03T0257700ZY	0	+	0	0	3298	0.0000000
zheyou73v0_A03	14127402	14130338	BnaA03T0257800ZY	0	+	0	0	2936	0.0000000
zheyou73v0_A03	14127402	14130338	BnaA03T0257800ZY.1	0	+	0	0	2936	0.0000000
zheyou73v0_A03	14134703	14136145	BnaA03T0257900ZY	0	+	0	0	1442	0.0000000
zheyou73v0_A03	14137332	14139764	BnaA03T0258000ZY	0	-	0	0	2432	0.0000000
zheyou73v0_A03	14150087	14152141	BnaA03T0258100ZY	0	+	0	0	2054	0.0000000
zheyou73v0_A03	14153291	14155926	BnaA03T0258200ZY	0	+	0	0	2635	0.0000000
zheyou73v0_A03	14158879	14160514	BnaA03T0258300ZY	0	+	0	0	1635	0.0000000
zheyou73v0_A03	14161618	14164821	BnaA03T0258400ZY	0	+	0	0	3203	0.0000000
zheyou73v0_A03	14171902	14173185	BnaA03T0258500ZY	0	+	0	0	1283	0.0000000
zheyou73v0_A03	14173420	14175772	BnaA03T0258600ZY	0	-	0	0	2352	0.0000000
zheyou73v0_A03	14173420	14175772	BnaA03T0258600ZY.1	0	-	0	0	2352	0.0000000
zheyou73v0_A03	14179551	14180029	BnaA03T0258700ZY	0	+	0	0	478	0.0000000
zheyou73v0_A03	14182895	14185203	BnaA03T0258800ZY	0	+	0	0	2308	0.0000000
zheyou73v0_A03	14187080	14189334	BnaA03T0258900ZY	0	-	0	0	2254	0.0000000
zheyou73v0_A03	14190273	14193162	BnaA03T0259000ZY	0	-	0	0	2889	0.0000000
zheyou73v0_A03	14194933	14198577	BnaA03T0259100ZY	0	+	0	0	3644	0.0000000
zheyou73v0_A03	14199182	14200725	BnaA03T0259200ZY	0	-	0	0	1543	0.0000000
zheyou73v0_A03	14222010	14224472	BnaA03T0259300ZY	0	+	0	0	2462	0.0000000
zheyou73v0_A03	14225953	14228759	BnaA03T0259400ZY	0	+	0	0	2806	0.0000000
zheyou73v0_A03	14233605	14237329	BnaA03T0259500ZY	0	+	0	0	3724	0.0000000
zheyou73v0_A03	14239332	14240565	BnaA03T0259600ZY	0	+	0	0	1233	0.0000000
zheyou73v0_A03	14243177	14244549	BnaA03T0259700ZY	0	+	0	0	1372	0.0000000
zheyou73v0_A03	14249451	14251847	BnaA03T0259800ZY	0	+	0	0	2396	0.0000000
zheyou73v0_A03	14252267	14253558	BnaA03T0259900ZY	0	+	0	0	1291	0.0000000
zheyou73v0_A03	14262220	14264368	BnaA03T0260000ZY	0	+	0	0	2148	0.0000000
zheyou73v0_A03	14267333	14273434	BnaA03T0260100ZY	0	-	0	0	6101	0.0000000
zheyou73v0_A03	14275834	14276458	BnaA03T0260200ZY	0	+	0	0	624	0.0000000
zheyou73v0_A03	14278487	14287618	BnaA03T0260300ZY	0	+	0	0	9131	0.0000000
zheyou73v0_A03	14288114	14288522	BnaA03T0260400ZY	0	+	0	0	408	0.0000000
zheyou73v0_A03	14290289	14292740	BnaA03T0260500ZY	0	-	0	0	2451	0.0000000
zheyou73v0_A03	14294501	14295648	BnaA03T0260600ZY	0	+	0	0	1147	0.0000000
zheyou73v0_A03	14296867	14297869	BnaA03T0260700ZY	0	-	0	0	1002	0.0000000
zheyou73v0_A03	14299031	14309474	BnaA03T0260800ZY	0	-	0	0	10443	0.0000000
zheyou73v0_A03	14316918	14319346	BnaA03T0260900ZY	0	+	0	0	2428	0.0000000
zheyou73v0_A03	14320489	14321931	BnaA03T0261000ZY	0	+	0	0	1442	0.0000000
zheyou73v0_A03	14322640	14323396	BnaA03T0261100ZY	0	-	0	0	756	0.0000000
zheyou73v0_A03	14323579	14325240	BnaA03T0261200ZY	0	-	0	0	1661	0.0000000
zheyou73v0_A03	14325644	14329123	BnaA03T0261300ZY	0	-	0	0	3479	0.0000000
zheyou73v0_A03	14329245	14331205	BnaA03T0261400ZY	0	+	0	0	1960	0.0000000
zheyou73v0_A03	14329245	14331205	BnaA03T0261400ZY.1	0	+	0	0	1960	0.0000000
zheyou73v0_A03	14333942	14334382	BnaA03T0261500ZY	0	+	0	0	440	0.0000000
zheyou73v0_A03	14337458	14339778	BnaA03T0261600ZY	0	-	0	0	2320	0.0000000
zheyou73v0_A03	14342039	14347764	BnaA03T0261700ZY	0	-	0	0	5725	0.0000000
zheyou73v0_A03	14351255	14353546	BnaA03T0261800ZY	0	+	0	0	2291	0.0000000
zheyou73v0_A03	14356441	14359166	BnaA03T0261900ZY	0	-	0	0	2725	0.0000000
zheyou73v0_A03	14356441	14359166	BnaA03T0261900ZY.1	0	-	0	0	2725	0.0000000
zheyou73v0_A03	14362365	14363356	BnaA03T0262000ZY	0	+	0	0	991	0.0000000
zheyou73v0_A03	14371757	14374178	BnaA03T0262100ZY	0	-	0	0	2421	0.0000000
zheyou73v0_A03	14379692	14381671	BnaA03T0262200ZY	0	+	0	0	1979	0.0000000
zheyou73v0_A03	14383108	14386437	BnaA03T0262300ZY	0	-	0	0	3329	0.0000000
zheyou73v0_A03	14387151	14389758	BnaA03T0262400ZY	0	-	0	0	2607	0.0000000
zheyou73v0_A03	14396773	14399235	BnaA03T0262500ZY	0	+	0	0	2462	0.0000000
zheyou73v0_A03	14398960	14406434	BnaA03T0262600ZY	0	-	0	0	7474	0.0000000
zheyou73v0_A03	14406798	14407812	BnaA03T0262700ZY	0	-	0	0	1014	0.0000000
zheyou73v0_A03	14412339	14416888	BnaA03T0262800ZY	0	+	0	0	4549	0.0000000
zheyou73v0_A03	14418389	14418888	BnaA03T0262900ZY	0	-	0	0	499	0.0000000
zheyou73v0_A03	14420052	14421501	BnaA03T0263000ZY	0	-	0	0	1449	0.0000000
zheyou73v0_A03	14422885	14435493	BnaA03T0263100ZY	0	-	0	0	12608	0.0000000
zheyou73v0_A03	14441502	14442977	BnaA03T0263200ZY	0	+	0	0	1475	0.0000000
zheyou73v0_A03	14445198	14447973	BnaA03T0263300ZY	0	-	0	0	2775	0.0000000
zheyou73v0_A03	14456063	14458921	BnaA03T0263400ZY	0	+	0	0	2858	0.0000000
zheyou73v0_A03	14456063	14458921	BnaA03T0263400ZY.1	0	+	0	0	2858	0.0000000
zheyou73v0_A03	14459563	14463050	BnaA03T0263500ZY	0	-	0	0	3487	0.0000000
zheyou73v0_A03	14459563	14463050	BnaA03T0263500ZY.1	0	-	0	0	3487	0.0000000
zheyou73v0_A03	14459563	14463050	BnaA03T0263500ZY.2	0	-	0	0	3487	0.0000000
zheyou73v0_A03	14459563	14463050	BnaA03T0263500ZY.3	0	-	0	0	3487	0.0000000
zheyou73v0_A03	14463935	14468468	BnaA03T0263600ZY	0	-	0	0	4533	0.0000000
zheyou73v0_A03	14472016	14473340	BnaA03T0263700ZY	0	-	0	0	1324	0.0000000
zheyou73v0_A03	14474057	14478570	BnaA03T0263800ZY	0	-	0	0	4513	0.0000000
zheyou73v0_A03	14480274	14481416	BnaA03T0263900ZY	0	+	0	0	1142	0.0000000
zheyou73v0_A03	14482338	14484447	BnaA03T0264000ZY	0	+	0	0	2109	0.0000000
zheyou73v0_A03	14482338	14484447	BnaA03T0264000ZY.1	0	+	0	0	2109	0.0000000
zheyou73v0_A03	14485225	14488032	BnaA03T0264100ZY	0	+	0	0	2807	0.0000000
zheyou73v0_A03	14489079	14491585	BnaA03T0264200ZY	0	-	0	0	2506	0.0000000
zheyou73v0_A03	14495626	14497206	BnaA03T0264300ZY	0	-	0	0	1580	0.0000000
zheyou73v0_A03	14500354	14502767	BnaA03T0264400ZY	0	+	0	0	2413	0.0000000
zheyou73v0_A03	14504712	14505300	BnaA03T0264500ZY	0	+	0	0	588	0.0000000
zheyou73v0_A03	14510088	14511400	BnaA03T0264600ZY	0	+	0	0	1312	0.0000000
zheyou73v0_A03	14513563	14515551	BnaA03T0264700ZY	0	+	0	0	1988	0.0000000
zheyou73v0_A03	14517266	14518557	BnaA03T0264800ZY	0	-	0	0	1291	0.0000000
zheyou73v0_A03	14522880	14523325	BnaA03T0264900ZY	0	+	0	0	445	0.0000000
zheyou73v0_A03	14528136	14530868	BnaA03T0265000ZY	0	+	0	0	2732	0.0000000
zheyou73v0_A03	14528136	14530868	BnaA03T0265000ZY.1	0	+	0	0	2732	0.0000000
zheyou73v0_A03	14536272	14537391	BnaA03T0265100ZY	0	+	0	0	1119	0.0000000
zheyou73v0_A03	14545579	14547099	BnaA03T0265200ZY	0	+	0	0	1520	0.0000000
zheyou73v0_A03	14545579	14547099	BnaA03T0265200ZY.1	0	+	0	0	1520	0.0000000
zheyou73v0_A03	14549968	14551617	BnaA03T0265300ZY	0	+	0	0	1649	0.0000000
zheyou73v0_A03	14555760	14558015	BnaA03T0265400ZY	0	+	0	0	2255	0.0000000
zheyou73v0_A03	14559839	14561361	BnaA03T0265500ZY	0	+	0	0	1522	0.0000000
zheyou73v0_A03	14559839	14561361	BnaA03T0265500ZY.1	0	+	0	0	1522	0.0000000
zheyou73v0_A03	14559839	14561361	BnaA03T0265500ZY.2	0	+	0	0	1522	0.0000000
zheyou73v0_A03	14565227	14565458	BnaA03T0265600ZY	0	-	0	0	231	0.0000000
zheyou73v0_A03	14567400	14569049	BnaA03T0265700ZY	0	+	0	0	1649	0.0000000
zheyou73v0_A03	14573192	14575757	BnaA03T0265800ZY	0	+	0	0	2565	0.0000000
zheyou73v0_A03	14575824	14578042	BnaA03T0265900ZY	0	+	0	0	2218	0.0000000
zheyou73v0_A03	14578875	14583002	BnaA03T0266000ZY	0	+	0	0	4127	0.0000000
zheyou73v0_A03	14590869	14594009	BnaA03T0266100ZY	0	-	0	0	3140	0.0000000
zheyou73v0_A03	14595488	14599608	BnaA03T0266200ZY	0	-	0	0	4120	0.0000000
zheyou73v0_A03	14601546	14604271	BnaA03T0266300ZY	0	-	0	0	2725	0.0000000
zheyou73v0_A03	14608342	14610836	BnaA03T0266400ZY	0	+	0	0	2494	0.0000000
zheyou73v0_A03	14611184	14612389	BnaA03T0266500ZY	0	-	0	0	1205	0.0000000
zheyou73v0_A03	14614423	14616391	BnaA03T0266600ZY	0	+	0	0	1968	0.0000000
zheyou73v0_A03	14614423	14616391	BnaA03T0266600ZY.1	0	+	0	0	1968	0.0000000
zheyou73v0_A03	14614423	14616391	BnaA03T0266600ZY.2	0	+	0	0	1968	0.0000000
zheyou73v0_A03	14618280	14619899	BnaA03T0266700ZY	0	+	0	0	1619	0.0000000
zheyou73v0_A03	14621419	14622252	BnaA03T0266800ZY	0	+	0	0	833	0.0000000
zheyou73v0_A03	14633565	14634054	BnaA03T0266900ZY	0	+	0	0	489	0.0000000
zheyou73v0_A03	14639653	14641355	BnaA03T0267000ZY	0	+	0	0	1702	0.0000000
zheyou73v0_A03	14641960	14643719	BnaA03T0267100ZY	0	-	0	0	1759	0.0000000
zheyou73v0_A03	14644964	14648606	BnaA03T0267200ZY	0	-	0	0	3642	0.0000000
zheyou73v0_A03	14649932	14652802	BnaA03T0267300ZY	0	-	0	0	2870	0.0000000
zheyou73v0_A03	14658686	14660593	BnaA03T0267400ZY	0	-	0	0	1907	0.0000000
zheyou73v0_A03	14658686	14660593	BnaA03T0267400ZY.1	0	-	0	0	1907	0.0000000
zheyou73v0_A03	14676895	14678585	BnaA03T0267500ZY	0	+	0	0	1690	0.0000000
zheyou73v0_A03	14681742	14685755	BnaA03T0267600ZY	0	-	0	0	4013	0.0000000
zheyou73v0_A03	14690491	14699469	BnaA03T0267700ZY	0	-	0	0	8978	0.0000000
zheyou73v0_A03	14704843	14708803	BnaA03T0267800ZY	0	-	0	0	3960	0.0000000
zheyou73v0_A03	14704843	14708803	BnaA03T0267800ZY.1	0	-	0	0	3960	0.0000000
zheyou73v0_A03	14716793	14718275	BnaA03T0267900ZY	0	-	0	0	1482	0.0000000
zheyou73v0_A03	14722672	14727730	BnaA03T0268000ZY	0	-	0	0	5058	0.0000000
zheyou73v0_A03	14728829	14730108	BnaA03T0268100ZY	0	-	0	0	1279	0.0000000
zheyou73v0_A03	14731011	14732154	BnaA03T0268200ZY	0	+	0	0	1143	0.0000000
zheyou73v0_A03	14732369	14734550	BnaA03T0268300ZY	0	+	0	0	2181	0.0000000
zheyou73v0_A03	14736522	14742463	BnaA03T0268400ZY	0	+	0	0	5941	0.0000000
zheyou73v0_A03	14745359	14746695	BnaA03T0268500ZY	0	+	0	0	1336	0.0000000
zheyou73v0_A03	14750909	14752726	BnaA03T0268600ZY	0	-	0	0	1817	0.0000000
zheyou73v0_A03	14750909	14752726	BnaA03T0268600ZY.1	0	-	0	0	1817	0.0000000
zheyou73v0_A03	14754181	14756628	BnaA03T0268700ZY	0	-	0	0	2447	0.0000000
zheyou73v0_A03	14796356	14796578	BnaA03T0268800ZY	0	+	0	0	222	0.0000000
zheyou73v0_A03	14810160	14811775	BnaA03T0268900ZY	0	-	0	0	1615	0.0000000
zheyou73v0_A03	14810160	14811775	BnaA03T0268900ZY.1	0	-	0	0	1615	0.0000000
zheyou73v0_A03	14815321	14816506	BnaA03T0269000ZY	0	+	0	0	1185	0.0000000
zheyou73v0_A03	14818104	14818649	BnaA03T0269100ZY	0	+	0	0	545	0.0000000
zheyou73v0_A03	14818868	14820292	BnaA03T0269200ZY	0	-	0	0	1424	0.0000000
zheyou73v0_A03	14821856	14824028	BnaA03T0269300ZY	0	-	0	0	2172	0.0000000
zheyou73v0_A03	14825979	14829802	BnaA03T0269400ZY	0	-	0	0	3823	0.0000000
zheyou73v0_A03	14832294	14833500	BnaA03T0269500ZY	0	-	0	0	1206	0.0000000
zheyou73v0_A03	14835128	14836692	BnaA03T0269600ZY	0	-	0	0	1564	0.0000000
zheyou73v0_A03	14839506	14841517	BnaA03T0269700ZY	0	+	0	0	2011	0.0000000
zheyou73v0_A03	14839506	14841517	BnaA03T0269700ZY.1	0	+	0	0	2011	0.0000000
zheyou73v0_A03	14847532	14848789	BnaA03T0269800ZY	0	+	0	0	1257	0.0000000
zheyou73v0_A03	14850488	14852506	BnaA03T0269900ZY	0	+	0	0	2018	0.0000000
zheyou73v0_A03	14855002	14857066	BnaA03T0270000ZY.1	0	+	0	0	2064	0.0000000
zheyou73v0_A03	14855007	14857066	BnaA03T0270000ZY	0	+	0	0	2059	0.0000000
zheyou73v0_A03	14858301	14860073	BnaA03T0270100ZY	0	-	0	0	1772	0.0000000
zheyou73v0_A03	14865419	14866163	BnaA03T0270200ZY	0	-	0	0	744	0.0000000
zheyou73v0_A03	14872359	14876780	BnaA03T0270300ZY	0	+	0	0	4421	0.0000000
zheyou73v0_A03	14872359	14876780	BnaA03T0270300ZY.1	0	+	0	0	4421	0.0000000
zheyou73v0_A03	14872359	14876780	BnaA03T0270300ZY.2	0	+	0	0	4421	0.0000000
zheyou73v0_A03	14882987	14883662	BnaA03T0270400ZY	0	+	0	0	675	0.0000000
zheyou73v0_A03	14886907	14887609	BnaA03T0270500ZY	0	+	0	0	702	0.0000000
zheyou73v0_A03	14887818	14889410	BnaA03T0270600ZY	0	-	0	0	1592	0.0000000
zheyou73v0_A03	14893440	14894460	BnaA03T0270700ZY	0	+	0	0	1020	0.0000000
zheyou73v0_A03	14894498	14898347	BnaA03T0270800ZY	0	-	0	0	3849	0.0000000
zheyou73v0_A03	14902004	14904837	BnaA03T0270900ZY	0	+	0	0	2833	0.0000000
zheyou73v0_A03	14905225	14905892	BnaA03T0271000ZY	0	-	0	0	667	0.0000000
zheyou73v0_A03	14906370	14907559	BnaA03T0271100ZY	0	+	0	0	1189	0.0000000
zheyou73v0_A03	14909869	14910953	BnaA03T0271200ZY	0	+	0	0	1084	0.0000000
zheyou73v0_A03	14913602	14915077	BnaA03T0271300ZY	0	+	0	0	1475	0.0000000
zheyou73v0_A03	14921601	14922768	BnaA03T0271400ZY	0	+	0	0	1167	0.0000000
zheyou73v0_A03	14923145	14925641	BnaA03T0271500ZY	0	-	0	0	2496	0.0000000
zheyou73v0_A03	14928661	14929588	BnaA03T0271600ZY	0	+	0	0	927	0.0000000
zheyou73v0_A03	14933265	14934208	BnaA03T0271700ZY	0	+	0	0	943	0.0000000
zheyou73v0_A03	14937342	14940510	BnaA03T0271800ZY	0	-	0	0	3168	0.0000000
zheyou73v0_A03	14937342	14940510	BnaA03T0271800ZY.1	0	-	0	0	3168	0.0000000
zheyou73v0_A03	14943089	14943513	BnaA03T0271900ZY	0	-	0	0	424	0.0000000
zheyou73v0_A03	14951938	14953690	BnaA03T0272000ZY	0	-	0	0	1752	0.0000000
zheyou73v0_A03	14957852	14960389	BnaA03T0272100ZY	0	+	0	0	2537	0.0000000
zheyou73v0_A03	14964613	14965190	BnaA03T0272200ZY	0	-	0	0	577	0.0000000
zheyou73v0_A03	14967477	14968959	BnaA03T0272300ZY	0	-	0	0	1482	0.0000000
zheyou73v0_A03	14967477	14968994	BnaA03T0272300ZY.1	0	-	0	0	1517	0.0000000
zheyou73v0_A03	14967477	14968994	BnaA03T0272300ZY.2	0	-	0	0	1517	0.0000000
zheyou73v0_A03	14974672	14977215	BnaA03T0272400ZY	0	+	0	0	2543	0.0000000
zheyou73v0_A03	14982087	14983864	BnaA03T0272500ZY	0	+	0	0	1777	0.0000000
zheyou73v0_A03	14984913	14985765	BnaA03T0272600ZY	0	-	0	0	852	0.0000000
zheyou73v0_A03	14987046	14988775	BnaA03T0272700ZY	0	-	0	0	1729	0.0000000
zheyou73v0_A03	14990589	14991852	BnaA03T0272800ZY	0	-	0	0	1263	0.0000000
zheyou73v0_A03	14998742	15000716	BnaA03T0272900ZY	0	+	0	0	1974	0.0000000
zheyou73v0_A03	14998742	15000716	BnaA03T0272900ZY.1	0	+	0	0	1974	0.0000000
zheyou73v0_A03	15001321	15004297	BnaA03T0273000ZY	0	+	0	0	2976	0.0000000
zheyou73v0_A03	15005847	15008813	BnaA03T0273100ZY	0	-	0	0	2966	0.0000000
zheyou73v0_A03	15011266	15011908	BnaA03T0273200ZY	0	+	0	0	642	0.0000000
zheyou73v0_A03	15016123	15017652	BnaA03T0273300ZY	0	+	0	0	1529	0.0000000
zheyou73v0_A03	15017633	15019508	BnaA03T0273400ZY	0	-	0	0	1875	0.0000000
zheyou73v0_A03	15017633	15019312	BnaA03T0273400ZY.1	0	-	0	0	1679	0.0000000
zheyou73v0_A03	15021233	15022779	BnaA03T0273500ZY	0	+	0	0	1546	0.0000000
zheyou73v0_A03	15025751	15026168	BnaA03T0273600ZY	0	-	0	0	417	0.0000000
zheyou73v0_A03	15028505	15028922	BnaA03T0273700ZY	0	-	0	0	417	0.0000000
zheyou73v0_A03	15036611	15055664	BnaA03T0273800ZY	0	-	0	0	19053	0.0000000
zheyou73v0_A03	15036611	15055694	BnaA03T0273800ZY.1	0	-	0	0	19083	0.0000000
zheyou73v0_A03	15061142	15063358	BnaA03T0273900ZY	0	+	0	0	2216	0.0000000
zheyou73v0_A03	15063439	15065859	BnaA03T0274000ZY	0	-	0	0	2420	0.0000000
zheyou73v0_A03	15063439	15065859	BnaA03T0274000ZY.1	0	-	0	0	2420	0.0000000
zheyou73v0_A03	15068696	15069926	BnaA03T0274100ZY	0	+	0	0	1230	0.0000000
zheyou73v0_A03	15071261	15074034	BnaA03T0274200ZY	0	-	0	0	2773	0.0000000
zheyou73v0_A03	15071261	15074034	BnaA03T0274200ZY.1	0	-	0	0	2773	0.0000000
zheyou73v0_A03	15071261	15074034	BnaA03T0274200ZY.2	0	-	0	0	2773	0.0000000
zheyou73v0_A03	15074379	15075581	BnaA03T0274300ZY	0	+	0	0	1202	0.0000000
zheyou73v0_A03	15076791	15079465	BnaA03T0274400ZY	0	+	0	0	2674	0.0000000
zheyou73v0_A03	15080301	15081043	BnaA03T0274500ZY	0	+	0	0	742	0.0000000
zheyou73v0_A03	15081440	15082979	BnaA03T0274600ZY	0	-	0	0	1539	0.0000000
zheyou73v0_A03	15083692	15084236	BnaA03T0274700ZY	0	-	0	0	544	0.0000000
zheyou73v0_A03	15087382	15089856	BnaA03T0274800ZY	0	-	0	0	2474	0.0000000
zheyou73v0_A03	15087382	15089856	BnaA03T0274800ZY.1	0	-	0	0	2474	0.0000000
zheyou73v0_A03	15095961	15096777	BnaA03T0274900ZY	0	+	0	0	816	0.0000000
zheyou73v0_A03	15097383	15098346	BnaA03T0275000ZY	0	+	0	0	963	0.0000000
zheyou73v0_A03	15102044	15106508	BnaA03T0275100ZY	0	+	0	0	4464	0.0000000
zheyou73v0_A03	15109016	15110505	BnaA03T0275200ZY	0	+	0	0	1489	0.0000000
zheyou73v0_A03	15117712	15125248	BnaA03T0275300ZY	0	-	0	0	7536	0.0000000
zheyou73v0_A03	15155188	15156629	BnaA03T0275400ZY	0	+	0	0	1441	0.0000000
zheyou73v0_A03	15176836	15182098	BnaA03T0275500ZY	0	+	0	0	5262	0.0000000
zheyou73v0_A03	15183122	15187663	BnaA03T0275600ZY	0	-	0	0	4541	0.0000000
zheyou73v0_A03	15192525	15194923	BnaA03T0275700ZY	0	+	0	0	2398	0.0000000
zheyou73v0_A03	15195254	15195878	BnaA03T0275800ZY	0	+	0	0	624	0.0000000
zheyou73v0_A03	15196276	15197380	BnaA03T0275900ZY	0	-	0	0	1104	0.0000000
zheyou73v0_A03	15203039	15205205	BnaA03T0276000ZY	0	+	0	0	2166	0.0000000
zheyou73v0_A03	15208483	15211771	BnaA03T0276100ZY	0	+	0	0	3288	0.0000000
zheyou73v0_A03	15212039	15216548	BnaA03T0276200ZY	0	-	0	0	4509	0.0000000
zheyou73v0_A03	15218109	15218788	BnaA03T0276300ZY	0	+	0	0	679	0.0000000
zheyou73v0_A03	15226401	15227461	BnaA03T0276400ZY	0	-	0	0	1060	0.0000000
zheyou73v0_A03	15237632	15239063	BnaA03T0276500ZY	0	+	0	0	1431	0.0000000
zheyou73v0_A03	15240793	15242841	BnaA03T0276600ZY	0	-	0	0	2048	0.0000000
zheyou73v0_A03	15247625	15252735	BnaA03T0276700ZY	0	-	0	0	5110	0.0000000
zheyou73v0_A03	15255222	15256569	BnaA03T0276800ZY	0	+	0	0	1347	0.0000000
zheyou73v0_A03	15255222	15256569	BnaA03T0276800ZY.1	0	+	0	0	1347	0.0000000
zheyou73v0_A03	15256592	15260602	BnaA03T0276900ZY	0	+	0	0	4010	0.0000000
zheyou73v0_A03	15266317	15268953	BnaA03T0277000ZY	0	-	0	0	2636	0.0000000
zheyou73v0_A03	15281121	15284311	BnaA03T0277100ZY	0	+	0	0	3190	0.0000000
zheyou73v0_A03	15285303	15288193	BnaA03T0277200ZY	0	-	0	0	2890	0.0000000
zheyou73v0_A03	15294081	15295754	BnaA03T0277300ZY	0	+	0	0	1673	0.0000000
zheyou73v0_A03	15294081	15296045	BnaA03T0277300ZY.1	0	+	0	0	1964	0.0000000
zheyou73v0_A03	15294081	15296045	BnaA03T0277300ZY.2	0	+	0	0	1964	0.0000000
zheyou73v0_A03	15294081	15296045	BnaA03T0277300ZY.3	0	+	0	0	1964	0.0000000
zheyou73v0_A03	15297073	15303413	BnaA03T0277400ZY	0	+	0	0	6340	0.0000000
zheyou73v0_A03	15304062	15305509	BnaA03T0277500ZY	0	+	0	0	1447	0.0000000
zheyou73v0_A03	15308989	15312524	BnaA03T0277600ZY	0	-	0	0	3535	0.0000000
zheyou73v0_A03	15308989	15311473	BnaA03T0277600ZY.1	0	-	0	0	2484	0.0000000
zheyou73v0_A03	15316484	15316811	BnaA03T0277700ZY	0	-	0	0	327	0.0000000
zheyou73v0_A03	15317733	15320739	BnaA03T0277800ZY	0	-	0	0	3006	0.0000000
zheyou73v0_A03	15322673	15325876	BnaA03T0277900ZY	0	-	0	0	3203	0.0000000
zheyou73v0_A03	15330781	15331346	BnaA03T0278000ZY	0	+	0	0	565	0.0000000
zheyou73v0_A03	15332862	15335093	BnaA03T0278100ZY	0	+	0	0	2231	0.0000000
zheyou73v0_A03	15342661	15350644	BnaA03T0278200ZY	0	+	0	0	7983	0.0000000
zheyou73v0_A03	15354470	15357651	BnaA03T0278300ZY	0	-	0	0	3181	0.0000000
zheyou73v0_A03	15354470	15357753	BnaA03T0278300ZY.1	0	-	0	0	3283	0.0000000
zheyou73v0_A03	15358525	15360132	BnaA03T0278400ZY	0	+	0	0	1607	0.0000000
zheyou73v0_A03	15360557	15362668	BnaA03T0278500ZY	0	-	0	0	2111	0.0000000
zheyou73v0_A03	15369713	15370414	BnaA03T0278600ZY	0	+	0	0	701	0.0000000
zheyou73v0_A03	15376054	15380459	BnaA03T0278700ZY	0	-	0	0	4405	0.0000000
zheyou73v0_A03	15385249	15386177	BnaA03T0278800ZY	0	+	0	0	928	0.0000000
zheyou73v0_A03	15389768	15399359	BnaA03T0278900ZY	0	+	0	0	9591	0.0000000
zheyou73v0_A03	15400570	15403668	BnaA03T0279000ZY	0	-	0	0	3098	0.0000000
zheyou73v0_A03	15420043	15421036	BnaA03T0279100ZY	0	+	0	0	993	0.0000000
zheyou73v0_A03	15424791	15425834	BnaA03T0279200ZY	0	+	0	0	1043	0.0000000
zheyou73v0_A03	15427235	15428834	BnaA03T0279300ZY	0	-	0	0	1599	0.0000000
zheyou73v0_A03	15430353	15434285	BnaA03T0279400ZY	0	-	0	0	3932	0.0000000
zheyou73v0_A03	15449127	15452264	BnaA03T0279500ZY	0	-	0	0	3137	0.0000000
zheyou73v0_A03	15455787	15457066	BnaA03T0279600ZY	0	+	0	0	1279	0.0000000
zheyou73v0_A03	15459808	15461106	BnaA03T0279700ZY	0	+	0	0	1298	0.0000000
zheyou73v0_A03	15470289	15472888	BnaA03T0279800ZY	0	-	0	0	2599	0.0000000
zheyou73v0_A03	15475059	15477267	BnaA03T0279900ZY	0	-	0	0	2208	0.0000000
zheyou73v0_A03	15479953	15482758	BnaA03T0280000ZY	0	+	0	0	2805	0.0000000
zheyou73v0_A03	15482880	15483117	BnaA03T0280100ZY	0	+	0	0	237	0.0000000
zheyou73v0_A03	15483985	15486291	BnaA03T0280200ZY	0	+	0	0	2306	0.0000000
zheyou73v0_A03	15483985	15486291	BnaA03T0280200ZY.1	0	+	0	0	2306	0.0000000
zheyou73v0_A03	15483985	15486291	BnaA03T0280200ZY.2	0	+	0	0	2306	0.0000000
zheyou73v0_A03	15483985	15486291	BnaA03T0280200ZY.3	0	+	0	0	2306	0.0000000
zheyou73v0_A03	15483985	15487203	BnaA03T0280200ZY.4	0	+	0	0	3218	0.0000000
zheyou73v0_A03	15488017	15492399	BnaA03T0280300ZY	0	-	0	0	4382	0.0000000
zheyou73v0_A03	15493233	15494390	BnaA03T0280400ZY	0	+	0	0	1157	0.0000000
zheyou73v0_A03	15499063	15499732	BnaA03T0280500ZY	0	-	0	0	669	0.0000000
zheyou73v0_A03	15501572	15501779	BnaA03T0280600ZY	0	-	0	0	207	0.0000000
zheyou73v0_A03	15503446	15505546	BnaA03T0280700ZY	0	+	0	0	2100	0.0000000
zheyou73v0_A03	15508343	15509478	BnaA03T0280800ZY	0	+	0	0	1135	0.0000000
zheyou73v0_A03	15510447	15512516	BnaA03T0280900ZY	0	-	0	0	2069	0.0000000
zheyou73v0_A03	15513534	15515584	BnaA03T0281000ZY	0	-	0	0	2050	0.0000000
zheyou73v0_A03	15528309	15529077	BnaA03T0281100ZY	0	-	0	0	768	0.0000000
zheyou73v0_A03	15537600	15540613	BnaA03T0281200ZY	0	-	0	0	3013	0.0000000
zheyou73v0_A03	15545823	15546905	BnaA03T0281300ZY	0	-	0	0	1082	0.0000000
zheyou73v0_A03	15552448	15557276	BnaA03T0281400ZY	0	+	0	0	4828	0.0000000
zheyou73v0_A03	15610940	15613837	BnaA03T0281500ZY	0	+	0	0	2897	0.0000000
zheyou73v0_A03	15622543	15623905	BnaA03T0281600ZY	0	+	0	0	1362	0.0000000
zheyou73v0_A03	15626291	15626758	BnaA03T0281700ZY	0	+	0	0	467	0.0000000
zheyou73v0_A03	15631731	15632367	BnaA03T0281800ZY	0	+	0	0	636	0.0000000
zheyou73v0_A03	15634505	15635594	BnaA03T0281900ZY	0	+	0	0	1089	0.0000000
zheyou73v0_A03	15636589	15639595	BnaA03T0282000ZY	0	+	0	0	3006	0.0000000
zheyou73v0_A03	15644682	15646770	BnaA03T0282100ZY	0	+	0	0	2088	0.0000000
zheyou73v0_A03	15644682	15646501	BnaA03T0282100ZY.1	0	+	0	0	1819	0.0000000
zheyou73v0_A03	15649857	15650466	BnaA03T0282200ZY	0	+	0	0	609	0.0000000
zheyou73v0_A03	15659898	15661520	BnaA03T0282300ZY	0	+	0	0	1622	0.0000000
zheyou73v0_A03	15661529	15662233	BnaA03T0282400ZY	0	-	0	0	704	0.0000000
zheyou73v0_A03	15667295	15669330	BnaA03T0282500ZY	0	+	0	0	2035	0.0000000
zheyou73v0_A03	15669862	15673116	BnaA03T0282600ZY	0	+	0	0	3254	0.0000000
zheyou73v0_A03	15676915	15682704	BnaA03T0282700ZY	0	+	0	0	5789	0.0000000
zheyou73v0_A03	15683103	15685325	BnaA03T0282800ZY	0	-	0	0	2222	0.0000000
zheyou73v0_A03	15688051	15693041	BnaA03T0282900ZY	0	+	0	0	4990	0.0000000
zheyou73v0_A03	15692843	15693542	BnaA03T0283000ZY	0	-	0	0	699	0.0000000
zheyou73v0_A03	15697029	15699796	BnaA03T0283100ZY	0	+	0	0	2767	0.0000000
zheyou73v0_A03	15709484	15711962	BnaA03T0283200ZY	0	+	0	0	2478	0.0000000
zheyou73v0_A03	15713240	15714446	BnaA03T0283300ZY	0	+	0	0	1206	0.0000000
zheyou73v0_A03	15716361	15721907	BnaA03T0283400ZY	0	+	0	0	5546	0.0000000
zheyou73v0_A03	15723409	15731672	BnaA03T0283500ZY	0	+	0	0	8263	0.0000000
zheyou73v0_A03	15734660	15735866	BnaA03T0283600ZY	0	+	0	0	1206	0.0000000
zheyou73v0_A03	15749861	15752649	BnaA03T0283700ZY	0	+	0	0	2788	0.0000000
zheyou73v0_A03	15771857	15775000	BnaA03T0283800ZY	0	+	0	0	3143	0.0000000
zheyou73v0_A03	15771857	15775000	BnaA03T0283800ZY.1	0	+	0	0	3143	0.0000000
zheyou73v0_A03	15771857	15774558	BnaA03T0283800ZY.2	0	+	0	0	2701	0.0000000
zheyou73v0_A03	15779679	15782463	BnaA03T0283900ZY	0	+	0	0	2784	0.0000000
zheyou73v0_A03	15783503	15783944	BnaA03T0284000ZY	0	-	0	0	441	0.0000000
zheyou73v0_A03	15785882	15787007	BnaA03T0284100ZY	0	-	0	0	1125	0.0000000
zheyou73v0_A03	15789291	15793915	BnaA03T0284200ZY	0	+	0	0	4624	0.0000000
zheyou73v0_A03	15797234	15797677	BnaA03T0284300ZY	0	-	0	0	443	0.0000000
zheyou73v0_A03	15808390	15812090	BnaA03T0284400ZY	0	+	0	0	3700	0.0000000
zheyou73v0_A03	15815254	15817304	BnaA03T0284500ZY	0	-	0	0	2050	0.0000000
zheyou73v0_A03	15824911	15825601	BnaA03T0284600ZY	0	+	0	0	690	0.0000000
zheyou73v0_A03	15841384	15847012	BnaA03T0284700ZY	0	-	0	0	5628	0.0000000
zheyou73v0_A03	15847479	15852623	BnaA03T0284800ZY	0	-	0	0	5144	0.0000000
zheyou73v0_A03	15852889	15855049	BnaA03T0284900ZY	0	-	0	0	2160	0.0000000
zheyou73v0_A03	15852889	15855049	BnaA03T0284900ZY.1	0	-	0	0	2160	0.0000000
zheyou73v0_A03	15857878	15858960	BnaA03T0285000ZY	0	+	0	0	1082	0.0000000
zheyou73v0_A03	15860266	15860918	BnaA03T0285100ZY	0	-	0	0	652	0.0000000
zheyou73v0_A03	15863253	15863836	BnaA03T0285200ZY	0	-	0	0	583	0.0000000
zheyou73v0_A03	15875601	15877466	BnaA03T0285300ZY	0	-	0	0	1865	0.0000000
zheyou73v0_A03	15878786	15880908	BnaA03T0285400ZY	0	-	0	0	2122	0.0000000
zheyou73v0_A03	15888102	15890361	BnaA03T0285500ZY	0	-	0	0	2259	0.0000000
zheyou73v0_A03	15893691	15894645	BnaA03T0285600ZY	0	-	0	0	954	0.0000000
zheyou73v0_A03	15895087	15900024	BnaA03T0285700ZY	0	-	0	0	4937	0.0000000
zheyou73v0_A03	15902619	15903411	BnaA03T0285800ZY	0	+	0	0	792	0.0000000
zheyou73v0_A03	15908718	15910821	BnaA03T0285900ZY	0	+	0	0	2103	0.0000000
zheyou73v0_A03	15917092	15918814	BnaA03T0286000ZY	0	+	0	0	1722	0.0000000
zheyou73v0_A03	15927778	15929022	BnaA03T0286100ZY	0	-	0	0	1244	0.0000000
zheyou73v0_A03	15933476	15935228	BnaA03T0286200ZY	0	-	0	0	1752	0.0000000
zheyou73v0_A03	15933476	15935281	BnaA03T0286200ZY.1	0	-	0	0	1805	0.0000000
zheyou73v0_A03	15937456	15941602	BnaA03T0286300ZY	0	+	0	0	4146	0.0000000
zheyou73v0_A03	15945632	15946148	BnaA03T0286400ZY	0	+	0	0	516	0.0000000
zheyou73v0_A03	15946604	15948985	BnaA03T0286500ZY	0	+	0	0	2381	0.0000000
zheyou73v0_A03	15953734	15954199	BnaA03T0286600ZY	0	-	0	0	465	0.0000000
zheyou73v0_A03	15955414	15956871	BnaA03T0286700ZY	0	-	0	0	1457	0.0000000
zheyou73v0_A03	15957920	15961934	BnaA03T0286800ZY	0	-	0	0	4014	0.0000000
zheyou73v0_A03	15962674	15963931	BnaA03T0286900ZY	0	+	0	0	1257	0.0000000
zheyou73v0_A03	15967033	15967901	BnaA03T0287000ZY	0	-	0	0	868	0.0000000
zheyou73v0_A03	15968770	15969315	BnaA03T0287100ZY	0	-	0	0	545	0.0000000
zheyou73v0_A03	15969459	15970616	BnaA03T0287200ZY	0	-	0	0	1157	0.0000000
zheyou73v0_A03	15974302	15974696	BnaA03T0287300ZY	0	-	0	0	394	0.0000000
zheyou73v0_A03	15975003	15975183	BnaA03T0287400ZY	0	-	0	0	180	0.0000000
zheyou73v0_A03	15975978	15978583	BnaA03T0287500ZY	0	+	0	0	2605	0.0000000
zheyou73v0_A03	15980211	15982337	BnaA03T0287600ZY	0	-	0	0	2126	0.0000000
zheyou73v0_A03	15984055	15985117	BnaA03T0287700ZY	0	-	0	0	1062	0.0000000
zheyou73v0_A03	15987196	15989644	BnaA03T0287800ZY	0	-	0	0	2448	0.0000000
zheyou73v0_A03	16002258	16007336	BnaA03T0287900ZY	0	+	0	0	5078	0.0000000
zheyou73v0_A03	16020383	16024296	BnaA03T0288000ZY	0	-	0	0	3913	0.0000000
zheyou73v0_A03	16020383	16023069	BnaA03T0288000ZY.1	0	-	0	0	2686	0.0000000
zheyou73v0_A03	16028642	16031578	BnaA03T0288100ZY	0	+	0	0	2936	0.0000000
zheyou73v0_A03	16028642	16031578	BnaA03T0288100ZY.1	0	+	0	0	2936	0.0000000
zheyou73v0_A03	16033825	16035320	BnaA03T0288200ZY	0	+	0	0	1495	0.0000000
zheyou73v0_A03	16039382	16040630	BnaA03T0288300ZY	0	-	0	0	1248	0.0000000
zheyou73v0_A03	16043724	16044699	BnaA03T0288400ZY	0	-	0	0	975	0.0000000
zheyou73v0_A03	16045099	16049044	BnaA03T0288500ZY	0	+	0	0	3945	0.0000000
zheyou73v0_A03	16049272	16051902	BnaA03T0288600ZY	0	-	0	0	2630	0.0000000
zheyou73v0_A03	16052569	16056687	BnaA03T0288700ZY	0	-	0	0	4118	0.0000000
zheyou73v0_A03	16057903	16059234	BnaA03T0288800ZY	0	-	0	0	1331	0.0000000
zheyou73v0_A03	16059730	16062409	BnaA03T0288900ZY	0	-	0	0	2679	0.0000000
zheyou73v0_A03	16059730	16062409	BnaA03T0288900ZY.1	0	-	0	0	2679	0.0000000
zheyou73v0_A03	16059730	16062586	BnaA03T0288900ZY.2	0	-	0	0	2856	0.0000000
zheyou73v0_A03	16059730	16062586	BnaA03T0288900ZY.3	0	-	0	0	2856	0.0000000
zheyou73v0_A03	16069496	16070877	BnaA03T0289000ZY	0	+	0	0	1381	0.0000000
zheyou73v0_A03	16077742	16078774	BnaA03T0289100ZY	0	+	0	0	1032	0.0000000
zheyou73v0_A03	16078670	16079790	BnaA03T0289200ZY	0	-	0	0	1120	0.0000000
zheyou73v0_A03	16080926	16082310	BnaA03T0289300ZY	0	-	0	0	1384	0.0000000
zheyou73v0_A03	16085613	16087116	BnaA03T0289400ZY	0	-	0	0	1503	0.0000000
zheyou73v0_A03	16085613	16087116	BnaA03T0289400ZY.1	0	-	0	0	1503	0.0000000
zheyou73v0_A03	16088685	16091138	BnaA03T0289500ZY	0	-	0	0	2453	0.0000000
zheyou73v0_A03	16119618	16138926	BnaA03T0289600ZY	0	+	0	0	19308	0.0000000
zheyou73v0_A03	16146599	16149506	BnaA03T0289700ZY	0	+	0	0	2907	0.0000000
zheyou73v0_A03	16149571	16149769	BnaA03T0289800ZY	0	+	0	0	198	0.0000000
zheyou73v0_A03	16151761	16154496	BnaA03T0289900ZY	0	+	0	0	2735	0.0000000
zheyou73v0_A03	16155720	16156585	BnaA03T0290000ZY	0	+	0	0	865	0.0000000
zheyou73v0_A03	16159043	16159492	BnaA03T0290100ZY	0	+	0	0	449	0.0000000
zheyou73v0_A03	16164087	16167672	BnaA03T0290200ZY	0	+	0	0	3585	0.0000000
zheyou73v0_A03	16168755	16182386	BnaA03T0290300ZY	0	+	0	0	13631	0.0000000
zheyou73v0_A03	16186442	16187585	BnaA03T0290400ZY	0	-	0	0	1143	0.0000000
zheyou73v0_A03	16191817	16193472	BnaA03T0290500ZY	0	+	0	0	1655	0.0000000
zheyou73v0_A03	16193769	16195696	BnaA03T0290600ZY	0	+	0	0	1927	0.0000000
zheyou73v0_A03	16197673	16204714	BnaA03T0290700ZY	0	-	0	0	7041	0.0000000
zheyou73v0_A03	16200422	16205088	BnaA03T0290700ZY.1	0	-	0	0	4666	0.0000000
zheyou73v0_A03	16200422	16205073	BnaA03T0290700ZY.2	0	-	0	0	4651	0.0000000
zheyou73v0_A03	16217056	16219037	BnaA03T0290800ZY	0	-	0	0	1981	0.0000000
zheyou73v0_A03	16227379	16232315	BnaA03T0290900ZY	0	+	0	0	4936	0.0000000
zheyou73v0_A03	16234165	16236417	BnaA03T0291000ZY	0	+	0	0	2252	0.0000000
zheyou73v0_A03	16238665	16240856	BnaA03T0291100ZY	0	+	0	0	2191	0.0000000
zheyou73v0_A03	16242213	16244241	BnaA03T0291200ZY	0	+	0	0	2028	0.0000000
zheyou73v0_A03	16246108	16248437	BnaA03T0291300ZY	0	+	0	0	2329	0.0000000
zheyou73v0_A03	16246108	16248437	BnaA03T0291300ZY.1	0	+	0	0	2329	0.0000000
zheyou73v0_A03	16248585	16252914	BnaA03T0291400ZY	0	-	0	0	4329	0.0000000
zheyou73v0_A03	16258110	16258831	BnaA03T0291500ZY	0	+	0	0	721	0.0000000
zheyou73v0_A03	16268810	16269814	BnaA03T0291600ZY	0	-	0	0	1004	0.0000000
zheyou73v0_A03	16272644	16273955	BnaA03T0291700ZY	0	+	0	0	1311	0.0000000
zheyou73v0_A03	16274684	16275418	BnaA03T0291800ZY	0	-	0	0	734	0.0000000
zheyou73v0_A03	16279793	16281060	BnaA03T0291900ZY	0	+	0	0	1267	0.0000000
zheyou73v0_A03	16279793	16281060	BnaA03T0291900ZY.1	0	+	0	0	1267	0.0000000
zheyou73v0_A03	16281888	16282425	BnaA03T0292000ZY	0	-	0	0	537	0.0000000
zheyou73v0_A03	16290480	16293293	BnaA03T0292100ZY	0	+	0	0	2813	0.0000000
zheyou73v0_A03	16294498	16295896	BnaA03T0292200ZY	0	+	0	0	1398	0.0000000
zheyou73v0_A03	16302841	16307639	BnaA03T0292300ZY	0	-	0	0	4798	0.0000000
zheyou73v0_A03	16312295	16314222	BnaA03T0292400ZY	0	+	0	0	1927	0.0000000
zheyou73v0_A03	16319325	16321466	BnaA03T0292500ZY	0	-	0	0	2141	0.0000000
zheyou73v0_A03	16319325	16321466	BnaA03T0292500ZY.1	0	-	0	0	2141	0.0000000
zheyou73v0_A03	16328594	16337527	BnaA03T0292600ZY	0	-	0	0	8933	0.0000000
zheyou73v0_A03	16338964	16340585	BnaA03T0292700ZY	0	-	0	0	1621	0.0000000
zheyou73v0_A03	16341357	16348458	BnaA03T0292800ZY	0	-	0	0	7101	0.0000000
zheyou73v0_A03	16348796	16352960	BnaA03T0292900ZY	0	-	0	0	4164	0.0000000
zheyou73v0_A03	16354722	16356842	BnaA03T0293000ZY	0	+	0	0	2120	0.0000000
zheyou73v0_A03	16357144	16357561	BnaA03T0293100ZY	0	-	0	0	417	0.0000000
zheyou73v0_A03	16358027	16361883	BnaA03T0293200ZY	0	-	0	0	3856	0.0000000
zheyou73v0_A03	16358027	16361888	BnaA03T0293200ZY.1	0	-	0	0	3861	0.0000000
zheyou73v0_A03	16363020	16364693	BnaA03T0293300ZY	0	-	0	0	1673	0.0000000
zheyou73v0_A03	16365556	16368049	BnaA03T0293400ZY	0	+	0	0	2493	0.0000000
zheyou73v0_A03	16376939	16378982	BnaA03T0293500ZY	0	+	0	0	2043	0.0000000
zheyou73v0_A03	16388835	16390294	BnaA03T0293600ZY	0	+	0	0	1459	0.0000000
zheyou73v0_A03	16391294	16392840	BnaA03T0293700ZY	0	+	0	0	1546	0.0000000
zheyou73v0_A03	16400331	16401853	BnaA03T0293800ZY	0	+	0	0	1522	0.0000000
zheyou73v0_A03	16402143	16403673	BnaA03T0293900ZY	0	-	0	0	1530	0.0000000
zheyou73v0_A03	16404113	16405786	BnaA03T0294000ZY	0	+	0	0	1673	0.0000000
zheyou73v0_A03	16405399	16405816	BnaA03T0294100ZY	0	-	0	0	417	0.0000000
zheyou73v0_A03	16429097	16430279	BnaA03T0294200ZY	0	+	0	0	1182	0.0000000
zheyou73v0_A03	16431819	16437144	BnaA03T0294300ZY	0	+	0	0	5325	0.0000000
zheyou73v0_A03	16437282	16438722	BnaA03T0294400ZY	0	-	0	0	1440	0.0000000
zheyou73v0_A03	16442956	16443808	BnaA03T0294500ZY	0	+	0	0	852	0.0000000
zheyou73v0_A03	16450685	16452258	BnaA03T0294600ZY	0	+	0	0	1573	0.0000000
zheyou73v0_A03	16455988	16457850	BnaA03T0294700ZY	0	+	0	0	1862	0.0000000
zheyou73v0_A03	16458456	16459682	BnaA03T0294800ZY	0	-	0	0	1226	0.0000000
zheyou73v0_A03	16466036	16466703	BnaA03T0294900ZY	0	+	0	0	667	0.0000000
zheyou73v0_A03	16474107	16476328	BnaA03T0295000ZY	0	-	0	0	2221	0.0000000
zheyou73v0_A03	16514311	16516526	BnaA03T0295100ZY	0	-	0	0	2215	0.0000000
zheyou73v0_A03	16521832	16523918	BnaA03T0295200ZY	0	-	0	0	2086	0.0000000
zheyou73v0_A03	16529601	16530523	BnaA03T0295300ZY	0	-	0	0	922	0.0000000
zheyou73v0_A03	16533207	16535826	BnaA03T0295400ZY	0	+	0	0	2619	0.0000000
zheyou73v0_A03	16536854	16537751	BnaA03T0295500ZY	0	-	0	0	897	0.0000000
zheyou73v0_A03	16547314	16549614	BnaA03T0295600ZY	0	+	0	0	2300	0.0000000
zheyou73v0_A03	16550438	16553697	BnaA03T0295700ZY	0	+	0	0	3259	0.0000000
zheyou73v0_A03	16550438	16553697	BnaA03T0295700ZY.1	0	+	0	0	3259	0.0000000
zheyou73v0_A03	16550438	16553697	BnaA03T0295700ZY.2	0	+	0	0	3259	0.0000000
zheyou73v0_A03	16553578	16555204	BnaA03T0295800ZY	0	-	0	0	1626	0.0000000
zheyou73v0_A03	16553578	16555204	BnaA03T0295800ZY.1	0	-	0	0	1626	0.0000000
zheyou73v0_A03	16556000	16559908	BnaA03T0295900ZY	0	-	0	0	3908	0.0000000
zheyou73v0_A03	16575960	16577793	BnaA03T0296000ZY	0	-	0	0	1833	0.0000000
zheyou73v0_A03	16590984	16595433	BnaA03T0296100ZY	0	-	0	0	4449	0.0000000
zheyou73v0_A03	16596163	16597444	BnaA03T0296200ZY	0	+	0	0	1281	0.0000000
zheyou73v0_A03	16598156	16603341	BnaA03T0296300ZY	0	+	0	0	5185	0.0000000
zheyou73v0_A03	16611099	16611931	BnaA03T0296400ZY	0	+	0	0	832	0.0000000
zheyou73v0_A03	16614165	16615854	BnaA03T0296500ZY	0	-	0	0	1689	0.0000000
zheyou73v0_A03	16622002	16624869	BnaA03T0296600ZY	0	-	0	0	2867	0.0000000
zheyou73v0_A03	16628118	16630936	BnaA03T0296700ZY	0	+	0	0	2818	0.0000000
zheyou73v0_A03	16631029	16632090	BnaA03T0296800ZY	0	-	0	0	1061	0.0000000
zheyou73v0_A03	16641191	16643003	BnaA03T0296900ZY	0	+	0	0	1812	0.0000000
zheyou73v0_A03	16644866	16646233	BnaA03T0297000ZY	0	+	0	0	1367	0.0000000
zheyou73v0_A03	16646377	16648490	BnaA03T0297100ZY	0	-	0	0	2113	0.0000000
zheyou73v0_A03	16649919	16654764	BnaA03T0297200ZY	0	-	0	0	4845	0.0000000
zheyou73v0_A03	16655705	16657694	BnaA03T0297300ZY	0	-	0	0	1989	0.0000000
zheyou73v0_A03	16655705	16657694	BnaA03T0297300ZY.1	0	-	0	0	1989	0.0000000
zheyou73v0_A03	16658534	16661062	BnaA03T0297400ZY	0	+	0	0	2528	0.0000000
zheyou73v0_A03	16661456	16666791	BnaA03T0297500ZY	0	-	0	0	5335	0.0000000
zheyou73v0_A03	16667134	16668467	BnaA03T0297600ZY	0	-	0	0	1333	0.0000000
zheyou73v0_A03	16668779	16671715	BnaA03T0297700ZY	0	+	0	0	2936	0.0000000
zheyou73v0_A03	16673116	16675022	BnaA03T0297800ZY	0	+	0	0	1906	0.0000000
zheyou73v0_A03	16675406	16677134	BnaA03T0297900ZY	0	-	0	0	1728	0.0000000
zheyou73v0_A03	16679414	16680753	BnaA03T0298000ZY	0	-	0	0	1339	0.0000000
zheyou73v0_A03	16683204	16686156	BnaA03T0298100ZY	0	+	0	0	2952	0.0000000
zheyou73v0_A03	16686489	16689122	BnaA03T0298200ZY	0	+	0	0	2633	0.0000000
zheyou73v0_A03	16692769	16696330	BnaA03T0298300ZY	0	+	0	0	3561	0.0000000
zheyou73v0_A03	16698471	16701421	BnaA03T0298400ZY	0	+	0	0	2950	0.0000000
zheyou73v0_A03	16701987	16704909	BnaA03T0298500ZY	0	-	0	0	2922	0.0000000
zheyou73v0_A03	16701987	16704909	BnaA03T0298500ZY.1	0	-	0	0	2922	0.0000000
zheyou73v0_A03	16712528	16713382	BnaA03T0298600ZY	0	+	0	0	854	0.0000000
zheyou73v0_A03	16713400	16716951	BnaA03T0298700ZY	0	-	0	0	3551	0.0000000
zheyou73v0_A03	16713400	16716951	BnaA03T0298700ZY.1	0	-	0	0	3551	0.0000000
zheyou73v0_A03	16717514	16719187	BnaA03T0298800ZY	0	+	0	0	1673	0.0000000
zheyou73v0_A03	16721232	16724725	BnaA03T0298900ZY	0	+	0	0	3493	0.0000000
zheyou73v0_A03	16725361	16726480	BnaA03T0299000ZY	0	-	0	0	1119	0.0000000
zheyou73v0_A03	16726601	16730389	BnaA03T0299100ZY	0	-	0	0	3788	0.0000000
zheyou73v0_A03	16737216	16738870	BnaA03T0299200ZY	0	+	0	0	1654	0.0000000
zheyou73v0_A03	16743152	16747464	BnaA03T0299300ZY	0	+	0	0	4312	0.0000000
zheyou73v0_A03	16749664	16751560	BnaA03T0299400ZY	0	+	0	0	1896	0.0000000
zheyou73v0_A03	16752026	16756313	BnaA03T0299500ZY	0	-	0	0	4287	0.0000000
zheyou73v0_A03	16763768	16767640	BnaA03T0299600ZY	0	-	0	0	3872	0.0000000
zheyou73v0_A03	16777493	16779040	BnaA03T0299700ZY	0	+	0	0	1547	0.0000000
zheyou73v0_A03	16779900	16783069	BnaA03T0299800ZY	0	+	0	0	3169	0.0000000
zheyou73v0_A03	16783072	16784790	BnaA03T0299900ZY	0	-	0	0	1718	0.0000000
zheyou73v0_A03	16783072	16784790	BnaA03T0299900ZY.1	0	-	0	0	1718	0.0000000
zheyou73v0_A03	16785557	16785990	BnaA03T0300000ZY	0	-	0	0	433	0.0000000
zheyou73v0_A03	16789226	16790913	BnaA03T0300100ZY	0	+	0	0	1687	0.0000000
zheyou73v0_A03	16789226	16790913	BnaA03T0300100ZY.1	0	+	0	0	1687	0.0000000
zheyou73v0_A03	16789226	16790913	BnaA03T0300100ZY.2	0	+	0	0	1687	0.0000000
zheyou73v0_A03	16789226	16790913	BnaA03T0300100ZY.3	0	+	0	0	1687	0.0000000
zheyou73v0_A03	16798888	16799555	BnaA03T0300200ZY	0	+	0	0	667	0.0000000
zheyou73v0_A03	16805586	16806550	BnaA03T0300300ZY	0	-	0	0	964	0.0000000
zheyou73v0_A03	16816571	16817065	BnaA03T0300400ZY	0	+	0	0	494	0.0000000
zheyou73v0_A03	16817536	16819501	BnaA03T0300500ZY	0	-	0	0	1965	0.0000000
zheyou73v0_A03	16817536	16819501	BnaA03T0300500ZY.1	0	-	0	0	1965	0.0000000
zheyou73v0_A03	16820868	16822632	BnaA03T0300600ZY	0	-	0	0	1764	0.0000000
zheyou73v0_A03	16823218	16824629	BnaA03T0300700ZY	0	-	0	0	1411	0.0000000
zheyou73v0_A03	16826011	16826619	BnaA03T0300800ZY	0	-	0	0	608	0.0000000
zheyou73v0_A03	16827088	16828630	BnaA03T0300900ZY	0	+	0	0	1542	0.0000000
zheyou73v0_A03	16828642	16832336	BnaA03T0301000ZY	0	-	0	0	3694	0.0000000
zheyou73v0_A03	16833132	16834687	BnaA03T0301100ZY	0	-	0	0	1555	0.0000000
zheyou73v0_A03	16834862	16836673	BnaA03T0301200ZY	0	+	0	0	1811	0.0000000
zheyou73v0_A03	16836631	16840044	BnaA03T0301300ZY	0	-	0	0	3413	0.0000000
zheyou73v0_A03	16841856	16842679	BnaA03T0301400ZY	0	-	0	0	823	0.0000000
zheyou73v0_A03	16845942	16849277	BnaA03T0301500ZY	0	+	0	0	3335	0.0000000
zheyou73v0_A03	16850013	16851877	BnaA03T0301600ZY	0	+	0	0	1864	0.0000000
zheyou73v0_A03	16852130	16852722	BnaA03T0301700ZY	0	-	0	0	592	0.0000000
zheyou73v0_A03	16853387	16856878	BnaA03T0301800ZY	0	-	0	0	3491	0.0000000
zheyou73v0_A03	16853387	16856878	BnaA03T0301800ZY.1	0	-	0	0	3491	0.0000000
zheyou73v0_A03	16858212	16860894	BnaA03T0301900ZY	0	-	0	0	2682	0.0000000
zheyou73v0_A03	16858212	16860894	BnaA03T0301900ZY.1	0	-	0	0	2682	0.0000000
zheyou73v0_A03	16861660	16863360	BnaA03T0302000ZY	0	-	0	0	1700	0.0000000
zheyou73v0_A03	16867157	16870489	BnaA03T0302100ZY	0	-	0	0	3332	0.0000000
zheyou73v0_A03	16871220	16875560	BnaA03T0302200ZY	0	-	0	0	4340	0.0000000
zheyou73v0_A03	16876460	16879722	BnaA03T0302300ZY	0	+	0	0	3262	0.0000000
zheyou73v0_A03	16880178	16882489	BnaA03T0302400ZY	0	+	0	0	2311	0.0000000
zheyou73v0_A03	16880178	16882489	BnaA03T0302400ZY.1	0	+	0	0	2311	0.0000000
zheyou73v0_A03	16883140	16886171	BnaA03T0302500ZY	0	+	0	0	3031	0.0000000
zheyou73v0_A03	16889001	16890194	BnaA03T0302600ZY	0	+	0	0	1193	0.0000000
zheyou73v0_A03	16890559	16893357	BnaA03T0302700ZY	0	+	0	0	2798	0.0000000
zheyou73v0_A03	16890559	16893357	BnaA03T0302700ZY.1	0	+	0	0	2798	0.0000000
zheyou73v0_A03	16898911	16899915	BnaA03T0302800ZY	0	+	0	0	1004	0.0000000
zheyou73v0_A03	16900464	16901529	BnaA03T0302900ZY	0	-	0	0	1065	0.0000000
zheyou73v0_A03	16902538	16902813	BnaA03T0303000ZY	0	+	0	0	275	0.0000000
zheyou73v0_A03	16903740	16904596	BnaA03T0303100ZY	0	+	0	0	856	0.0000000
zheyou73v0_A03	16907270	16914320	BnaA03T0303200ZY	0	+	0	0	7050	0.0000000
zheyou73v0_A03	16916739	16917830	BnaA03T0303300ZY	0	+	0	0	1091	0.0000000
zheyou73v0_A03	16918880	16920052	BnaA03T0303400ZY	0	-	0	0	1172	0.0000000
zheyou73v0_A03	16920870	16923216	BnaA03T0303500ZY	0	+	0	0	2346	0.0000000
zheyou73v0_A03	16926325	16928732	BnaA03T0303600ZY	0	+	0	0	2407	0.0000000
zheyou73v0_A03	16929295	16929987	BnaA03T0303700ZY	0	+	0	0	692	0.0000000
zheyou73v0_A03	16932742	16933476	BnaA03T0303800ZY	0	+	0	0	734	0.0000000
zheyou73v0_A03	16933924	16934555	BnaA03T0303900ZY	0	+	0	0	631	0.0000000
zheyou73v0_A03	16934727	16936217	BnaA03T0304000ZY	0	-	0	0	1490	0.0000000
zheyou73v0_A03	16936468	16938094	BnaA03T0304100ZY	0	-	0	0	1626	0.0000000
zheyou73v0_A03	16938889	16939293	BnaA03T0304200ZY	0	+	0	0	404	0.0000000
zheyou73v0_A03	16939685	16940418	BnaA03T0304300ZY	0	+	0	0	733	0.0000000
zheyou73v0_A03	16941884	16944432	BnaA03T0304400ZY	0	+	0	0	2548	0.0000000
zheyou73v0_A03	16945747	16948876	BnaA03T0304500ZY	0	+	0	0	3129	0.0000000
zheyou73v0_A03	16949455	16951867	BnaA03T0304600ZY	0	+	0	0	2412	0.0000000
zheyou73v0_A03	16956664	16958052	BnaA03T0304700ZY	0	+	0	0	1388	0.0000000
zheyou73v0_A03	16959403	16964641	BnaA03T0304800ZY	0	-	0	0	5238	0.0000000
zheyou73v0_A03	16985137	16986818	BnaA03T0304900ZY	0	-	0	0	1681	0.0000000
zheyou73v0_A03	16985137	16986645	BnaA03T0304900ZY.1	0	-	0	0	1508	0.0000000
zheyou73v0_A03	16986982	16990434	BnaA03T0305000ZY	0	-	0	0	3452	0.0000000
zheyou73v0_A03	16986982	16990434	BnaA03T0305000ZY.1	0	-	0	0	3452	0.0000000
zheyou73v0_A03	16990975	16991935	BnaA03T0305100ZY	0	-	0	0	960	0.0000000
zheyou73v0_A03	16992459	16994723	BnaA03T0305200ZY	0	+	0	0	2264	0.0000000
zheyou73v0_A03	16994893	16996208	BnaA03T0305300ZY	0	-	0	0	1315	0.0000000
zheyou73v0_A03	17001485	17003394	BnaA03T0305400ZY	0	+	0	0	1909	0.0000000
zheyou73v0_A03	17004130	17005083	BnaA03T0305500ZY	0	-	0	0	953	0.0000000
zheyou73v0_A03	17013879	17015191	BnaA03T0305600ZY.1	0	+	0	0	1312	0.0000000
zheyou73v0_A03	17013886	17015191	BnaA03T0305600ZY	0	+	0	0	1305	0.0000000
zheyou73v0_A03	17016600	17016966	BnaA03T0305700ZY	0	-	0	0	366	0.0000000
zheyou73v0_A03	17016994	17017201	BnaA03T0305800ZY	0	+	0	0	207	0.0000000
zheyou73v0_A03	17019018	17020586	BnaA03T0305900ZY	0	+	0	0	1568	0.0000000
zheyou73v0_A03	17020591	17023797	BnaA03T0306000ZY	0	-	0	0	3206	0.0000000
zheyou73v0_A03	17032691	17033615	BnaA03T0306100ZY	0	+	0	0	924	0.0000000
zheyou73v0_A03	17033866	17036147	BnaA03T0306200ZY	0	+	0	0	2281	0.0000000
zheyou73v0_A03	17044366	17045194	BnaA03T0306300ZY	0	+	0	0	828	0.0000000
zheyou73v0_A03	17048088	17050597	BnaA03T0306400ZY	0	-	0	0	2509	0.0000000
zheyou73v0_A03	17054828	17058395	BnaA03T0306500ZY	0	+	0	0	3567	0.0000000
zheyou73v0_A03	17072900	17073932	BnaA03T0306600ZY	0	-	0	0	1032	0.0000000
zheyou73v0_A03	17074956	17075739	BnaA03T0306700ZY	0	-	0	0	783	0.0000000
zheyou73v0_A03	17076805	17078480	BnaA03T0306800ZY	0	+	0	0	1675	0.0000000
zheyou73v0_A03	17079167	17081113	BnaA03T0306900ZY	0	+	0	0	1946	0.0000000
zheyou73v0_A03	17085425	17086097	BnaA03T0307000ZY	0	+	0	0	672	0.0000000
zheyou73v0_A03	17087018	17087445	BnaA03T0307100ZY	0	+	0	0	427	0.0000000
zheyou73v0_A03	17088027	17090187	BnaA03T0307200ZY	0	+	0	0	2160	0.0000000
zheyou73v0_A03	17096062	17098943	BnaA03T0307300ZY	0	+	0	0	2881	0.0000000
zheyou73v0_A03	17098983	17100765	BnaA03T0307400ZY	0	-	0	0	1782	0.0000000
zheyou73v0_A03	17102338	17104951	BnaA03T0307500ZY	0	-	0	0	2613	0.0000000
zheyou73v0_A03	17105500	17106764	BnaA03T0307600ZY	0	-	0	0	1264	0.0000000
zheyou73v0_A03	17107486	17109148	BnaA03T0307700ZY	0	-	0	0	1662	0.0000000
zheyou73v0_A03	17107486	17109148	BnaA03T0307700ZY.1	0	-	0	0	1662	0.0000000
zheyou73v0_A03	17109947	17111257	BnaA03T0307800ZY	0	+	0	0	1310	0.0000000
zheyou73v0_A03	17112372	17113563	BnaA03T0307900ZY	0	+	0	0	1191	0.0000000
zheyou73v0_A03	17114078	17115217	BnaA03T0308000ZY	0	+	0	0	1139	0.0000000
zheyou73v0_A03	17123496	17126197	BnaA03T0308100ZY.1	0	+	0	0	2701	0.0000000
zheyou73v0_A03	17124133	17126197	BnaA03T0308100ZY	0	+	0	0	2064	0.0000000
zheyou73v0_A03	17126403	17128489	BnaA03T0308200ZY	0	+	0	0	2086	0.0000000
zheyou73v0_A03	17129115	17130810	BnaA03T0308300ZY	0	+	0	0	1695	0.0000000
zheyou73v0_A03	17134091	17136993	BnaA03T0308400ZY	0	-	0	0	2902	0.0000000
zheyou73v0_A03	17137649	17140649	BnaA03T0308500ZY	0	-	0	0	3000	0.0000000
zheyou73v0_A03	17141355	17142662	BnaA03T0308600ZY	0	-	0	0	1307	0.0000000
zheyou73v0_A03	17143267	17145326	BnaA03T0308700ZY	0	-	0	0	2059	0.0000000
zheyou73v0_A03	17146499	17147489	BnaA03T0308800ZY	0	-	0	0	990	0.0000000
zheyou73v0_A03	17148515	17151015	BnaA03T0308900ZY	0	-	0	0	2500	0.0000000
zheyou73v0_A03	17152295	17154019	BnaA03T0309000ZY	0	+	0	0	1724	0.0000000
zheyou73v0_A03	17155613	17156720	BnaA03T0309100ZY	0	+	0	0	1107	0.0000000
zheyou73v0_A03	17156159	17160983	BnaA03T0309200ZY.1	0	-	0	0	4824	0.0000000
zheyou73v0_A03	17157080	17160983	BnaA03T0309200ZY	0	-	0	0	3903	0.0000000
zheyou73v0_A03	17157080	17160983	BnaA03T0309200ZY.2	0	-	0	0	3903	0.0000000
zheyou73v0_A03	17162523	17164535	BnaA03T0309300ZY	0	-	0	0	2012	0.0000000
zheyou73v0_A03	17166088	17167221	BnaA03T0309400ZY	0	-	0	0	1133	0.0000000
zheyou73v0_A03	17172344	17174266	BnaA03T0309500ZY	0	+	0	0	1922	0.0000000
zheyou73v0_A03	17176759	17180409	BnaA03T0309600ZY	0	-	0	0	3650	0.0000000
zheyou73v0_A03	17181894	17185112	BnaA03T0309700ZY	0	-	0	0	3218	0.0000000
zheyou73v0_A03	17187155	17189050	BnaA03T0309800ZY	0	-	0	0	1895	0.0000000
zheyou73v0_A03	17189478	17189871	BnaA03T0309900ZY	0	+	0	0	393	0.0000000
zheyou73v0_A03	17191253	17191933	BnaA03T0310000ZY	0	+	0	0	680	0.0000000
zheyou73v0_A03	17192969	17193359	BnaA03T0310100ZY	0	-	0	0	390	0.0000000
zheyou73v0_A03	17194266	17194623	BnaA03T0310200ZY	0	+	0	0	357	0.0000000
zheyou73v0_A03	17195095	17195561	BnaA03T0310300ZY	0	+	0	0	466	0.0000000
zheyou73v0_A03	17195960	17198361	BnaA03T0310400ZY	0	-	0	0	2401	0.0000000
zheyou73v0_A03	17199381	17200587	BnaA03T0310500ZY	0	-	0	0	1206	0.0000000
zheyou73v0_A03	17201732	17202683	BnaA03T0310600ZY	0	-	0	0	951	0.0000000
zheyou73v0_A03	17209789	17213021	BnaA03T0310700ZY	0	-	0	0	3232	0.0000000
zheyou73v0_A03	17214037	17219150	BnaA03T0310800ZY	0	+	0	0	5113	0.0000000
zheyou73v0_A03	17218459	17219122	BnaA03T0310900ZY	0	-	0	0	663	0.0000000
zheyou73v0_A03	17220271	17222663	BnaA03T0311000ZY	0	-	0	0	2392	0.0000000
zheyou73v0_A03	17231440	17240100	BnaA03T0311100ZY	0	+	0	0	8660	0.0000000
zheyou73v0_A03	17247875	17248238	BnaA03T0311200ZY	0	+	0	0	363	0.0000000
zheyou73v0_A03	17249353	17249641	BnaA03T0311300ZY	0	+	0	0	288	0.0000000
zheyou73v0_A03	17249612	17253619	BnaA03T0311400ZY	0	-	0	0	4007	0.0000000
zheyou73v0_A03	17249612	17253619	BnaA03T0311400ZY.1	0	-	0	0	4007	0.0000000
zheyou73v0_A03	17258019	17258913	BnaA03T0311500ZY	0	+	0	0	894	0.0000000
zheyou73v0_A03	17259006	17261979	BnaA03T0311600ZY	0	+	0	0	2973	0.0000000
zheyou73v0_A03	17262941	17266215	BnaA03T0311700ZY	0	-	0	0	3274	0.0000000
zheyou73v0_A03	17267915	17268235	BnaA03T0311800ZY	0	+	0	0	320	0.0000000
zheyou73v0_A03	17268912	17270804	BnaA03T0311900ZY	0	+	0	0	1892	0.0000000
zheyou73v0_A03	17270837	17273817	BnaA03T0312000ZY	0	-	0	0	2980	0.0000000
zheyou73v0_A03	17274855	17278148	BnaA03T0312100ZY	0	+	0	0	3293	0.0000000
zheyou73v0_A03	17278683	17280395	BnaA03T0312200ZY	0	+	0	0	1712	0.0000000
zheyou73v0_A03	17286679	17288797	BnaA03T0312300ZY	0	+	0	0	2118	0.0000000
zheyou73v0_A03	17288958	17293839	BnaA03T0312400ZY	0	-	0	0	4881	0.0000000
zheyou73v0_A03	17288958	17293839	BnaA03T0312400ZY.1	0	-	0	0	4881	0.0000000
zheyou73v0_A03	17296660	17297547	BnaA03T0312500ZY	0	-	0	0	887	0.0000000
zheyou73v0_A03	17299073	17299802	BnaA03T0312600ZY	0	-	0	0	729	0.0000000
zheyou73v0_A03	17300639	17301672	BnaA03T0312700ZY	0	-	0	0	1033	0.0000000
zheyou73v0_A03	17302916	17305897	BnaA03T0312800ZY	0	-	0	0	2981	0.0000000
zheyou73v0_A03	17308642	17309047	BnaA03T0312900ZY	0	+	0	0	405	0.0000000
zheyou73v0_A03	17309462	17310795	BnaA03T0313000ZY	0	-	0	0	1333	0.0000000
zheyou73v0_A03	17311286	17312701	BnaA03T0313100ZY	0	-	0	0	1415	0.0000000
zheyou73v0_A03	17315261	17317980	BnaA03T0313200ZY	0	+	0	0	2719	0.0000000
zheyou73v0_A03	17321768	17324520	BnaA03T0313300ZY	0	+	0	0	2752	0.0000000
zheyou73v0_A03	17324719	17328145	BnaA03T0313400ZY	0	-	0	0	3426	0.0000000
zheyou73v0_A03	17330832	17331269	BnaA03T0313500ZY	0	-	0	0	437	0.0000000
zheyou73v0_A03	17334107	17338293	BnaA03T0313600ZY	0	-	0	0	4186	0.0000000
zheyou73v0_A03	17346709	17347282	BnaA03T0313700ZY	0	-	0	0	573	0.0000000
zheyou73v0_A03	17350159	17352792	BnaA03T0313800ZY	0	+	0	0	2633	0.0000000
zheyou73v0_A03	17352815	17354842	BnaA03T0313900ZY	0	-	0	0	2027	0.0000000
zheyou73v0_A03	17358647	17359392	BnaA03T0314000ZY	0	-	0	0	745	0.0000000
zheyou73v0_A03	17364171	17366829	BnaA03T0314100ZY	0	-	0	0	2658	0.0000000
zheyou73v0_A03	17367136	17371102	BnaA03T0314200ZY	0	-	0	0	3966	0.0000000
zheyou73v0_A03	17378142	17380601	BnaA03T0314300ZY	0	+	0	0	2459	0.0000000
zheyou73v0_A03	17381080	17382658	BnaA03T0314400ZY	0	-	0	0	1578	0.0000000
zheyou73v0_A03	17384671	17387326	BnaA03T0314500ZY	0	-	0	0	2655	0.0000000
zheyou73v0_A03	17384671	17387326	BnaA03T0314500ZY.1	0	-	0	0	2655	0.0000000
zheyou73v0_A03	17388722	17390407	BnaA03T0314600ZY	0	+	0	0	1685	0.0000000
zheyou73v0_A03	17390501	17393629	BnaA03T0314700ZY	0	+	0	0	3128	0.0000000
zheyou73v0_A03	17393965	17394617	BnaA03T0314800ZY	0	-	0	0	652	0.0000000
zheyou73v0_A03	17395721	17396639	BnaA03T0314900ZY	0	-	0	0	918	0.0000000
zheyou73v0_A03	17397669	17399170	BnaA03T0315000ZY	0	-	0	0	1501	0.0000000
zheyou73v0_A03	17410094	17412550	BnaA03T0315100ZY	0	+	0	0	2456	0.0000000
zheyou73v0_A03	17413007	17416845	BnaA03T0315200ZY	0	-	0	0	3838	0.0000000
zheyou73v0_A03	17417862	17420415	BnaA03T0315300ZY	0	+	0	0	2553	0.0000000
zheyou73v0_A03	17421236	17422772	BnaA03T0315400ZY	0	+	0	0	1536	0.0000000
zheyou73v0_A03	17423162	17425782	BnaA03T0315500ZY	0	-	0	0	2620	0.0000000
zheyou73v0_A03	17427722	17428169	BnaA03T0315600ZY	0	+	0	0	447	0.0000000
zheyou73v0_A03	17432672	17436454	BnaA03T0315700ZY	0	+	0	0	3782	0.0000000
zheyou73v0_A03	17439221	17442577	BnaA03T0315800ZY	0	+	0	0	3356	0.0000000
zheyou73v0_A03	17442781	17443736	BnaA03T0315900ZY	0	-	0	0	955	0.0000000
zheyou73v0_A03	17445848	17446305	BnaA03T0316000ZY	0	-	0	0	457	0.0000000
zheyou73v0_A03	17447909	17452480	BnaA03T0316100ZY	0	+	0	0	4571	0.0000000
zheyou73v0_A03	17452655	17453753	BnaA03T0316200ZY	0	-	0	0	1098	0.0000000
zheyou73v0_A03	17454908	17455983	BnaA03T0316300ZY	0	+	0	0	1075	0.0000000
zheyou73v0_A03	17456038	17461139	BnaA03T0316400ZY	0	-	0	0	5101	0.0000000
zheyou73v0_A03	17456038	17461139	BnaA03T0316400ZY.1	0	-	0	0	5101	0.0000000
zheyou73v0_A03	17456038	17461139	BnaA03T0316400ZY.2	0	-	0	0	5101	0.0000000
zheyou73v0_A03	17456038	17461139	BnaA03T0316400ZY.3	0	-	0	0	5101	0.0000000
zheyou73v0_A03	17461911	17463756	BnaA03T0316500ZY	0	+	0	0	1845	0.0000000
zheyou73v0_A03	17464334	17466773	BnaA03T0316600ZY	0	-	0	0	2439	0.0000000
zheyou73v0_A03	17469799	17471147	BnaA03T0316700ZY	0	+	0	0	1348	0.0000000
zheyou73v0_A03	17477468	17486297	BnaA03T0316800ZY	0	+	0	0	8829	0.0000000
zheyou73v0_A03	17487265	17488306	BnaA03T0316900ZY	0	+	0	0	1041	0.0000000
zheyou73v0_A03	17493428	17493998	BnaA03T0317000ZY	0	+	0	0	570	0.0000000
zheyou73v0_A03	17494670	17496461	BnaA03T0317100ZY	0	-	0	0	1791	0.0000000
zheyou73v0_A03	17496793	17497490	BnaA03T0317200ZY	0	-	0	0	697	0.0000000
zheyou73v0_A03	17498544	17500343	BnaA03T0317300ZY	0	-	0	0	1799	0.0000000
zheyou73v0_A03	17500792	17502636	BnaA03T0317400ZY	0	-	0	0	1844	0.0000000
zheyou73v0_A03	17503347	17504587	BnaA03T0317500ZY	0	-	0	0	1240	0.0000000
zheyou73v0_A03	17506731	17509560	BnaA03T0317600ZY	0	+	0	0	2829	0.0000000
zheyou73v0_A03	17510065	17514762	BnaA03T0317700ZY	0	+	0	0	4697	0.0000000
zheyou73v0_A03	17514852	17517595	BnaA03T0317800ZY	0	-	0	0	2743	0.0000000
zheyou73v0_A03	17524012	17524963	BnaA03T0317900ZY	0	+	0	0	951	0.0000000
zheyou73v0_A03	17525783	17528174	BnaA03T0318000ZY	0	+	0	0	2391	0.0000000
zheyou73v0_A03	17529383	17531587	BnaA03T0318100ZY	0	+	0	0	2204	0.0000000
zheyou73v0_A03	17532160	17534414	BnaA03T0318200ZY	0	+	0	0	2254	0.0000000
zheyou73v0_A03	17535382	17537869	BnaA03T0318300ZY	0	+	0	0	2487	0.0000000
zheyou73v0_A03	17540415	17542071	BnaA03T0318400ZY	0	-	0	0	1656	0.0000000
zheyou73v0_A03	17543995	17545388	BnaA03T0318500ZY	0	+	0	0	1393	0.0000000
zheyou73v0_A03	17545449	17548240	BnaA03T0318600ZY	0	-	0	0	2791	0.0000000
zheyou73v0_A03	17549140	17550535	BnaA03T0318700ZY	0	+	0	0	1395	0.0000000
zheyou73v0_A03	17551220	17554906	BnaA03T0318800ZY	0	+	0	0	3686	0.0000000
zheyou73v0_A03	17555694	17557885	BnaA03T0318900ZY	0	-	0	0	2191	0.0000000
zheyou73v0_A03	17563045	17573680	BnaA03T0319000ZY	0	-	0	0	10635	0.0000000
zheyou73v0_A03	17574830	17577101	BnaA03T0319100ZY	0	-	0	0	2271	0.0000000
zheyou73v0_A03	17581638	17584051	BnaA03T0319200ZY	0	-	0	0	2413	0.0000000
zheyou73v0_A03	17586546	17586943	BnaA03T0319300ZY	0	+	0	0	397	0.0000000
zheyou73v0_A03	17589541	17590288	BnaA03T0319400ZY	0	+	0	0	747	0.0000000
zheyou73v0_A03	17602120	17604751	BnaA03T0319500ZY	0	+	0	0	2631	0.0000000
zheyou73v0_A03	17608066	17608456	BnaA03T0319600ZY	0	+	0	0	390	0.0000000
zheyou73v0_A03	17611155	17611698	BnaA03T0319700ZY	0	+	0	0	543	0.0000000
zheyou73v0_A03	17617274	17619030	BnaA03T0319800ZY	0	-	0	0	1756	0.0000000
zheyou73v0_A03	17619307	17621957	BnaA03T0319900ZY	0	-	0	0	2650	0.0000000
zheyou73v0_A03	17624209	17625385	BnaA03T0320000ZY	0	+	0	0	1176	0.0000000
zheyou73v0_A03	17625697	17626406	BnaA03T0320100ZY	0	-	0	0	709	0.0000000
zheyou73v0_A03	17627786	17628286	BnaA03T0320200ZY	0	-	0	0	500	0.0000000
zheyou73v0_A03	17629422	17632781	BnaA03T0320300ZY	0	+	0	0	3359	0.0000000
zheyou73v0_A03	17633828	17634726	BnaA03T0320400ZY	0	+	0	0	898	0.0000000
zheyou73v0_A03	17644879	17645728	BnaA03T0320500ZY	0	-	0	0	849	0.0000000
zheyou73v0_A03	17646576	17651875	BnaA03T0320600ZY	0	-	0	0	5299	0.0000000
zheyou73v0_A03	17664064	17665197	BnaA03T0320700ZY	0	+	0	0	1133	0.0000000
zheyou73v0_A03	17672521	17673257	BnaA03T0320800ZY	0	-	0	0	736	0.0000000
zheyou73v0_A03	17674176	17674719	BnaA03T0320900ZY	0	-	0	0	543	0.0000000
zheyou73v0_A03	17675549	17675792	BnaA03T0321000ZY	0	+	0	0	243	0.0000000
zheyou73v0_A03	17680297	17681133	BnaA03T0321100ZY	0	-	0	0	836	0.0000000
zheyou73v0_A03	17682822	17685541	BnaA03T0321200ZY	0	-	0	0	2719	0.0000000
zheyou73v0_A03	17689904	17691050	BnaA03T0321300ZY	0	+	0	0	1146	0.0000000
zheyou73v0_A03	17691630	17693705	BnaA03T0321400ZY	0	-	0	0	2075	0.0000000
zheyou73v0_A03	17694615	17696571	BnaA03T0321500ZY	0	-	0	0	1956	0.0000000
zheyou73v0_A03	17698602	17700663	BnaA03T0321600ZY	0	+	0	0	2061	0.0000000
zheyou73v0_A03	17712293	17714801	BnaA03T0321700ZY	0	-	0	0	2508	0.0000000
zheyou73v0_A03	17717454	17719535	BnaA03T0321800ZY	0	+	0	0	2081	0.0000000
zheyou73v0_A03	17720469	17721920	BnaA03T0321900ZY	0	+	0	0	1451	0.0000000
zheyou73v0_A03	17722077	17727472	BnaA03T0322000ZY	0	-	0	0	5395	0.0000000
zheyou73v0_A03	17729761	17730957	BnaA03T0322100ZY	0	+	0	0	1196	0.0000000
zheyou73v0_A03	17736161	17737460	BnaA03T0322200ZY	0	-	0	0	1299	0.0000000
zheyou73v0_A03	17740685	17741480	BnaA03T0322300ZY	0	+	0	0	795	0.0000000
zheyou73v0_A03	17741774	17753842	BnaA03T0322400ZY	0	-	0	0	12068	0.0000000
zheyou73v0_A03	17756381	17757869	BnaA03T0322500ZY	0	+	0	0	1488	0.0000000
zheyou73v0_A03	17760844	17762359	BnaA03T0322600ZY	0	+	0	0	1515	0.0000000
zheyou73v0_A03	17760844	17762359	BnaA03T0322600ZY.1	0	+	0	0	1515	0.0000000
zheyou73v0_A03	17762576	17764075	BnaA03T0322700ZY	0	-	0	0	1499	0.0000000
zheyou73v0_A03	17766558	17768661	BnaA03T0322800ZY	0	+	0	0	2103	0.0000000
zheyou73v0_A03	17769006	17772745	BnaA03T0322900ZY	0	-	0	0	3739	0.0000000
zheyou73v0_A03	17773682	17776515	BnaA03T0323000ZY	0	-	0	0	2833	0.0000000
zheyou73v0_A03	17778712	17782219	BnaA03T0323100ZY	0	-	0	0	3507	0.0000000
zheyou73v0_A03	17778712	17782219	BnaA03T0323100ZY.1	0	-	0	0	3507	0.0000000
zheyou73v0_A03	17786000	17788317	BnaA03T0323200ZY	0	+	0	0	2317	0.0000000
zheyou73v0_A03	17798692	17800686	BnaA03T0323300ZY	0	+	0	0	1994	0.0000000
zheyou73v0_A03	17802883	17806154	BnaA03T0323400ZY	0	-	0	0	3271	0.0000000
zheyou73v0_A03	17806879	17808306	BnaA03T0323500ZY	0	+	0	0	1427	0.0000000
zheyou73v0_A03	17808731	17811566	BnaA03T0323600ZY	0	-	0	0	2835	0.0000000
zheyou73v0_A03	17813212	17813566	BnaA03T0323700ZY	0	+	0	0	354	0.0000000
zheyou73v0_A03	17813912	17814224	BnaA03T0323800ZY	0	-	0	0	312	0.0000000
zheyou73v0_A03	17816120	17817415	BnaA03T0323900ZY	0	-	0	0	1295	0.0000000
zheyou73v0_A03	17821215	17821677	BnaA03T0324000ZY	0	+	0	0	462	0.0000000
zheyou73v0_A03	17822820	17823409	BnaA03T0324100ZY	0	-	0	0	589	0.0000000
zheyou73v0_A03	17824313	17825190	BnaA03T0324200ZY	0	-	0	0	877	0.0000000
zheyou73v0_A03	17826576	17827199	BnaA03T0324300ZY	0	-	0	0	623	0.0000000
zheyou73v0_A03	17828235	17830900	BnaA03T0324400ZY	0	-	0	0	2665	0.0000000
zheyou73v0_A03	17831913	17833662	BnaA03T0324500ZY	0	-	0	0	1749	0.0000000
zheyou73v0_A03	17834238	17836065	BnaA03T0324600ZY	0	+	0	0	1827	0.0000000
zheyou73v0_A03	17836872	17838881	BnaA03T0324700ZY	0	-	0	0	2009	0.0000000
zheyou73v0_A03	17840020	17841481	BnaA03T0324800ZY	0	+	0	0	1461	0.0000000
zheyou73v0_A03	17841220	17841968	BnaA03T0324900ZY	0	-	0	0	748	0.0000000
zheyou73v0_A03	17843451	17845971	BnaA03T0325000ZY	0	+	0	0	2520	0.0000000
zheyou73v0_A03	17846549	17848618	BnaA03T0325100ZY	0	+	0	0	2069	0.0000000
zheyou73v0_A03	17851223	17853803	BnaA03T0325200ZY	0	+	0	0	2580	0.0000000
zheyou73v0_A03	17854640	17857337	BnaA03T0325300ZY	0	+	0	0	2697	0.0000000
zheyou73v0_A03	17857604	17858894	BnaA03T0325400ZY	0	-	0	0	1290	0.0000000
zheyou73v0_A03	17859825	17861907	BnaA03T0325500ZY	0	+	0	0	2082	0.0000000
zheyou73v0_A03	17859825	17861907	BnaA03T0325500ZY.1	0	+	0	0	2082	0.0000000
zheyou73v0_A03	17871328	17873633	BnaA03T0325600ZY	0	-	0	0	2305	0.0000000
zheyou73v0_A03	17874437	17875860	BnaA03T0325700ZY	0	+	0	0	1423	0.0000000
zheyou73v0_A03	17874437	17875860	BnaA03T0325700ZY.1	0	+	0	0	1423	0.0000000
zheyou73v0_A03	17874437	17875860	BnaA03T0325700ZY.2	0	+	0	0	1423	0.0000000
zheyou73v0_A03	17874437	17875860	BnaA03T0325700ZY.3	0	+	0	0	1423	0.0000000
zheyou73v0_A03	17882677	17884294	BnaA03T0325800ZY	0	+	0	0	1617	0.0000000
zheyou73v0_A03	17885986	17887584	BnaA03T0325900ZY	0	+	0	0	1598	0.0000000
zheyou73v0_A03	17885986	17887584	BnaA03T0325900ZY.1	0	+	0	0	1598	0.0000000
zheyou73v0_A03	17888053	17889171	BnaA03T0326000ZY	0	-	0	0	1118	0.0000000
zheyou73v0_A03	17889517	17890554	BnaA03T0326100ZY	0	-	0	0	1037	0.0000000
zheyou73v0_A03	17893162	17894156	BnaA03T0326200ZY	0	-	0	0	994	0.0000000
zheyou73v0_A03	17896741	17898912	BnaA03T0326300ZY	0	+	0	0	2171	0.0000000
zheyou73v0_A03	17899973	17903067	BnaA03T0326400ZY	0	+	0	0	3094	0.0000000
zheyou73v0_A03	17913362	17915833	BnaA03T0326500ZY	0	+	0	0	2471	0.0000000
zheyou73v0_A03	17916057	17923194	BnaA03T0326600ZY	0	-	0	0	7137	0.0000000
zheyou73v0_A03	17923636	17925585	BnaA03T0326700ZY	0	+	0	0	1949	0.0000000
zheyou73v0_A03	17927359	17946761	BnaA03T0326800ZY	0	-	0	0	19402	0.0000000
zheyou73v0_A03	17956552	17958015	BnaA03T0326900ZY	0	-	0	0	1463	0.0000000
zheyou73v0_A03	17960976	17963304	BnaA03T0327000ZY	0	-	0	0	2328	0.0000000
zheyou73v0_A03	17964411	17973002	BnaA03T0327100ZY	0	-	0	0	8591	0.0000000
zheyou73v0_A03	17974350	17974666	BnaA03T0327200ZY	0	+	0	0	316	0.0000000
zheyou73v0_A03	17975590	17982800	BnaA03T0327300ZY	0	+	0	0	7210	0.0000000
zheyou73v0_A03	17983000	17985279	BnaA03T0327400ZY	0	-	0	0	2279	0.0000000
zheyou73v0_A03	17991146	17994739	BnaA03T0327500ZY	0	+	0	0	3593	0.0000000
zheyou73v0_A03	17995609	17997349	BnaA03T0327600ZY	0	+	0	0	1740	0.0000000
zheyou73v0_A03	17998207	17998861	BnaA03T0327700ZY	0	+	0	0	654	0.0000000
zheyou73v0_A03	18004295	18006392	BnaA03T0327800ZY	0	+	0	0	2097	0.0000000
zheyou73v0_A03	18006783	18007645	BnaA03T0327900ZY	0	+	0	0	862	0.0000000
zheyou73v0_A03	18009928	18011383	BnaA03T0328000ZY	0	-	0	0	1455	0.0000000
zheyou73v0_A03	18012106	18014147	BnaA03T0328100ZY	0	+	0	0	2041	0.0000000
zheyou73v0_A03	18013904	18017850	BnaA03T0328200ZY	0	-	0	0	3946	0.0000000
zheyou73v0_A03	18021216	18022282	BnaA03T0328300ZY	0	+	0	0	1066	0.0000000
zheyou73v0_A03	18026705	18029412	BnaA03T0328400ZY	0	+	0	0	2707	0.0000000
zheyou73v0_A03	18039420	18039800	BnaA03T0328500ZY	0	+	0	0	380	0.0000000
zheyou73v0_A03	18040665	18042698	BnaA03T0328600ZY	0	+	0	0	2033	0.0000000
zheyou73v0_A03	18044022	18044648	BnaA03T0328700ZY	0	+	0	0	626	0.0000000
zheyou73v0_A03	18044908	18046954	BnaA03T0328800ZY	0	-	0	0	2046	0.0000000
zheyou73v0_A03	18047515	18049141	BnaA03T0328900ZY	0	-	0	0	1626	0.0000000
zheyou73v0_A03	18050779	18051358	BnaA03T0329000ZY	0	-	0	0	579	0.0000000
zheyou73v0_A03	18052231	18055371	BnaA03T0329100ZY	0	-	0	0	3140	0.0000000
zheyou73v0_A03	18056043	18056740	BnaA03T0329200ZY	0	+	0	0	697	0.0000000
zheyou73v0_A03	18057144	18059158	BnaA03T0329300ZY	0	-	0	0	2014	0.0000000
zheyou73v0_A03	18060408	18061493	BnaA03T0329400ZY	0	-	0	0	1085	0.0000000
zheyou73v0_A03	18061772	18064060	BnaA03T0329500ZY	0	+	0	0	2288	0.0000000
zheyou73v0_A03	18072173	18074767	BnaA03T0329600ZY	0	+	0	0	2594	0.0000000
zheyou73v0_A03	18075946	18076282	BnaA03T0329700ZY	0	+	0	0	336	0.0000000
zheyou73v0_A03	18076787	18078569	BnaA03T0329800ZY	0	-	0	0	1782	0.0000000
zheyou73v0_A03	18079005	18081309	BnaA03T0329900ZY	0	-	0	0	2304	0.0000000
zheyou73v0_A03	18081766	18085810	BnaA03T0330000ZY	0	-	0	0	4044	0.0000000
zheyou73v0_A03	18090307	18090878	BnaA03T0330100ZY	0	-	0	0	571	0.0000000
zheyou73v0_A03	18091416	18095030	BnaA03T0330200ZY	0	-	0	0	3614	0.0000000
zheyou73v0_A03	18096048	18100288	BnaA03T0330300ZY	0	-	0	0	4240	0.0000000
zheyou73v0_A03	18110124	18111855	BnaA03T0330400ZY	0	-	0	0	1731	0.0000000
zheyou73v0_A03	18112423	18115262	BnaA03T0330500ZY	0	+	0	0	2839	0.0000000
zheyou73v0_A03	18115763	18116832	BnaA03T0330600ZY	0	-	0	0	1069	0.0000000
zheyou73v0_A03	18117265	18117963	BnaA03T0330700ZY	0	+	0	0	698	0.0000000
zheyou73v0_A03	18118771	18120820	BnaA03T0330800ZY	0	+	0	0	2049	0.0000000
zheyou73v0_A03	18121052	18123149	BnaA03T0330900ZY	0	-	0	0	2097	0.0000000
zheyou73v0_A03	18124366	18124882	BnaA03T0331000ZY	0	-	0	0	516	0.0000000
zheyou73v0_A03	18138610	18138946	BnaA03T0331100ZY	0	+	0	0	336	0.0000000
zheyou73v0_A03	18146284	18149133	BnaA03T0331200ZY	0	+	0	0	2849	0.0000000
zheyou73v0_A03	18149947	18150574	BnaA03T0331300ZY	0	-	0	0	627	0.0000000
zheyou73v0_A03	18151576	18154172	BnaA03T0331400ZY	0	+	0	0	2596	0.0000000
zheyou73v0_A03	18154297	18156410	BnaA03T0331500ZY	0	-	0	0	2113	0.0000000
zheyou73v0_A03	18156887	18158564	BnaA03T0331600ZY	0	+	0	0	1677	0.0000000
zheyou73v0_A03	18159075	18161908	BnaA03T0331700ZY	0	+	0	0	2833	0.0000000
zheyou73v0_A03	18167976	18170269	BnaA03T0331800ZY	0	+	0	0	2293	0.0000000
zheyou73v0_A03	18171276	18173834	BnaA03T0331900ZY	0	+	0	0	2558	0.0000000
zheyou73v0_A03	18182372	18185459	BnaA03T0332000ZY	0	+	0	0	3087	0.0000000
zheyou73v0_A03	18188643	18190756	BnaA03T0332100ZY	0	+	0	0	2113	0.0000000
zheyou73v0_A03	18191187	18192665	BnaA03T0332200ZY	0	-	0	0	1478	0.0000000
zheyou73v0_A03	18193635	18196067	BnaA03T0332300ZY	0	-	0	0	2432	0.0000000
zheyou73v0_A03	18193635	18196067	BnaA03T0332300ZY.1	0	-	0	0	2432	0.0000000
zheyou73v0_A03	18193635	18196067	BnaA03T0332300ZY.2	0	-	0	0	2432	0.0000000
zheyou73v0_A03	18197753	18204039	BnaA03T0332400ZY	0	+	0	0	6286	0.0000000
zheyou73v0_A03	18204627	18206313	BnaA03T0332500ZY	0	-	0	0	1686	0.0000000
zheyou73v0_A03	18206992	18210015	BnaA03T0332600ZY	0	-	0	0	3023	0.0000000
zheyou73v0_A03	18210679	18212861	BnaA03T0332700ZY	0	+	0	0	2182	0.0000000
zheyou73v0_A03	18215624	18216441	BnaA03T0332800ZY	0	-	0	0	817	0.0000000
zheyou73v0_A03	18216639	18217824	BnaA03T0332900ZY	0	-	0	0	1185	0.0000000
zheyou73v0_A03	18216639	18217824	BnaA03T0332900ZY.1	0	-	0	0	1185	0.0000000
zheyou73v0_A03	18220337	18223453	BnaA03T0333000ZY	0	+	0	0	3116	0.0000000
zheyou73v0_A03	18226356	18236289	BnaA03T0333100ZY	0	+	0	0	9933	0.0000000
zheyou73v0_A03	18238196	18243832	BnaA03T0333200ZY	0	+	0	0	5636	0.0000000
zheyou73v0_A03	18245038	18245380	BnaA03T0333300ZY	0	+	0	0	342	0.0000000
zheyou73v0_A03	18247569	18253205	BnaA03T0333400ZY	0	+	0	0	5636	0.0000000
zheyou73v0_A03	18254411	18254917	BnaA03T0333500ZY	0	+	0	0	506	0.0000000
zheyou73v0_A03	18255706	18258486	BnaA03T0333600ZY	0	-	0	0	2780	0.0000000
zheyou73v0_A03	18259757	18262738	BnaA03T0333700ZY	0	-	0	0	2981	0.0000000
zheyou73v0_A03	18259757	18262738	BnaA03T0333700ZY.1	0	-	0	0	2981	0.0000000
zheyou73v0_A03	18264272	18270466	BnaA03T0333800ZY	0	-	0	0	6194	0.0000000
zheyou73v0_A03	18273864	18277060	BnaA03T0333900ZY	0	+	0	0	3196	0.0000000
zheyou73v0_A03	18278991	18280153	BnaA03T0334000ZY	0	-	0	0	1162	0.0000000
zheyou73v0_A03	18287090	18287690	BnaA03T0334100ZY	0	+	0	0	600	0.0000000
zheyou73v0_A03	18289146	18291006	BnaA03T0334200ZY	0	+	0	0	1860	0.0000000
zheyou73v0_A03	18291401	18295800	BnaA03T0334300ZY	0	-	0	0	4399	0.0000000
zheyou73v0_A03	18296322	18304830	BnaA03T0334400ZY	0	-	0	0	8508	0.0000000
zheyou73v0_A03	18296322	18304830	BnaA03T0334400ZY.1	0	-	0	0	8508	0.0000000
zheyou73v0_A03	18306784	18309921	BnaA03T0334500ZY	0	+	0	0	3137	0.0000000
zheyou73v0_A03	18310312	18311406	BnaA03T0334600ZY	0	-	0	0	1094	0.0000000
zheyou73v0_A03	18312592	18314681	BnaA03T0334700ZY	0	-	0	0	2089	0.0000000
zheyou73v0_A03	18317314	18320525	BnaA03T0334800ZY	0	-	0	0	3211	0.0000000
zheyou73v0_A03	18326287	18329203	BnaA03T0334900ZY	0	+	0	0	2916	0.0000000
zheyou73v0_A03	18330149	18333556	BnaA03T0335000ZY	0	+	0	0	3407	0.0000000
zheyou73v0_A03	18336088	18336776	BnaA03T0335100ZY	0	-	0	0	688	0.0000000
zheyou73v0_A03	18342777	18346300	BnaA03T0335200ZY	0	+	0	0	3523	0.0000000
zheyou73v0_A03	18348629	18350544	BnaA03T0335300ZY	0	+	0	0	1915	0.0000000
zheyou73v0_A03	18352041	18352851	BnaA03T0335400ZY	0	+	0	0	810	0.0000000
zheyou73v0_A03	18352968	18354544	BnaA03T0335500ZY	0	-	0	0	1576	0.0000000
zheyou73v0_A03	18352968	18354544	BnaA03T0335500ZY.1	0	-	0	0	1576	0.0000000
zheyou73v0_A03	18354826	18360335	BnaA03T0335600ZY	0	-	0	0	5509	0.0000000
zheyou73v0_A03	18363160	18363580	BnaA03T0335700ZY	0	-	0	0	420	0.0000000
zheyou73v0_A03	18364160	18366330	BnaA03T0335800ZY	0	-	0	0	2170	0.0000000
zheyou73v0_A03	18367100	18372929	BnaA03T0335900ZY	0	-	0	0	5829	0.0000000
zheyou73v0_A03	18374683	18376592	BnaA03T0336000ZY	0	+	0	0	1909	0.0000000
zheyou73v0_A03	18377807	18382504	BnaA03T0336100ZY	0	-	0	0	4697	0.0000000
zheyou73v0_A03	18384723	18385131	BnaA03T0336200ZY	0	+	0	0	408	0.0000000
zheyou73v0_A03	18391211	18391658	BnaA03T0336300ZY	0	+	0	0	447	0.0000000
zheyou73v0_A03	18392011	18393818	BnaA03T0336400ZY	0	-	0	0	1807	0.0000000
zheyou73v0_A03	18392011	18393818	BnaA03T0336400ZY.1	0	-	0	0	1807	0.0000000
zheyou73v0_A03	18397475	18398473	BnaA03T0336500ZY	0	+	0	0	998	0.0000000
zheyou73v0_A03	18398564	18399206	BnaA03T0336600ZY	0	-	0	0	642	0.0000000
zheyou73v0_A03	18400321	18401234	BnaA03T0336700ZY	0	-	0	0	913	0.0000000
zheyou73v0_A03	18405194	18405551	BnaA03T0336800ZY	0	+	0	0	357	0.0000000
zheyou73v0_A03	18411935	18414025	BnaA03T0336900ZY	0	-	0	0	2090	0.0000000
zheyou73v0_A03	18416962	18417946	BnaA03T0337000ZY	0	+	0	0	984	0.0000000
zheyou73v0_A03	18418622	18420331	BnaA03T0337100ZY	0	-	0	0	1709	0.0000000
zheyou73v0_A03	18422361	18423516	BnaA03T0337200ZY	0	+	0	0	1155	0.0000000
zheyou73v0_A03	18426812	18429218	BnaA03T0337300ZY	0	+	0	0	2406	0.0000000
zheyou73v0_A03	18433900	18436461	BnaA03T0337400ZY	0	-	0	0	2561	0.0000000
zheyou73v0_A03	18438494	18438971	BnaA03T0337500ZY	0	+	0	0	477	0.0000000
zheyou73v0_A03	18440172	18441032	BnaA03T0337600ZY	0	-	0	0	860	0.0000000
zheyou73v0_A03	18442138	18450498	BnaA03T0337700ZY	0	-	0	0	8360	0.0000000
zheyou73v0_A03	18458770	18458935	BnaA03T0337800ZY	0	+	0	0	165	0.0000000
zheyou73v0_A03	18459237	18459476	BnaA03T0337900ZY	0	+	0	0	239	0.0000000
zheyou73v0_A03	18459838	18460246	BnaA03T0338000ZY	0	+	0	0	408	0.0000000
zheyou73v0_A03	18461569	18463930	BnaA03T0338100ZY	0	+	0	0	2361	0.0000000
zheyou73v0_A03	18464364	18466539	BnaA03T0338200ZY	0	-	0	0	2175	0.0000000
zheyou73v0_A03	18473308	18473637	BnaA03T0338300ZY	0	-	0	0	329	0.0000000
zheyou73v0_A03	18485650	18487113	BnaA03T0338400ZY	0	+	0	0	1463	0.0000000
zheyou73v0_A03	18488143	18489520	BnaA03T0338500ZY	0	+	0	0	1377	0.0000000
zheyou73v0_A03	18489927	18491898	BnaA03T0338600ZY	0	-	0	0	1971	0.0000000
zheyou73v0_A03	18493114	18496148	BnaA03T0338700ZY	0	-	0	0	3034	0.0000000
zheyou73v0_A03	18496999	18499249	BnaA03T0338800ZY	0	+	0	0	2250	0.0000000
zheyou73v0_A03	18502775	18503404	BnaA03T0338900ZY	0	+	0	0	629	0.0000000
zheyou73v0_A03	18504175	18505911	BnaA03T0339000ZY	0	+	0	0	1736	0.0000000
zheyou73v0_A03	18506890	18509868	BnaA03T0339100ZY	0	+	0	0	2978	0.0000000
zheyou73v0_A03	18514409	18516290	BnaA03T0339200ZY	0	-	0	0	1881	0.0000000
zheyou73v0_A03	18534503	18535091	BnaA03T0339300ZY	0	+	0	0	588	0.0000000
zheyou73v0_A03	18535612	18537402	BnaA03T0339400ZY	0	-	0	0	1790	0.0000000
zheyou73v0_A03	18538210	18539473	BnaA03T0339500ZY	0	-	0	0	1263	0.0000000
zheyou73v0_A03	18542685	18547022	BnaA03T0339600ZY	0	+	0	0	4337	0.0000000
zheyou73v0_A03	18547686	18548827	BnaA03T0339700ZY	0	+	0	0	1141	0.0000000
zheyou73v0_A03	18548848	18551721	BnaA03T0339800ZY	0	-	0	0	2873	0.0000000
zheyou73v0_A03	18554308	18555522	BnaA03T0339900ZY	0	-	0	0	1214	0.0000000
zheyou73v0_A03	18562484	18562847	BnaA03T0340000ZY	0	+	0	0	363	0.0000000
zheyou73v0_A03	18567180	18568831	BnaA03T0340100ZY	0	+	0	0	1651	0.0000000
zheyou73v0_A03	18576439	18576966	BnaA03T0340200ZY	0	+	0	0	527	0.0000000
zheyou73v0_A03	18577943	18586142	BnaA03T0340300ZY	0	-	0	0	8199	0.0000000
zheyou73v0_A03	18577943	18586142	BnaA03T0340300ZY.1	0	-	0	0	8199	0.0000000
zheyou73v0_A03	18586544	18588273	BnaA03T0340400ZY	0	+	0	0	1729	0.0000000
zheyou73v0_A03	18589091	18594369	BnaA03T0340500ZY	0	-	0	0	5278	0.0000000
zheyou73v0_A03	18591148	18594369	BnaA03T0340500ZY.1	0	-	0	0	3221	0.0000000
zheyou73v0_A03	18595039	18597959	BnaA03T0340600ZY	0	-	0	0	2920	0.0000000
zheyou73v0_A03	18599004	18601298	BnaA03T0340700ZY	0	-	0	0	2294	0.0000000
zheyou73v0_A03	18599004	18601298	BnaA03T0340700ZY.1	0	-	0	0	2294	0.0000000
zheyou73v0_A03	18607053	18608216	BnaA03T0340800ZY	0	+	0	0	1163	0.0000000
zheyou73v0_A03	18608731	18610913	BnaA03T0340900ZY	0	-	0	0	2182	0.0000000
zheyou73v0_A03	18612211	18613386	BnaA03T0341000ZY	0	+	0	0	1175	0.0000000
zheyou73v0_A03	18613537	18615263	BnaA03T0341100ZY	0	-	0	0	1726	0.0000000
zheyou73v0_A03	18616401	18620756	BnaA03T0341200ZY	0	+	0	0	4355	0.0000000
zheyou73v0_A03	18621323	18623511	BnaA03T0341300ZY	0	-	0	0	2188	0.0000000
zheyou73v0_A03	18627845	18630498	BnaA03T0341400ZY	0	+	0	0	2653	0.0000000
zheyou73v0_A03	18630901	18639511	BnaA03T0341500ZY	0	-	0	0	8610	0.0000000
zheyou73v0_A03	18641903	18643312	BnaA03T0341600ZY	0	+	0	0	1409	0.0000000
zheyou73v0_A03	18644896	18646415	BnaA03T0341700ZY	0	-	0	0	1519	0.0000000
zheyou73v0_A03	18649911	18652497	BnaA03T0341800ZY	0	-	0	0	2586	0.0000000
zheyou73v0_A03	18653052	18655445	BnaA03T0341900ZY	0	-	0	0	2393	0.0000000
zheyou73v0_A03	18656288	18664420	BnaA03T0342000ZY	0	+	0	0	8132	0.0000000
zheyou73v0_A03	18656288	18664420	BnaA03T0342000ZY.1	0	+	0	0	8132	0.0000000
zheyou73v0_A03	18666068	18673230	BnaA03T0342100ZY	0	-	0	0	7162	0.0000000
zheyou73v0_A03	18675971	18676784	BnaA03T0342200ZY	0	+	0	0	813	0.0000000
zheyou73v0_A03	18682513	18684000	BnaA03T0342300ZY	0	-	0	0	1487	0.0000000
zheyou73v0_A03	18685309	18688584	BnaA03T0342400ZY	0	+	0	0	3275	0.0000000
zheyou73v0_A03	18688939	18690984	BnaA03T0342500ZY	0	-	0	0	2045	0.0000000
zheyou73v0_A03	18694933	18695196	BnaA03T0342600ZY	0	+	0	0	263	0.0000000
zheyou73v0_A03	18697132	18699273	BnaA03T0342700ZY	0	-	0	0	2141	0.0000000
zheyou73v0_A03	18700195	18702354	BnaA03T0342800ZY	0	-	0	0	2159	0.0000000
zheyou73v0_A03	18727318	18730487	BnaA03T0342900ZY	0	+	0	0	3169	0.0000000
zheyou73v0_A03	18730986	18732155	BnaA03T0343000ZY	0	-	0	0	1169	0.0000000
zheyou73v0_A03	18732688	18734963	BnaA03T0343100ZY	0	+	0	0	2275	0.0000000
zheyou73v0_A03	18735099	18740564	BnaA03T0343200ZY	0	-	0	0	5465	0.0000000
zheyou73v0_A03	18741009	18742538	BnaA03T0343300ZY	0	+	0	0	1529	0.0000000
zheyou73v0_A03	18741009	18742777	BnaA03T0343300ZY.1	0	+	0	0	1768	0.0000000
zheyou73v0_A03	18743110	18743937	BnaA03T0343400ZY	0	-	0	0	827	0.0000000
zheyou73v0_A03	18744584	18746210	BnaA03T0343500ZY	0	+	0	0	1626	0.0000000
zheyou73v0_A03	18747205	18748449	BnaA03T0343600ZY	0	+	0	0	1244	0.0000000
zheyou73v0_A03	18748796	18751272	BnaA03T0343700ZY	0	-	0	0	2476	0.0000000
zheyou73v0_A03	18751851	18754079	BnaA03T0343800ZY	0	+	0	0	2228	0.0000000
zheyou73v0_A03	18754304	18756597	BnaA03T0343900ZY	0	-	0	0	2293	0.0000000
zheyou73v0_A03	18759974	18763518	BnaA03T0344000ZY	0	-	0	0	3544	0.0000000
zheyou73v0_A03	18765072	18768782	BnaA03T0344100ZY	0	-	0	0	3710	0.0000000
zheyou73v0_A03	18769342	18770629	BnaA03T0344200ZY	0	-	0	0	1287	0.0000000
zheyou73v0_A03	18771542	18774372	BnaA03T0344300ZY	0	+	0	0	2830	0.0000000
zheyou73v0_A03	18780230	18782943	BnaA03T0344400ZY	0	-	0	0	2713	0.0000000
zheyou73v0_A03	18785099	18792436	BnaA03T0344500ZY	0	-	0	0	7337	0.0000000
zheyou73v0_A03	18792884	18794423	BnaA03T0344600ZY	0	+	0	0	1539	0.0000000
zheyou73v0_A03	18796887	18798565	BnaA03T0344700ZY	0	-	0	0	1678	0.0000000
zheyou73v0_A03	18799095	18801839	BnaA03T0344800ZY	0	+	0	0	2744	0.0000000
zheyou73v0_A03	18799095	18801839	BnaA03T0344800ZY.1	0	+	0	0	2744	0.0000000
zheyou73v0_A03	18799095	18801839	BnaA03T0344800ZY.2	0	+	0	0	2744	0.0000000
zheyou73v0_A03	18802580	18805718	BnaA03T0344900ZY	0	+	0	0	3138	0.0000000
zheyou73v0_A03	18802661	18805718	BnaA03T0344900ZY.1	0	+	0	0	3057	0.0000000
zheyou73v0_A03	18805850	18806561	BnaA03T0345000ZY	0	-	0	0	711	0.0000000
zheyou73v0_A03	18809275	18810448	BnaA03T0345100ZY	0	+	0	0	1173	0.0000000
zheyou73v0_A03	18811050	18811856	BnaA03T0345200ZY	0	-	0	0	806	0.0000000
zheyou73v0_A03	18816652	18819050	BnaA03T0345300ZY	0	+	0	0	2398	0.0000000
zheyou73v0_A03	18820098	18824385	BnaA03T0345400ZY	0	+	0	0	4287	0.0000000
zheyou73v0_A03	18825950	18827096	BnaA03T0345500ZY	0	+	0	0	1146	0.0000000
zheyou73v0_A03	18827284	18829770	BnaA03T0345600ZY	0	-	0	0	2486	0.0000000
zheyou73v0_A03	18830593	18831978	BnaA03T0345700ZY	0	-	0	0	1385	0.0000000
zheyou73v0_A03	18834306	18835849	BnaA03T0345800ZY	0	-	0	0	1543	0.0000000
zheyou73v0_A03	18842120	18842982	BnaA03T0345900ZY	0	-	0	0	862	0.0000000
zheyou73v0_A03	18854369	18857104	BnaA03T0346000ZY	0	+	0	0	2735	0.0000000
zheyou73v0_A03	18861308	18862865	BnaA03T0346100ZY	0	+	0	0	1557	0.0000000
zheyou73v0_A03	18861308	18862865	BnaA03T0346100ZY.1	0	+	0	0	1557	0.0000000
zheyou73v0_A03	18870402	18879810	BnaA03T0346200ZY	0	+	0	0	9408	0.0000000
zheyou73v0_A03	18884811	18886341	BnaA03T0346300ZY	0	+	0	0	1530	0.0000000
zheyou73v0_A03	18893267	18894795	BnaA03T0346400ZY	0	-	0	0	1528	0.0000000
zheyou73v0_A03	18912044	18913067	BnaA03T0346500ZY	0	-	0	0	1023	0.0000000
zheyou73v0_A03	18914355	18916556	BnaA03T0346600ZY	0	+	0	0	2201	0.0000000
zheyou73v0_A03	18918970	18927093	BnaA03T0346700ZY	0	+	0	0	8123	0.0000000
zheyou73v0_A03	18927355	18929940	BnaA03T0346800ZY	0	-	0	0	2585	0.0000000
zheyou73v0_A03	18936794	18937404	BnaA03T0346900ZY	0	+	0	0	610	0.0000000
zheyou73v0_A03	18939808	18941117	BnaA03T0347000ZY	0	-	0	0	1309	0.0000000
zheyou73v0_A03	18941521	18943997	BnaA03T0347100ZY	0	-	0	0	2476	0.0000000
zheyou73v0_A03	18941521	18943997	BnaA03T0347100ZY.1	0	-	0	0	2476	0.0000000
zheyou73v0_A03	18946465	18950299	BnaA03T0347200ZY	0	+	0	0	3834	0.0000000
zheyou73v0_A03	18951460	18953133	BnaA03T0347300ZY	0	+	0	0	1673	0.0000000
zheyou73v0_A03	18953593	18956922	BnaA03T0347400ZY	0	-	0	0	3329	0.0000000
zheyou73v0_A03	18957383	18963839	BnaA03T0347500ZY	0	-	0	0	6456	0.0000000
zheyou73v0_A03	18965502	18966846	BnaA03T0347600ZY	0	+	0	0	1344	0.0000000
zheyou73v0_A03	18969190	18975023	BnaA03T0347700ZY	0	+	0	0	5833	0.0000000
zheyou73v0_A03	18978424	18979164	BnaA03T0347800ZY	0	+	0	0	740	0.0000000
zheyou73v0_A03	18985693	18987035	BnaA03T0347900ZY	0	-	0	0	1342	0.0000000
zheyou73v0_A03	18993587	18994952	BnaA03T0348000ZY	0	+	0	0	1365	0.0000000
zheyou73v0_A03	18996342	18996935	BnaA03T0348100ZY	0	+	0	0	593	0.0000000
zheyou73v0_A03	18997607	18998483	BnaA03T0348200ZY	0	-	0	0	876	0.0000000
zheyou73v0_A03	18999306	19003321	BnaA03T0348300ZY	0	-	0	0	4015	0.0000000
zheyou73v0_A03	19010093	19010880	BnaA03T0348400ZY	0	-	0	0	787	0.0000000
zheyou73v0_A03	19014386	19016680	BnaA03T0348500ZY	0	+	0	0	2294	0.0000000
zheyou73v0_A03	19016929	19026608	BnaA03T0348600ZY	0	-	0	0	9679	0.0000000
zheyou73v0_A03	19028546	19031831	BnaA03T0348700ZY	0	+	0	0	3285	0.0000000
zheyou73v0_A03	19031953	19033495	BnaA03T0348800ZY	0	-	0	0	1542	0.0000000
zheyou73v0_A03	19034063	19036407	BnaA03T0348900ZY	0	-	0	0	2344	0.0000000
zheyou73v0_A03	19038330	19041051	BnaA03T0349000ZY	0	+	0	0	2721	0.0000000
zheyou73v0_A03	19044978	19047308	BnaA03T0349100ZY	0	-	0	0	2330	0.0000000
zheyou73v0_A03	19052604	19053517	BnaA03T0349200ZY	0	+	0	0	913	0.0000000
zheyou73v0_A03	19065984	19069378	BnaA03T0349300ZY	0	-	0	0	3394	0.0000000
zheyou73v0_A03	19088310	19095723	BnaA03T0349400ZY	0	-	0	0	7413	0.0000000
zheyou73v0_A03	19107582	19108901	BnaA03T0349500ZY	0	-	0	0	1319	0.0000000
zheyou73v0_A03	19114278	19116493	BnaA03T0349600ZY	0	+	0	0	2215	0.0000000
zheyou73v0_A03	19118001	19119777	BnaA03T0349700ZY	0	+	0	0	1776	0.0000000
zheyou73v0_A03	19123046	19125195	BnaA03T0349800ZY	0	-	0	0	2149	0.0000000
zheyou73v0_A03	19126115	19129879	BnaA03T0349900ZY	0	-	0	0	3764	0.0000000
zheyou73v0_A03	19130550	19131315	BnaA03T0350000ZY	0	+	0	0	765	0.0000000
zheyou73v0_A03	19132049	19133193	BnaA03T0350100ZY	0	+	0	0	1144	0.0000000
zheyou73v0_A03	19135175	19138921	BnaA03T0350200ZY	0	+	0	0	3746	0.0000000
zheyou73v0_A03	19135175	19138921	BnaA03T0350200ZY.1	0	+	0	0	3746	0.0000000
zheyou73v0_A03	19140926	19145682	BnaA03T0350300ZY	0	+	0	0	4756	0.0000000
zheyou73v0_A03	19144879	19145661	BnaA03T0350400ZY	0	-	0	0	782	0.0000000
zheyou73v0_A03	19152887	19155658	BnaA03T0350500ZY	0	+	0	0	2771	0.0000000
zheyou73v0_A03	19162362	19164232	BnaA03T0350600ZY	0	+	0	0	1870	0.0000000
zheyou73v0_A03	19165393	19168326	BnaA03T0350700ZY	0	-	0	0	2933	0.0000000
zheyou73v0_A03	19169816	19172164	BnaA03T0350800ZY	0	+	0	0	2348	0.0000000
zheyou73v0_A03	19180778	19183696	BnaA03T0350900ZY	0	-	0	0	2918	0.0000000
zheyou73v0_A03	19184204	19185210	BnaA03T0351000ZY	0	-	0	0	1006	0.0000000
zheyou73v0_A03	19231538	19231709	BnaA03T0351100ZY	0	+	0	0	171	0.0000000
zheyou73v0_A03	19238390	19242311	BnaA03T0351200ZY	0	+	0	0	3921	0.0000000
zheyou73v0_A03	19250373	19251822	BnaA03T0351300ZY	0	+	0	0	1449	0.0000000
zheyou73v0_A03	19253689	19254244	BnaA03T0351400ZY	0	-	0	0	555	0.0000000
zheyou73v0_A03	19266575	19268133	BnaA03T0351500ZY	0	-	0	0	1558	0.0000000
zheyou73v0_A03	19266575	19268133	BnaA03T0351500ZY.1	0	-	0	0	1558	0.0000000
zheyou73v0_A03	19268551	19270169	BnaA03T0351600ZY	0	-	0	0	1618	0.0000000
zheyou73v0_A03	19270984	19273056	BnaA03T0351700ZY	0	-	0	0	2072	0.0000000
zheyou73v0_A03	19273704	19274158	BnaA03T0351800ZY	0	+	0	0	454	0.0000000
zheyou73v0_A03	19274306	19280170	BnaA03T0351900ZY	0	-	0	0	5864	0.0000000
zheyou73v0_A03	19290895	19292172	BnaA03T0352000ZY	0	+	0	0	1277	0.0000000
zheyou73v0_A03	19290895	19292172	BnaA03T0352000ZY.1	0	+	0	0	1277	0.0000000
zheyou73v0_A03	19292510	19294491	BnaA03T0352100ZY	0	-	0	0	1981	0.0000000
zheyou73v0_A03	19292510	19294491	BnaA03T0352100ZY.1	0	-	0	0	1981	0.0000000
zheyou73v0_A03	19296220	19296844	BnaA03T0352200ZY	0	+	0	0	624	0.0000000
zheyou73v0_A03	19298742	19300675	BnaA03T0352300ZY	0	-	0	0	1933	0.0000000
zheyou73v0_A03	19303154	19305887	BnaA03T0352400ZY	0	-	0	0	2733	0.0000000
zheyou73v0_A03	19310250	19311115	BnaA03T0352500ZY	0	-	0	0	865	0.0000000
zheyou73v0_A03	19319699	19326242	BnaA03T0352600ZY	0	+	0	0	6543	0.0000000
zheyou73v0_A03	19327450	19330714	BnaA03T0352700ZY	0	-	0	0	3264	0.0000000
zheyou73v0_A03	19335649	19341436	BnaA03T0352800ZY	0	-	0	0	5787	0.0000000
zheyou73v0_A03	19354864	19355092	BnaA03T0352900ZY	0	+	0	0	228	0.0000000
zheyou73v0_A03	19355671	19356256	BnaA03T0353000ZY	0	-	0	0	585	0.0000000
zheyou73v0_A03	19356928	19357556	BnaA03T0353100ZY	0	-	0	0	628	0.0000000
zheyou73v0_A03	19361232	19362987	BnaA03T0353200ZY	0	-	0	0	1755	0.0000000
zheyou73v0_A03	19390150	19392297	BnaA03T0353300ZY	0	-	0	0	2147	0.0000000
zheyou73v0_A03	19418817	19421280	BnaA03T0353400ZY	0	+	0	0	2463	0.0000000
zheyou73v0_A03	19422153	19428614	BnaA03T0353500ZY	0	-	0	0	6461	0.0000000
zheyou73v0_A03	19429435	19431743	BnaA03T0353600ZY	0	-	0	0	2308	0.0000000
zheyou73v0_A03	19433276	19434641	BnaA03T0353700ZY	0	+	0	0	1365	0.0000000
zheyou73v0_A03	19435214	19436659	BnaA03T0353800ZY	0	+	0	0	1445	0.0000000
zheyou73v0_A03	19441210	19441468	BnaA03T0353900ZY	0	+	0	0	258	0.0000000
zheyou73v0_A03	19467959	19471394	BnaA03T0354000ZY	0	-	0	0	3435	0.0000000
zheyou73v0_A03	19524133	19525322	BnaA03T0354100ZY	0	+	0	0	1189	0.0000000
zheyou73v0_A03	19525807	19528238	BnaA03T0354200ZY	0	-	0	0	2431	0.0000000
zheyou73v0_A03	19531704	19533024	BnaA03T0354300ZY	0	+	0	0	1320	0.0000000
zheyou73v0_A03	19535360	19538748	BnaA03T0354400ZY	0	+	0	0	3388	0.0000000
zheyou73v0_A03	19539520	19541876	BnaA03T0354500ZY	0	+	0	0	2356	0.0000000
zheyou73v0_A03	19550639	19552870	BnaA03T0354600ZY	0	-	0	0	2231	0.0000000
zheyou73v0_A03	19566782	19568467	BnaA03T0354700ZY	0	+	0	0	1685	0.0000000
zheyou73v0_A03	19566880	19568467	BnaA03T0354700ZY.1	0	+	0	0	1587	0.0000000
zheyou73v0_A03	19570450	19571128	BnaA03T0354800ZY	0	-	0	0	678	0.0000000
zheyou73v0_A03	19577026	19577990	BnaA03T0354900ZY	0	+	0	0	964	0.0000000
zheyou73v0_A03	19578260	19579962	BnaA03T0355000ZY	0	-	0	0	1702	0.0000000
zheyou73v0_A03	19582387	19584566	BnaA03T0355100ZY	0	+	0	0	2179	0.0000000
zheyou73v0_A03	19584923	19591440	BnaA03T0355200ZY	0	-	0	0	6517	0.0000000
zheyou73v0_A03	19592863	19595204	BnaA03T0355300ZY	0	-	0	0	2341	0.0000000
zheyou73v0_A03	19595561	19598835	BnaA03T0355400ZY	0	+	0	0	3274	0.0000000
zheyou73v0_A03	19600102	19602769	BnaA03T0355500ZY	0	+	0	0	2667	0.0000000
zheyou73v0_A03	19603405	19604545	BnaA03T0355600ZY	0	+	0	0	1140	0.0000000
zheyou73v0_A03	19607594	19608999	BnaA03T0355700ZY	0	+	0	0	1405	0.0000000
zheyou73v0_A03	19615731	19616848	BnaA03T0355800ZY	0	-	0	0	1117	0.0000000
zheyou73v0_A03	19618783	19622204	BnaA03T0355900ZY	0	+	0	0	3421	0.0000000
zheyou73v0_A03	19624344	19627539	BnaA03T0356000ZY	0	-	0	0	3195	0.0000000
zheyou73v0_A03	19630397	19632849	BnaA03T0356100ZY	0	+	0	0	2452	0.0000000
zheyou73v0_A03	19633297	19634408	BnaA03T0356200ZY	0	+	0	0	1111	0.0000000
zheyou73v0_A03	19637041	19643308	BnaA03T0356300ZY	0	+	0	0	6267	0.0000000
zheyou73v0_A03	19643916	19646246	BnaA03T0356400ZY	0	-	0	0	2330	0.0000000
zheyou73v0_A03	19648550	19653000	BnaA03T0356500ZY	0	+	0	0	4450	0.0000000
zheyou73v0_A03	19648550	19653000	BnaA03T0356500ZY.1	0	+	0	0	4450	0.0000000
zheyou73v0_A03	19653521	19655133	BnaA03T0356600ZY	0	-	0	0	1612	0.0000000
zheyou73v0_A03	19660194	19660829	BnaA03T0356700ZY	0	+	0	0	635	0.0000000
zheyou73v0_A03	19660947	19661322	BnaA03T0356800ZY	0	+	0	0	375	0.0000000
zheyou73v0_A03	19674632	19676724	BnaA03T0356900ZY	0	+	0	0	2092	0.0000000
zheyou73v0_A03	19687717	19690574	BnaA03T0357000ZY	0	-	0	0	2857	0.0000000
zheyou73v0_A03	19693340	19694071	BnaA03T0357100ZY	0	-	0	0	731	0.0000000
zheyou73v0_A03	19694865	19698349	BnaA03T0357200ZY	0	+	0	0	3484	0.0000000
zheyou73v0_A03	19713979	19714922	BnaA03T0357300ZY	0	+	0	0	943	0.0000000
zheyou73v0_A03	19716227	19717827	BnaA03T0357400ZY	0	+	0	0	1600	0.0000000
zheyou73v0_A03	19718711	19719420	BnaA03T0357500ZY	0	-	0	0	709	0.0000000
zheyou73v0_A03	19725609	19727142	BnaA03T0357600ZY	0	+	0	0	1533	0.0000000
zheyou73v0_A03	19730023	19732158	BnaA03T0357700ZY	0	-	0	0	2135	0.0000000
zheyou73v0_A03	19739865	19741803	BnaA03T0357800ZY	0	-	0	0	1938	0.0000000
zheyou73v0_A03	19743533	19746374	BnaA03T0357900ZY	0	+	0	0	2841	0.0000000
zheyou73v0_A03	19746857	19748691	BnaA03T0358000ZY	0	-	0	0	1834	0.0000000
zheyou73v0_A03	19749152	19750809	BnaA03T0358100ZY	0	+	0	0	1657	0.0000000
zheyou73v0_A03	19754261	19756098	BnaA03T0358200ZY	0	+	0	0	1837	0.0000000
zheyou73v0_A03	19757964	19760394	BnaA03T0358300ZY	0	+	0	0	2430	0.0000000
zheyou73v0_A03	19767344	19767803	BnaA03T0358400ZY	0	+	0	0	459	0.0000000
zheyou73v0_A03	19768784	19775718	BnaA03T0358500ZY	0	+	0	0	6934	0.0000000
zheyou73v0_A03	19776139	19782684	BnaA03T0358600ZY	0	-	0	0	6545	0.0000000
zheyou73v0_A03	19788699	19789092	BnaA03T0358700ZY	0	-	0	0	393	0.0000000
zheyou73v0_A03	19789716	19790567	BnaA03T0358800ZY	0	-	0	0	851	0.0000000
zheyou73v0_A03	19794872	19796012	BnaA03T0358900ZY	0	-	0	0	1140	0.0000000
zheyou73v0_A03	19796204	19803587	BnaA03T0359000ZY	0	-	0	0	7383	0.0000000
zheyou73v0_A03	19796204	19803587	BnaA03T0359000ZY.1	0	-	0	0	7383	0.0000000
zheyou73v0_A03	19796822	19803587	BnaA03T0359000ZY.2	0	-	0	0	6765	0.0000000
zheyou73v0_A03	19796822	19803587	BnaA03T0359000ZY.3	0	-	0	0	6765	0.0000000
zheyou73v0_A03	19796822	19803587	BnaA03T0359000ZY.4	0	-	0	0	6765	0.0000000
zheyou73v0_A03	19796822	19803587	BnaA03T0359000ZY.5	0	-	0	0	6765	0.0000000
zheyou73v0_A03	19796822	19803587	BnaA03T0359000ZY.6	0	-	0	0	6765	0.0000000
zheyou73v0_A03	19796822	19803587	BnaA03T0359000ZY.7	0	-	0	0	6765	0.0000000
zheyou73v0_A03	19813946	19819567	BnaA03T0359100ZY	0	+	0	0	5621	0.0000000
zheyou73v0_A03	19817849	19820183	BnaA03T0359200ZY	0	-	0	0	2334	0.0000000
zheyou73v0_A03	19821218	19823777	BnaA03T0359300ZY	0	+	0	0	2559	0.0000000
zheyou73v0_A03	19824553	19825405	BnaA03T0359400ZY	0	-	0	0	852	0.0000000
zheyou73v0_A03	19827281	19828933	BnaA03T0359500ZY	0	-	0	0	1652	0.0000000
zheyou73v0_A03	19837674	19838256	BnaA03T0359600ZY	0	-	0	0	582	0.0000000
zheyou73v0_A03	19846801	19847326	BnaA03T0359700ZY	0	-	0	0	525	0.0000000
zheyou73v0_A03	19847534	19848179	BnaA03T0359800ZY	0	+	0	0	645	0.0000000
zheyou73v0_A03	19848501	19851046	BnaA03T0359900ZY	0	+	0	0	2545	0.0000000
zheyou73v0_A03	19851964	19853053	BnaA03T0360000ZY	0	-	0	0	1089	0.0000000
zheyou73v0_A03	19856857	19859490	BnaA03T0360100ZY	0	+	0	0	2633	0.0000000
zheyou73v0_A03	19856857	19859490	BnaA03T0360100ZY.1	0	+	0	0	2633	0.0000000
zheyou73v0_A03	19856857	19859490	BnaA03T0360100ZY.2	0	+	0	0	2633	0.0000000
zheyou73v0_A03	19856857	19859490	BnaA03T0360100ZY.3	0	+	0	0	2633	0.0000000
zheyou73v0_A03	19864862	19866334	BnaA03T0360200ZY	0	+	0	0	1472	0.0000000
zheyou73v0_A03	19866773	19867473	BnaA03T0360300ZY	0	-	0	0	700	0.0000000
zheyou73v0_A03	19873387	19874117	BnaA03T0360400ZY	0	+	0	0	730	0.0000000
zheyou73v0_A03	19883346	19884998	BnaA03T0360500ZY	0	+	0	0	1652	0.0000000
zheyou73v0_A03	19897462	19898875	BnaA03T0360600ZY	0	-	0	0	1413	0.0000000
zheyou73v0_A03	19899207	19900740	BnaA03T0360700ZY	0	+	0	0	1533	0.0000000
zheyou73v0_A03	19905719	19906175	BnaA03T0360800ZY	0	+	0	0	456	0.0000000
zheyou73v0_A03	19935499	19936980	BnaA03T0360900ZY	0	+	0	0	1481	0.0000000
zheyou73v0_A03	19937427	19939182	BnaA03T0361000ZY	0	+	0	0	1755	0.0000000
zheyou73v0_A03	19945217	19946611	BnaA03T0361100ZY	0	-	0	0	1394	0.0000000
zheyou73v0_A03	19967895	19969463	BnaA03T0361200ZY	0	-	0	0	1568	0.0000000
zheyou73v0_A03	19974566	19976041	BnaA03T0361300ZY	0	-	0	0	1475	0.0000000
zheyou73v0_A03	19979290	19980987	BnaA03T0361400ZY	0	+	0	0	1697	0.0000000
zheyou73v0_A03	19981229	19981768	BnaA03T0361500ZY	0	-	0	0	539	0.0000000
zheyou73v0_A03	19982794	19984087	BnaA03T0361600ZY	0	-	0	0	1293	0.0000000
zheyou73v0_A03	19982794	19984087	BnaA03T0361600ZY.1	0	-	0	0	1293	0.0000000
zheyou73v0_A03	19985962	19987557	BnaA03T0361700ZY	0	-	0	0	1595	0.0000000
zheyou73v0_A03	19989272	19990147	BnaA03T0361800ZY	0	+	0	0	875	0.0000000
zheyou73v0_A03	19997678	19999018	BnaA03T0361900ZY	0	+	0	0	1340	0.0000000
zheyou73v0_A03	20003817	20004585	BnaA03T0362000ZY	0	+	0	0	768	0.0000000
zheyou73v0_A03	20008589	20011152	BnaA03T0362100ZY	0	+	0	0	2563	0.0000000
zheyou73v0_A03	20015378	20018263	BnaA03T0362200ZY	0	+	0	0	2885	0.0000000
zheyou73v0_A03	20019895	20020711	BnaA03T0362300ZY	0	-	0	0	816	0.0000000
zheyou73v0_A03	20021807	20025369	BnaA03T0362400ZY	0	-	0	0	3562	0.0000000
zheyou73v0_A03	20026345	20027406	BnaA03T0362500ZY	0	-	0	0	1061	0.0000000
zheyou73v0_A03	20029625	20030274	BnaA03T0362600ZY	0	+	0	0	649	0.0000000
zheyou73v0_A03	20033542	20034455	BnaA03T0362700ZY	0	-	0	0	913	0.0000000
zheyou73v0_A03	20034875	20035709	BnaA03T0362800ZY	0	+	0	0	834	0.0000000
zheyou73v0_A03	20040823	20041924	BnaA03T0362900ZY	0	+	0	0	1101	0.0000000
zheyou73v0_A03	20041966	20043633	BnaA03T0363000ZY	0	-	0	0	1667	0.0000000
zheyou73v0_A03	20047776	20049269	BnaA03T0363100ZY	0	-	0	0	1493	0.0000000
zheyou73v0_A03	20060979	20061333	BnaA03T0363200ZY	0	+	0	0	354	0.0000000
zheyou73v0_A03	20061343	20063163	BnaA03T0363300ZY	0	+	0	0	1820	0.0000000
zheyou73v0_A03	20061343	20063163	BnaA03T0363300ZY.1	0	+	0	0	1820	0.0000000
zheyou73v0_A03	20063652	20064278	BnaA03T0363400ZY	0	-	0	0	626	0.0000000
zheyou73v0_A03	20065118	20069253	BnaA03T0363500ZY	0	+	0	0	4135	0.0000000
zheyou73v0_A03	20070353	20070917	BnaA03T0363600ZY	0	-	0	0	564	0.0000000
zheyou73v0_A03	20077875	20078773	BnaA03T0363700ZY	0	+	0	0	898	0.0000000
zheyou73v0_A03	20079152	20080646	BnaA03T0363800ZY	0	-	0	0	1494	0.0000000
zheyou73v0_A03	20079152	20080646	BnaA03T0363800ZY.1	0	-	0	0	1494	0.0000000
zheyou73v0_A03	20081730	20083509	BnaA03T0363900ZY	0	+	0	0	1779	0.0000000
zheyou73v0_A03	20083737	20085368	BnaA03T0364000ZY	0	-	0	0	1631	0.0000000
zheyou73v0_A03	20087628	20090430	BnaA03T0364100ZY	0	+	0	0	2802	0.0000000
zheyou73v0_A03	20090757	20091730	BnaA03T0364200ZY	0	-	0	0	973	0.0000000
zheyou73v0_A03	20095344	20098500	BnaA03T0364300ZY	0	+	0	0	3156	0.0000000
zheyou73v0_A03	20095344	20098500	BnaA03T0364300ZY.1	0	+	0	0	3156	0.0000000
zheyou73v0_A03	20098550	20102429	BnaA03T0364400ZY	0	-	0	0	3879	0.0000000
zheyou73v0_A03	20107080	20107941	BnaA03T0364500ZY	0	-	0	0	861	0.0000000
zheyou73v0_A03	20112522	20113358	BnaA03T0364600ZY	0	+	0	0	836	0.0000000
zheyou73v0_A03	20114966	20115385	BnaA03T0364700ZY	0	+	0	0	419	0.0000000
zheyou73v0_A03	20119921	20120551	BnaA03T0364800ZY	0	+	0	0	630	0.0000000
zheyou73v0_A03	20123514	20124646	BnaA03T0364900ZY	0	-	0	0	1132	0.0000000
zheyou73v0_A03	20127643	20128639	BnaA03T0365000ZY	0	+	0	0	996	0.0000000
zheyou73v0_A03	20130835	20133969	BnaA03T0365100ZY	0	+	0	0	3134	0.0000000
zheyou73v0_A03	20136246	20137437	BnaA03T0365200ZY	0	+	0	0	1191	0.0000000
zheyou73v0_A03	20138000	20140763	BnaA03T0365300ZY	0	+	0	0	2763	0.0000000
zheyou73v0_A03	20157711	20157927	BnaA03T0365400ZY	0	-	0	0	216	0.0000000
zheyou73v0_A03	20161451	20162017	BnaA03T0365500ZY	0	+	0	0	566	0.0000000
zheyou73v0_A03	20179458	20180823	BnaA03T0365600ZY	0	+	0	0	1365	0.0000000
zheyou73v0_A03	20184633	20186327	BnaA03T0365700ZY	0	-	0	0	1694	0.0000000
zheyou73v0_A03	20187930	20188259	BnaA03T0365800ZY	0	+	0	0	329	0.0000000
zheyou73v0_A03	20188615	20197918	BnaA03T0365900ZY	0	-	0	0	9303	0.0000000
zheyou73v0_A03	20202512	20204956	BnaA03T0366000ZY	0	+	0	0	2444	0.0000000
zheyou73v0_A03	20211803	20213067	BnaA03T0366100ZY	0	+	0	0	1264	0.0000000
zheyou73v0_A03	20213404	20216866	BnaA03T0366200ZY	0	+	0	0	3462	0.0000000
zheyou73v0_A03	20219276	20220515	BnaA03T0366300ZY	0	-	0	0	1239	0.0000000
zheyou73v0_A03	20222917	20223985	BnaA03T0366400ZY	0	+	0	0	1068	0.0000000
zheyou73v0_A03	20225412	20229166	BnaA03T0366500ZY	0	+	0	0	3754	0.0000000
zheyou73v0_A03	20238353	20240552	BnaA03T0366600ZY	0	-	0	0	2199	0.0000000
zheyou73v0_A03	20244762	20245841	BnaA03T0366700ZY	0	-	0	0	1079	0.0000000
zheyou73v0_A03	20247048	20252942	BnaA03T0366800ZY	0	-	0	0	5894	0.0000000
zheyou73v0_A03	20255730	20258685	BnaA03T0366900ZY	0	-	0	0	2955	0.0000000
zheyou73v0_A03	20259395	20262660	BnaA03T0367000ZY	0	+	0	0	3265	0.0000000
zheyou73v0_A03	20263480	20265208	BnaA03T0367100ZY	0	+	0	0	1728	0.0000000
zheyou73v0_A03	20266794	20268503	BnaA03T0367200ZY	0	+	0	0	1709	0.0000000
zheyou73v0_A03	20268764	20270474	BnaA03T0367300ZY	0	-	0	0	1710	0.0000000
zheyou73v0_A03	20271799	20274197	BnaA03T0367400ZY	0	-	0	0	2398	0.0000000
zheyou73v0_A03	20278746	20280173	BnaA03T0367500ZY	0	-	0	0	1427	0.0000000
zheyou73v0_A03	20282715	20283479	BnaA03T0367600ZY	0	+	0	0	764	0.0000000
zheyou73v0_A03	20283909	20284518	BnaA03T0367700ZY	0	+	0	0	609	0.0000000
zheyou73v0_A03	20284845	20285610	BnaA03T0367800ZY	0	+	0	0	765	0.0000000
zheyou73v0_A03	20285955	20289573	BnaA03T0367900ZY	0	+	0	0	3618	0.0000000
zheyou73v0_A03	20289951	20290716	BnaA03T0368000ZY	0	-	0	0	765	0.0000000
zheyou73v0_A03	20299337	20300233	BnaA03T0368100ZY	0	+	0	0	896	0.0000000
zheyou73v0_A03	20308381	20310547	BnaA03T0368200ZY	0	-	0	0	2166	0.0000000
zheyou73v0_A03	20314448	20314770	BnaA03T0368300ZY	0	+	0	0	322	0.0000000
zheyou73v0_A03	20323951	20327562	BnaA03T0368400ZY	0	+	0	0	3611	0.0000000
zheyou73v0_A03	20327706	20331770	BnaA03T0368500ZY	0	-	0	0	4064	0.0000000
zheyou73v0_A03	20341911	20343871	BnaA03T0368600ZY	0	+	0	0	1960	0.0000000
zheyou73v0_A03	20341911	20343871	BnaA03T0368600ZY.1	0	+	0	0	1960	0.0000000
zheyou73v0_A03	20341911	20343871	BnaA03T0368600ZY.2	0	+	0	0	1960	0.0000000
zheyou73v0_A03	20355669	20356386	BnaA03T0368700ZY	0	-	0	0	717	0.0000000
zheyou73v0_A03	20357416	20358063	BnaA03T0368800ZY	0	+	0	0	647	0.0000000
zheyou73v0_A03	20359584	20362768	BnaA03T0368900ZY	0	-	0	0	3184	0.0000000
zheyou73v0_A03	20363252	20365631	BnaA03T0369000ZY	0	+	0	0	2379	0.0000000
zheyou73v0_A03	20366557	20369064	BnaA03T0369100ZY	0	+	0	0	2507	0.0000000
zheyou73v0_A03	20366557	20369064	BnaA03T0369100ZY.1	0	+	0	0	2507	0.0000000
zheyou73v0_A03	20368818	20369466	BnaA03T0369200ZY	0	-	0	0	648	0.0000000
zheyou73v0_A03	20370383	20371661	BnaA03T0369300ZY	0	-	0	0	1278	0.0000000
zheyou73v0_A03	20378215	20378755	BnaA03T0369400ZY	0	+	0	0	540	0.0000000
zheyou73v0_A03	20383077	20383723	BnaA03T0369500ZY	0	+	0	0	646	0.0000000
zheyou73v0_A03	20384217	20392254	BnaA03T0369600ZY	0	-	0	0	8037	0.0000000
zheyou73v0_A03	20392646	20394073	BnaA03T0369700ZY	0	-	0	0	1427	0.0000000
zheyou73v0_A03	20395834	20396799	BnaA03T0369800ZY	0	+	0	0	965	0.0000000
zheyou73v0_A03	20408142	20410652	BnaA03T0369900ZY	0	+	0	0	2510	0.0000000
zheyou73v0_A03	20408142	20410245	BnaA03T0369900ZY.1	0	+	0	0	2103	0.0000000
zheyou73v0_A03	20410725	20413973	BnaA03T0370000ZY	0	-	0	0	3248	0.0000000
zheyou73v0_A03	20415272	20416923	BnaA03T0370100ZY	0	+	0	0	1651	0.0000000
zheyou73v0_A03	20417406	20420036	BnaA03T0370200ZY	0	-	0	0	2630	0.0000000
zheyou73v0_A03	20436354	20441577	BnaA03T0370300ZY	0	+	0	0	5223	0.0000000
zheyou73v0_A03	20450265	20451694	BnaA03T0370400ZY	0	-	0	0	1429	0.0000000
zheyou73v0_A03	20458865	20460452	BnaA03T0370500ZY	0	+	0	0	1587	0.0000000
zheyou73v0_A03	20464575	20466872	BnaA03T0370600ZY	0	-	0	0	2297	0.0000000
zheyou73v0_A03	20482735	20486006	BnaA03T0370700ZY	0	-	0	0	3271	0.0000000
zheyou73v0_A03	20486638	20487396	BnaA03T0370800ZY	0	+	0	0	758	0.0000000
zheyou73v0_A03	20488900	20489260	BnaA03T0370900ZY	0	-	0	0	360	0.0000000
zheyou73v0_A03	20494213	20494514	BnaA03T0371000ZY	0	-	0	0	301	0.0000000
zheyou73v0_A03	20515254	20520856	BnaA03T0371100ZY	0	+	0	0	5602	0.0000000
zheyou73v0_A03	20519021	20520856	BnaA03T0371100ZY.1	0	+	0	0	1835	0.0000000
zheyou73v0_A03	20521653	20524377	BnaA03T0371200ZY	0	+	0	0	2724	0.0000000
zheyou73v0_A03	20525857	20528480	BnaA03T0371300ZY	0	+	0	0	2623	0.0000000
zheyou73v0_A03	20528761	20530102	BnaA03T0371400ZY	0	-	0	0	1341	0.0000000
zheyou73v0_A03	20532649	20535368	BnaA03T0371500ZY	0	-	0	0	2719	0.0000000
zheyou73v0_A03	20539564	20543157	BnaA03T0371600ZY	0	+	0	0	3593	0.0000000
zheyou73v0_A03	20543695	20544266	BnaA03T0371700ZY	0	+	0	0	571	0.0000000
zheyou73v0_A03	20558021	20559159	BnaA03T0371800ZY	0	-	0	0	1138	0.0000000
zheyou73v0_A03	20558021	20559159	BnaA03T0371800ZY.1	0	-	0	0	1138	0.0000000
zheyou73v0_A03	20571848	20573207	BnaA03T0371900ZY	0	-	0	0	1359	0.0000000
zheyou73v0_A03	20575364	20580630	BnaA03T0372000ZY	0	-	0	0	5266	0.0000000
zheyou73v0_A03	20582537	20583959	BnaA03T0372100ZY	0	+	0	0	1422	0.0000000
zheyou73v0_A03	20584764	20586681	BnaA03T0372200ZY	0	-	0	0	1917	0.0000000
zheyou73v0_A03	20588482	20591184	BnaA03T0372300ZY	0	-	0	0	2702	0.0000000
zheyou73v0_A03	20597155	20598975	BnaA03T0372400ZY	0	+	0	0	1820	0.0000000
zheyou73v0_A03	20597698	20598975	BnaA03T0372400ZY.1	0	+	0	0	1277	0.0000000
zheyou73v0_A03	20601436	20601902	BnaA03T0372500ZY	0	+	0	0	466	0.0000000
zheyou73v0_A03	20602312	20606833	BnaA03T0372600ZY	0	+	0	0	4521	0.0000000
zheyou73v0_A03	20609519	20609984	BnaA03T0372700ZY	0	+	0	0	465	0.0000000
zheyou73v0_A03	20610406	20612023	BnaA03T0372800ZY	0	+	0	0	1617	0.0000000
zheyou73v0_A03	20614248	20615100	BnaA03T0372900ZY	0	-	0	0	852	0.0000000
zheyou73v0_A03	20616054	20619007	BnaA03T0373000ZY	0	+	0	0	2953	0.0000000
zheyou73v0_A03	20619219	20621560	BnaA03T0373100ZY	0	-	0	0	2341	0.0000000
zheyou73v0_A03	20622369	20623522	BnaA03T0373200ZY	0	-	0	0	1153	0.0000000
zheyou73v0_A03	20645149	20646277	BnaA03T0373300ZY	0	-	0	0	1128	0.0000000
zheyou73v0_A03	20647533	20649918	BnaA03T0373400ZY	0	-	0	0	2385	0.0000000
zheyou73v0_A03	20651913	20653977	BnaA03T0373500ZY	0	-	0	0	2064	0.0000000
zheyou73v0_A03	20654482	20654773	BnaA03T0373600ZY	0	-	0	0	291	0.0000000
zheyou73v0_A03	20655327	20657457	BnaA03T0373700ZY	0	-	0	0	2130	0.0000000
zheyou73v0_A03	20658783	20661398	BnaA03T0373800ZY	0	-	0	0	2615	0.0000000
zheyou73v0_A03	20666516	20667356	BnaA03T0373900ZY	0	+	0	0	840	0.0000000
zheyou73v0_A03	20667470	20668805	BnaA03T0374000ZY	0	-	0	0	1335	0.0000000
zheyou73v0_A03	20671730	20674103	BnaA03T0374100ZY	0	-	0	0	2373	0.0000000
zheyou73v0_A03	20680497	20683069	BnaA03T0374200ZY	0	+	0	0	2572	0.0000000
zheyou73v0_A03	20684308	20686756	BnaA03T0374300ZY	0	-	0	0	2448	0.0000000
zheyou73v0_A03	20692986	20693588	BnaA03T0374400ZY	0	-	0	0	602	0.0000000
zheyou73v0_A03	20697425	20700245	BnaA03T0374500ZY	0	-	0	0	2820	0.0000000
zheyou73v0_A03	20706567	20707877	BnaA03T0374600ZY	0	+	0	0	1310	0.0000000
zheyou73v0_A03	20716548	20717219	BnaA03T0374700ZY	0	-	0	0	671	0.0000000
zheyou73v0_A03	20719634	20728639	BnaA03T0374800ZY	0	+	0	0	9005	0.0000000
zheyou73v0_A03	20730385	20732521	BnaA03T0374900ZY	0	+	0	0	2136	0.0000000
zheyou73v0_A03	20733234	20734915	BnaA03T0375000ZY	0	+	0	0	1681	0.0000000
zheyou73v0_A03	20742097	20749922	BnaA03T0375100ZY	0	+	0	0	7825	0.0000000
zheyou73v0_A03	20749513	20752256	BnaA03T0375200ZY	0	+	0	0	2743	0.0000000
zheyou73v0_A03	20753063	20755563	BnaA03T0375300ZY	0	+	0	0	2500	0.0000000
zheyou73v0_A03	20755575	20758921	BnaA03T0375400ZY	0	+	0	0	3346	0.0000000
zheyou73v0_A03	20760104	20764606	BnaA03T0375500ZY	0	+	0	0	4502	0.0000000
zheyou73v0_A03	20765575	20774104	BnaA03T0375600ZY	0	-	0	0	8529	0.0000000
zheyou73v0_A03	20796977	20801966	BnaA03T0375700ZY	0	+	0	0	4989	0.0000000
zheyou73v0_A03	20805453	20806521	BnaA03T0375800ZY	0	+	0	0	1068	0.0000000
zheyou73v0_A03	20807508	20809100	BnaA03T0375900ZY	0	+	0	0	1592	0.0000000
zheyou73v0_A03	20809761	20812232	BnaA03T0376000ZY	0	+	0	0	2471	0.0000000
zheyou73v0_A03	20813170	20814701	BnaA03T0376100ZY	0	+	0	0	1531	0.0000000
zheyou73v0_A03	20815574	20818358	BnaA03T0376200ZY	0	-	0	0	2784	0.0000000
zheyou73v0_A03	20815574	20818358	BnaA03T0376200ZY.1	0	-	0	0	2784	0.0000000
zheyou73v0_A03	20819736	20821266	BnaA03T0376300ZY	0	-	0	0	1530	0.0000000
zheyou73v0_A03	20823362	20825873	BnaA03T0376400ZY	0	-	0	0	2511	0.0000000
zheyou73v0_A03	20830221	20830869	BnaA03T0376500ZY	0	-	0	0	648	0.0000000
zheyou73v0_A03	20835453	20837183	BnaA03T0376600ZY	0	-	0	0	1730	0.0000000
zheyou73v0_A03	20837624	20838071	BnaA03T0376700ZY	0	-	0	0	447	0.0000000
zheyou73v0_A03	20843551	20853306	BnaA03T0376800ZY	0	+	0	0	9755	0.0000000
zheyou73v0_A03	20855594	20855888	BnaA03T0376900ZY	0	+	0	0	294	0.0000000
zheyou73v0_A03	20862541	20864358	BnaA03T0377000ZY	0	+	0	0	1817	0.0000000
zheyou73v0_A03	20870405	20870771	BnaA03T0377100ZY	0	-	0	0	366	0.0000000
zheyou73v0_A03	20871161	20874278	BnaA03T0377200ZY	0	+	0	0	3117	0.0000000
zheyou73v0_A03	20874446	20874698	BnaA03T0377300ZY	0	+	0	0	252	0.0000000
zheyou73v0_A03	20878483	20880218	BnaA03T0377400ZY	0	+	0	0	1735	0.0000000
zheyou73v0_A03	20880057	20881779	BnaA03T0377500ZY	0	-	0	0	1722	0.0000000
zheyou73v0_A03	20885224	20887466	BnaA03T0377600ZY	0	+	0	0	2242	0.0000000
zheyou73v0_A03	20889043	20893641	BnaA03T0377700ZY	0	+	0	0	4598	0.0000000
zheyou73v0_A03	20895434	20896887	BnaA03T0377800ZY	0	+	0	0	1453	0.0000000
zheyou73v0_A03	20897467	20900177	BnaA03T0377900ZY	0	-	0	0	2710	0.0000000
zheyou73v0_A03	20901634	20905890	BnaA03T0378000ZY	0	+	0	0	4256	0.0000000
zheyou73v0_A03	20906182	20906879	BnaA03T0378100ZY	0	-	0	0	697	0.0000000
zheyou73v0_A03	20907196	20910142	BnaA03T0378200ZY	0	-	0	0	2946	0.0000000
zheyou73v0_A03	20917072	20917708	BnaA03T0378300ZY	0	+	0	0	636	0.0000000
zheyou73v0_A03	20920168	20925822	BnaA03T0378400ZY	0	-	0	0	5654	0.0000000
zheyou73v0_A03	20920168	20925580	BnaA03T0378400ZY.1	0	-	0	0	5412	0.0000000
zheyou73v0_A03	20928008	20929902	BnaA03T0378500ZY	0	+	0	0	1894	0.0000000
zheyou73v0_A03	20934815	20937167	BnaA03T0378600ZY	0	+	0	0	2352	0.0000000
zheyou73v0_A03	20942279	20944853	BnaA03T0378700ZY	0	-	0	0	2574	0.0000000
zheyou73v0_A03	20942279	20944788	BnaA03T0378700ZY.1	0	-	0	0	2509	0.0000000
zheyou73v0_A03	20969066	20969507	BnaA03T0378800ZY	0	-	0	0	441	0.0000000
zheyou73v0_A03	20971802	20972192	BnaA03T0378900ZY	0	-	0	0	390	0.0000000
zheyou73v0_A03	20980029	20981116	BnaA03T0379000ZY	0	+	0	0	1087	0.0000000
zheyou73v0_A03	20989384	20991499	BnaA03T0379100ZY	0	-	0	0	2115	0.0000000
zheyou73v0_A03	20993082	20993271	BnaA03T0379200ZY	0	-	0	0	189	0.0000000
zheyou73v0_A03	20996424	20998069	BnaA03T0379300ZY	0	+	0	0	1645	0.0000000
zheyou73v0_A03	21002128	21002699	BnaA03T0379400ZY	0	+	0	0	571	0.0000000
zheyou73v0_A03	21005341	21006591	BnaA03T0379500ZY	0	+	0	0	1250	0.0000000
zheyou73v0_A03	21006931	21008721	BnaA03T0379600ZY	0	-	0	0	1790	0.0000000
zheyou73v0_A03	21012799	21013271	BnaA03T0379700ZY	0	-	0	0	472	0.0000000
zheyou73v0_A03	21013616	21016987	BnaA03T0379800ZY	0	-	0	0	3371	0.0000000
zheyou73v0_A03	21013616	21016987	BnaA03T0379800ZY.1	0	-	0	0	3371	0.0000000
zheyou73v0_A03	21020447	21023447	BnaA03T0379900ZY	0	-	0	0	3000	0.0000000
zheyou73v0_A03	21020447	21023240	BnaA03T0379900ZY.1	0	-	0	0	2793	0.0000000
zheyou73v0_A03	21023714	21025606	BnaA03T0380000ZY	0	+	0	0	1892	0.0000000
zheyou73v0_A03	21026038	21027760	BnaA03T0380100ZY	0	-	0	0	1722	0.0000000
zheyou73v0_A03	21030882	21032675	BnaA03T0380200ZY	0	-	0	0	1793	0.0000000
zheyou73v0_A03	21033429	21035533	BnaA03T0380300ZY	0	-	0	0	2104	0.0000000
zheyou73v0_A03	21036312	21037005	BnaA03T0380400ZY	0	-	0	0	693	0.0000000
zheyou73v0_A03	21038885	21042824	BnaA03T0380500ZY	0	-	0	0	3939	0.0000000
zheyou73v0_A03	21046811	21052960	BnaA03T0380600ZY	0	+	0	0	6149	0.0000000
zheyou73v0_A03	21055020	21055586	BnaA03T0380700ZY	0	-	0	0	566	0.0000000
zheyou73v0_A03	21055994	21064415	BnaA03T0380800ZY	0	+	0	0	8421	0.0000000
zheyou73v0_A03	21067200	21068505	BnaA03T0380900ZY	0	+	0	0	1305	0.0000000
zheyou73v0_A03	21069190	21074025	BnaA03T0381000ZY	0	-	0	0	4835	0.0000000
zheyou73v0_A03	21069190	21074025	BnaA03T0381000ZY.1	0	-	0	0	4835	0.0000000
zheyou73v0_A03	21069190	21074025	BnaA03T0381000ZY.2	0	-	0	0	4835	0.0000000
zheyou73v0_A03	21069190	21074025	BnaA03T0381000ZY.3	0	-	0	0	4835	0.0000000
zheyou73v0_A03	21083297	21091670	BnaA03T0381100ZY	0	-	0	0	8373	0.0000000
zheyou73v0_A03	21092599	21095166	BnaA03T0381200ZY	0	-	0	0	2567	0.0000000
zheyou73v0_A03	21096073	21097431	BnaA03T0381300ZY	0	-	0	0	1358	0.0000000
zheyou73v0_A03	21102777	21104916	BnaA03T0381400ZY	0	+	0	0	2139	0.0000000
zheyou73v0_A03	21107684	21108947	BnaA03T0381500ZY	0	+	0	0	1263	0.0000000
zheyou73v0_A03	21120719	21121025	BnaA03T0381600ZY	0	+	0	0	306	0.0000000
zheyou73v0_A03	21121922	21122381	BnaA03T0381700ZY	0	+	0	0	459	0.0000000
zheyou73v0_A03	21122777	21125036	BnaA03T0381800ZY	0	-	0	0	2259	0.0000000
zheyou73v0_A03	21122777	21125237	BnaA03T0381800ZY.1	0	-	0	0	2460	0.0000000
zheyou73v0_A03	21135617	21136625	BnaA03T0381900ZY	0	+	0	0	1008	0.0000000
zheyou73v0_A03	21139097	21143385	BnaA03T0382000ZY	0	-	0	0	4288	0.0000000
zheyou73v0_A03	21147548	21147905	BnaA03T0382100ZY	0	+	0	0	357	0.0000000
zheyou73v0_A03	21150864	21152316	BnaA03T0382200ZY	0	-	0	0	1452	0.0000000
zheyou73v0_A03	21153404	21153791	BnaA03T0382300ZY	0	-	0	0	387	0.0000000
zheyou73v0_A03	21160223	21160740	BnaA03T0382400ZY	0	-	0	0	517	0.0000000
zheyou73v0_A03	21170805	21171538	BnaA03T0382500ZY	0	+	0	0	733	0.0000000
zheyou73v0_A03	21172042	21175474	BnaA03T0382600ZY	0	-	0	0	3432	0.0000000
zheyou73v0_A03	21200329	21202185	BnaA03T0382700ZY	0	-	0	0	1856	0.0000000
zheyou73v0_A03	21203229	21205425	BnaA03T0382800ZY	0	-	0	0	2196	0.0000000
zheyou73v0_A03	21205935	21207681	BnaA03T0382900ZY	0	-	0	0	1746	0.0000000
zheyou73v0_A03	21209174	21210418	BnaA03T0383000ZY	0	-	0	0	1244	0.0000000
zheyou73v0_A03	21211350	21214331	BnaA03T0383100ZY	0	-	0	0	2981	0.0000000
zheyou73v0_A03	21218467	21218965	BnaA03T0383200ZY	0	-	0	0	498	0.0000000
zheyou73v0_A03	21220493	21220802	BnaA03T0383300ZY	0	-	0	0	309	0.0000000
zheyou73v0_A03	21221099	21222050	BnaA03T0383400ZY	0	-	0	0	951	0.0000000
zheyou73v0_A03	21226592	21231411	BnaA03T0383500ZY	0	+	0	0	4819	0.0000000
zheyou73v0_A03	21233703	21235685	BnaA03T0383600ZY	0	+	0	0	1982	0.0000000
zheyou73v0_A03	21245192	21246548	BnaA03T0383700ZY	0	+	0	0	1356	0.0000000
zheyou73v0_A03	21256999	21261680	BnaA03T0383800ZY	0	-	0	0	4681	0.0000000
zheyou73v0_A03	21265092	21265729	BnaA03T0383900ZY	0	-	0	0	637	0.0000000
zheyou73v0_A03	21268157	21269060	BnaA03T0384000ZY	0	+	0	0	903	0.0000000
zheyou73v0_A03	21274143	21275911	BnaA03T0384100ZY	0	+	0	0	1768	0.0000000
zheyou73v0_A03	21276287	21278062	BnaA03T0384200ZY	0	+	0	0	1775	0.0000000
zheyou73v0_A03	21280696	21282303	BnaA03T0384300ZY	0	-	0	0	1607	0.0000000
zheyou73v0_A03	21285643	21287484	BnaA03T0384400ZY	0	-	0	0	1841	0.0000000
zheyou73v0_A03	21289314	21290582	BnaA03T0384500ZY	0	+	0	0	1268	0.0000000
zheyou73v0_A03	21295568	21297178	BnaA03T0384600ZY	0	+	0	0	1610	0.0000000
zheyou73v0_A03	21301781	21303401	BnaA03T0384700ZY	0	+	0	0	1620	0.0000000
zheyou73v0_A03	21305441	21305882	BnaA03T0384800ZY	0	-	0	0	441	0.0000000
zheyou73v0_A03	21307343	21308582	BnaA03T0384900ZY	0	-	0	0	1239	0.0000000
zheyou73v0_A03	21309640	21310131	BnaA03T0385000ZY	0	+	0	0	491	0.0000000
zheyou73v0_A03	21322371	21322790	BnaA03T0385100ZY	0	-	0	0	419	0.0000000
zheyou73v0_A03	21323453	21332231	BnaA03T0385200ZY	0	-	0	0	8778	0.0000000
zheyou73v0_A03	21339727	21340313	BnaA03T0385300ZY	0	-	0	0	586	0.0000000
zheyou73v0_A03	21352478	21354398	BnaA03T0385400ZY	0	+	0	0	1920	0.0000000
zheyou73v0_A03	21357529	21357706	BnaA03T0385500ZY	0	+	0	0	177	0.0000000
zheyou73v0_A03	21358452	21359585	BnaA03T0385600ZY	0	-	0	0	1133	0.0000000
zheyou73v0_A03	21363030	21366268	BnaA03T0385700ZY	0	+	0	0	3238	0.0000000
zheyou73v0_A03	21366919	21367763	BnaA03T0385800ZY	0	+	0	0	844	0.0000000
zheyou73v0_A03	21368426	21369916	BnaA03T0385900ZY	0	-	0	0	1490	0.0000000
zheyou73v0_A03	21371236	21373599	BnaA03T0386000ZY	0	+	0	0	2363	0.0000000
zheyou73v0_A03	21378928	21384522	BnaA03T0386100ZY	0	+	0	0	5594	0.0000000
zheyou73v0_A03	21386949	21387368	BnaA03T0386200ZY	0	+	0	0	419	0.0000000
zheyou73v0_A03	21392832	21395059	BnaA03T0386300ZY	0	+	0	0	2227	0.0000000
zheyou73v0_A03	21395397	21396351	BnaA03T0386400ZY	0	+	0	0	954	0.0000000
zheyou73v0_A03	21396412	21397334	BnaA03T0386500ZY	0	-	0	0	922	0.0000000
zheyou73v0_A03	21398715	21400737	BnaA03T0386600ZY	0	+	0	0	2022	0.0000000
zheyou73v0_A03	21402336	21404064	BnaA03T0386700ZY	0	+	0	0	1728	0.0000000
zheyou73v0_A03	21405571	21406010	BnaA03T0386800ZY	0	-	0	0	439	0.0000000
zheyou73v0_A03	21415528	21417243	BnaA03T0386900ZY	0	-	0	0	1715	0.0000000
zheyou73v0_A03	21415528	21417243	BnaA03T0386900ZY.1	0	-	0	0	1715	0.0000000
zheyou73v0_A03	21426119	21427183	BnaA03T0387000ZY	0	-	0	0	1064	0.0000000
zheyou73v0_A03	21426119	21427183	BnaA03T0387000ZY.1	0	-	0	0	1064	0.0000000
zheyou73v0_A03	21428150	21429053	BnaA03T0387100ZY	0	+	0	0	903	0.0000000
zheyou73v0_A03	21432508	21433591	BnaA03T0387200ZY	0	-	0	0	1083	0.0000000
zheyou73v0_A03	21434992	21435385	BnaA03T0387300ZY	0	+	0	0	393	0.0000000
zheyou73v0_A03	21437448	21437814	BnaA03T0387400ZY	0	+	0	0	366	0.0000000
zheyou73v0_A03	21438212	21440108	BnaA03T0387500ZY	0	-	0	0	1896	0.0000000
zheyou73v0_A03	21440813	21441639	BnaA03T0387600ZY	0	+	0	0	826	0.0000000
zheyou73v0_A03	21446378	21453040	BnaA03T0387700ZY	0	+	0	0	6662	0.0000000
zheyou73v0_A03	21457029	21458746	BnaA03T0387800ZY	0	+	0	0	1717	0.0000000
zheyou73v0_A03	21479574	21480547	BnaA03T0387900ZY	0	+	0	0	973	0.0000000
zheyou73v0_A03	21481133	21482276	BnaA03T0388000ZY	0	+	0	0	1143	0.0000000
zheyou73v0_A03	21482931	21483506	BnaA03T0388100ZY	0	-	0	0	575	0.0000000
zheyou73v0_A03	21496878	21499213	BnaA03T0388200ZY	0	+	0	0	2335	0.0000000
zheyou73v0_A03	21501039	21502548	BnaA03T0388300ZY	0	-	0	0	1509	0.0000000
zheyou73v0_A03	21504000	21504580	BnaA03T0388400ZY	0	+	0	0	580	0.0000000
zheyou73v0_A03	21515921	21517260	BnaA03T0388500ZY	0	+	0	0	1339	0.0000000
zheyou73v0_A03	21515921	21517260	BnaA03T0388500ZY.1	0	+	0	0	1339	0.0000000
zheyou73v0_A03	21517323	21519002	BnaA03T0388600ZY	0	-	0	0	1679	0.0000000
zheyou73v0_A03	21520021	21523502	BnaA03T0388700ZY	0	+	0	0	3481	0.0000000
zheyou73v0_A03	21549986	21551655	BnaA03T0388800ZY	0	+	0	0	1669	0.0000000
zheyou73v0_A03	21559405	21560390	BnaA03T0388900ZY	0	-	0	0	985	0.0000000
zheyou73v0_A03	21562160	21563104	BnaA03T0389000ZY	0	-	0	0	944	0.0000000
zheyou73v0_A03	21580968	21582566	BnaA03T0389100ZY	0	+	0	0	1598	0.0000000
zheyou73v0_A03	21584765	21584996	BnaA03T0389200ZY	0	-	0	0	231	0.0000000
zheyou73v0_A03	21586015	21586918	BnaA03T0389300ZY	0	+	0	0	903	0.0000000
zheyou73v0_A03	21592225	21594522	BnaA03T0389400ZY	0	+	0	0	2297	0.0000000
zheyou73v0_A03	21595872	21599526	BnaA03T0389500ZY	0	-	0	0	3654	0.0000000
zheyou73v0_A03	21605687	21606203	BnaA03T0389600ZY	0	+	0	0	516	0.0000000
zheyou73v0_A03	21609750	21610432	BnaA03T0389700ZY	0	-	0	0	682	0.0000000
zheyou73v0_A03	21619540	21620777	BnaA03T0389800ZY	0	+	0	0	1237	0.0000000
zheyou73v0_A03	21628583	21629772	BnaA03T0389900ZY	0	+	0	0	1189	0.0000000
zheyou73v0_A03	21638319	21639855	BnaA03T0390000ZY	0	+	0	0	1536	0.0000000
zheyou73v0_A03	21641992	21644567	BnaA03T0390100ZY	0	+	0	0	2575	0.0000000
zheyou73v0_A03	21646190	21646942	BnaA03T0390200ZY	0	+	0	0	752	0.0000000
zheyou73v0_A03	21647854	21648759	BnaA03T0390300ZY	0	+	0	0	905	0.0000000
zheyou73v0_A03	21650699	21656656	BnaA03T0390400ZY	0	+	0	0	5957	0.0000000
zheyou73v0_A03	21657091	21658088	BnaA03T0390500ZY	0	-	0	0	997	0.0000000
zheyou73v0_A03	21661062	21666389	BnaA03T0390600ZY	0	+	0	0	5327	0.0000000
zheyou73v0_A03	21667659	21668106	BnaA03T0390700ZY	0	+	0	0	447	0.0000000
zheyou73v0_A03	21669720	21671404	BnaA03T0390800ZY	0	-	0	0	1684	0.0000000
zheyou73v0_A03	21674368	21675664	BnaA03T0390900ZY	0	-	0	0	1296	0.0000000
zheyou73v0_A03	21676524	21678182	BnaA03T0391000ZY	0	+	0	0	1658	0.0000000
zheyou73v0_A03	21679869	21684651	BnaA03T0391100ZY	0	+	0	0	4782	0.0000000
zheyou73v0_A03	21684814	21685216	BnaA03T0391200ZY	0	+	0	0	402	0.0000000
zheyou73v0_A03	21685990	21688199	BnaA03T0391300ZY	0	-	0	0	2209	0.0000000
zheyou73v0_A03	21701345	21702331	BnaA03T0391400ZY	0	-	0	0	986	0.0000000
zheyou73v0_A03	21716848	21718865	BnaA03T0391500ZY	0	+	0	0	2017	0.0000000
zheyou73v0_A03	21722026	21723759	BnaA03T0391600ZY	0	+	0	0	1733	0.0000000
zheyou73v0_A03	21726431	21727697	BnaA03T0391700ZY	0	+	0	0	1266	0.0000000
zheyou73v0_A03	21740735	21744522	BnaA03T0391800ZY	0	-	0	0	3787	0.0000000
zheyou73v0_A03	21744945	21746995	BnaA03T0391900ZY	0	-	0	0	2050	0.0000000
zheyou73v0_A03	21754822	21756282	BnaA03T0392000ZY	0	-	0	0	1460	0.0000000
zheyou73v0_A03	21767636	21770112	BnaA03T0392100ZY	0	-	0	0	2476	0.0000000
zheyou73v0_A03	21785840	21788488	BnaA03T0392200ZY	0	+	0	0	2648	0.0000000
zheyou73v0_A03	21788914	21792256	BnaA03T0392300ZY	0	-	0	0	3342	0.0000000
zheyou73v0_A03	21794257	21795347	BnaA03T0392400ZY	0	+	0	0	1090	0.0000000
zheyou73v0_A03	21796900	21797321	BnaA03T0392500ZY	0	+	0	0	421	0.0000000
zheyou73v0_A03	21797621	21801166	BnaA03T0392600ZY	0	-	0	0	3545	0.0000000
zheyou73v0_A03	21814473	21814899	BnaA03T0392700ZY	0	+	0	0	426	0.0000000
zheyou73v0_A03	21815838	21818311	BnaA03T0392800ZY	0	-	0	0	2473	0.0000000
zheyou73v0_A03	21822832	21823213	BnaA03T0392900ZY	0	-	0	0	381	0.0000000
zheyou73v0_A03	21828018	21828396	BnaA03T0393000ZY	0	-	0	0	378	0.0000000
zheyou73v0_A03	21830596	21832194	BnaA03T0393100ZY	0	-	0	0	1598	0.0000000
zheyou73v0_A03	21844745	21846249	BnaA03T0393200ZY	0	+	0	0	1504	0.0000000
zheyou73v0_A03	21847705	21848285	BnaA03T0393300ZY	0	-	0	0	580	0.0000000
zheyou73v0_A03	21852960	21853987	BnaA03T0393400ZY	0	-	0	0	1027	0.0000000
zheyou73v0_A03	21864489	21866703	BnaA03T0393500ZY	0	+	0	0	2214	0.0000000
zheyou73v0_A03	21867053	21870262	BnaA03T0393600ZY	0	-	0	0	3209	0.0000000
zheyou73v0_A03	21871222	21874595	BnaA03T0393700ZY	0	-	0	0	3373	0.0000000
zheyou73v0_A03	21875991	21878427	BnaA03T0393800ZY	0	+	0	0	2436	0.0000000
zheyou73v0_A03	21878707	21881327	BnaA03T0393900ZY	0	-	0	0	2620	0.0000000
zheyou73v0_A03	21878707	21881327	BnaA03T0393900ZY.1	0	-	0	0	2620	0.0000000
zheyou73v0_A03	21883088	21884435	BnaA03T0394000ZY	0	+	0	0	1347	0.0000000
zheyou73v0_A03	21885666	21887451	BnaA03T0394100ZY	0	-	0	0	1785	0.0000000
zheyou73v0_A03	21920832	21923659	BnaA03T0394200ZY	0	-	0	0	2827	0.0000000
zheyou73v0_A03	21933680	21935049	BnaA03T0394300ZY	0	+	0	0	1369	0.0000000
zheyou73v0_A03	21935902	21945832	BnaA03T0394400ZY	0	-	0	0	9930	0.0000000
zheyou73v0_A03	21970132	21970697	BnaA03T0394500ZY	0	-	0	0	565	0.0000000
zheyou73v0_A03	21974956	21981637	BnaA03T0394600ZY	0	-	0	0	6681	0.0000000
zheyou73v0_A03	21984251	21985354	BnaA03T0394700ZY	0	+	0	0	1103	0.0000000
zheyou73v0_A03	21995885	21996542	BnaA03T0394800ZY	0	-	0	0	657	0.0000000
zheyou73v0_A03	22001408	22001834	BnaA03T0394900ZY	0	-	0	0	426	0.0000000
zheyou73v0_A03	22005337	22007134	BnaA03T0395000ZY	0	-	0	0	1797	0.0000000
zheyou73v0_A03	22005337	22007134	BnaA03T0395000ZY.1	0	-	0	0	1797	0.0000000
zheyou73v0_A03	22008296	22011870	BnaA03T0395100ZY	0	-	0	0	3574	0.0000000
zheyou73v0_A03	22023315	22026136	BnaA03T0395200ZY	0	+	0	0	2821	0.0000000
zheyou73v0_A03	22029062	22031421	BnaA03T0395300ZY	0	+	0	0	2359	0.0000000
zheyou73v0_A03	22034588	22035592	BnaA03T0395400ZY	0	-	0	0	1004	0.0000000
zheyou73v0_A03	22036862	22040485	BnaA03T0395500ZY	0	+	0	0	3623	0.0000000
zheyou73v0_A03	22040537	22041540	BnaA03T0395600ZY	0	-	0	0	1003	0.0000000
zheyou73v0_A03	22047060	22048321	BnaA03T0395700ZY	0	+	0	0	1261	0.0000000
zheyou73v0_A03	22051590	22053692	BnaA03T0395800ZY	0	+	0	0	2102	0.0000000
zheyou73v0_A03	22051590	22053692	BnaA03T0395800ZY.1	0	+	0	0	2102	0.0000000
zheyou73v0_A03	22051590	22053692	BnaA03T0395800ZY.2	0	+	0	0	2102	0.0000000
zheyou73v0_A03	22060058	22061224	BnaA03T0395900ZY	0	+	0	0	1166	0.0000000
zheyou73v0_A03	22064370	22065892	BnaA03T0396000ZY	0	+	0	0	1522	0.0000000
zheyou73v0_A03	22066073	22075304	BnaA03T0396100ZY	0	-	0	0	9231	0.0000000
zheyou73v0_A03	22076393	22078029	BnaA03T0396200ZY	0	+	0	0	1636	0.0000000
zheyou73v0_A03	22076393	22078029	BnaA03T0396200ZY.1	0	+	0	0	1636	0.0000000
zheyou73v0_A03	22082176	22084133	BnaA03T0396300ZY	0	+	0	0	1957	0.0000000
zheyou73v0_A03	22085135	22087877	BnaA03T0396400ZY	0	-	0	0	2742	0.0000000
zheyou73v0_A03	22090211	22091969	BnaA03T0396500ZY	0	+	0	0	1758	0.0000000
zheyou73v0_A03	22098057	22099911	BnaA03T0396600ZY	0	+	0	0	1854	0.0000000
zheyou73v0_A03	22116665	22117316	BnaA03T0396700ZY	0	+	0	0	651	0.0000000
zheyou73v0_A03	22118293	22118797	BnaA03T0396800ZY	0	+	0	0	504	0.0000000
zheyou73v0_A03	22122994	22124632	BnaA03T0396900ZY	0	-	0	0	1638	0.0000000
zheyou73v0_A03	22125313	22125529	BnaA03T0397000ZY	0	-	0	0	216	0.0000000
zheyou73v0_A03	22127604	22129000	BnaA03T0397100ZY	0	-	0	0	1396	0.0000000
zheyou73v0_A03	22132468	22134645	BnaA03T0397200ZY	0	-	0	0	2177	0.0000000
zheyou73v0_A03	22142328	22143670	BnaA03T0397300ZY	0	+	0	0	1342	0.0000000
zheyou73v0_A03	22146326	22147877	BnaA03T0397400ZY	0	+	0	0	1551	0.0000000
zheyou73v0_A03	22152327	22155469	BnaA03T0397500ZY	0	+	0	0	3142	0.0000000
zheyou73v0_A03	22152327	22155469	BnaA03T0397500ZY.1	0	+	0	0	3142	0.0000000
zheyou73v0_A03	22155956	22156805	BnaA03T0397600ZY	0	+	0	0	849	0.0000000
zheyou73v0_A03	22158181	22174841	BnaA03T0397700ZY	0	+	0	0	16660	0.0000000
zheyou73v0_A03	22178858	22180410	BnaA03T0397800ZY	0	-	0	0	1552	0.0000000
zheyou73v0_A03	22181923	22183598	BnaA03T0397900ZY	0	+	0	0	1675	0.0000000
zheyou73v0_A03	22184291	22185303	BnaA03T0398000ZY	0	-	0	0	1012	0.0000000
zheyou73v0_A03	22186419	22190147	BnaA03T0398100ZY	0	-	0	0	3728	0.0000000
zheyou73v0_A03	22200727	22202630	BnaA03T0398200ZY	0	+	0	0	1903	0.0000000
zheyou73v0_A03	22203138	22216236	BnaA03T0398300ZY	0	-	0	0	13098	0.0000000
zheyou73v0_A03	22222913	22229003	BnaA03T0398400ZY	0	-	0	0	6090	0.0000000
zheyou73v0_A03	22236484	22236917	BnaA03T0398500ZY	0	+	0	0	433	0.0000000
zheyou73v0_A03	22237427	22238856	BnaA03T0398600ZY	0	-	0	0	1429	0.0000000
zheyou73v0_A03	22244339	22247899	BnaA03T0398700ZY	0	+	0	0	3560	0.0000000
zheyou73v0_A03	22248251	22250755	BnaA03T0398800ZY	0	+	0	0	2504	0.0000000
zheyou73v0_A03	22251989	22253297	BnaA03T0398900ZY	0	-	0	0	1308	0.0000000
zheyou73v0_A03	22253317	22253743	BnaA03T0399000ZY	0	-	0	0	426	0.0000000
zheyou73v0_A03	22267296	22267927	BnaA03T0399100ZY	0	+	0	0	631	0.0000000
zheyou73v0_A03	22274821	22275037	BnaA03T0399200ZY	0	+	0	0	216	0.0000000
zheyou73v0_A03	22275805	22276342	BnaA03T0399300ZY	0	-	0	0	537	0.0000000
zheyou73v0_A03	22276615	22278066	BnaA03T0399400ZY	0	+	0	0	1451	0.0000000
zheyou73v0_A03	22281683	22282567	BnaA03T0399500ZY	0	+	0	0	884	0.0000000
zheyou73v0_A03	22287787	22288426	BnaA03T0399600ZY	0	+	0	0	639	0.0000000
zheyou73v0_A03	22288684	22289122	BnaA03T0399700ZY	0	-	0	0	438	0.0000000
zheyou73v0_A03	22290461	22291999	BnaA03T0399800ZY	0	+	0	0	1538	0.0000000
zheyou73v0_A03	22292143	22294638	BnaA03T0399900ZY	0	-	0	0	2495	0.0000000
zheyou73v0_A03	22295874	22297695	BnaA03T0400000ZY	0	+	0	0	1821	0.0000000
zheyou73v0_A03	22301023	22302906	BnaA03T0400100ZY	0	+	0	0	1883	0.0000000
zheyou73v0_A03	22307397	22314126	BnaA03T0400200ZY	0	+	0	0	6729	0.0000000
zheyou73v0_A03	22320671	22322224	BnaA03T0400300ZY	0	+	0	0	1553	0.0000000
zheyou73v0_A03	22322628	22323581	BnaA03T0400400ZY	0	+	0	0	953	0.0000000
zheyou73v0_A03	22340441	22340717	BnaA03T0400500ZY	0	+	0	0	276	0.0000000
zheyou73v0_A03	22343385	22346359	BnaA03T0400600ZY	0	-	0	0	2974	0.0000000
zheyou73v0_A03	22347191	22347616	BnaA03T0400700ZY	0	-	0	0	425	0.0000000
zheyou73v0_A03	22352286	22353029	BnaA03T0400800ZY	0	-	0	0	743	0.0000000
zheyou73v0_A03	22353330	22355238	BnaA03T0400900ZY	0	+	0	0	1908	0.0000000
zheyou73v0_A03	22355311	22357670	BnaA03T0401000ZY	0	-	0	0	2359	0.0000000
zheyou73v0_A03	22358065	22361122	BnaA03T0401100ZY	0	+	0	0	3057	0.0000000
zheyou73v0_A03	22362875	22365643	BnaA03T0401200ZY	0	+	0	0	2768	0.0000000
zheyou73v0_A03	22365756	22371722	BnaA03T0401300ZY	0	-	0	0	5966	0.0000000
zheyou73v0_A03	22366810	22371722	BnaA03T0401300ZY.1	0	-	0	0	4912	0.0000000
zheyou73v0_A03	22375366	22378482	BnaA03T0401400ZY	0	-	0	0	3116	0.0000000
zheyou73v0_A03	22392503	22393513	BnaA03T0401500ZY	0	+	0	0	1010	0.0000000
zheyou73v0_A03	22395289	22396321	BnaA03T0401600ZY	0	-	0	0	1032	0.0000000
zheyou73v0_A03	22396873	22401863	BnaA03T0401700ZY	0	-	0	0	4990	0.0000000
zheyou73v0_A03	22407178	22409631	BnaA03T0401800ZY	0	+	0	0	2453	0.0000000
zheyou73v0_A03	22410534	22410879	BnaA03T0401900ZY	0	-	0	0	345	0.0000000
zheyou73v0_A03	22411733	22414068	BnaA03T0402000ZY	0	-	0	0	2335	0.0000000
zheyou73v0_A03	22418894	22420593	BnaA03T0402100ZY	0	+	0	0	1699	0.0000000
zheyou73v0_A03	22426013	22426758	BnaA03T0402200ZY	0	+	0	0	745	0.0000000
zheyou73v0_A03	22428812	22430024	BnaA03T0402300ZY	0	-	0	0	1212	0.0000000
zheyou73v0_A03	22436146	22436927	BnaA03T0402400ZY	0	+	0	0	781	0.0000000
zheyou73v0_A03	22440113	22444170	BnaA03T0402500ZY	0	+	0	0	4057	0.0000000
zheyou73v0_A03	22444560	22445044	BnaA03T0402600ZY	0	-	0	0	484	0.0000000
zheyou73v0_A03	22445562	22446654	BnaA03T0402700ZY	0	-	0	0	1092	0.0000000
zheyou73v0_A03	22450719	22456040	BnaA03T0402800ZY	0	+	0	0	5321	0.0000000
zheyou73v0_A03	22457125	22460167	BnaA03T0402900ZY	0	+	0	0	3042	0.0000000
zheyou73v0_A03	22457125	22459198	BnaA03T0402900ZY.1	0	+	0	0	2073	0.0000000
zheyou73v0_A03	22461037	22464103	BnaA03T0403000ZY	0	+	0	0	3066	0.0000000
zheyou73v0_A03	22467724	22471767	BnaA03T0403100ZY	0	+	0	0	4043	0.0000000
zheyou73v0_A03	22467724	22470653	BnaA03T0403100ZY.1	0	+	0	0	2929	0.0000000
zheyou73v0_A03	22472729	22476639	BnaA03T0403200ZY	0	-	0	0	3910	0.0000000
zheyou73v0_A03	22478846	22484111	BnaA03T0403300ZY	0	-	0	0	5265	0.0000000
zheyou73v0_A03	22486240	22489317	BnaA03T0403400ZY	0	+	0	0	3077	0.0000000
zheyou73v0_A03	22490505	22491333	BnaA03T0403500ZY	0	-	0	0	828	0.0000000
zheyou73v0_A03	22492486	22494581	BnaA03T0403600ZY	0	-	0	0	2095	0.0000000
zheyou73v0_A03	22502950	22504465	BnaA03T0403700ZY	0	+	0	0	1515	0.0000000
zheyou73v0_A03	22506757	22513299	BnaA03T0403800ZY	0	+	0	0	6542	0.0000000
zheyou73v0_A03	22514010	22517370	BnaA03T0403900ZY	0	+	0	0	3360	0.0000000
zheyou73v0_A03	22517434	22519575	BnaA03T0404000ZY	0	-	0	0	2141	0.0000000
zheyou73v0_A03	22521391	22523869	BnaA03T0404100ZY	0	+	0	0	2478	0.0000000
zheyou73v0_A03	22521391	22523869	BnaA03T0404100ZY.1	0	+	0	0	2478	0.0000000
zheyou73v0_A03	22533655	22535609	BnaA03T0404200ZY	0	+	0	0	1954	0.0000000
zheyou73v0_A03	22536276	22537484	BnaA03T0404300ZY	0	+	0	0	1208	0.0000000
zheyou73v0_A03	22538701	22539966	BnaA03T0404400ZY	0	-	0	0	1265	0.0000000
zheyou73v0_A03	22542284	22545681	BnaA03T0404500ZY	0	-	0	0	3397	0.0000000
zheyou73v0_A03	22548898	22550546	BnaA03T0404600ZY	0	-	0	0	1648	0.0000000
zheyou73v0_A03	22552491	22555214	BnaA03T0404700ZY	0	-	0	0	2723	0.0000000
zheyou73v0_A03	22561200	22562873	BnaA03T0404800ZY	0	+	0	0	1673	0.0000000
zheyou73v0_A03	22572200	22574850	BnaA03T0404900ZY	0	+	0	0	2650	0.0000000
zheyou73v0_A03	22579078	22580907	BnaA03T0405000ZY	0	+	0	0	1829	0.0000000
zheyou73v0_A03	22582670	22587509	BnaA03T0405100ZY	0	+	0	0	4839	0.0000000
zheyou73v0_A03	22585285	22587509	BnaA03T0405100ZY.1	0	+	0	0	2224	0.0000000
zheyou73v0_A03	22588069	22589775	BnaA03T0405200ZY	0	-	0	0	1706	0.0000000
zheyou73v0_A03	22590543	22595359	BnaA03T0405300ZY	0	-	0	0	4816	0.0000000
zheyou73v0_A03	22596057	22602083	BnaA03T0405400ZY	0	-	0	0	6026	0.0000000
zheyou73v0_A03	22610968	22611825	BnaA03T0405500ZY	0	-	0	0	857	0.0000000
zheyou73v0_A03	22613606	22615736	BnaA03T0405600ZY	0	+	0	0	2130	0.0000000
zheyou73v0_A03	22615956	22618210	BnaA03T0405700ZY	0	-	0	0	2254	0.0000000
zheyou73v0_A03	22629003	22632448	BnaA03T0405800ZY	0	-	0	0	3445	0.0000000
zheyou73v0_A03	22639896	22643982	BnaA03T0405900ZY	0	+	0	0	4086	0.0000000
zheyou73v0_A03	22646742	22650189	BnaA03T0406000ZY	0	-	0	0	3447	0.0000000
zheyou73v0_A03	22646742	22650189	BnaA03T0406000ZY.1	0	-	0	0	3447	0.0000000
zheyou73v0_A03	22653267	22654869	BnaA03T0406100ZY	0	-	0	0	1602	0.0000000
zheyou73v0_A03	22660878	22661199	BnaA03T0406200ZY	0	-	0	0	321	0.0000000
zheyou73v0_A03	22668584	22670530	BnaA03T0406300ZY	0	-	0	0	1946	0.0000000
zheyou73v0_A03	22680573	22684774	BnaA03T0406400ZY	0	+	0	0	4201	0.0000000
zheyou73v0_A03	22689460	22690882	BnaA03T0406500ZY	0	-	0	0	1422	0.0000000
zheyou73v0_A03	22689460	22690882	BnaA03T0406500ZY.1	0	-	0	0	1422	0.0000000
zheyou73v0_A03	22694679	22694968	BnaA03T0406600ZY	0	-	0	0	289	0.0000000
zheyou73v0_A03	22695128	22695817	BnaA03T0406700ZY	0	-	0	0	689	0.0000000
zheyou73v0_A03	22702928	22706078	BnaA03T0406800ZY	0	+	0	0	3150	0.0000000
zheyou73v0_A03	22707532	22709996	BnaA03T0406900ZY	0	+	0	0	2464	0.0000000
zheyou73v0_A03	22707532	22709996	BnaA03T0406900ZY.1	0	+	0	0	2464	0.0000000
zheyou73v0_A03	22710972	22713487	BnaA03T0407000ZY	0	-	0	0	2515	0.0000000
zheyou73v0_A03	22717574	22718142	BnaA03T0407100ZY	0	+	0	0	568	0.0000000
zheyou73v0_A03	22718946	22721457	BnaA03T0407200ZY	0	-	0	0	2511	0.0000000
zheyou73v0_A03	22727676	22729671	BnaA03T0407300ZY	0	+	0	0	1995	0.0000000
zheyou73v0_A03	22731272	22731755	BnaA03T0407400ZY	0	-	0	0	483	0.0000000
zheyou73v0_A03	22736419	22737271	BnaA03T0407500ZY	0	-	0	0	852	0.0000000
zheyou73v0_A03	22749530	22752013	BnaA03T0407600ZY	0	-	0	0	2483	0.0000000
zheyou73v0_A03	22756307	22759525	BnaA03T0407700ZY	0	+	0	0	3218	0.0000000
zheyou73v0_A03	22760062	22761840	BnaA03T0407800ZY	0	+	0	0	1778	0.0000000
zheyou73v0_A03	22760062	22761840	BnaA03T0407800ZY.1	0	+	0	0	1778	0.0000000
zheyou73v0_A03	22767103	22773211	BnaA03T0407900ZY	0	+	0	0	6108	0.0000000
zheyou73v0_A03	22774639	22776054	BnaA03T0408000ZY	0	+	0	0	1415	0.0000000
zheyou73v0_A03	22784579	22786093	BnaA03T0408100ZY	0	+	0	0	1514	0.0000000
zheyou73v0_A03	22790289	22791094	BnaA03T0408200ZY	0	-	0	0	805	0.0000000
zheyou73v0_A03	22795084	22796287	BnaA03T0408300ZY	0	-	0	0	1203	0.0000000
zheyou73v0_A03	22802421	22803996	BnaA03T0408400ZY	0	-	0	0	1575	0.0000000
zheyou73v0_A03	22825089	22825767	BnaA03T0408500ZY	0	+	0	0	678	0.0000000
zheyou73v0_A03	22833817	22835618	BnaA03T0408600ZY	0	-	0	0	1801	0.0000000
zheyou73v0_A03	22841980	22842709	BnaA03T0408700ZY	0	+	0	0	729	0.0000000
zheyou73v0_A03	22843085	22843543	BnaA03T0408800ZY	0	+	0	0	458	0.0000000
zheyou73v0_A03	22860517	22861695	BnaA03T0408900ZY	0	-	0	0	1178	0.0000000
zheyou73v0_A03	22871694	22873317	BnaA03T0409000ZY	0	+	0	0	1623	0.0000000
zheyou73v0_A03	22878557	22879035	BnaA03T0409100ZY	0	+	0	0	478	0.0000000
zheyou73v0_A03	22883205	22886671	BnaA03T0409200ZY	0	+	0	0	3466	0.0000000
zheyou73v0_A03	22889207	22890132	BnaA03T0409300ZY	0	+	0	0	925	0.0000000
zheyou73v0_A03	22893766	22894360	BnaA03T0409400ZY	0	+	0	0	594	0.0000000
zheyou73v0_A03	22896816	22897008	BnaA03T0409500ZY	0	-	0	0	192	0.0000000
zheyou73v0_A03	22898356	22898771	BnaA03T0409600ZY	0	+	0	0	415	0.0000000
zheyou73v0_A03	22903233	22905292	BnaA03T0409700ZY	0	+	0	0	2059	0.0000000
zheyou73v0_A03	22910088	22911967	BnaA03T0409800ZY	0	-	0	0	1879	0.0000000
zheyou73v0_A03	22914313	22916711	BnaA03T0409900ZY	0	-	0	0	2398	0.0000000
zheyou73v0_A03	22924594	22927251	BnaA03T0410000ZY	0	+	0	0	2657	0.0000000
zheyou73v0_A03	22935621	22936201	BnaA03T0410100ZY	0	+	0	0	580	0.0000000
zheyou73v0_A03	22943076	22946427	BnaA03T0410200ZY	0	-	0	0	3351	0.0000000
zheyou73v0_A03	22946813	22949038	BnaA03T0410300ZY	0	+	0	0	2225	0.0000000
zheyou73v0_A03	22949500	22952335	BnaA03T0410400ZY	0	-	0	0	2835	0.0000000
zheyou73v0_A03	22952497	22955147	BnaA03T0410500ZY	0	-	0	0	2650	0.0000000
zheyou73v0_A03	22958626	22959538	BnaA03T0410600ZY	0	-	0	0	912	0.0000000
zheyou73v0_A03	22959913	22960992	BnaA03T0410700ZY	0	-	0	0	1079	0.0000000
zheyou73v0_A03	22964712	22964977	BnaA03T0410800ZY	0	+	0	0	265	0.0000000
zheyou73v0_A03	22966794	22968124	BnaA03T0410900ZY	0	+	0	0	1330	0.0000000
zheyou73v0_A03	22968658	22970864	BnaA03T0411000ZY	0	-	0	0	2206	0.0000000
zheyou73v0_A03	22976715	22978025	BnaA03T0411100ZY	0	-	0	0	1310	0.0000000
zheyou73v0_A03	22980237	22981675	BnaA03T0411200ZY	0	+	0	0	1438	0.0000000
zheyou73v0_A03	22983956	22987306	BnaA03T0411300ZY	0	-	0	0	3350	0.0000000
zheyou73v0_A03	22988765	22990171	BnaA03T0411400ZY	0	-	0	0	1406	0.0000000
zheyou73v0_A03	22993673	22995137	BnaA03T0411500ZY	0	+	0	0	1464	0.0000000
zheyou73v0_A03	23003071	23004408	BnaA03T0411600ZY	0	+	0	0	1337	0.0000000
zheyou73v0_A03	23004817	23008262	BnaA03T0411700ZY	0	-	0	0	3445	0.0000000
zheyou73v0_A03	23014425	23026002	BnaA03T0411800ZY	0	+	0	0	11577	0.0000000
zheyou73v0_A03	23026387	23027968	BnaA03T0411900ZY	0	-	0	0	1581	0.0000000
zheyou73v0_A03	23034909	23035452	BnaA03T0412000ZY	0	+	0	0	543	0.0000000
zheyou73v0_A03	23074484	23078552	BnaA03T0412100ZY	0	-	0	0	4068	0.0000000
zheyou73v0_A03	23079571	23079859	BnaA03T0412200ZY	0	-	0	0	288	0.0000000
zheyou73v0_A03	23080395	23081785	BnaA03T0412300ZY	0	+	0	0	1390	0.0000000
zheyou73v0_A03	23082155	23083593	BnaA03T0412400ZY	0	-	0	0	1438	0.0000000
zheyou73v0_A03	23087279	23088748	BnaA03T0412500ZY	0	-	0	0	1469	0.0000000
zheyou73v0_A03	23092070	23093254	BnaA03T0412600ZY	0	+	0	0	1184	0.0000000
zheyou73v0_A03	23095520	23096169	BnaA03T0412700ZY	0	-	0	0	649	0.0000000
zheyou73v0_A03	23102386	23104486	BnaA03T0412800ZY	0	+	0	0	2100	0.0000000
zheyou73v0_A03	23111131	23113905	BnaA03T0412900ZY	0	-	0	0	2774	0.0000000
zheyou73v0_A03	23129082	23130478	BnaA03T0413000ZY	0	+	0	0	1396	0.0000000
zheyou73v0_A03	23130535	23131403	BnaA03T0413100ZY	0	-	0	0	868	0.0000000
zheyou73v0_A03	23135066	23136613	BnaA03T0413200ZY	0	+	0	0	1547	0.0000000
zheyou73v0_A03	23137780	23138631	BnaA03T0413300ZY	0	-	0	0	851	0.0000000
zheyou73v0_A03	23142805	23143981	BnaA03T0413400ZY	0	-	0	0	1176	0.0000000
zheyou73v0_A03	23149347	23151929	BnaA03T0413500ZY	0	-	0	0	2582	0.0000000
zheyou73v0_A03	23149347	23151929	BnaA03T0413500ZY.1	0	-	0	0	2582	0.0000000
zheyou73v0_A03	23153088	23157326	BnaA03T0413600ZY	0	-	0	0	4238	0.0000000
zheyou73v0_A03	23160186	23162059	BnaA03T0413700ZY	0	+	0	0	1873	0.0000000
zheyou73v0_A03	23163344	23164521	BnaA03T0413800ZY	0	+	0	0	1177	0.0000000
zheyou73v0_A03	23166359	23167155	BnaA03T0413900ZY	0	+	0	0	796	0.0000000
zheyou73v0_A03	23174241	23175551	BnaA03T0414000ZY	0	+	0	0	1310	0.0000000
zheyou73v0_A03	23174241	23175551	BnaA03T0414000ZY.1	0	+	0	0	1310	0.0000000
zheyou73v0_A03	23175738	23176377	BnaA03T0414100ZY	0	-	0	0	639	0.0000000
zheyou73v0_A03	23180446	23181046	BnaA03T0414200ZY	0	+	0	0	600	0.0000000
zheyou73v0_A03	23183310	23186078	BnaA03T0414300ZY	0	+	0	0	2768	0.0000000
zheyou73v0_A03	23202480	23204870	BnaA03T0414400ZY	0	+	0	0	2390	0.0000000
zheyou73v0_A03	23207190	23208864	BnaA03T0414500ZY	0	-	0	0	1674	0.0000000
zheyou73v0_A03	23207190	23209171	BnaA03T0414500ZY.1	0	-	0	0	1981	0.0000000
zheyou73v0_A03	23214067	23216385	BnaA03T0414600ZY	0	+	0	0	2318	0.0000000
zheyou73v0_A03	23222408	23238983	BnaA03T0414700ZY	0	-	0	0	16575	0.0000000
zheyou73v0_A03	23242145	23247567	BnaA03T0414800ZY	0	+	0	0	5422	0.0000000
zheyou73v0_A03	23249996	23259367	BnaA03T0414900ZY	0	+	0	0	9371	0.0000000
zheyou73v0_A03	23259786	23266956	BnaA03T0415000ZY	0	-	0	0	7170	0.0000000
zheyou73v0_A03	23267956	23269853	BnaA03T0415100ZY	0	+	0	0	1897	0.0000000
zheyou73v0_A03	23270422	23272070	BnaA03T0415200ZY	0	+	0	0	1648	0.0000000
zheyou73v0_A03	23276577	23277896	BnaA03T0415300ZY	0	+	0	0	1319	0.0000000
zheyou73v0_A03	23281224	23282016	BnaA03T0415400ZY	0	+	0	0	792	0.0000000
zheyou73v0_A03	23283086	23283860	BnaA03T0415500ZY	0	+	0	0	774	0.0000000
zheyou73v0_A03	23288497	23289299	BnaA03T0415600ZY	0	+	0	0	802	0.0000000
zheyou73v0_A03	23293754	23296027	BnaA03T0415700ZY	0	-	0	0	2273	0.0000000
zheyou73v0_A03	23302698	23304899	BnaA03T0415800ZY	0	-	0	0	2201	0.0000000
zheyou73v0_A03	23307837	23310220	BnaA03T0415900ZY	0	-	0	0	2383	0.0000000
zheyou73v0_A03	23312600	23315030	BnaA03T0416000ZY	0	-	0	0	2430	0.0000000
zheyou73v0_A03	23312600	23315030	BnaA03T0416000ZY.1	0	-	0	0	2430	0.0000000
zheyou73v0_A03	23316085	23317938	BnaA03T0416100ZY	0	+	0	0	1853	0.0000000
zheyou73v0_A03	23324808	23326044	BnaA03T0416200ZY	0	+	0	0	1236	0.0000000
zheyou73v0_A03	23328075	23333762	BnaA03T0416300ZY.1	0	-	0	0	5687	0.0000000
zheyou73v0_A03	23328308	23333762	BnaA03T0416300ZY	0	-	0	0	5454	0.0000000
zheyou73v0_A03	23335711	23336493	BnaA03T0416400ZY	0	-	0	0	782	0.0000000
zheyou73v0_A03	23336755	23338358	BnaA03T0416500ZY	0	-	0	0	1603	0.0000000
zheyou73v0_A03	23341696	23343853	BnaA03T0416600ZY	0	-	0	0	2157	0.0000000
zheyou73v0_A03	23344179	23361472	BnaA03T0416700ZY	0	-	0	0	17293	0.0000000
zheyou73v0_A03	23379898	23381254	BnaA03T0416800ZY	0	-	0	0	1356	0.0000000
zheyou73v0_A03	23385079	23390734	BnaA03T0416900ZY	0	+	0	0	5655	0.0000000
zheyou73v0_A03	23391004	23392147	BnaA03T0417000ZY	0	-	0	0	1143	0.0000000
zheyou73v0_A03	23395617	23398040	BnaA03T0417100ZY	0	+	0	0	2423	0.0000000
zheyou73v0_A03	23395617	23398040	BnaA03T0417100ZY.1	0	+	0	0	2423	0.0000000
zheyou73v0_A03	23399149	23404808	BnaA03T0417200ZY	0	+	0	0	5659	0.0000000
zheyou73v0_A03	23434301	23435713	BnaA03T0417300ZY	0	+	0	0	1412	0.0000000
zheyou73v0_A03	23436911	23437534	BnaA03T0417400ZY	0	+	0	0	623	0.0000000
zheyou73v0_A03	23437573	23438501	BnaA03T0417500ZY	0	-	0	0	928	0.0000000
zheyou73v0_A03	23437573	23438501	BnaA03T0417500ZY.1	0	-	0	0	928	0.0000000
zheyou73v0_A03	23452051	23453793	BnaA03T0417600ZY	0	+	0	0	1742	0.0000000
zheyou73v0_A03	23455245	23457265	BnaA03T0417700ZY	0	-	0	0	2020	0.0000000
zheyou73v0_A03	23458120	23459245	BnaA03T0417800ZY	0	-	0	0	1125	0.0000000
zheyou73v0_A03	23465746	23467137	BnaA03T0417900ZY	0	+	0	0	1391	0.0000000
zheyou73v0_A03	23477733	23481625	BnaA03T0418000ZY	0	-	0	0	3892	0.0000000
zheyou73v0_A03	23482524	23482770	BnaA03T0418100ZY	0	+	0	0	246	0.0000000
zheyou73v0_A03	23484174	23486949	BnaA03T0418200ZY	0	-	0	0	2775	0.0000000
zheyou73v0_A03	23499069	23502772	BnaA03T0418300ZY	0	-	0	0	3703	0.0000000
zheyou73v0_A03	23511726	23514352	BnaA03T0418400ZY	0	-	0	0	2626	0.0000000
zheyou73v0_A03	23515218	23516411	BnaA03T0418500ZY	0	-	0	0	1193	0.0000000
zheyou73v0_A03	23516836	23521848	BnaA03T0418600ZY	0	-	0	0	5012	0.0000000
zheyou73v0_A03	23522209	23524930	BnaA03T0418700ZY	0	+	0	0	2721	0.0000000
zheyou73v0_A03	23524829	23525717	BnaA03T0418800ZY	0	-	0	0	888	0.0000000
zheyou73v0_A03	23526165	23527713	BnaA03T0418900ZY	0	-	0	0	1548	0.0000000
zheyou73v0_A03	23528145	23530201	BnaA03T0419000ZY	0	+	0	0	2056	0.0000000
zheyou73v0_A03	23538463	23540023	BnaA03T0419100ZY	0	-	0	0	1560	0.0000000
zheyou73v0_A03	23547025	23550369	BnaA03T0419200ZY	0	+	0	0	3344	0.0000000
zheyou73v0_A03	23547555	23550369	BnaA03T0419200ZY.1	0	+	0	0	2814	0.0000000
zheyou73v0_A03	23547555	23550369	BnaA03T0419200ZY.2	0	+	0	0	2814	0.0000000
zheyou73v0_A03	23547555	23550369	BnaA03T0419200ZY.3	0	+	0	0	2814	0.0000000
zheyou73v0_A03	23550666	23553191	BnaA03T0419300ZY	0	-	0	0	2525	0.0000000
zheyou73v0_A03	23553406	23556237	BnaA03T0419400ZY	0	-	0	0	2831	0.0000000
zheyou73v0_A03	23557785	23560720	BnaA03T0419500ZY	0	+	0	0	2935	0.0000000
zheyou73v0_A03	23560766	23562485	BnaA03T0419600ZY	0	+	0	0	1719	0.0000000
zheyou73v0_A03	23562769	23564653	BnaA03T0419700ZY	0	-	0	0	1884	0.0000000
zheyou73v0_A03	23565339	23568470	BnaA03T0419800ZY	0	-	0	0	3131	0.0000000
zheyou73v0_A03	23568818	23571819	BnaA03T0419900ZY	0	-	0	0	3001	0.0000000
zheyou73v0_A03	23577992	23583054	BnaA03T0420000ZY	0	-	0	0	5062	0.0000000
zheyou73v0_A03	23591268	23593315	BnaA03T0420100ZY	0	-	0	0	2047	0.0000000
zheyou73v0_A03	23591268	23593315	BnaA03T0420100ZY.1	0	-	0	0	2047	0.0000000
zheyou73v0_A03	23593971	23595093	BnaA03T0420200ZY	0	+	0	0	1122	0.0000000
zheyou73v0_A03	23609601	23612539	BnaA03T0420300ZY	0	+	0	0	2938	0.0000000
zheyou73v0_A03	23616498	23616762	BnaA03T0420400ZY	0	-	0	0	264	0.0000000
zheyou73v0_A03	23617480	23618746	BnaA03T0420500ZY	0	+	0	0	1266	0.0000000
zheyou73v0_A03	23619776	23622385	BnaA03T0420600ZY	0	+	0	0	2609	0.0000000
zheyou73v0_A03	23619776	23622388	BnaA03T0420600ZY.1	0	+	0	0	2612	0.0000000
zheyou73v0_A03	23622453	23625099	BnaA03T0420700ZY	0	-	0	0	2646	0.0000000
zheyou73v0_A03	23634049	23635414	BnaA03T0420800ZY	0	+	0	0	1365	0.0000000
zheyou73v0_A03	23635649	23641897	BnaA03T0420900ZY	0	-	0	0	6248	0.0000000
zheyou73v0_A03	23647954	23655582	BnaA03T0421000ZY	0	+	0	0	7628	0.0000000
zheyou73v0_A03	23655818	23659928	BnaA03T0421100ZY	0	-	0	0	4110	0.0000000
zheyou73v0_A03	23660756	23662084	BnaA03T0421200ZY	0	-	0	0	1328	0.0000000
zheyou73v0_A03	23671995	23672635	BnaA03T0421300ZY	0	+	0	0	640	0.0000000
zheyou73v0_A03	23672756	23674678	BnaA03T0421400ZY	0	-	0	0	1922	0.0000000
zheyou73v0_A03	23675928	23679365	BnaA03T0421500ZY	0	+	0	0	3437	0.0000000
zheyou73v0_A03	23677416	23678895	BnaA03T0421600ZY	0	-	0	0	1479	0.0000000
zheyou73v0_A03	23680615	23683611	BnaA03T0421700ZY	0	+	0	0	2996	0.0000000
zheyou73v0_A03	23683918	23686098	BnaA03T0421800ZY	0	-	0	0	2180	0.0000000
zheyou73v0_A03	23686360	23686913	BnaA03T0421900ZY	0	-	0	0	553	0.0000000
zheyou73v0_A03	23701951	23703810	BnaA03T0422000ZY	0	-	0	0	1859	0.0000000
zheyou73v0_A03	23723489	23725023	BnaA03T0422100ZY	0	-	0	0	1534	0.0000000
zheyou73v0_A03	23730468	23731921	BnaA03T0422200ZY	0	+	0	0	1453	0.0000000
zheyou73v0_A03	23733056	23735519	BnaA03T0422300ZY	0	-	0	0	2463	0.0000000
zheyou73v0_A03	23741522	23744293	BnaA03T0422400ZY	0	+	0	0	2771	0.0000000
zheyou73v0_A03	23744499	23751320	BnaA03T0422500ZY	0	-	0	0	6821	0.0000000
zheyou73v0_A03	23757432	23759910	BnaA03T0422600ZY	0	-	0	0	2478	0.0000000
zheyou73v0_A03	23767335	23768154	BnaA03T0422700ZY	0	+	0	0	819	0.0000000
zheyou73v0_A03	23769409	23773198	BnaA03T0422800ZY	0	-	0	0	3789	0.0000000
zheyou73v0_A03	23781355	23782420	BnaA03T0422900ZY	0	+	0	0	1065	0.0000000
zheyou73v0_A03	23782814	23784631	BnaA03T0423000ZY	0	-	0	0	1817	0.0000000
zheyou73v0_A03	23785366	23787744	BnaA03T0423100ZY	0	-	0	0	2378	0.0000000
zheyou73v0_A03	23789687	23791511	BnaA03T0423200ZY	0	+	0	0	1824	0.0000000
zheyou73v0_A03	23791965	23794304	BnaA03T0423300ZY	0	+	0	0	2339	0.0000000
zheyou73v0_A03	23795694	23798975	BnaA03T0423400ZY	0	+	0	0	3281	0.0000000
zheyou73v0_A03	23805201	23805459	BnaA03T0423500ZY	0	-	0	0	258	0.0000000
zheyou73v0_A03	23808418	23812219	BnaA03T0423600ZY	0	+	0	0	3801	0.0000000
zheyou73v0_A03	23814027	23817833	BnaA03T0423700ZY	0	+	0	0	3806	0.0000000
zheyou73v0_A03	23816349	23818665	BnaA03T0423800ZY	0	-	0	0	2316	0.0000000
zheyou73v0_A03	23818904	23823071	BnaA03T0423900ZY	0	+	0	0	4167	0.0000000
zheyou73v0_A03	23818904	23823071	BnaA03T0423900ZY.1	0	+	0	0	4167	0.0000000
zheyou73v0_A03	23822283	23822889	BnaA03T0424000ZY	0	-	0	0	606	0.0000000
zheyou73v0_A03	23823931	23825173	BnaA03T0424100ZY	0	-	0	0	1242	0.0000000
zheyou73v0_A03	23829667	23833774	BnaA03T0424200ZY	0	+	0	0	4107	0.0000000
zheyou73v0_A03	23835538	23836719	BnaA03T0424300ZY	0	+	0	0	1181	0.0000000
zheyou73v0_A03	23838464	23839426	BnaA03T0424400ZY	0	-	0	0	962	0.0000000
zheyou73v0_A03	23844197	23844929	BnaA03T0424500ZY	0	+	0	0	732	0.0000000
zheyou73v0_A03	23848498	23852041	BnaA03T0424600ZY	0	+	0	0	3543	0.0000000
zheyou73v0_A03	23852377	23853090	BnaA03T0424700ZY	0	-	0	0	713	0.0000000
zheyou73v0_A03	23976897	23977512	BnaA03T0424800ZY	0	-	0	0	615	0.0000000
zheyou73v0_A03	23987263	23991421	BnaA03T0424900ZY	0	+	0	0	4158	0.0000000
zheyou73v0_A03	24001669	24003364	BnaA03T0425000ZY	0	-	0	0	1695	0.0000000
zheyou73v0_A03	24011617	24014481	BnaA03T0425100ZY	0	+	0	0	2864	0.0000000
zheyou73v0_A03	24016004	24017175	BnaA03T0425200ZY	0	-	0	0	1171	0.0000000
zheyou73v0_A03	24023087	24024130	BnaA03T0425300ZY	0	+	0	0	1043	0.0000000
zheyou73v0_A03	24024311	24025772	BnaA03T0425400ZY	0	-	0	0	1461	0.0000000
zheyou73v0_A03	24032528	24033950	BnaA03T0425500ZY	0	+	0	0	1422	0.0000000
zheyou73v0_A03	24034446	24035105	BnaA03T0425600ZY	0	+	0	0	659	0.0000000
zheyou73v0_A03	24035700	24037486	BnaA03T0425700ZY	0	-	0	0	1786	0.0000000
zheyou73v0_A03	24035700	24037486	BnaA03T0425700ZY.1	0	-	0	0	1786	0.0000000
zheyou73v0_A03	24039522	24040500	BnaA03T0425800ZY	0	+	0	0	978	0.0000000
zheyou73v0_A03	24044901	24045978	BnaA03T0425900ZY	0	+	0	0	1077	0.0000000
zheyou73v0_A03	24053529	24054168	BnaA03T0426000ZY	0	-	0	0	639	0.0000000
zheyou73v0_A03	24055506	24057265	BnaA03T0426100ZY	0	-	0	0	1759	0.0000000
zheyou73v0_A03	24068607	24069879	BnaA03T0426200ZY	0	-	0	0	1272	0.0000000
zheyou73v0_A03	24071173	24072309	BnaA03T0426300ZY	0	-	0	0	1136	0.0000000
zheyou73v0_A03	24081072	24082302	BnaA03T0426400ZY	0	-	0	0	1230	0.0000000
zheyou73v0_A03	24085871	24088966	BnaA03T0426500ZY	0	-	0	0	3095	0.0000000
zheyou73v0_A03	24089463	24091555	BnaA03T0426600ZY	0	-	0	0	2092	0.0000000
zheyou73v0_A03	24096435	24098556	BnaA03T0426700ZY	0	-	0	0	2121	0.0000000
zheyou73v0_A03	24099518	24101952	BnaA03T0426800ZY	0	-	0	0	2434	0.0000000
zheyou73v0_A03	24107290	24109031	BnaA03T0426900ZY	0	-	0	0	1741	0.0000000
zheyou73v0_A03	24114210	24116264	BnaA03T0427000ZY	0	-	0	0	2054	0.0000000
zheyou73v0_A03	24120946	24122348	BnaA03T0427100ZY	0	+	0	0	1402	0.0000000
zheyou73v0_A03	24123034	24133095	BnaA03T0427200ZY	0	+	0	0	10061	0.0000000
zheyou73v0_A03	24133135	24133864	BnaA03T0427300ZY	0	+	0	0	729	0.0000000
zheyou73v0_A03	24134073	24136212	BnaA03T0427400ZY	0	-	0	0	2139	0.0000000
zheyou73v0_A03	24137223	24138569	BnaA03T0427500ZY	0	-	0	0	1346	0.0000000
zheyou73v0_A03	24137841	24138569	BnaA03T0427500ZY.1	0	-	0	0	728	0.0000000
zheyou73v0_A03	24151234	24153196	BnaA03T0427600ZY	0	-	0	0	1962	0.0000000
zheyou73v0_A03	24153762	24157172	BnaA03T0427700ZY	0	+	0	0	3410	0.0000000
zheyou73v0_A03	24159692	24161430	BnaA03T0427800ZY	0	-	0	0	1738	0.0000000
zheyou73v0_A03	24177198	24178479	BnaA03T0427900ZY	0	+	0	0	1281	0.0000000
zheyou73v0_A03	24182425	24183898	BnaA03T0428000ZY	0	-	0	0	1473	0.0000000
zheyou73v0_A03	24188493	24190231	BnaA03T0428100ZY	0	+	0	0	1738	0.0000000
zheyou73v0_A03	24196024	24197470	BnaA03T0428200ZY	0	-	0	0	1446	0.0000000
zheyou73v0_A03	24201378	24202677	BnaA03T0428300ZY	0	-	0	0	1299	0.0000000
zheyou73v0_A03	24204549	24205271	BnaA03T0428400ZY	0	+	0	0	722	0.0000000
zheyou73v0_A03	24206274	24206935	BnaA03T0428500ZY	0	+	0	0	661	0.0000000
zheyou73v0_A03	24215322	24216558	BnaA03T0428600ZY	0	+	0	0	1236	0.0000000
zheyou73v0_A03	24223728	24224625	BnaA03T0428700ZY	0	+	0	0	897	0.0000000
zheyou73v0_A03	24231667	24232138	BnaA03T0428800ZY	0	-	0	0	471	0.0000000
zheyou73v0_A03	24234783	24235400	BnaA03T0428900ZY	0	-	0	0	617	0.0000000
zheyou73v0_A03	24237771	24239527	BnaA03T0429000ZY	0	-	0	0	1756	0.0000000
zheyou73v0_A03	24239879	24240901	BnaA03T0429100ZY	0	-	0	0	1022	0.0000000
zheyou73v0_A03	24251620	24252937	BnaA03T0429200ZY	0	+	0	0	1317	0.0000000
zheyou73v0_A03	24294286	24295469	BnaA03T0429300ZY	0	+	0	0	1183	0.0000000
zheyou73v0_A03	24306186	24307085	BnaA03T0429400ZY	0	+	0	0	899	0.0000000
zheyou73v0_A03	24308151	24308574	BnaA03T0429500ZY	0	+	0	0	423	0.0000000
zheyou73v0_A03	24310123	24312436	BnaA03T0429600ZY	0	+	0	0	2313	0.0000000
zheyou73v0_A03	24312486	24316237	BnaA03T0429700ZY	0	-	0	0	3751	0.0000000
zheyou73v0_A03	24321062	24322028	BnaA03T0429800ZY	0	+	0	0	966	0.0000000
zheyou73v0_A03	24326751	24328563	BnaA03T0429900ZY	0	+	0	0	1812	0.0000000
zheyou73v0_A03	24328867	24332122	BnaA03T0430000ZY	0	-	0	0	3255	0.0000000
zheyou73v0_A03	24332406	24333527	BnaA03T0430100ZY	0	-	0	0	1121	0.0000000
zheyou73v0_A03	24334027	24334498	BnaA03T0430200ZY	0	+	0	0	471	0.0000000
zheyou73v0_A03	24336606	24337766	BnaA03T0430300ZY	0	-	0	0	1160	0.0000000
zheyou73v0_A03	24338877	24344576	BnaA03T0430400ZY	0	+	0	0	5699	0.0000000
zheyou73v0_A03	24345649	24347604	BnaA03T0430500ZY	0	-	0	0	1955	0.0000000
zheyou73v0_A03	24347836	24349609	BnaA03T0430600ZY	0	-	0	0	1773	0.0000000
zheyou73v0_A03	24351286	24357222	BnaA03T0430700ZY	0	-	0	0	5936	0.0000000
zheyou73v0_A03	24363472	24368358	BnaA03T0430800ZY	0	+	0	0	4886	0.0000000
zheyou73v0_A03	24388631	24392696	BnaA03T0430900ZY	0	+	0	0	4065	0.0000000
zheyou73v0_A03	24393072	24394158	BnaA03T0431000ZY	0	-	0	0	1086	0.0000000
zheyou73v0_A03	24395224	24396169	BnaA03T0431100ZY	0	-	0	0	945	0.0000000
zheyou73v0_A03	24397457	24398132	BnaA03T0431200ZY	0	-	0	0	675	0.0000000
zheyou73v0_A03	24399619	24400963	BnaA03T0431300ZY	0	+	0	0	1344	0.0000000
zheyou73v0_A03	24401839	24403410	BnaA03T0431400ZY	0	+	0	0	1571	0.0000000
zheyou73v0_A03	24404193	24407144	BnaA03T0431500ZY	0	+	0	0	2951	0.0000000
zheyou73v0_A03	24407436	24409087	BnaA03T0431600ZY	0	+	0	0	1651	0.0000000
zheyou73v0_A03	24411161	24412230	BnaA03T0431700ZY	0	+	0	0	1069	0.0000000
zheyou73v0_A03	24412140	24415241	BnaA03T0431800ZY	0	-	0	0	3101	0.0000000
zheyou73v0_A03	24419958	24420275	BnaA03T0431900ZY	0	+	0	0	317	0.0000000
zheyou73v0_A03	24422624	24423389	BnaA03T0432000ZY	0	-	0	0	765	0.0000000
zheyou73v0_A03	24424877	24425921	BnaA03T0432100ZY	0	-	0	0	1044	0.0000000
zheyou73v0_A03	24428781	24429621	BnaA03T0432200ZY	0	-	0	0	840	0.0000000
zheyou73v0_A03	24434252	24434984	BnaA03T0432300ZY	0	+	0	0	732	0.0000000
zheyou73v0_A03	24435208	24437168	BnaA03T0432400ZY	0	+	0	0	1960	0.0000000
zheyou73v0_A03	24435208	24437168	BnaA03T0432400ZY.1	0	+	0	0	1960	0.0000000
zheyou73v0_A03	24437495	24440685	BnaA03T0432500ZY	0	-	0	0	3190	0.0000000
zheyou73v0_A03	24441254	24443910	BnaA03T0432600ZY	0	-	0	0	2656	0.0000000
zheyou73v0_A03	24448969	24450899	BnaA03T0432700ZY	0	-	0	0	1930	0.0000000
zheyou73v0_A03	24448969	24450899	BnaA03T0432700ZY.1	0	-	0	0	1930	0.0000000
zheyou73v0_A03	24448969	24450899	BnaA03T0432700ZY.2	0	-	0	0	1930	0.0000000
zheyou73v0_A03	24451318	24451743	BnaA03T0432800ZY	0	+	0	0	425	0.0000000
zheyou73v0_A03	24455513	24458401	BnaA03T0432900ZY	0	+	0	0	2888	0.0000000
zheyou73v0_A03	24461405	24461972	BnaA03T0433000ZY	0	+	0	0	567	0.0000000
zheyou73v0_A03	24464736	24466041	BnaA03T0433100ZY	0	-	0	0	1305	0.0000000
zheyou73v0_A03	24464736	24466001	BnaA03T0433100ZY.1	0	-	0	0	1265	0.0000000
zheyou73v0_A03	24476203	24479155	BnaA03T0433200ZY	0	+	0	0	2952	0.0000000
zheyou73v0_A03	24486455	24487515	BnaA03T0433300ZY	0	-	0	0	1060	0.0000000
zheyou73v0_A03	24493389	24495033	BnaA03T0433400ZY	0	+	0	0	1644	0.0000000
zheyou73v0_A03	24495849	24497400	BnaA03T0433500ZY	0	+	0	0	1551	0.0000000
zheyou73v0_A03	24495849	24497400	BnaA03T0433500ZY.1	0	+	0	0	1551	0.0000000
zheyou73v0_A03	24495849	24497400	BnaA03T0433500ZY.2	0	+	0	0	1551	0.0000000
zheyou73v0_A03	24497680	24498286	BnaA03T0433600ZY	0	-	0	0	606	0.0000000
zheyou73v0_A03	24498794	24499118	BnaA03T0433700ZY	0	-	0	0	324	0.0000000
zheyou73v0_A03	24499761	24502950	BnaA03T0433800ZY	0	-	0	0	3189	0.0000000
zheyou73v0_A03	24503745	24508533	BnaA03T0433900ZY	0	+	0	0	4788	0.0000000
zheyou73v0_A03	24508920	24509953	BnaA03T0434000ZY	0	+	0	0	1033	0.0000000
zheyou73v0_A03	24513886	24515761	BnaA03T0434100ZY	0	-	0	0	1875	0.0000000
zheyou73v0_A03	24513886	24515761	BnaA03T0434100ZY.1	0	-	0	0	1875	0.0000000
zheyou73v0_A03	24516284	24518717	BnaA03T0434200ZY	0	-	0	0	2433	0.0000000
zheyou73v0_A03	24524674	24526874	BnaA03T0434300ZY	0	+	0	0	2200	0.0000000
zheyou73v0_A03	24542061	24542528	BnaA03T0434400ZY	0	+	0	0	467	0.0000000
zheyou73v0_A03	24561762	24564172	BnaA03T0434500ZY	0	-	0	0	2410	0.0000000
zheyou73v0_A03	24561762	24564039	BnaA03T0434500ZY.1	0	-	0	0	2277	0.0000000
zheyou73v0_A03	24567101	24567678	BnaA03T0434600ZY	0	+	0	0	577	0.0000000
zheyou73v0_A03	24568832	24571440	BnaA03T0434700ZY	0	+	0	0	2608	0.0000000
zheyou73v0_A03	24568832	24571440	BnaA03T0434700ZY.1	0	+	0	0	2608	0.0000000
zheyou73v0_A03	24568832	24571440	BnaA03T0434700ZY.2	0	+	0	0	2608	0.0000000
zheyou73v0_A03	24571295	24571749	BnaA03T0434800ZY	0	-	0	0	454	0.0000000
zheyou73v0_A03	24573038	24574933	BnaA03T0434900ZY	0	-	0	0	1895	0.0000000
zheyou73v0_A03	24576877	24579984	BnaA03T0435000ZY	0	+	0	0	3107	0.0000000
zheyou73v0_A03	24580122	24581008	BnaA03T0435100ZY	0	-	0	0	886	0.0000000
zheyou73v0_A03	24581572	24584816	BnaA03T0435200ZY	0	+	0	0	3244	0.0000000
zheyou73v0_A03	24586783	24587192	BnaA03T0435300ZY	0	-	0	0	409	0.0000000
zheyou73v0_A03	24588132	24589341	BnaA03T0435400ZY	0	+	0	0	1209	0.0000000
zheyou73v0_A03	24588132	24589341	BnaA03T0435400ZY.1	0	+	0	0	1209	0.0000000
zheyou73v0_A03	24589402	24590904	BnaA03T0435500ZY	0	-	0	0	1502	0.0000000
zheyou73v0_A03	24591136	24593415	BnaA03T0435600ZY	0	-	0	0	2279	0.0000000
zheyou73v0_A03	24594964	24602393	BnaA03T0435700ZY	0	+	0	0	7429	0.0000000
zheyou73v0_A03	24597238	24602393	BnaA03T0435700ZY.1	0	+	0	0	5155	0.0000000
zheyou73v0_A03	24597238	24602393	BnaA03T0435700ZY.2	0	+	0	0	5155	0.0000000
zheyou73v0_A03	24602201	24606934	BnaA03T0435800ZY	0	-	0	0	4733	0.0000000
zheyou73v0_A03	24602201	24606934	BnaA03T0435800ZY.1	0	-	0	0	4733	0.0000000
zheyou73v0_A03	24608050	24609453	BnaA03T0435900ZY	0	-	0	0	1403	0.0000000
zheyou73v0_A03	24610376	24611589	BnaA03T0436000ZY	0	+	0	0	1213	0.0000000
zheyou73v0_A03	24611710	24612472	BnaA03T0436100ZY	0	-	0	0	762	0.0000000
zheyou73v0_A03	24612564	24614450	BnaA03T0436200ZY	0	-	0	0	1886	0.0000000
zheyou73v0_A03	24615085	24616693	BnaA03T0436300ZY	0	+	0	0	1608	0.0000000
zheyou73v0_A03	24616835	24618065	BnaA03T0436400ZY	0	-	0	0	1230	0.0000000
zheyou73v0_A03	24626678	24628206	BnaA03T0436500ZY	0	+	0	0	1528	0.0000000
zheyou73v0_A03	24628591	24629956	BnaA03T0436600ZY	0	-	0	0	1365	0.0000000
zheyou73v0_A03	24632424	24636719	BnaA03T0436700ZY	0	+	0	0	4295	0.0000000
zheyou73v0_A03	24637814	24638537	BnaA03T0436800ZY	0	+	0	0	723	0.0000000
zheyou73v0_A03	24645682	24646954	BnaA03T0436900ZY	0	-	0	0	1272	0.0000000
zheyou73v0_A03	24651001	24652215	BnaA03T0437000ZY	0	+	0	0	1214	0.0000000
zheyou73v0_A03	24654891	24655987	BnaA03T0437100ZY	0	+	0	0	1096	0.0000000
zheyou73v0_A03	24664980	24668145	BnaA03T0437200ZY	0	-	0	0	3165	0.0000000
zheyou73v0_A03	24676633	24678382	BnaA03T0437300ZY	0	-	0	0	1749	0.0000000
zheyou73v0_A03	24680138	24686324	BnaA03T0437400ZY	0	-	0	0	6186	0.0000000
zheyou73v0_A03	24696820	24698997	BnaA03T0437500ZY	0	+	0	0	2177	0.0000000
zheyou73v0_A03	24699007	24704227	BnaA03T0437600ZY	0	+	0	0	5220	0.0000000
zheyou73v0_A03	24705026	24707111	BnaA03T0437700ZY	0	-	0	0	2085	0.0000000
zheyou73v0_A03	24713084	24714650	BnaA03T0437800ZY	0	+	0	0	1566	0.0000000
zheyou73v0_A03	24715205	24716857	BnaA03T0437900ZY	0	-	0	0	1652	0.0000000
zheyou73v0_A03	24734459	24736794	BnaA03T0438000ZY	0	+	0	0	2335	0.0000000
zheyou73v0_A03	24741325	24744990	BnaA03T0438100ZY	0	+	0	0	3665	0.0000000
zheyou73v0_A03	24746281	24748058	BnaA03T0438200ZY	0	+	0	0	1777	0.0000000
zheyou73v0_A03	24746281	24748058	BnaA03T0438200ZY.1	0	+	0	0	1777	0.0000000
zheyou73v0_A03	24748947	24750493	BnaA03T0438300ZY	0	+	0	0	1546	0.0000000
zheyou73v0_A03	24751623	24753156	BnaA03T0438400ZY	0	+	0	0	1533	0.0000000
zheyou73v0_A03	24759207	24764178	BnaA03T0438500ZY	0	+	0	0	4971	0.0000000
zheyou73v0_A03	24764204	24764640	BnaA03T0438600ZY	0	-	0	0	436	0.0000000
zheyou73v0_A03	24767853	24769041	BnaA03T0438700ZY	0	+	0	0	1188	0.0000000
zheyou73v0_A03	24773276	24775964	BnaA03T0438800ZY	0	+	0	0	2688	0.0000000
zheyou73v0_A03	24775988	24776578	BnaA03T0438900ZY	0	+	0	0	590	0.0000000
zheyou73v0_A03	24780638	24782442	BnaA03T0439000ZY	0	-	0	0	1804	0.0000000
zheyou73v0_A03	24783957	24785002	BnaA03T0439100ZY	0	+	0	0	1045	0.0000000
zheyou73v0_A03	24785544	24790971	BnaA03T0439200ZY	0	-	0	0	5427	0.0000000
zheyou73v0_A03	24785544	24789630	BnaA03T0439200ZY.1	0	-	0	0	4086	0.0000000
zheyou73v0_A03	24793353	24795671	BnaA03T0439300ZY	0	-	0	0	2318	0.0000000
zheyou73v0_A03	24798572	24801673	BnaA03T0439400ZY	0	+	0	0	3101	0.0000000
zheyou73v0_A03	24802209	24803100	BnaA03T0439500ZY	0	-	0	0	891	0.0000000
zheyou73v0_A03	24814936	24816889	BnaA03T0439600ZY	0	+	0	0	1953	0.0000000
zheyou73v0_A03	24824725	24825148	BnaA03T0439700ZY	0	-	0	0	423	0.0000000
zheyou73v0_A03	24827512	24829651	BnaA03T0439800ZY	0	+	0	0	2139	0.0000000
zheyou73v0_A03	24831324	24832413	BnaA03T0439900ZY	0	+	0	0	1089	0.0000000
zheyou73v0_A03	24842198	24844037	BnaA03T0440000ZY	0	+	0	0	1839	0.0000000
zheyou73v0_A03	24847100	24847961	BnaA03T0440100ZY	0	+	0	0	861	0.0000000
zheyou73v0_A03	24848438	24849752	BnaA03T0440200ZY	0	-	0	0	1314	0.0000000
zheyou73v0_A03	24852948	24853578	BnaA03T0440300ZY	0	-	0	0	630	0.0000000
zheyou73v0_A03	24854345	24856320	BnaA03T0440400ZY	0	-	0	0	1975	0.0000000
zheyou73v0_A03	24856733	24857248	BnaA03T0440500ZY	0	-	0	0	515	0.0000000
zheyou73v0_A03	24858717	24859570	BnaA03T0440600ZY	0	+	0	0	853	0.0000000
zheyou73v0_A03	24862105	24862666	BnaA03T0440700ZY	0	+	0	0	561	0.0000000
zheyou73v0_A03	24864112	24865279	BnaA03T0440800ZY	0	-	0	0	1167	0.0000000
zheyou73v0_A03	24866672	24868881	BnaA03T0440900ZY	0	+	0	0	2209	0.0000000
zheyou73v0_A03	24869326	24873687	BnaA03T0441000ZY	0	+	0	0	4361	0.0000000
zheyou73v0_A03	24874952	24875842	BnaA03T0441100ZY	0	+	0	0	890	0.0000000
zheyou73v0_A03	24879462	24880421	BnaA03T0441200ZY	0	+	0	0	959	0.0000000
zheyou73v0_A03	24879462	24880421	BnaA03T0441200ZY.1	0	+	0	0	959	0.0000000
zheyou73v0_A03	24882386	24885330	BnaA03T0441300ZY	0	-	0	0	2944	0.0000000
zheyou73v0_A03	24882386	24885330	BnaA03T0441300ZY.1	0	-	0	0	2944	0.0000000
zheyou73v0_A03	24887323	24889664	BnaA03T0441400ZY	0	-	0	0	2341	0.0000000
zheyou73v0_A03	24893594	24895127	BnaA03T0441500ZY	0	+	0	0	1533	0.0000000
zheyou73v0_A03	24897414	24907582	BnaA03T0441600ZY	0	-	0	0	10168	0.0000000
zheyou73v0_A03	24913467	24919030	BnaA03T0441700ZY	0	+	0	0	5563	0.0000000
zheyou73v0_A03	24919638	24922641	BnaA03T0441800ZY	0	+	0	0	3003	0.0000000
zheyou73v0_A03	24923530	24926441	BnaA03T0441900ZY	0	-	0	0	2911	0.0000000
zheyou73v0_A03	24931162	24931988	BnaA03T0442000ZY	0	+	0	0	826	0.0000000
zheyou73v0_A03	24937128	24938406	BnaA03T0442100ZY	0	-	0	0	1278	0.0000000
zheyou73v0_A03	24940668	24942366	BnaA03T0442200ZY	0	-	0	0	1698	0.0000000
zheyou73v0_A03	24952518	24953322	BnaA03T0442300ZY	0	+	0	0	804	0.0000000
zheyou73v0_A03	24959333	24960752	BnaA03T0442400ZY	0	+	0	0	1419	0.0000000
zheyou73v0_A03	24961071	24962803	BnaA03T0442500ZY	0	-	0	0	1732	0.0000000
zheyou73v0_A03	24967095	24970776	BnaA03T0442600ZY	0	-	0	0	3681	0.0000000
zheyou73v0_A03	24975344	24976835	BnaA03T0442700ZY	0	+	0	0	1491	0.0000000
zheyou73v0_A03	24984546	24987875	BnaA03T0442800ZY	0	+	0	0	3329	0.0000000
zheyou73v0_A03	24989406	24990244	BnaA03T0442900ZY	0	-	0	0	838	0.0000000
zheyou73v0_A03	24991160	24994415	BnaA03T0443000ZY	0	-	0	0	3255	0.0000000
zheyou73v0_A03	25001673	25003644	BnaA03T0443100ZY	0	-	0	0	1971	0.0000000
zheyou73v0_A03	25006884	25008251	BnaA03T0443200ZY	0	-	0	0	1367	0.0000000
zheyou73v0_A03	25008587	25009786	BnaA03T0443300ZY	0	+	0	0	1199	0.0000000
zheyou73v0_A03	25011236	25012484	BnaA03T0443400ZY	0	+	0	0	1248	0.0000000
zheyou73v0_A03	25012823	25017665	BnaA03T0443500ZY	0	-	0	0	4842	0.0000000
zheyou73v0_A03	25017908	25019412	BnaA03T0443600ZY	0	+	0	0	1504	0.0000000
zheyou73v0_A03	25019413	25019887	BnaA03T0443700ZY	0	-	0	0	474	0.0000000
zheyou73v0_A03	25019896	25021272	BnaA03T0443800ZY	0	-	0	0	1376	0.0000000
zheyou73v0_A03	25029566	25031299	BnaA03T0443900ZY	0	+	0	0	1733	0.0000000
zheyou73v0_A03	25036015	25036352	BnaA03T0444000ZY	0	-	0	0	337	0.0000000
zheyou73v0_A03	25040395	25041367	BnaA03T0444100ZY	0	+	0	0	972	0.0000000
zheyou73v0_A03	25053647	25055314	BnaA03T0444200ZY	0	+	0	0	1667	0.0000000
zheyou73v0_A03	25057472	25059217	BnaA03T0444300ZY	0	+	0	0	1745	0.0000000
zheyou73v0_A03	25057472	25059217	BnaA03T0444300ZY.1	0	+	0	0	1745	0.0000000
zheyou73v0_A03	25059602	25060780	BnaA03T0444400ZY	0	+	0	0	1178	0.0000000
zheyou73v0_A03	25060187	25061491	BnaA03T0444500ZY	0	-	0	0	1304	0.0000000
zheyou73v0_A03	25061585	25064244	BnaA03T0444600ZY	0	-	0	0	2659	0.0000000
zheyou73v0_A03	25061585	25064244	BnaA03T0444600ZY.1	0	-	0	0	2659	0.0000000
zheyou73v0_A03	25061585	25064244	BnaA03T0444600ZY.2	0	-	0	0	2659	0.0000000
zheyou73v0_A03	25061585	25064244	BnaA03T0444600ZY.3	0	-	0	0	2659	0.0000000
zheyou73v0_A03	25061585	25064244	BnaA03T0444600ZY.4	0	-	0	0	2659	0.0000000
zheyou73v0_A03	25061585	25064244	BnaA03T0444600ZY.5	0	-	0	0	2659	0.0000000
zheyou73v0_A03	25061585	25064244	BnaA03T0444600ZY.6	0	-	0	0	2659	0.0000000
zheyou73v0_A03	25061585	25064244	BnaA03T0444600ZY.7	0	-	0	0	2659	0.0000000
zheyou73v0_A03	25061585	25064244	BnaA03T0444600ZY.8	0	-	0	0	2659	0.0000000
zheyou73v0_A03	25061585	25064244	BnaA03T0444600ZY.9	0	-	0	0	2659	0.0000000
zheyou73v0_A03	25071797	25073347	BnaA03T0444700ZY	0	+	0	0	1550	0.0000000
zheyou73v0_A03	25072339	25074674	BnaA03T0444800ZY	0	-	0	0	2335	0.0000000
zheyou73v0_A03	25075344	25076415	BnaA03T0444900ZY	0	-	0	0	1071	0.0000000
zheyou73v0_A03	25079911	25080497	BnaA03T0445000ZY	0	+	0	0	586	0.0000000
zheyou73v0_A03	25081987	25082400	BnaA03T0445100ZY	0	+	0	0	413	0.0000000
zheyou73v0_A03	25091247	25092236	BnaA03T0445200ZY	0	+	0	0	989	0.0000000
zheyou73v0_A03	25102562	25105514	BnaA03T0445300ZY	0	+	0	0	2952	0.0000000
zheyou73v0_A03	25103124	25105514	BnaA03T0445300ZY.1	0	+	0	0	2390	0.0000000
zheyou73v0_A03	25103131	25105514	BnaA03T0445300ZY.2	0	+	0	0	2383	0.0000000
zheyou73v0_A03	25105962	25107452	BnaA03T0445400ZY	0	-	0	0	1490	0.0000000
zheyou73v0_A03	25116956	25117389	BnaA03T0445500ZY	0	-	0	0	433	0.0000000
zheyou73v0_A03	25119856	25120303	BnaA03T0445600ZY	0	-	0	0	447	0.0000000
zheyou73v0_A03	25121702	25123151	BnaA03T0445700ZY	0	-	0	0	1449	0.0000000
zheyou73v0_A03	25124032	25126255	BnaA03T0445800ZY	0	+	0	0	2223	0.0000000
zheyou73v0_A03	25124032	25125311	BnaA03T0445800ZY.1	0	+	0	0	1279	0.0000000
zheyou73v0_A03	25126177	25127848	BnaA03T0445900ZY	0	-	0	0	1671	0.0000000
zheyou73v0_A03	25134402	25135329	BnaA03T0446000ZY	0	-	0	0	927	0.0000000
zheyou73v0_A03	25135419	25136202	BnaA03T0446100ZY	0	-	0	0	783	0.0000000
zheyou73v0_A03	25136251	25136452	BnaA03T0446200ZY	0	-	0	0	201	0.0000000
zheyou73v0_A03	25136511	25137213	BnaA03T0446300ZY	0	-	0	0	702	0.0000000
zheyou73v0_A03	25143951	25145208	BnaA03T0446400ZY	0	-	0	0	1257	0.0000000
zheyou73v0_A03	25145773	25147469	BnaA03T0446500ZY	0	-	0	0	1696	0.0000000
zheyou73v0_A03	25150705	25153808	BnaA03T0446600ZY	0	-	0	0	3103	0.0000000
zheyou73v0_A03	25158359	25159247	BnaA03T0446700ZY	0	-	0	0	888	0.0000000
zheyou73v0_A03	25160071	25161346	BnaA03T0446800ZY	0	-	0	0	1275	0.0000000
zheyou73v0_A03	25161837	25169642	BnaA03T0446900ZY	0	+	0	0	7805	0.0000000
zheyou73v0_A03	25171709	25172593	BnaA03T0447000ZY	0	-	0	0	884	0.0000000
zheyou73v0_A03	25176752	25178450	BnaA03T0447100ZY	0	-	0	0	1698	0.0000000
zheyou73v0_A03	25179084	25183820	BnaA03T0447200ZY	0	+	0	0	4736	0.0000000
zheyou73v0_A03	25192966	25194061	BnaA03T0447300ZY	0	-	0	0	1095	0.0000000
zheyou73v0_A03	25196052	25198161	BnaA03T0447400ZY	0	-	0	0	2109	0.0000000
zheyou73v0_A03	25198872	25200652	BnaA03T0447500ZY	0	-	0	0	1780	0.0000000
zheyou73v0_A03	25202474	25205515	BnaA03T0447600ZY	0	+	0	0	3041	0.0000000
zheyou73v0_A03	25202474	25205515	BnaA03T0447600ZY.1	0	+	0	0	3041	0.0000000
zheyou73v0_A03	25206409	25213351	BnaA03T0447700ZY	0	+	0	0	6942	0.0000000
zheyou73v0_A03	25213661	25214890	BnaA03T0447800ZY	0	-	0	0	1229	0.0000000
zheyou73v0_A03	25215371	25216827	BnaA03T0447900ZY	0	+	0	0	1456	0.0000000
zheyou73v0_A03	25226061	25227490	BnaA03T0448000ZY	0	-	0	0	1429	0.0000000
zheyou73v0_A03	25235507	25236223	BnaA03T0448100ZY	0	-	0	0	716	0.0000000
zheyou73v0_A03	25241533	25244616	BnaA03T0448200ZY	0	-	0	0	3083	0.0000000
zheyou73v0_A03	25250485	25252023	BnaA03T0448300ZY	0	+	0	0	1538	0.0000000
zheyou73v0_A03	25252502	25254265	BnaA03T0448400ZY	0	-	0	0	1763	0.0000000
zheyou73v0_A03	25259239	25265726	BnaA03T0448500ZY	0	-	0	0	6487	0.0000000
zheyou73v0_A03	25266932	25267579	BnaA03T0448600ZY	0	+	0	0	647	0.0000000
zheyou73v0_A03	25286200	25288454	BnaA03T0448700ZY	0	-	0	0	2254	0.0000000
zheyou73v0_A03	25288780	25291200	BnaA03T0448800ZY	0	+	0	0	2420	0.0000000
zheyou73v0_A03	25298337	25300052	BnaA03T0448900ZY	0	+	0	0	1715	0.0000000
zheyou73v0_A03	25306479	25310071	BnaA03T0449000ZY	0	+	0	0	3592	0.0000000
zheyou73v0_A03	25317817	25318564	BnaA03T0449100ZY	0	+	0	0	747	0.0000000
zheyou73v0_A03	25321332	25325547	BnaA03T0449200ZY	0	+	0	0	4215	0.0000000
zheyou73v0_A03	25327971	25328276	BnaA03T0449300ZY	0	-	0	0	305	0.0000000
zheyou73v0_A03	25328853	25330810	BnaA03T0449400ZY	0	-	0	0	1957	0.0000000
zheyou73v0_A03	25332792	25335357	BnaA03T0449500ZY	0	-	0	0	2565	0.0000000
zheyou73v0_A03	25332792	25335357	BnaA03T0449500ZY.1	0	-	0	0	2565	0.0000000
zheyou73v0_A03	25338809	25339377	BnaA03T0449600ZY	0	-	0	0	568	0.0000000
zheyou73v0_A03	25345901	25347565	BnaA03T0449700ZY	0	-	0	0	1664	0.0000000
zheyou73v0_A03	25347771	25348572	BnaA03T0449800ZY	0	-	0	0	801	0.0000000
zheyou73v0_A03	25351714	25352230	BnaA03T0449900ZY	0	+	0	0	516	0.0000000
zheyou73v0_A03	25352693	25355009	BnaA03T0450000ZY	0	-	0	0	2316	0.0000000
zheyou73v0_A03	25356905	25359330	BnaA03T0450100ZY	0	+	0	0	2425	0.0000000
zheyou73v0_A03	25360228	25361351	BnaA03T0450200ZY	0	+	0	0	1123	0.0000000
zheyou73v0_A03	25362752	25365326	BnaA03T0450300ZY	0	+	0	0	2574	0.0000000
zheyou73v0_A03	25366690	25368355	BnaA03T0450400ZY	0	+	0	0	1665	0.0000000
zheyou73v0_A03	25368806	25370460	BnaA03T0450500ZY	0	+	0	0	1654	0.0000000
zheyou73v0_A03	25370924	25372649	BnaA03T0450600ZY	0	-	0	0	1725	0.0000000
zheyou73v0_A03	25375558	25376810	BnaA03T0450700ZY	0	+	0	0	1252	0.0000000
zheyou73v0_A03	25376995	25378606	BnaA03T0450800ZY	0	+	0	0	1611	0.0000000
zheyou73v0_A03	25379455	25381071	BnaA03T0450900ZY	0	-	0	0	1616	0.0000000
zheyou73v0_A03	25387980	25389211	BnaA03T0451000ZY	0	+	0	0	1231	0.0000000
zheyou73v0_A03	25394650	25395767	BnaA03T0451100ZY	0	+	0	0	1117	0.0000000
zheyou73v0_A03	25396350	25398009	BnaA03T0451200ZY	0	-	0	0	1659	0.0000000
zheyou73v0_A03	25396350	25398009	BnaA03T0451200ZY.1	0	-	0	0	1659	0.0000000
zheyou73v0_A03	25398334	25399973	BnaA03T0451300ZY	0	-	0	0	1639	0.0000000
zheyou73v0_A03	25398334	25399973	BnaA03T0451300ZY.1	0	-	0	0	1639	0.0000000
zheyou73v0_A03	25400747	25402497	BnaA03T0451400ZY	0	-	0	0	1750	0.0000000
zheyou73v0_A03	25403008	25404801	BnaA03T0451500ZY	0	+	0	0	1793	0.0000000
zheyou73v0_A03	25405046	25406580	BnaA03T0451600ZY	0	-	0	0	1534	0.0000000
zheyou73v0_A03	25405046	25406580	BnaA03T0451600ZY.1	0	-	0	0	1534	0.0000000
zheyou73v0_A03	25414344	25416277	BnaA03T0451700ZY	0	-	0	0	1933	0.0000000
zheyou73v0_A03	25425475	25427177	BnaA03T0451800ZY	0	+	0	0	1702	0.0000000
zheyou73v0_A03	25434777	25439115	BnaA03T0451900ZY	0	+	0	0	4338	0.0000000
zheyou73v0_A03	25439976	25442875	BnaA03T0452000ZY	0	+	0	0	2899	0.0000000
zheyou73v0_A03	25443174	25445185	BnaA03T0452100ZY	0	+	0	0	2011	0.0000000
zheyou73v0_A03	25443174	25445185	BnaA03T0452100ZY.1	0	+	0	0	2011	0.0000000
zheyou73v0_A03	25445263	25446055	BnaA03T0452200ZY	0	+	0	0	792	0.0000000
zheyou73v0_A03	25446705	25447864	BnaA03T0452300ZY	0	-	0	0	1159	0.0000000
zheyou73v0_A03	25464567	25465915	BnaA03T0452400ZY	0	-	0	0	1348	0.0000000
zheyou73v0_A03	25503535	25505078	BnaA03T0452500ZY	0	+	0	0	1543	0.0000000
zheyou73v0_A03	25505460	25508004	BnaA03T0452600ZY	0	-	0	0	2544	0.0000000
zheyou73v0_A03	25509868	25511647	BnaA03T0452700ZY	0	+	0	0	1779	0.0000000
zheyou73v0_A03	25519026	25523033	BnaA03T0452800ZY	0	+	0	0	4007	0.0000000
zheyou73v0_A03	25519026	25523033	BnaA03T0452800ZY.1	0	+	0	0	4007	0.0000000
zheyou73v0_A03	25523029	25524202	BnaA03T0452900ZY	0	-	0	0	1173	0.0000000
zheyou73v0_A03	25525232	25526479	BnaA03T0453000ZY	0	-	0	0	1247	0.0000000
zheyou73v0_A03	25541981	25543776	BnaA03T0453100ZY	0	+	0	0	1795	0.0000000
zheyou73v0_A03	25548268	25549598	BnaA03T0453200ZY	0	-	0	0	1330	0.0000000
zheyou73v0_A03	25551757	25553955	BnaA03T0453300ZY	0	-	0	0	2198	0.0000000
zheyou73v0_A03	25569949	25570757	BnaA03T0453400ZY	0	+	0	0	808	0.0000000
zheyou73v0_A03	25573443	25575638	BnaA03T0453500ZY	0	+	0	0	2195	0.0000000
zheyou73v0_A03	25575505	25577594	BnaA03T0453600ZY	0	-	0	0	2089	0.0000000
zheyou73v0_A03	25577929	25579076	BnaA03T0453700ZY	0	+	0	0	1147	0.0000000
zheyou73v0_A03	25585683	25588250	BnaA03T0453800ZY	0	+	0	0	2567	0.0000000
zheyou73v0_A03	25589147	25592006	BnaA03T0453900ZY	0	+	0	0	2859	0.0000000
zheyou73v0_A03	25592595	25592975	BnaA03T0454000ZY	0	+	0	0	380	0.0000000
zheyou73v0_A03	25601315	25603585	BnaA03T0454100ZY	0	+	0	0	2270	0.0000000
zheyou73v0_A03	25604567	25606815	BnaA03T0454200ZY	0	-	0	0	2248	0.0000000
zheyou73v0_A03	25609167	25610441	BnaA03T0454300ZY	0	-	0	0	1274	0.0000000
zheyou73v0_A03	25624522	25627110	BnaA03T0454400ZY	0	+	0	0	2588	0.0000000
zheyou73v0_A03	25629859	25630978	BnaA03T0454500ZY	0	-	0	0	1119	0.0000000
zheyou73v0_A03	25639065	25659201	BnaA03T0454600ZY	0	-	0	0	20136	0.0000000
zheyou73v0_A03	25662758	25664123	BnaA03T0454700ZY	0	+	0	0	1365	0.0000000
zheyou73v0_A03	25665710	25669124	BnaA03T0454800ZY	0	-	0	0	3414	0.0000000
zheyou73v0_A03	25665710	25669124	BnaA03T0454800ZY.1	0	-	0	0	3414	0.0000000
zheyou73v0_A03	25691713	25695818	BnaA03T0454900ZY	0	-	0	0	4105	0.0000000
zheyou73v0_A03	25706865	25707524	BnaA03T0455000ZY	0	-	0	0	659	0.0000000
zheyou73v0_A03	25720455	25725827	BnaA03T0455100ZY	0	+	0	0	5372	0.0000000
zheyou73v0_A03	25726030	25728191	BnaA03T0455200ZY	0	-	0	0	2161	0.0000000
zheyou73v0_A03	25730311	25732315	BnaA03T0455300ZY	0	+	0	0	2004	0.0000000
zheyou73v0_A03	25733050	25735025	BnaA03T0455400ZY	0	+	0	0	1975	0.0000000
zheyou73v0_A03	25735650	25747182	BnaA03T0455500ZY	0	-	0	0	11532	0.0000000
zheyou73v0_A03	25748107	25749033	BnaA03T0455600ZY	0	-	0	0	926	0.0000000
zheyou73v0_A03	25751986	25752367	BnaA03T0455700ZY	0	+	0	0	381	0.0000000
zheyou73v0_A03	25755960	25758001	BnaA03T0455800ZY	0	+	0	0	2041	0.0000000
zheyou73v0_A03	25763789	25765350	BnaA03T0455900ZY	0	+	0	0	1561	0.0000000
zheyou73v0_A03	25771987	25773847	BnaA03T0456000ZY	0	+	0	0	1860	0.0000000
zheyou73v0_A03	25774495	25775611	BnaA03T0456100ZY	0	+	0	0	1116	0.0000000
zheyou73v0_A03	25776006	25777084	BnaA03T0456200ZY	0	-	0	0	1078	0.0000000
zheyou73v0_A03	25779906	25780077	BnaA03T0456300ZY	0	+	0	0	171	0.0000000
zheyou73v0_A03	25782174	25784613	BnaA03T0456400ZY	0	+	0	0	2439	0.0000000
zheyou73v0_A03	25789357	25792090	BnaA03T0456500ZY	0	-	0	0	2733	0.0000000
zheyou73v0_A03	25804963	25809897	BnaA03T0456600ZY	0	-	0	0	4934	0.0000000
zheyou73v0_A03	25811214	25814197	BnaA03T0456700ZY	0	-	0	0	2983	0.0000000
zheyou73v0_A03	25811214	25813695	BnaA03T0456700ZY.1	0	-	0	0	2481	0.0000000
zheyou73v0_A03	25816041	25816931	BnaA03T0456800ZY	0	+	0	0	890	0.0000000
zheyou73v0_A03	25816978	25819163	BnaA03T0456900ZY	0	-	0	0	2185	0.0000000
zheyou73v0_A03	25840451	25842406	BnaA03T0457000ZY	0	+	0	0	1955	0.0000000
zheyou73v0_A03	25848446	25849103	BnaA03T0457100ZY	0	-	0	0	657	0.0000000
zheyou73v0_A03	25850682	25852067	BnaA03T0457200ZY	0	-	0	0	1385	0.0000000
zheyou73v0_A03	25858369	25859510	BnaA03T0457300ZY	0	-	0	0	1141	0.0000000
zheyou73v0_A03	25862280	25863111	BnaA03T0457400ZY	0	-	0	0	831	0.0000000
zheyou73v0_A03	25864976	25865213	BnaA03T0457500ZY	0	+	0	0	237	0.0000000
zheyou73v0_A03	25865551	25865936	BnaA03T0457600ZY	0	-	0	0	385	0.0000000
zheyou73v0_A03	25872145	25873285	BnaA03T0457700ZY	0	-	0	0	1140	0.0000000
zheyou73v0_A03	25874351	25876663	BnaA03T0457800ZY	0	-	0	0	2312	0.0000000
zheyou73v0_A03	25876981	25878766	BnaA03T0457900ZY	0	-	0	0	1785	0.0000000
zheyou73v0_A03	25876981	25878766	BnaA03T0457900ZY.1	0	-	0	0	1785	0.0000000
zheyou73v0_A03	25879567	25883393	BnaA03T0458000ZY	0	+	0	0	3826	0.0000000
zheyou73v0_A03	25885932	25886508	BnaA03T0458100ZY	0	+	0	0	576	0.0000000
zheyou73v0_A03	25893199	25893436	BnaA03T0458200ZY	0	+	0	0	237	0.0000000
zheyou73v0_A03	25897765	25898002	BnaA03T0458300ZY	0	+	0	0	237	0.0000000
zheyou73v0_A03	25906543	25908660	BnaA03T0458400ZY	0	-	0	0	2117	0.0000000
zheyou73v0_A03	25909537	25911918	BnaA03T0458500ZY	0	+	0	0	2381	0.0000000
zheyou73v0_A03	25914050	25914817	BnaA03T0458600ZY	0	+	0	0	767	0.0000000
zheyou73v0_A03	25916827	25918997	BnaA03T0458700ZY	0	-	0	0	2170	0.0000000
zheyou73v0_A03	25920361	25920637	BnaA03T0458800ZY	0	-	0	0	276	0.0000000
zheyou73v0_A03	25921251	25928112	BnaA03T0458900ZY	0	-	0	0	6861	0.0000000
zheyou73v0_A03	25951701	25954647	BnaA03T0459000ZY	0	+	0	0	2946	0.0000000
zheyou73v0_A03	25951701	25954647	BnaA03T0459000ZY.1	0	+	0	0	2946	0.0000000
zheyou73v0_A03	25956145	25957442	BnaA03T0459100ZY	0	+	0	0	1297	0.0000000
zheyou73v0_A03	25962636	25963212	BnaA03T0459200ZY	0	+	0	0	576	0.0000000
zheyou73v0_A03	25973626	25976571	BnaA03T0459300ZY	0	+	0	0	2945	0.0000000
zheyou73v0_A03	25981984	25982842	BnaA03T0459400ZY	0	+	0	0	858	0.0000000
zheyou73v0_A03	25989249	25991144	BnaA03T0459500ZY	0	+	0	0	1895	0.0000000
zheyou73v0_A03	25989249	25991144	BnaA03T0459500ZY.1	0	+	0	0	1895	0.0000000
zheyou73v0_A03	25992752	25993606	BnaA03T0459600ZY	0	+	0	0	854	0.0000000
zheyou73v0_A03	25994840	25996284	BnaA03T0459700ZY	0	+	0	0	1444	0.0000000
zheyou73v0_A03	25996507	26000566	BnaA03T0459800ZY	0	-	0	0	4059	0.0000000
zheyou73v0_A03	26001560	26003710	BnaA03T0459900ZY	0	-	0	0	2150	0.0000000
zheyou73v0_A03	26004572	26005620	BnaA03T0460000ZY	0	-	0	0	1048	0.0000000
zheyou73v0_A03	26015862	26016315	BnaA03T0460100ZY	0	-	0	0	453	0.0000000
zheyou73v0_A03	26019074	26020492	BnaA03T0460200ZY	0	+	0	0	1418	0.0000000
zheyou73v0_A03	26022500	26023055	BnaA03T0460300ZY	0	+	0	0	555	0.0000000
zheyou73v0_A03	26023275	26023665	BnaA03T0460400ZY	0	+	0	0	390	0.0000000
zheyou73v0_A03	26045504	26046053	BnaA03T0460500ZY	0	-	0	0	549	0.0000000
zheyou73v0_A03	26054245	26056376	BnaA03T0460600ZY	0	-	0	0	2131	0.0000000
zheyou73v0_A03	26058707	26060857	BnaA03T0460700ZY	0	+	0	0	2150	0.0000000
zheyou73v0_A03	26068339	26068546	BnaA03T0460800ZY	0	+	0	0	207	0.0000000
zheyou73v0_A03	26071040	26071428	BnaA03T0460900ZY	0	+	0	0	388	0.0000000
zheyou73v0_A03	26074151	26074406	BnaA03T0461000ZY	0	+	0	0	255	0.0000000
zheyou73v0_A03	26084076	26086188	BnaA03T0461100ZY	0	+	0	0	2112	0.0000000
zheyou73v0_A03	26087354	26088707	BnaA03T0461200ZY	0	+	0	0	1353	0.0000000
zheyou73v0_A03	26099574	26103633	BnaA03T0461300ZY	0	+	0	0	4059	0.0000000
zheyou73v0_A03	26104564	26106234	BnaA03T0461400ZY	0	-	0	0	1670	0.0000000
zheyou73v0_A03	26112616	26113503	BnaA03T0461500ZY	0	+	0	0	887	0.0000000
zheyou73v0_A03	26121392	26122666	BnaA03T0461600ZY	0	-	0	0	1274	0.0000000
zheyou73v0_A03	26123418	26124147	BnaA03T0461700ZY	0	+	0	0	729	0.0000000
zheyou73v0_A03	26124968	26132139	BnaA03T0461800ZY	0	-	0	0	7171	0.0000000
zheyou73v0_A03	26145424	26150956	BnaA03T0461900ZY	0	-	0	0	5532	0.0000000
zheyou73v0_A03	26151361	26153018	BnaA03T0462000ZY	0	-	0	0	1657	0.0000000
zheyou73v0_A03	26153400	26156223	BnaA03T0462100ZY	0	-	0	0	2823	0.0000000
zheyou73v0_A03	26153400	26156223	BnaA03T0462100ZY.1	0	-	0	0	2823	0.0000000
zheyou73v0_A03	26159240	26160436	BnaA03T0462200ZY	0	-	0	0	1196	0.0000000
zheyou73v0_A03	26160550	26164302	BnaA03T0462300ZY	0	-	0	0	3752	0.0000000
zheyou73v0_A03	26177862	26180436	BnaA03T0462400ZY	0	-	0	0	2574	0.0000000
zheyou73v0_A03	26183418	26184824	BnaA03T0462500ZY	0	+	0	0	1406	0.0000000
zheyou73v0_A03	26186304	26189523	BnaA03T0462600ZY	0	+	0	0	3219	0.0000000
zheyou73v0_A03	26189539	26192436	BnaA03T0462700ZY	0	-	0	0	2897	0.0000000
zheyou73v0_A03	26218865	26221307	BnaA03T0462800ZY	0	+	0	0	2442	0.0000000
zheyou73v0_A03	26218865	26221307	BnaA03T0462800ZY.1	0	+	0	0	2442	0.0000000
zheyou73v0_A03	26233667	26238654	BnaA03T0462900ZY	0	+	0	0	4987	0.0000000
zheyou73v0_A03	26240036	26241462	BnaA03T0463000ZY	0	+	0	0	1426	0.0000000
zheyou73v0_A03	26243612	26250648	BnaA03T0463100ZY	0	-	0	0	7036	0.0000000
zheyou73v0_A03	26266687	26267368	BnaA03T0463200ZY	0	-	0	0	681	0.0000000
zheyou73v0_A03	26269655	26270510	BnaA03T0463300ZY	0	-	0	0	855	0.0000000
zheyou73v0_A03	26281859	26286287	BnaA03T0463400ZY	0	+	0	0	4428	0.0000000
zheyou73v0_A03	26286423	26287866	BnaA03T0463500ZY	0	-	0	0	1443	0.0000000
zheyou73v0_A03	26288567	26293210	BnaA03T0463600ZY	0	-	0	0	4643	0.0000000
zheyou73v0_A03	26292725	26298548	BnaA03T0463700ZY	0	+	0	0	5823	0.0000000
zheyou73v0_A03	26298878	26305803	BnaA03T0463800ZY	0	+	0	0	6925	0.0000000
zheyou73v0_A03	26298878	26305321	BnaA03T0463800ZY.1	0	+	0	0	6443	0.0000000
zheyou73v0_A03	26306306	26306647	BnaA03T0463900ZY	0	-	0	0	341	0.0000000
zheyou73v0_A03	26308328	26310334	BnaA03T0464000ZY	0	-	0	0	2006	0.0000000
zheyou73v0_A03	26311299	26312559	BnaA03T0464100ZY	0	-	0	0	1260	0.0000000
zheyou73v0_A03	26313486	26314941	BnaA03T0464200ZY	0	-	0	0	1455	0.0000000
zheyou73v0_A03	26316574	26324695	BnaA03T0464300ZY	0	+	0	0	8121	0.0000000
zheyou73v0_A03	26331108	26333077	BnaA03T0464400ZY	0	+	0	0	1969	0.0000000
zheyou73v0_A03	26336773	26338880	BnaA03T0464500ZY	0	+	0	0	2107	0.0000000
zheyou73v0_A03	26343109	26344329	BnaA03T0464600ZY	0	-	0	0	1220	0.0000000
zheyou73v0_A03	26360510	26362885	BnaA03T0464700ZY	0	-	0	0	2375	0.0000000
zheyou73v0_A03	26363942	26365707	BnaA03T0464800ZY	0	-	0	0	1765	0.0000000
zheyou73v0_A03	26366777	26368109	BnaA03T0464900ZY	0	+	0	0	1332	0.0000000
zheyou73v0_A03	26372536	26374543	BnaA03T0465000ZY	0	-	0	0	2007	0.0000000
zheyou73v0_A03	26377228	26380569	BnaA03T0465100ZY	0	+	0	0	3341	0.0000000
zheyou73v0_A03	26380969	26381200	BnaA03T0465200ZY	0	+	0	0	231	0.0000000
zheyou73v0_A03	26398327	26400201	BnaA03T0465300ZY	0	+	0	0	1874	0.0000000
zheyou73v0_A03	26401086	26402987	BnaA03T0465400ZY	0	+	0	0	1901	0.0000000
zheyou73v0_A03	26403297	26405315	BnaA03T0465500ZY	0	-	0	0	2018	0.0000000
zheyou73v0_A03	26405612	26406278	BnaA03T0465600ZY	0	+	0	0	666	0.0000000
zheyou73v0_A03	26406349	26408119	BnaA03T0465700ZY	0	-	0	0	1770	0.0000000
zheyou73v0_A03	26409186	26409492	BnaA03T0465800ZY	0	-	0	0	306	0.0000000
zheyou73v0_A03	26410723	26410990	BnaA03T0465900ZY	0	-	0	0	267	0.0000000
zheyou73v0_A03	26415149	26418279	BnaA03T0466000ZY	0	+	0	0	3130	0.0000000
zheyou73v0_A03	26419717	26421219	BnaA03T0466100ZY	0	-	0	0	1502	0.0000000
zheyou73v0_A03	26424100	26424526	BnaA03T0466200ZY	0	-	0	0	426	0.0000000
zheyou73v0_A03	26428471	26429614	BnaA03T0466300ZY	0	-	0	0	1143	0.0000000
zheyou73v0_A03	26435647	26437773	BnaA03T0466400ZY	0	-	0	0	2126	0.0000000
zheyou73v0_A03	26437844	26440625	BnaA03T0466500ZY	0	-	0	0	2781	0.0000000
zheyou73v0_A03	26441405	26444837	BnaA03T0466600ZY	0	-	0	0	3432	0.0000000
zheyou73v0_A03	26450575	26456661	BnaA03T0466700ZY	0	-	0	0	6086	0.0000000
zheyou73v0_A03	26466982	26468463	BnaA03T0466800ZY	0	+	0	0	1481	0.0000000
zheyou73v0_A03	26477482	26480010	BnaA03T0466900ZY	0	+	0	0	2528	0.0000000
zheyou73v0_A03	26489300	26492812	BnaA03T0467000ZY	0	+	0	0	3512	0.0000000
zheyou73v0_A03	26507628	26508636	BnaA03T0467100ZY	0	+	0	0	1008	0.0000000
zheyou73v0_A03	26510893	26518398	BnaA03T0467200ZY	0	+	0	0	7505	0.0000000
zheyou73v0_A03	26519169	26520895	BnaA03T0467300ZY	0	+	0	0	1726	0.0000000
zheyou73v0_A03	26523096	26524097	BnaA03T0467400ZY	0	+	0	0	1001	0.0000000
zheyou73v0_A03	26524736	26525425	BnaA03T0467500ZY	0	+	0	0	689	0.0000000
zheyou73v0_A03	26525626	26526031	BnaA03T0467600ZY	0	-	0	0	405	0.0000000
zheyou73v0_A03	26527078	26528032	BnaA03T0467700ZY	0	-	0	0	954	0.0000000
zheyou73v0_A03	26532342	26533024	BnaA03T0467800ZY	0	-	0	0	682	0.0000000
zheyou73v0_A03	26537197	26540333	BnaA03T0467900ZY	0	+	0	0	3136	0.0000000
zheyou73v0_A03	26541856	26543702	BnaA03T0468000ZY	0	+	0	0	1846	0.0000000
zheyou73v0_A03	26546748	26555731	BnaA03T0468100ZY	0	-	0	0	8983	0.0000000
zheyou73v0_A03	26566396	26567780	BnaA03T0468200ZY	0	-	0	0	1384	0.0000000
zheyou73v0_A03	26569136	26570318	BnaA03T0468300ZY	0	-	0	0	1182	0.0000000
zheyou73v0_A03	26572492	26573985	BnaA03T0468400ZY	0	+	0	0	1493	0.0000000
zheyou73v0_A03	26574006	26575390	BnaA03T0468500ZY	0	-	0	0	1384	0.0000000
zheyou73v0_A03	26576746	26577928	BnaA03T0468600ZY	0	-	0	0	1182	0.0000000
zheyou73v0_A03	26580058	26582264	BnaA03T0468700ZY	0	+	0	0	2206	0.0000000
zheyou73v0_A03	26582292	26583655	BnaA03T0468800ZY	0	-	0	0	1363	0.0000000
zheyou73v0_A03	26587819	26589080	BnaA03T0468900ZY	0	+	0	0	1261	0.0000000
zheyou73v0_A03	26591051	26592332	BnaA03T0469000ZY	0	+	0	0	1281	0.0000000
zheyou73v0_A03	26605490	26606842	BnaA03T0469100ZY	0	+	0	0	1352	0.0000000
zheyou73v0_A03	26610995	26611442	BnaA03T0469200ZY	0	+	0	0	447	0.0000000
zheyou73v0_A03	26613867	26616306	BnaA03T0469300ZY	0	-	0	0	2439	0.0000000
zheyou73v0_A03	26619403	26620024	BnaA03T0469400ZY	0	+	0	0	621	0.0000000
zheyou73v0_A03	26621674	26622281	BnaA03T0469500ZY	0	+	0	0	607	0.0000000
zheyou73v0_A03	26623011	26623593	BnaA03T0469600ZY	0	+	0	0	582	0.0000000
zheyou73v0_A03	26624249	26625231	BnaA03T0469700ZY	0	+	0	0	982	0.0000000
zheyou73v0_A03	26627576	26631039	BnaA03T0469800ZY	0	+	0	0	3463	0.0000000
zheyou73v0_A03	26631641	26631966	BnaA03T0469900ZY	0	-	0	0	325	0.0000000
zheyou73v0_A03	26632594	26639895	BnaA03T0470000ZY	0	+	0	0	7301	0.0000000
zheyou73v0_A03	26640047	26641120	BnaA03T0470100ZY	0	-	0	0	1073	0.0000000
zheyou73v0_A03	26641676	26642318	BnaA03T0470200ZY	0	+	0	0	642	0.0000000
zheyou73v0_A03	26647423	26649923	BnaA03T0470300ZY	0	+	0	0	2500	0.0000000
zheyou73v0_A03	26652946	26657163	BnaA03T0470400ZY	0	-	0	0	4217	0.0000000
zheyou73v0_A03	26663101	26666458	BnaA03T0470500ZY	0	+	0	0	3357	0.0000000
zheyou73v0_A03	26677716	26680884	BnaA03T0470600ZY	0	+	0	0	3168	0.0000000
zheyou73v0_A03	26682096	26684858	BnaA03T0470700ZY	0	-	0	0	2762	0.0000000
zheyou73v0_A03	26687364	26691364	BnaA03T0470800ZY	0	-	0	0	4000	0.0000000
zheyou73v0_A03	26693852	26694193	BnaA03T0470900ZY	0	+	0	0	341	0.0000000
zheyou73v0_A03	26698783	26699267	BnaA03T0471000ZY	0	-	0	0	484	0.0000000
zheyou73v0_A03	26705574	26706831	BnaA03T0471100ZY	0	-	0	0	1257	0.0000000
zheyou73v0_A03	26719150	26721846	BnaA03T0471200ZY	0	+	0	0	2696	0.0000000
zheyou73v0_A03	26724608	26727043	BnaA03T0471300ZY	0	-	0	0	2435	0.0000000
zheyou73v0_A03	26729541	26730863	BnaA03T0471400ZY	0	+	0	0	1322	0.0000000
zheyou73v0_A03	26732811	26733213	BnaA03T0471500ZY	0	+	0	0	402	0.0000000
zheyou73v0_A03	26733272	26756801	BnaA03T0471600ZY	0	-	0	0	23529	0.0000000
zheyou73v0_A03	26763371	26768334	BnaA03T0471700ZY	0	+	0	0	4963	0.0000000
zheyou73v0_A03	26768364	26770615	BnaA03T0471800ZY	0	-	0	0	2251	0.0000000
zheyou73v0_A03	26787006	26788871	BnaA03T0471900ZY	0	-	0	0	1865	0.0000000
zheyou73v0_A03	26789354	26795864	BnaA03T0472000ZY	0	-	0	0	6510	0.0000000
zheyou73v0_A03	26796124	26797826	BnaA03T0472100ZY	0	+	0	0	1702	0.0000000
zheyou73v0_A03	26796124	26797826	BnaA03T0472100ZY.1	0	+	0	0	1702	0.0000000
zheyou73v0_A03	26798214	26798646	BnaA03T0472200ZY	0	+	0	0	432	0.0000000
zheyou73v0_A03	26801728	26802856	BnaA03T0472300ZY	0	+	0	0	1128	0.0000000
zheyou73v0_A03	26811846	26812038	BnaA03T0472400ZY	0	+	0	0	192	0.0000000
zheyou73v0_A03	26833496	26835506	BnaA03T0472500ZY	0	+	0	0	2010	0.0000000
zheyou73v0_A03	26835510	26835846	BnaA03T0472600ZY	0	+	0	0	336	0.0000000
zheyou73v0_A03	26837670	26839155	BnaA03T0472700ZY	0	-	0	0	1485	0.0000000
zheyou73v0_A03	26846408	26847673	BnaA03T0472800ZY	0	-	0	0	1265	0.0000000
zheyou73v0_A03	26849751	26853407	BnaA03T0472900ZY	0	-	0	0	3656	0.0000000
zheyou73v0_A03	26865616	26870148	BnaA03T0473000ZY	0	-	0	0	4532	0.0000000
zheyou73v0_A03	26865616	26870148	BnaA03T0473000ZY.1	0	-	0	0	4532	0.0000000
zheyou73v0_A03	26870299	26870675	BnaA03T0473100ZY	0	+	0	0	376	0.0000000
zheyou73v0_A03	26877202	26889651	BnaA03T0473200ZY	0	-	0	0	12449	0.0000000
zheyou73v0_A03	26906030	26906651	BnaA03T0473300ZY	0	-	0	0	621	0.0000000
zheyou73v0_A03	26939202	26939364	BnaA03T0473400ZY	0	+	0	0	162	0.0000000
zheyou73v0_A03	26939530	26940004	BnaA03T0473500ZY	0	+	0	0	474	0.0000000
zheyou73v0_A03	26942295	26944071	BnaA03T0473600ZY.1	0	+	0	0	1776	0.0000000
zheyou73v0_A03	26942366	26944071	BnaA03T0473600ZY	0	+	0	0	1705	0.0000000
zheyou73v0_A03	26943827	26945415	BnaA03T0473700ZY	0	-	0	0	1588	0.0000000
zheyou73v0_A03	26956516	26957536	BnaA03T0473800ZY	0	+	0	0	1020	0.0000000
zheyou73v0_A03	26965392	26970767	BnaA03T0473900ZY	0	-	0	0	5375	0.0000000
zheyou73v0_A03	26973896	26974457	BnaA03T0474000ZY	0	+	0	0	561	0.0000000
zheyou73v0_A03	26978896	26982243	BnaA03T0474100ZY	0	-	0	0	3347	0.0000000
zheyou73v0_A03	26987432	26987756	BnaA03T0474200ZY	0	-	0	0	324	0.0000000
zheyou73v0_A03	26993965	26995929	BnaA03T0474300ZY	0	+	0	0	1964	0.0000000
zheyou73v0_A03	26993965	26995929	BnaA03T0474300ZY.1	0	+	0	0	1964	0.0000000
zheyou73v0_A03	27016668	27017769	BnaA03T0474400ZY	0	+	0	0	1101	0.0000000
zheyou73v0_A03	27019946	27025949	BnaA03T0474500ZY	0	+	0	0	6003	0.0000000
zheyou73v0_A03	27030389	27035286	BnaA03T0474600ZY	0	-	0	0	4897	0.0000000
zheyou73v0_A03	27041191	27041561	BnaA03T0474700ZY	0	+	0	0	370	0.0000000
zheyou73v0_A03	27043928	27044219	BnaA03T0474800ZY	0	-	0	0	291	0.0000000
zheyou73v0_A03	27049308	27049845	BnaA03T0474900ZY	0	-	0	0	537	0.0000000
zheyou73v0_A03	27050626	27052972	BnaA03T0475000ZY	0	-	0	0	2346	0.0000000
zheyou73v0_A03	27050626	27052972	BnaA03T0475000ZY.1	0	-	0	0	2346	0.0000000
zheyou73v0_A03	27057965	27059084	BnaA03T0475100ZY	0	+	0	0	1119	0.0000000
zheyou73v0_A03	27060343	27061294	BnaA03T0475200ZY	0	-	0	0	951	0.0000000
zheyou73v0_A03	27072406	27073098	BnaA03T0475300ZY	0	-	0	0	692	0.0000000
zheyou73v0_A03	27074315	27076014	BnaA03T0475400ZY	0	-	0	0	1699	0.0000000
zheyou73v0_A03	27076819	27084288	BnaA03T0475500ZY	0	+	0	0	7469	0.0000000
zheyou73v0_A03	27082501	27084288	BnaA03T0475500ZY.1	0	+	0	0	1787	0.0000000
zheyou73v0_A03	27084191	27089629	BnaA03T0475600ZY	0	-	0	0	5438	0.0000000
zheyou73v0_A03	27093990	27097306	BnaA03T0475700ZY	0	-	0	0	3316	0.0000000
zheyou73v0_A03	27098523	27100657	BnaA03T0475800ZY	0	-	0	0	2134	0.0000000
zheyou73v0_A03	27104105	27107130	BnaA03T0475900ZY	0	-	0	0	3025	0.0000000
zheyou73v0_A03	27107303	27108507	BnaA03T0476000ZY	0	+	0	0	1204	0.0000000
zheyou73v0_A03	27109388	27110422	BnaA03T0476100ZY	0	-	0	0	1034	0.0000000
zheyou73v0_A03	27111385	27112955	BnaA03T0476200ZY	0	+	0	0	1570	0.0000000
zheyou73v0_A03	27113372	27115635	BnaA03T0476300ZY	0	-	0	0	2263	0.0000000
zheyou73v0_A03	27117074	27119154	BnaA03T0476400ZY	0	+	0	0	2080	0.0000000
zheyou73v0_A03	27129054	27137111	BnaA03T0476500ZY	0	+	0	0	8057	0.0000000
zheyou73v0_A03	27137303	27137925	BnaA03T0476600ZY	0	-	0	0	622	0.0000000
zheyou73v0_A03	27141233	27144320	BnaA03T0476700ZY	0	+	0	0	3087	0.0000000
zheyou73v0_A03	27148205	27150215	BnaA03T0476800ZY	0	+	0	0	2010	0.0000000
zheyou73v0_A03	27152612	27153153	BnaA03T0476900ZY	0	-	0	0	541	0.0000000
zheyou73v0_A03	27155542	27159766	BnaA03T0477000ZY	0	-	0	0	4224	0.0000000
zheyou73v0_A03	27176150	27177282	BnaA03T0477100ZY	0	+	0	0	1132	0.0000000
zheyou73v0_A03	27178144	27179796	BnaA03T0477200ZY	0	+	0	0	1652	0.0000000
zheyou73v0_A03	27183906	27185093	BnaA03T0477300ZY	0	+	0	0	1187	0.0000000
zheyou73v0_A03	27185260	27188284	BnaA03T0477400ZY	0	-	0	0	3024	0.0000000
zheyou73v0_A03	27220161	27220882	BnaA03T0477500ZY	0	+	0	0	721	0.0000000
zheyou73v0_A03	27227818	27233926	BnaA03T0477600ZY	0	-	0	0	6108	0.0000000
zheyou73v0_A03	27250476	27252247	BnaA03T0477700ZY	0	+	0	0	1771	0.0000000
zheyou73v0_A03	27253760	27254042	BnaA03T0477800ZY	0	+	0	0	282	0.0000000
zheyou73v0_A03	27261165	27262542	BnaA03T0477900ZY	0	+	0	0	1377	0.0000000
zheyou73v0_A03	27263605	27266290	BnaA03T0478000ZY	0	+	0	0	2685	0.0000000
zheyou73v0_A03	27275994	27276986	BnaA03T0478100ZY	0	-	0	0	992	0.0000000
zheyou73v0_A03	27285295	27285919	BnaA03T0478200ZY	0	+	0	0	624	0.0000000
zheyou73v0_A03	27286546	27286810	BnaA03T0478300ZY	0	-	0	0	264	0.0000000
zheyou73v0_A03	27287554	27288670	BnaA03T0478400ZY	0	-	0	0	1116	0.0000000
zheyou73v0_A03	27293785	27295776	BnaA03T0478500ZY	0	-	0	0	1991	0.0000000
zheyou73v0_A03	27300601	27303426	BnaA03T0478600ZY	0	-	0	0	2825	0.0000000
zheyou73v0_A03	27300601	27302981	BnaA03T0478600ZY.1	0	-	0	0	2380	0.0000000
zheyou73v0_A03	27314157	27316177	BnaA03T0478700ZY	0	-	0	0	2020	0.0000000
zheyou73v0_A03	27325261	27326732	BnaA03T0478800ZY	0	+	0	0	1471	0.0000000
zheyou73v0_A03	27329473	27332789	BnaA03T0478900ZY	0	-	0	0	3316	0.0000000
zheyou73v0_A03	27333606	27334064	BnaA03T0479000ZY	0	-	0	0	458	0.0000000
zheyou73v0_A03	27338177	27340203	BnaA03T0479100ZY	0	-	0	0	2026	0.0000000
zheyou73v0_A03	27342119	27345600	BnaA03T0479200ZY	0	+	0	0	3481	0.0000000
zheyou73v0_A03	27346032	27346820	BnaA03T0479300ZY	0	-	0	0	788	0.0000000
zheyou73v0_A03	27346837	27347261	BnaA03T0479400ZY	0	-	0	0	424	0.0000000
zheyou73v0_A03	27348770	27350838	BnaA03T0479500ZY	0	+	0	0	2068	0.0000000
zheyou73v0_A03	27351993	27353010	BnaA03T0479600ZY	0	+	0	0	1017	0.0000000
zheyou73v0_A03	27354183	27357184	BnaA03T0479700ZY	0	+	0	0	3001	0.0000000
zheyou73v0_A03	27357683	27359305	BnaA03T0479800ZY	0	-	0	0	1622	0.0000000
zheyou73v0_A03	27357683	27359305	BnaA03T0479800ZY.1	0	-	0	0	1622	0.0000000
zheyou73v0_A03	27359731	27361901	BnaA03T0479900ZY	0	+	0	0	2170	0.0000000
zheyou73v0_A03	27362503	27367466	BnaA03T0480000ZY	0	-	0	0	4963	0.0000000
zheyou73v0_A03	27373288	27383102	BnaA03T0480100ZY	0	-	0	0	9814	0.0000000
zheyou73v0_A03	27383643	27388511	BnaA03T0480200ZY	0	+	0	0	4868	0.0000000
zheyou73v0_A03	27388670	27391332	BnaA03T0480300ZY	0	-	0	0	2662	0.0000000
zheyou73v0_A03	27399591	27401176	BnaA03T0480400ZY	0	+	0	0	1585	0.0000000
zheyou73v0_A03	27405614	27409469	BnaA03T0480500ZY	0	+	0	0	3855	0.0000000
zheyou73v0_A03	27413875	27422166	BnaA03T0480600ZY	0	+	0	0	8291	0.0000000
zheyou73v0_A03	27433337	27435027	BnaA03T0480700ZY	0	+	0	0	1690	0.0000000
zheyou73v0_A03	27437081	27437336	BnaA03T0480800ZY	0	+	0	0	255	0.0000000
zheyou73v0_A03	27478493	27479331	BnaA03T0480900ZY	0	+	0	0	838	0.0000000
zheyou73v0_A03	27486359	27486967	BnaA03T0481000ZY	0	+	0	0	608	0.0000000
zheyou73v0_A03	27489212	27491730	BnaA03T0481100ZY	0	-	0	0	2518	0.0000000
zheyou73v0_A03	27493967	27494162	BnaA03T0481200ZY	0	+	0	0	195	0.0000000
zheyou73v0_A03	27494320	27494750	BnaA03T0481300ZY	0	+	0	0	430	0.0000000
zheyou73v0_A03	27501544	27504826	BnaA03T0481400ZY	0	-	0	0	3282	0.0000000
zheyou73v0_A03	27508692	27508851	BnaA03T0481500ZY	0	-	0	0	159	0.0000000
zheyou73v0_A03	27509296	27509963	BnaA03T0481600ZY	0	-	0	0	667	0.0000000
zheyou73v0_A03	27552917	27553972	BnaA03T0481700ZY	0	+	0	0	1055	0.0000000
zheyou73v0_A03	27560365	27560520	BnaA03T0481800ZY	0	+	0	0	155	0.0000000
zheyou73v0_A03	27579449	27582217	BnaA03T0481900ZY	0	-	0	0	2768	0.0000000
zheyou73v0_A03	27582973	27586983	BnaA03T0482000ZY	0	-	0	0	4010	0.0000000
zheyou73v0_A03	27589499	27598263	BnaA03T0482100ZY	0	-	0	0	8764	0.0000000
zheyou73v0_A03	27603852	27606598	BnaA03T0482200ZY	0	-	0	0	2746	0.0000000
zheyou73v0_A03	27607608	27610428	BnaA03T0482300ZY	0	-	0	0	2820	0.0000000
zheyou73v0_A03	27607608	27610428	BnaA03T0482300ZY.1	0	-	0	0	2820	0.0000000
zheyou73v0_A03	27612106	27616911	BnaA03T0482400ZY	0	-	0	0	4805	0.0000000
zheyou73v0_A03	27617671	27620097	BnaA03T0482500ZY	0	+	0	0	2426	0.0000000
zheyou73v0_A03	27620404	27621617	BnaA03T0482600ZY	0	+	0	0	1213	0.0000000
zheyou73v0_A03	27620404	27621617	BnaA03T0482600ZY.1	0	+	0	0	1213	0.0000000
zheyou73v0_A03	27620404	27621617	BnaA03T0482600ZY.2	0	+	0	0	1213	0.0000000
zheyou73v0_A03	27624992	27628438	BnaA03T0482700ZY	0	+	0	0	3446	0.0000000
zheyou73v0_A03	27629711	27630978	BnaA03T0482800ZY	0	+	0	0	1267	0.0000000
zheyou73v0_A03	27631628	27632897	BnaA03T0482900ZY	0	-	0	0	1269	0.0000000
zheyou73v0_A03	27634096	27638480	BnaA03T0483000ZY	0	-	0	0	4384	0.0000000
zheyou73v0_A03	27641244	27643697	BnaA03T0483100ZY	0	-	0	0	2453	0.0000000
zheyou73v0_A03	27644981	27646565	BnaA03T0483200ZY	0	+	0	0	1584	0.0000000
zheyou73v0_A03	27647863	27649066	BnaA03T0483300ZY	0	+	0	0	1203	0.0000000
zheyou73v0_A03	27658484	27662098	BnaA03T0483400ZY	0	+	0	0	3614	0.0000000
zheyou73v0_A03	27660821	27663813	BnaA03T0483500ZY	0	-	0	0	2992	0.0000000
zheyou73v0_A03	27671131	27675860	BnaA03T0483600ZY	0	-	0	0	4729	0.0000000
zheyou73v0_A03	27671131	27675860	BnaA03T0483600ZY.1	0	-	0	0	4729	0.0000000
zheyou73v0_A03	27676302	27677771	BnaA03T0483700ZY	0	+	0	0	1469	0.0000000
zheyou73v0_A03	27678078	27680527	BnaA03T0483800ZY	0	-	0	0	2449	0.0000000
zheyou73v0_A03	27697409	27697700	BnaA03T0483900ZY	0	-	0	0	291	0.0000000
zheyou73v0_A03	27707033	27710640	BnaA03T0484000ZY	0	+	0	0	3607	0.0000000
zheyou73v0_A03	27711704	27713268	BnaA03T0484100ZY	0	-	0	0	1564	0.0000000
zheyou73v0_A03	27717607	27718959	BnaA03T0484200ZY	0	+	0	0	1352	0.0000000
zheyou73v0_A03	27725062	27726481	BnaA03T0484300ZY	0	+	0	0	1419	0.0000000
zheyou73v0_A03	27727135	27729917	BnaA03T0484400ZY	0	-	0	0	2782	0.0000000
zheyou73v0_A03	27733968	27736016	BnaA03T0484500ZY	0	+	0	0	2048	0.0000000
zheyou73v0_A03	27758269	27760788	BnaA03T0484600ZY	0	+	0	0	2519	0.0000000
zheyou73v0_A03	27764863	27765019	BnaA03T0484700ZY	0	-	0	0	156	0.0000000
zheyou73v0_A03	27787136	27788379	BnaA03T0484800ZY	0	+	0	0	1243	0.0000000
zheyou73v0_A03	27789575	27792105	BnaA03T0484900ZY	0	+	0	0	2530	0.0000000
zheyou73v0_A03	27793663	27795175	BnaA03T0485000ZY	0	+	0	0	1512	0.0000000
zheyou73v0_A03	27795374	27799288	BnaA03T0485100ZY	0	-	0	0	3914	0.0000000
zheyou73v0_A03	27802761	27803274	BnaA03T0485200ZY	0	+	0	0	513	0.0000000
zheyou73v0_A03	27807694	27809237	BnaA03T0485300ZY	0	-	0	0	1543	0.0000000
zheyou73v0_A03	27819699	27826220	BnaA03T0485400ZY	0	+	0	0	6521	0.0000000
zheyou73v0_A03	27819699	27826458	BnaA03T0485400ZY.1	0	+	0	0	6759	0.0000000
zheyou73v0_A03	27819699	27826458	BnaA03T0485400ZY.2	0	+	0	0	6759	0.0000000
zheyou73v0_A03	27819699	27826220	BnaA03T0485400ZY.3	0	+	0	0	6521	0.0000000
zheyou73v0_A03	27819699	27826458	BnaA03T0485400ZY.4	0	+	0	0	6759	0.0000000
zheyou73v0_A03	27819699	27826220	BnaA03T0485400ZY.5	0	+	0	0	6521	0.0000000
zheyou73v0_A03	27834161	27835705	BnaA03T0485500ZY	0	+	0	0	1544	0.0000000
zheyou73v0_A03	27836502	27839579	BnaA03T0485600ZY	0	-	0	0	3077	0.0000000
zheyou73v0_A03	27840114	27841851	BnaA03T0485700ZY	0	-	0	0	1737	0.0000000
zheyou73v0_A03	27844091	27844700	BnaA03T0485800ZY	0	-	0	0	609	0.0000000
zheyou73v0_A03	27857597	27858246	BnaA03T0485900ZY	0	-	0	0	649	0.0000000
zheyou73v0_A03	27859838	27860620	BnaA03T0486000ZY	0	-	0	0	782	0.0000000
zheyou73v0_A03	27862755	27866092	BnaA03T0486100ZY	0	-	0	0	3337	0.0000000
zheyou73v0_A03	27870885	27871449	BnaA03T0486200ZY	0	+	0	0	564	0.0000000
zheyou73v0_A03	27880364	27881315	BnaA03T0486300ZY	0	+	0	0	951	0.0000000
zheyou73v0_A03	27883596	27884828	BnaA03T0486400ZY	0	-	0	0	1232	0.0000000
zheyou73v0_A03	27894891	27896902	BnaA03T0486500ZY	0	+	0	0	2011	0.0000000
zheyou73v0_A03	27897946	27900717	BnaA03T0486600ZY	0	+	0	0	2771	0.0000000
zheyou73v0_A03	27916538	27917704	BnaA03T0486700ZY	0	+	0	0	1166	0.0000000
zheyou73v0_A03	27918381	27919422	BnaA03T0486800ZY	0	+	0	0	1041	0.0000000
zheyou73v0_A03	27926306	27927293	BnaA03T0486900ZY	0	-	0	0	987	0.0000000
zheyou73v0_A03	27935167	27935902	BnaA03T0487000ZY	0	+	0	0	735	0.0000000
zheyou73v0_A03	27937419	27939811	BnaA03T0487100ZY	0	+	0	0	2392	0.0000000
zheyou73v0_A03	27940135	27941409	BnaA03T0487200ZY	0	-	0	0	1274	0.0000000
zheyou73v0_A03	27948002	27951011	BnaA03T0487300ZY	0	-	0	0	3009	0.0000000
zheyou73v0_A03	27951580	27954442	BnaA03T0487400ZY	0	+	0	0	2862	0.0000000
zheyou73v0_A03	27955905	27956729	BnaA03T0487500ZY	0	+	0	0	824	0.0000000
zheyou73v0_A03	27957580	27958256	BnaA03T0487600ZY	0	-	0	0	676	0.0000000
zheyou73v0_A03	27959803	27960158	BnaA03T0487700ZY	0	+	0	0	355	0.0000000
zheyou73v0_A03	27960283	27961238	BnaA03T0487800ZY	0	-	0	0	955	0.0000000
zheyou73v0_A03	27961777	27963747	BnaA03T0487900ZY	0	+	0	0	1970	0.0000000
zheyou73v0_A03	27975047	27977489	BnaA03T0488000ZY	0	+	0	0	2442	0.0000000
zheyou73v0_A03	27977615	27978718	BnaA03T0488100ZY	0	-	0	0	1103	0.0000000
zheyou73v0_A03	27988103	27992562	BnaA03T0488200ZY	0	+	0	0	4459	0.0000000
zheyou73v0_A03	27994269	28001033	BnaA03T0488300ZY	0	+	0	0	6764	0.0000000
zheyou73v0_A03	28000560	28002943	BnaA03T0488400ZY	0	-	0	0	2383	0.0000000
zheyou73v0_A03	28019287	28022931	BnaA03T0488500ZY	0	+	0	0	3644	0.0000000
zheyou73v0_A03	28019287	28022931	BnaA03T0488500ZY.1	0	+	0	0	3644	0.0000000
zheyou73v0_A03	28019287	28022931	BnaA03T0488500ZY.2	0	+	0	0	3644	0.0000000
zheyou73v0_A03	28024882	28025311	BnaA03T0488600ZY	0	+	0	0	429	0.0000000
zheyou73v0_A03	28026503	28029744	BnaA03T0488700ZY	0	+	0	0	3241	0.0000000
zheyou73v0_A03	28046894	28050215	BnaA03T0488800ZY	0	+	0	0	3321	0.0000000
zheyou73v0_A03	28046894	28050867	BnaA03T0488800ZY.1	0	+	0	0	3973	0.0000000
zheyou73v0_A03	28062398	28064238	BnaA03T0488900ZY	0	+	0	0	1840	0.0000000
zheyou73v0_A03	28065128	28067952	BnaA03T0489000ZY	0	+	0	0	2824	0.0000000
zheyou73v0_A03	28071883	28072289	BnaA03T0489100ZY	0	+	0	0	406	0.0000000
zheyou73v0_A03	28078550	28081616	BnaA03T0489200ZY	0	+	0	0	3066	0.0000000
zheyou73v0_A03	28078550	28081616	BnaA03T0489200ZY.2	0	+	0	0	3066	0.0000000
zheyou73v0_A03	28079064	28081616	BnaA03T0489200ZY.1	0	+	0	0	2552	0.0000000
zheyou73v0_A03	28084526	28085378	BnaA03T0489300ZY	0	+	0	0	852	0.0000000
zheyou73v0_A03	28088468	28090245	BnaA03T0489400ZY	0	+	0	0	1777	0.0000000
zheyou73v0_A03	28090967	28092904	BnaA03T0489500ZY	0	+	0	0	1937	0.0000000
zheyou73v0_A03	28094061	28095372	BnaA03T0489600ZY	0	-	0	0	1311	0.0000000
zheyou73v0_A03	28095980	28099343	BnaA03T0489700ZY	0	-	0	0	3363	0.0000000
zheyou73v0_A03	28099441	28102372	BnaA03T0489800ZY	0	+	0	0	2931	0.0000000
zheyou73v0_A03	28103838	28104938	BnaA03T0489900ZY	0	-	0	0	1100	0.0000000
zheyou73v0_A03	28107726	28108939	BnaA03T0490000ZY	0	+	0	0	1213	0.0000000
zheyou73v0_A03	28109609	28111084	BnaA03T0490100ZY	0	-	0	0	1475	0.0000000
zheyou73v0_A03	28112541	28114762	BnaA03T0490200ZY	0	+	0	0	2221	0.0000000
zheyou73v0_A03	28114780	28117660	BnaA03T0490300ZY	0	-	0	0	2880	0.0000000
zheyou73v0_A03	28120529	28121041	BnaA03T0490400ZY	0	-	0	0	512	0.0000000
zheyou73v0_A03	28129314	28131846	BnaA03T0490500ZY	0	-	0	0	2532	0.0000000
zheyou73v0_A03	28139982	28143574	BnaA03T0490600ZY	0	-	0	0	3592	0.0000000
zheyou73v0_A03	28144492	28145040	BnaA03T0490700ZY	0	-	0	0	548	0.0000000
zheyou73v0_A03	28145306	28145548	BnaA03T0490800ZY	0	-	0	0	242	0.0000000
zheyou73v0_A03	28145577	28146388	BnaA03T0490900ZY	0	-	0	0	811	0.0000000
zheyou73v0_A03	28173775	28174245	BnaA03T0491000ZY	0	+	0	0	470	0.0000000
zheyou73v0_A03	28177423	28180528	BnaA03T0491100ZY	0	+	0	0	3105	0.0000000
zheyou73v0_A03	28184023	28186275	BnaA03T0491200ZY	0	-	0	0	2252	0.0000000
zheyou73v0_A03	28206245	28207718	BnaA03T0491300ZY	0	+	0	0	1473	0.0000000
zheyou73v0_A03	28206245	28207718	BnaA03T0491300ZY.1	0	+	0	0	1473	0.0000000
zheyou73v0_A03	28206245	28207718	BnaA03T0491300ZY.2	0	+	0	0	1473	0.0000000
zheyou73v0_A03	28208430	28210324	BnaA03T0491400ZY.1	0	+	0	0	1894	0.0000000
zheyou73v0_A03	28208578	28210324	BnaA03T0491400ZY	0	+	0	0	1746	0.0000000
zheyou73v0_A03	28210691	28211498	BnaA03T0491500ZY	0	-	0	0	807	0.0000000
zheyou73v0_A03	28212193	28215094	BnaA03T0491600ZY	0	-	0	0	2901	0.0000000
zheyou73v0_A03	28215554	28216956	BnaA03T0491700ZY	0	+	0	0	1402	0.0000000
zheyou73v0_A03	28217001	28221025	BnaA03T0491800ZY	0	-	0	0	4024	0.0000000
zheyou73v0_A03	28222048	28222336	BnaA03T0491900ZY	0	-	0	0	288	0.0000000
zheyou73v0_A03	28223697	28225600	BnaA03T0492000ZY	0	-	0	0	1903	0.0000000
zheyou73v0_A03	28228308	28229476	BnaA03T0492100ZY	0	+	0	0	1168	0.0000000
zheyou73v0_A03	28229663	28234300	BnaA03T0492200ZY	0	-	0	0	4637	0.0000000
zheyou73v0_A03	28236237	28237374	BnaA03T0492300ZY	0	+	0	0	1137	0.0000000
zheyou73v0_A03	28237550	28242840	BnaA03T0492400ZY	0	-	0	0	5290	0.0000000
zheyou73v0_A03	28244351	28245416	BnaA03T0492500ZY	0	+	0	0	1065	0.0000000
zheyou73v0_A03	28246038	28247666	BnaA03T0492600ZY	0	+	0	0	1628	0.0000000
zheyou73v0_A03	28246038	28247666	BnaA03T0492600ZY.1	0	+	0	0	1628	0.0000000
zheyou73v0_A03	28246038	28247666	BnaA03T0492600ZY.2	0	+	0	0	1628	0.0000000
zheyou73v0_A03	28247918	28253024	BnaA03T0492700ZY	0	-	0	0	5106	0.0000000
zheyou73v0_A03	28255587	28259045	BnaA03T0492800ZY	0	-	0	0	3458	0.0000000
zheyou73v0_A03	28261370	28268251	BnaA03T0492900ZY	0	+	0	0	6881	0.0000000
zheyou73v0_A03	28269826	28271595	BnaA03T0493000ZY	0	+	0	0	1769	0.0000000
zheyou73v0_A03	28277327	28280529	BnaA03T0493100ZY	0	+	0	0	3202	0.0000000
zheyou73v0_A03	28280733	28281156	BnaA03T0493200ZY	0	-	0	0	423	0.0000000
zheyou73v0_A03	28281640	28282618	BnaA03T0493300ZY	0	-	0	0	978	0.0000000
zheyou73v0_A03	28295528	28296162	BnaA03T0493400ZY	0	-	0	0	634	0.0000000
zheyou73v0_A03	28312345	28313760	BnaA03T0493500ZY	0	-	0	0	1415	0.0000000
zheyou73v0_A03	28329443	28329897	BnaA03T0493600ZY	0	-	0	0	454	0.0000000
zheyou73v0_A03	28346471	28347346	BnaA03T0493700ZY	0	-	0	0	875	0.0000000
zheyou73v0_A03	28357622	28360646	BnaA03T0493800ZY	0	+	0	0	3024	0.0000000
zheyou73v0_A03	28360871	28361329	BnaA03T0493900ZY	0	+	0	0	458	0.0000000
zheyou73v0_A03	28362762	28365081	BnaA03T0494000ZY	0	-	0	0	2319	0.0000000
zheyou73v0_A03	28368656	28371883	BnaA03T0494100ZY	0	-	0	0	3227	0.0000000
zheyou73v0_A03	28379441	28382165	BnaA03T0494200ZY	0	-	0	0	2724	0.0000000
zheyou73v0_A03	28382605	28386790	BnaA03T0494300ZY	0	-	0	0	4185	0.0000000
zheyou73v0_A03	28392710	28395096	BnaA03T0494400ZY	0	+	0	0	2386	0.0000000
zheyou73v0_A03	28395311	28395926	BnaA03T0494500ZY	0	-	0	0	615	0.0000000
zheyou73v0_A03	28398011	28408481	BnaA03T0494600ZY	0	-	0	0	10470	0.0000000
zheyou73v0_A03	28409849	28410254	BnaA03T0494700ZY	0	-	0	0	405	0.0000000
zheyou73v0_A03	28411239	28414494	BnaA03T0494800ZY	0	+	0	0	3255	0.0000000
zheyou73v0_A03	28415142	28416363	BnaA03T0494900ZY	0	+	0	0	1221	0.0000000
zheyou73v0_A03	28415306	28416363	BnaA03T0494900ZY.1	0	+	0	0	1057	0.0000000
zheyou73v0_A03	28417417	28421568	BnaA03T0495000ZY	0	+	0	0	4151	0.0000000
zheyou73v0_A03	28422922	28423756	BnaA03T0495100ZY	0	-	0	0	834	0.0000000
zheyou73v0_A03	28425019	28426817	BnaA03T0495200ZY	0	-	0	0	1798	0.0000000
zheyou73v0_A03	28430804	28434798	BnaA03T0495300ZY	0	+	0	0	3994	0.0000000
zheyou73v0_A03	28436221	28439685	BnaA03T0495400ZY	0	+	0	0	3464	0.0000000
zheyou73v0_A03	28442069	28443511	BnaA03T0495500ZY	0	+	0	0	1442	0.0000000
zheyou73v0_A03	28449873	28450792	BnaA03T0495600ZY	0	+	0	0	919	0.0000000
zheyou73v0_A03	28451577	28453217	BnaA03T0495700ZY	0	+	0	0	1640	0.0000000
zheyou73v0_A03	28453337	28458607	BnaA03T0495800ZY	0	-	0	0	5270	0.0000000
zheyou73v0_A03	28460024	28464549	BnaA03T0495900ZY	0	-	0	0	4525	0.0000000
zheyou73v0_A03	28471989	28473364	BnaA03T0496000ZY	0	-	0	0	1375	0.0000000
zheyou73v0_A03	28474089	28482125	BnaA03T0496100ZY	0	+	0	0	8036	0.0000000
zheyou73v0_A03	28481901	28482811	BnaA03T0496200ZY	0	-	0	0	910	0.0000000
zheyou73v0_A03	28483560	28484541	BnaA03T0496300ZY	0	+	0	0	981	0.0000000
zheyou73v0_A03	28485463	28489250	BnaA03T0496400ZY	0	-	0	0	3787	0.0000000
zheyou73v0_A03	28494146	28495797	BnaA03T0496500ZY	0	-	0	0	1651	0.0000000
zheyou73v0_A03	28497166	28498264	BnaA03T0496600ZY	0	+	0	0	1098	0.0000000
zheyou73v0_A03	28498795	28499068	BnaA03T0496700ZY	0	-	0	0	273	0.0000000
zheyou73v0_A03	28499433	28503552	BnaA03T0496800ZY	0	+	0	0	4119	0.0000000
zheyou73v0_A03	28499433	28503384	BnaA03T0496800ZY.1	0	+	0	0	3951	0.0000000
zheyou73v0_A03	28517833	28518439	BnaA03T0496900ZY	0	-	0	0	606	0.0000000
zheyou73v0_A03	28519991	28531644	BnaA03T0497000ZY	0	-	0	0	11653	0.0000000
zheyou73v0_A03	28519991	28531644	BnaA03T0497000ZY.1	0	-	0	0	11653	0.0000000
zheyou73v0_A03	28532023	28533466	BnaA03T0497100ZY	0	+	0	0	1443	0.0000000
zheyou73v0_A03	28533629	28535269	BnaA03T0497200ZY	0	-	0	0	1640	0.0000000
zheyou73v0_A03	28546670	28548896	BnaA03T0497300ZY	0	+	0	0	2226	0.0000000
zheyou73v0_A03	28554756	28555861	BnaA03T0497400ZY	0	+	0	0	1105	0.0000000
zheyou73v0_A03	28557165	28559897	BnaA03T0497500ZY	0	-	0	0	2732	0.0000000
zheyou73v0_A03	28557165	28559897	BnaA03T0497500ZY.1	0	-	0	0	2732	0.0000000
zheyou73v0_A03	28560151	28562936	BnaA03T0497600ZY	0	+	0	0	2785	0.0000000
zheyou73v0_A03	28560151	28562507	BnaA03T0497600ZY.1	0	+	0	0	2356	0.0000000
zheyou73v0_A03	28563033	28563889	BnaA03T0497700ZY	0	-	0	0	856	0.0000000
zheyou73v0_A03	28565439	28567440	BnaA03T0497800ZY	0	+	0	0	2001	0.0000000
zheyou73v0_A03	28567657	28568053	BnaA03T0497900ZY	0	-	0	0	396	0.0000000
zheyou73v0_A03	28569155	28570982	BnaA03T0498000ZY	0	+	0	0	1827	0.0000000
zheyou73v0_A03	28579153	28581129	BnaA03T0498100ZY	0	+	0	0	1976	0.0000000
zheyou73v0_A03	28592785	28593665	BnaA03T0498200ZY	0	+	0	0	880	0.0000000
zheyou73v0_A03	28613523	28614928	BnaA03T0498300ZY	0	-	0	0	1405	0.0000000
zheyou73v0_A03	28630977	28634339	BnaA03T0498400ZY	0	-	0	0	3362	0.0000000
zheyou73v0_A03	28648492	28649889	BnaA03T0498500ZY	0	-	0	0	1397	0.0000000
zheyou73v0_A03	28653889	28654782	BnaA03T0498600ZY	0	-	0	0	893	0.0000000
zheyou73v0_A03	28674015	28674621	BnaA03T0498700ZY	0	+	0	0	606	0.0000000
zheyou73v0_A03	28680967	28684690	BnaA03T0498800ZY	0	+	0	0	3723	0.0000000
zheyou73v0_A03	28685538	28700511	BnaA03T0498900ZY	0	-	0	0	14973	0.0000000
zheyou73v0_A03	28700788	28703031	BnaA03T0499000ZY	0	+	0	0	2243	0.0000000
zheyou73v0_A03	28704575	28705506	BnaA03T0499100ZY	0	+	0	0	931	0.0000000
zheyou73v0_A03	28707749	28709729	BnaA03T0499200ZY	0	-	0	0	1980	0.0000000
zheyou73v0_A03	28710245	28712363	BnaA03T0499300ZY	0	+	0	0	2118	0.0000000
zheyou73v0_A03	28712638	28714514	BnaA03T0499400ZY	0	-	0	0	1876	0.0000000
zheyou73v0_A03	28715547	28725891	BnaA03T0499500ZY	0	+	0	0	10344	0.0000000
zheyou73v0_A03	28725192	28726869	BnaA03T0499600ZY	0	-	0	0	1677	0.0000000
zheyou73v0_A03	28737144	28739403	BnaA03T0499700ZY	0	+	0	0	2259	0.0000000
zheyou73v0_A03	28740009	28743132	BnaA03T0499800ZY	0	-	0	0	3123	0.0000000
zheyou73v0_A03	28745869	28746028	BnaA03T0499900ZY	0	-	0	0	159	0.0000000
zheyou73v0_A03	28748943	28751122	BnaA03T0500000ZY	0	-	0	0	2179	0.0000000
zheyou73v0_A03	28748943	28751122	BnaA03T0500000ZY.1	0	-	0	0	2179	0.0000000
zheyou73v0_A03	28748943	28751122	BnaA03T0500000ZY.2	0	-	0	0	2179	0.0000000
zheyou73v0_A03	28752218	28756094	BnaA03T0500100ZY	0	-	0	0	3876	0.0000000
zheyou73v0_A03	28756883	28757934	BnaA03T0500200ZY	0	-	0	0	1051	0.0000000
zheyou73v0_A03	28766503	28766857	BnaA03T0500300ZY	0	+	0	0	354	0.0000000
zheyou73v0_A03	28779615	28780324	BnaA03T0500400ZY	0	+	0	0	709	0.0000000
zheyou73v0_A03	28791941	28792847	BnaA03T0500500ZY	0	+	0	0	906	0.0000000
zheyou73v0_A03	28792888	28793128	BnaA03T0500600ZY	0	+	0	0	240	0.0000000
zheyou73v0_A03	28797544	28799259	BnaA03T0500700ZY	0	+	0	0	1715	0.0000000
zheyou73v0_A03	28799377	28801359	BnaA03T0500800ZY.1	0	-	0	0	1982	0.0000000
zheyou73v0_A03	28799389	28801979	BnaA03T0500800ZY	0	-	0	0	2590	0.0000000
zheyou73v0_A03	28804184	28808400	BnaA03T0500900ZY	0	+	0	0	4216	0.0000000
zheyou73v0_A03	28808535	28809208	BnaA03T0501000ZY	0	-	0	0	673	0.0000000
zheyou73v0_A03	28817600	28823315	BnaA03T0501100ZY	0	+	0	0	5715	0.0000000
zheyou73v0_A03	28823318	28825098	BnaA03T0501200ZY	0	-	0	0	1780	0.0000000
zheyou73v0_A03	28828730	28831155	BnaA03T0501300ZY	0	+	0	0	2425	0.0000000
zheyou73v0_A03	28832137	28833581	BnaA03T0501400ZY	0	+	0	0	1444	0.0000000
zheyou73v0_A03	28836923	28838044	BnaA03T0501500ZY	0	+	0	0	1121	0.0000000
zheyou73v0_A03	28838345	28839938	BnaA03T0501600ZY	0	-	0	0	1593	0.0000000
zheyou73v0_A03	28843329	28844323	BnaA03T0501700ZY	0	+	0	0	994	0.0000000
zheyou73v0_A03	28848239	28849233	BnaA03T0501800ZY	0	+	0	0	994	0.0000000
zheyou73v0_A03	28852972	28853387	BnaA03T0501900ZY	0	-	0	0	415	0.0000000
zheyou73v0_A03	28861291	28865014	BnaA03T0502000ZY	0	+	0	0	3723	0.0000000
zheyou73v0_A03	28871713	28876163	BnaA03T0502100ZY	0	-	0	0	4450	0.0000000
zheyou73v0_A03	28872518	28874146	BnaA03T0502100ZY.1	0	-	0	0	1628	0.0000000
zheyou73v0_A03	28879329	28882673	BnaA03T0502200ZY	0	+	0	0	3344	0.0000000
zheyou73v0_A03	28882038	28883857	BnaA03T0502300ZY	0	-	0	0	1819	0.0000000
zheyou73v0_A03	28890320	28894988	BnaA03T0502400ZY	0	-	0	0	4668	0.0000000
zheyou73v0_A03	28896705	28897004	BnaA03T0502500ZY	0	+	0	0	299	0.0000000
zheyou73v0_A03	28905276	28906986	BnaA03T0502600ZY	0	+	0	0	1710	0.0000000
zheyou73v0_A03	28922272	28923914	BnaA03T0502700ZY	0	+	0	0	1642	0.0000000
zheyou73v0_A03	28927285	28928870	BnaA03T0502800ZY	0	+	0	0	1585	0.0000000
zheyou73v0_A03	28929236	28930319	BnaA03T0502900ZY	0	-	0	0	1083	0.0000000
zheyou73v0_A03	28929236	28930319	BnaA03T0502900ZY.1	0	-	0	0	1083	0.0000000
zheyou73v0_A03	28941362	28943689	BnaA03T0503000ZY	0	+	0	0	2327	0.0000000
zheyou73v0_A03	28944679	28945828	BnaA03T0503100ZY	0	-	0	0	1149	0.0000000
zheyou73v0_A03	28946765	28950572	BnaA03T0503200ZY	0	-	0	0	3807	0.0000000
zheyou73v0_A03	28951493	28951898	BnaA03T0503300ZY	0	-	0	0	405	0.0000000
zheyou73v0_A03	28954080	28954368	BnaA03T0503400ZY	0	-	0	0	288	0.0000000
zheyou73v0_A03	28956018	28959506	BnaA03T0503500ZY	0	+	0	0	3488	0.0000000
zheyou73v0_A03	28962910	28964572	BnaA03T0503600ZY	0	+	0	0	1662	0.0000000
zheyou73v0_A03	28966138	28968233	BnaA03T0503700ZY	0	-	0	0	2095	0.0000000
zheyou73v0_A03	28966693	28968233	BnaA03T0503700ZY.1	0	-	0	0	1540	0.0000000
zheyou73v0_A03	28968793	28970294	BnaA03T0503800ZY	0	-	0	0	1501	0.0000000
zheyou73v0_A03	28970502	28972405	BnaA03T0503900ZY	0	+	0	0	1903	0.0000000
zheyou73v0_A03	28972426	28973425	BnaA03T0504000ZY	0	-	0	0	999	0.0000000
zheyou73v0_A03	28974856	28977231	BnaA03T0504100ZY	0	+	0	0	2375	0.0000000
zheyou73v0_A03	28977310	28979201	BnaA03T0504200ZY	0	-	0	0	1891	0.0000000
zheyou73v0_A03	28986004	28989185	BnaA03T0504300ZY	0	+	0	0	3181	0.0000000
zheyou73v0_A03	28989679	28990748	BnaA03T0504400ZY	0	-	0	0	1069	0.0000000
zheyou73v0_A03	28993258	28994177	BnaA03T0504500ZY	0	+	0	0	919	0.0000000
zheyou73v0_A03	28994611	28997279	BnaA03T0504600ZY	0	-	0	0	2668	0.0000000
zheyou73v0_A03	29000147	29002150	BnaA03T0504700ZY	0	-	0	0	2003	0.0000000
zheyou73v0_A03	29002171	29003668	BnaA03T0504800ZY	0	-	0	0	1497	0.0000000
zheyou73v0_A03	29003821	29006402	BnaA03T0504900ZY	0	-	0	0	2581	0.0000000
zheyou73v0_A03	29003821	29006402	BnaA03T0504900ZY.1	0	-	0	0	2581	0.0000000
zheyou73v0_A03	29010033	29013683	BnaA03T0505000ZY	0	-	0	0	3650	0.0000000
zheyou73v0_A03	29018793	29022609	BnaA03T0505100ZY	0	-	0	0	3816	0.0000000
zheyou73v0_A03	29028561	29030681	BnaA03T0505200ZY	0	+	0	0	2120	0.0000000
zheyou73v0_A03	29028561	29031069	BnaA03T0505200ZY.1	0	+	0	0	2508	0.0000000
zheyou73v0_A03	29031997	29035309	BnaA03T0505300ZY	0	-	0	0	3312	0.0000000
zheyou73v0_A03	29039515	29040279	BnaA03T0505400ZY	0	+	0	0	764	0.0000000
zheyou73v0_A03	29040572	29041313	BnaA03T0505500ZY	0	-	0	0	741	0.0000000
zheyou73v0_A03	29041664	29043409	BnaA03T0505600ZY	0	+	0	0	1745	0.0000000
zheyou73v0_A03	29043794	29045124	BnaA03T0505700ZY	0	-	0	0	1330	0.0000000
zheyou73v0_A03	29044222	29045124	BnaA03T0505700ZY.1	0	-	0	0	902	0.0000000
zheyou73v0_A03	29049563	29050013	BnaA03T0505800ZY	0	+	0	0	450	0.0000000
zheyou73v0_A03	29059554	29062828	BnaA03T0505900ZY	0	+	0	0	3274	0.0000000
zheyou73v0_A03	29063858	29071768	BnaA03T0506000ZY	0	+	0	0	7910	0.0000000
zheyou73v0_A03	29075356	29081256	BnaA03T0506100ZY	0	-	0	0	5900	0.0000000
zheyou73v0_A03	29081744	29083472	BnaA03T0506200ZY	0	-	0	0	1728	0.0000000
zheyou73v0_A03	29087757	29088668	BnaA03T0506300ZY	0	+	0	0	911	0.0000000
zheyou73v0_A03	29088753	29090568	BnaA03T0506400ZY	0	-	0	0	1815	0.0000000
zheyou73v0_A03	29094091	29096543	BnaA03T0506500ZY	0	-	0	0	2452	0.0000000
zheyou73v0_A03	29097899	29098880	BnaA03T0506600ZY	0	-	0	0	981	0.0000000
zheyou73v0_A03	29105458	29107425	BnaA03T0506700ZY	0	-	0	0	1967	0.0000000
zheyou73v0_A03	29107772	29110852	BnaA03T0506800ZY	0	-	0	0	3080	0.0000000
zheyou73v0_A03	29118127	29121185	BnaA03T0506900ZY	0	-	0	0	3058	0.0000000
zheyou73v0_A03	29122023	29122899	BnaA03T0507000ZY	0	+	0	0	876	0.0000000
zheyou73v0_A03	29122339	29124677	BnaA03T0507100ZY	0	-	0	0	2338	0.0000000
zheyou73v0_A03	29125777	29128175	BnaA03T0507200ZY	0	+	0	0	2398	0.0000000
zheyou73v0_A03	29138439	29138747	BnaA03T0507300ZY	0	+	0	0	308	0.0000000
zheyou73v0_A03	29139577	29143269	BnaA03T0507400ZY	0	+	0	0	3692	0.0000000
zheyou73v0_A03	29143732	29144878	BnaA03T0507500ZY	0	-	0	0	1146	0.0000000
zheyou73v0_A03	29143732	29144878	BnaA03T0507500ZY.1	0	-	0	0	1146	0.0000000
zheyou73v0_A03	29145148	29147447	BnaA03T0507600ZY	0	-	0	0	2299	0.0000000
zheyou73v0_A03	29147885	29149543	BnaA03T0507700ZY	0	-	0	0	1658	0.0000000
zheyou73v0_A03	29149900	29150422	BnaA03T0507800ZY	0	+	0	0	522	0.0000000
zheyou73v0_A03	29152158	29152580	BnaA03T0507900ZY	0	+	0	0	422	0.0000000
zheyou73v0_A03	29156004	29160858	BnaA03T0508000ZY	0	+	0	0	4854	0.0000000
zheyou73v0_A03	29161884	29162361	BnaA03T0508100ZY	0	+	0	0	477	0.0000000
zheyou73v0_A03	29164236	29167266	BnaA03T0508200ZY	0	+	0	0	3030	0.0000000
zheyou73v0_A03	29168717	29170606	BnaA03T0508300ZY	0	-	0	0	1889	0.0000000
zheyou73v0_A03	29174806	29175160	BnaA03T0508400ZY	0	+	0	0	354	0.0000000
zheyou73v0_A03	29184209	29186825	BnaA03T0508500ZY	0	+	0	0	2616	0.0000000
zheyou73v0_A03	29204615	29207495	BnaA03T0508600ZY	0	+	0	0	2880	0.0000000
zheyou73v0_A03	29214383	29215586	BnaA03T0508700ZY	0	+	0	0	1203	0.0000000
zheyou73v0_A03	29216454	29218761	BnaA03T0508800ZY	0	-	0	0	2307	0.0000000
zheyou73v0_A03	29221030	29222293	BnaA03T0508900ZY	0	-	0	0	1263	0.0000000
zheyou73v0_A03	29230290	29231758	BnaA03T0509000ZY	0	-	0	0	1468	0.0000000
zheyou73v0_A03	29232595	29234167	BnaA03T0509100ZY	0	+	0	0	1572	0.0000000
zheyou73v0_A03	29234907	29236259	BnaA03T0509200ZY	0	-	0	0	1352	0.0000000
zheyou73v0_A03	29234907	29236259	BnaA03T0509200ZY.1	0	-	0	0	1352	0.0000000
zheyou73v0_A03	29239380	29242052	BnaA03T0509300ZY	0	-	0	0	2672	0.0000000
zheyou73v0_A03	29246572	29247867	BnaA03T0509400ZY	0	+	0	0	1295	0.0000000
zheyou73v0_A03	29248246	29251856	BnaA03T0509500ZY	0	+	0	0	3610	0.0000000
zheyou73v0_A03	29252051	29253549	BnaA03T0509600ZY	0	-	0	0	1498	0.0000000
zheyou73v0_A03	29257912	29258552	BnaA03T0509700ZY	0	+	0	0	640	0.0000000
zheyou73v0_A03	29260171	29262835	BnaA03T0509800ZY	0	+	0	0	2664	0.0000000
zheyou73v0_A03	29266643	29268418	BnaA03T0509900ZY	0	-	0	0	1775	0.0000000
zheyou73v0_A03	29271855	29276102	BnaA03T0510000ZY	0	+	0	0	4247	0.0000000
zheyou73v0_A03	29276142	29276751	BnaA03T0510100ZY	0	-	0	0	609	0.0000000
zheyou73v0_A03	29279408	29279855	BnaA03T0510200ZY	0	+	0	0	447	0.0000000
zheyou73v0_A03	29283039	29284977	BnaA03T0510300ZY	0	-	0	0	1938	0.0000000
zheyou73v0_A03	29285391	29287905	BnaA03T0510400ZY	0	-	0	0	2514	0.0000000
zheyou73v0_A03	29289086	29294629	BnaA03T0510500ZY	0	-	0	0	5543	0.0000000
zheyou73v0_A03	29296214	29296448	BnaA03T0510600ZY	0	+	0	0	234	0.0000000
zheyou73v0_A03	29299918	29304081	BnaA03T0510700ZY	0	-	0	0	4163	0.0000000
zheyou73v0_A03	29311341	29311954	BnaA03T0510800ZY	0	+	0	0	613	0.0000000
zheyou73v0_A03	29322473	29322662	BnaA03T0510900ZY	0	+	0	0	189	0.0000000
zheyou73v0_A03	29325180	29325369	BnaA03T0511000ZY	0	+	0	0	189	0.0000000
zheyou73v0_A03	29326146	29326335	BnaA03T0511100ZY	0	+	0	0	189	0.0000000
zheyou73v0_A03	29329119	29329985	BnaA03T0511200ZY	0	-	0	0	866	0.0000000
zheyou73v0_A03	29330830	29332362	BnaA03T0511300ZY	0	+	0	0	1532	0.0000000
zheyou73v0_A03	29333783	29334692	BnaA03T0511400ZY	0	+	0	0	909	0.0000000
zheyou73v0_A03	29335560	29337366	BnaA03T0511500ZY	0	+	0	0	1806	0.0000000
zheyou73v0_A03	29335560	29337366	BnaA03T0511500ZY.1	0	+	0	0	1806	0.0000000
zheyou73v0_A03	29343610	29345816	BnaA03T0511600ZY	0	+	0	0	2206	0.0000000
zheyou73v0_A03	29346192	29348526	BnaA03T0511700ZY	0	+	0	0	2334	0.0000000
zheyou73v0_A03	29349362	29350796	BnaA03T0511800ZY	0	+	0	0	1434	0.0000000
zheyou73v0_A03	29351596	29354000	BnaA03T0511900ZY	0	-	0	0	2404	0.0000000
zheyou73v0_A03	29365370	29366560	BnaA03T0512000ZY	0	-	0	0	1190	0.0000000
zheyou73v0_A03	29369902	29370784	BnaA03T0512100ZY	0	-	0	0	882	0.0000000
zheyou73v0_A03	29386047	29388876	BnaA03T0512200ZY	0	+	0	0	2829	0.0000000
zheyou73v0_A03	29390297	29391519	BnaA03T0512300ZY	0	+	0	0	1222	0.0000000
zheyou73v0_A03	29394706	29395078	BnaA03T0512400ZY	0	+	0	0	372	0.0000000
zheyou73v0_A03	29401715	29402732	BnaA03T0512500ZY	0	+	0	0	1017	0.0000000
zheyou73v0_A03	29404562	29405727	BnaA03T0512600ZY	0	+	0	0	1165	0.0000000
zheyou73v0_A03	29406908	29412326	BnaA03T0512700ZY	0	+	0	0	5418	0.0000000
zheyou73v0_A03	29417465	29418732	BnaA03T0512800ZY	0	-	0	0	1267	0.0000000
zheyou73v0_A03	29425868	29432088	BnaA03T0512900ZY	0	-	0	0	6220	0.0000000
zheyou73v0_A03	29433865	29435827	BnaA03T0513000ZY	0	-	0	0	1962	0.0000000
zheyou73v0_A03	29437290	29438631	BnaA03T0513100ZY	0	+	0	0	1341	0.0000000
zheyou73v0_A03	29440214	29444338	BnaA03T0513200ZY	0	+	0	0	4124	0.0000000
zheyou73v0_A03	29444486	29446281	BnaA03T0513300ZY	0	-	0	0	1795	0.0000000
zheyou73v0_A03	29446925	29448361	BnaA03T0513400ZY	0	-	0	0	1436	0.0000000
zheyou73v0_A03	29448871	29450512	BnaA03T0513500ZY	0	-	0	0	1641	0.0000000
zheyou73v0_A03	29450876	29451747	BnaA03T0513600ZY	0	-	0	0	871	0.0000000
zheyou73v0_A03	29452071	29460514	BnaA03T0513700ZY	0	-	0	0	8443	0.0000000
zheyou73v0_A03	29466897	29468431	BnaA03T0513800ZY	0	+	0	0	1534	0.0000000
zheyou73v0_A03	29475724	29480132	BnaA03T0513900ZY	0	+	0	0	4408	0.0000000
zheyou73v0_A03	29504908	29505271	BnaA03T0514000ZY	0	-	0	0	363	0.0000000
zheyou73v0_A03	29506293	29507502	BnaA03T0514100ZY	0	-	0	0	1209	0.0000000
zheyou73v0_A03	29509880	29512754	BnaA03T0514200ZY	0	+	0	0	2874	0.0000000
zheyou73v0_A03	29534683	29536445	BnaA03T0514300ZY	0	-	0	0	1762	0.0000000
zheyou73v0_A03	29539545	29539920	BnaA03T0514400ZY	0	+	0	0	375	0.0000000
zheyou73v0_A03	29543529	29544049	BnaA03T0514500ZY	0	+	0	0	520	0.0000000
zheyou73v0_A03	29550033	29551764	BnaA03T0514600ZY	0	+	0	0	1731	0.0000000
zheyou73v0_A03	29552652	29553974	BnaA03T0514700ZY	0	+	0	0	1322	0.0000000
zheyou73v0_A03	29554561	29557802	BnaA03T0514800ZY	0	+	0	0	3241	0.0000000
zheyou73v0_A03	29557938	29558702	BnaA03T0514900ZY	0	-	0	0	764	0.0000000
zheyou73v0_A03	29561746	29563167	BnaA03T0515000ZY	0	-	0	0	1421	0.0000000
zheyou73v0_A03	29567815	29569754	BnaA03T0515100ZY	0	-	0	0	1939	0.0000000
zheyou73v0_A03	29579327	29581495	BnaA03T0515200ZY	0	+	0	0	2168	0.0000000
zheyou73v0_A03	29581970	29583517	BnaA03T0515300ZY	0	-	0	0	1547	0.0000000
zheyou73v0_A03	29581970	29583517	BnaA03T0515300ZY.1	0	-	0	0	1547	0.0000000
zheyou73v0_A03	29591398	29592405	BnaA03T0515400ZY	0	+	0	0	1007	0.0000000
zheyou73v0_A03	29594120	29596151	BnaA03T0515500ZY	0	+	0	0	2031	0.0000000
zheyou73v0_A03	29596500	29597167	BnaA03T0515600ZY	0	+	0	0	667	0.0000000
zheyou73v0_A03	29607098	29608876	BnaA03T0515700ZY	0	+	0	0	1778	0.0000000
zheyou73v0_A03	29610191	29610555	BnaA03T0515800ZY	0	-	0	0	364	0.0000000
zheyou73v0_A03	29618621	29625483	BnaA03T0515900ZY	0	+	0	0	6862	0.0000000
zheyou73v0_A03	29635009	29647800	BnaA03T0516000ZY	0	+	0	0	12791	0.0000000
zheyou73v0_A03	29655922	29659674	BnaA03T0516100ZY	0	+	0	0	3752	0.0000000
zheyou73v0_A03	29660255	29661362	BnaA03T0516200ZY	0	+	0	0	1107	0.0000000
zheyou73v0_A03	29661412	29664268	BnaA03T0516300ZY	0	-	0	0	2856	0.0000000
zheyou73v0_A03	29666645	29667005	BnaA03T0516400ZY	0	+	0	0	360	0.0000000
zheyou73v0_A03	29666983	29672499	BnaA03T0516500ZY	0	-	0	0	5516	0.0000000
zheyou73v0_A03	29672995	29675082	BnaA03T0516600ZY	0	+	0	0	2087	0.0000000
zheyou73v0_A03	29674719	29675559	BnaA03T0516700ZY	0	-	0	0	840	0.0000000
zheyou73v0_A03	29795522	29800276	BnaA03T0516800ZY	0	-	0	0	4754	0.0000000
zheyou73v0_A03	29795522	29800276	BnaA03T0516800ZY.1	0	-	0	0	4754	0.0000000
zheyou73v0_A03	29821491	29825954	BnaA03T0516900ZY	0	-	0	0	4463	0.0000000
zheyou73v0_A03	29826232	29829481	BnaA03T0517000ZY	0	+	0	0	3249	0.0000000
zheyou73v0_A03	29830753	29833982	BnaA03T0517100ZY	0	+	0	0	3229	0.0000000
zheyou73v0_A03	29836736	29837027	BnaA03T0517200ZY	0	+	0	0	291	0.0000000
zheyou73v0_A03	29838559	29839659	BnaA03T0517300ZY	0	-	0	0	1100	0.0000000
zheyou73v0_A03	29839743	29840504	BnaA03T0517400ZY	0	-	0	0	761	0.0000000
zheyou73v0_A03	29845134	29845359	BnaA03T0517500ZY	0	-	0	0	225	0.0000000
zheyou73v0_A03	29845404	29846882	BnaA03T0517600ZY	0	-	0	0	1478	0.0000000
zheyou73v0_A03	29850843	29857342	BnaA03T0517700ZY	0	+	0	0	6499	0.0000000
zheyou73v0_A03	29858434	29860112	BnaA03T0517800ZY	0	+	0	0	1678	0.0000000
zheyou73v0_A03	29862060	29863311	BnaA03T0517900ZY	0	-	0	0	1251	0.0000000
zheyou73v0_A03	29870162	29876595	BnaA03T0518000ZY	0	-	0	0	6433	0.0000000
zheyou73v0_A03	29879159	29880750	BnaA03T0518100ZY	0	+	0	0	1591	0.0000000
zheyou73v0_A03	29880840	29882352	BnaA03T0518200ZY	0	+	0	0	1512	0.0000000
zheyou73v0_A03	29880840	29882352	BnaA03T0518200ZY.1	0	+	0	0	1512	0.0000000
zheyou73v0_A03	29883647	29886745	BnaA03T0518300ZY	0	-	0	0	3098	0.0000000
zheyou73v0_A03	29888210	29888672	BnaA03T0518400ZY	0	+	0	0	462	0.0000000
zheyou73v0_A03	29889182	29890637	BnaA03T0518500ZY	0	-	0	0	1455	0.0000000
zheyou73v0_A03	29890813	29891993	BnaA03T0518600ZY	0	+	0	0	1180	0.0000000
zheyou73v0_A03	29914311	29915921	BnaA03T0518700ZY	0	+	0	0	1610	0.0000000
zheyou73v0_A03	29917603	29920982	BnaA03T0518800ZY	0	+	0	0	3379	0.0000000
zheyou73v0_A03	29917603	29920982	BnaA03T0518800ZY.1	0	+	0	0	3379	0.0000000
zheyou73v0_A03	29921759	29923022	BnaA03T0518900ZY	0	-	0	0	1263	0.0000000
zheyou73v0_A03	29924583	29926586	BnaA03T0519000ZY.1	0	-	0	0	2003	0.0000000
zheyou73v0_A03	29924828	29926586	BnaA03T0519000ZY	0	-	0	0	1758	0.0000000
zheyou73v0_A03	29930211	29931127	BnaA03T0519100ZY	0	+	0	0	916	0.0000000
zheyou73v0_A03	29942227	29942407	BnaA03T0519200ZY	0	-	0	0	180	0.0000000
zheyou73v0_A03	29957246	29958458	BnaA03T0519300ZY	0	-	0	0	1212	0.0000000
zheyou73v0_A03	29959371	29961886	BnaA03T0519400ZY	0	+	0	0	2515	0.0000000
zheyou73v0_A03	29967268	29968117	BnaA03T0519500ZY	0	+	0	0	849	0.0000000
zheyou73v0_A03	29970314	29971666	BnaA03T0519600ZY	0	+	0	0	1352	0.0000000
zheyou73v0_A03	29972555	29978818	BnaA03T0519700ZY	0	+	0	0	6263	0.0000000
zheyou73v0_A03	29979085	29979358	BnaA03T0519800ZY	0	+	0	0	273	0.0000000
zheyou73v0_A03	29979610	29981741	BnaA03T0519900ZY	0	+	0	0	2131	0.0000000
zheyou73v0_A03	29983685	29987781	BnaA03T0520000ZY	0	-	0	0	4096	0.0000000
zheyou73v0_A03	29989405	29991913	BnaA03T0520100ZY	0	+	0	0	2508	0.0000000
zheyou73v0_A03	29995766	29998036	BnaA03T0520200ZY	0	+	0	0	2270	0.0000000
zheyou73v0_A03	30000239	30003862	BnaA03T0520300ZY	0	+	0	0	3623	0.0000000
zheyou73v0_A03	30004448	30006596	BnaA03T0520400ZY	0	+	0	0	2148	0.0000000
zheyou73v0_A03	30010346	30014451	BnaA03T0520500ZY	0	-	0	0	4105	0.0000000
zheyou73v0_A03	30023044	30023467	BnaA03T0520600ZY	0	+	0	0	423	0.0000000
zheyou73v0_A03	30028605	30029229	BnaA03T0520700ZY	0	+	0	0	624	0.0000000
zheyou73v0_A03	30030119	30030575	BnaA03T0520800ZY	0	+	0	0	456	0.0000000
zheyou73v0_A03	30031360	30031993	BnaA03T0520900ZY	0	-	0	0	633	0.0000000
zheyou73v0_A03	30032335	30032825	BnaA03T0521000ZY	0	-	0	0	490	0.0000000
zheyou73v0_A03	30035508	30039100	BnaA03T0521100ZY	0	+	0	0	3592	0.0000000
zheyou73v0_A03	30057663	30062067	BnaA03T0521200ZY	0	+	0	0	4404	0.0000000
zheyou73v0_A03	30070698	30071644	BnaA03T0521300ZY	0	+	0	0	946	0.0000000
zheyou73v0_A03	30106698	30108592	BnaA03T0521400ZY	0	+	0	0	1894	0.0000000
zheyou73v0_A03	30117710	30119554	BnaA03T0521500ZY	0	+	0	0	1844	0.0000000
zheyou73v0_A03	30123306	30124583	BnaA03T0521600ZY	0	+	0	0	1277	0.0000000
zheyou73v0_A03	30125432	30127552	BnaA03T0521700ZY	0	+	0	0	2120	0.0000000
zheyou73v0_A03	30127705	30131691	BnaA03T0521800ZY	0	+	0	0	3986	0.0000000
zheyou73v0_A03	30134228	30135520	BnaA03T0521900ZY	0	-	0	0	1292	0.0000000
zheyou73v0_A03	30149049	30149421	BnaA03T0522000ZY	0	-	0	0	372	0.0000000
zheyou73v0_A03	30149783	30170823	BnaA03T0522100ZY	0	+	0	0	21040	0.0000000
zheyou73v0_A03	30170996	30171982	BnaA03T0522200ZY	0	+	0	0	986	0.0000000
zheyou73v0_A03	30172972	30175548	BnaA03T0522300ZY	0	+	0	0	2576	0.0000000
zheyou73v0_A03	30172972	30175548	BnaA03T0522300ZY.1	0	+	0	0	2576	0.0000000
zheyou73v0_A03	30178432	30178684	BnaA03T0522400ZY	0	+	0	0	252	0.0000000
zheyou73v0_A03	30184238	30184471	BnaA03T0522500ZY	0	-	0	0	233	0.0000000
zheyou73v0_A03	30185334	30192157	BnaA03T0522600ZY	0	+	0	0	6823	0.0000000
zheyou73v0_A03	30196882	30199663	BnaA03T0522700ZY	0	-	0	0	2781	0.0000000
zheyou73v0_A03	30196972	30198190	BnaA03T0522800ZY	0	+	0	0	1218	0.0000000
zheyou73v0_A03	30209947	30210545	BnaA03T0522900ZY	0	+	0	0	598	0.0000000
zheyou73v0_A03	30211762	30212347	BnaA03T0523000ZY	0	+	0	0	585	0.0000000
zheyou73v0_A03	30213505	30215682	BnaA03T0523100ZY	0	+	0	0	2177	0.0000000
zheyou73v0_A03	30216325	30217409	BnaA03T0523200ZY	0	+	0	0	1084	0.0000000
zheyou73v0_A03	30222541	30224318	BnaA03T0523300ZY	0	+	0	0	1777	0.0000000
zheyou73v0_A03	30229053	30230504	BnaA03T0523400ZY	0	+	0	0	1451	0.0000000
zheyou73v0_A03	30230977	30232316	BnaA03T0523500ZY	0	-	0	0	1339	0.0000000
zheyou73v0_A03	30232810	30233696	BnaA03T0523600ZY	0	-	0	0	886	0.0000000
zheyou73v0_A03	30234405	30236330	BnaA03T0523700ZY	0	+	0	0	1925	0.0000000
zheyou73v0_A03	30236246	30238651	BnaA03T0523800ZY	0	-	0	0	2405	0.0000000
zheyou73v0_A03	30250987	30253133	BnaA03T0523900ZY	0	+	0	0	2146	0.0000000
zheyou73v0_A03	30259371	30260422	BnaA03T0524000ZY	0	+	0	0	1051	0.0000000
zheyou73v0_A03	30260998	30262164	BnaA03T0524100ZY	0	+	0	0	1166	0.0000000
zheyou73v0_A03	30262618	30265658	BnaA03T0524200ZY	0	-	0	0	3040	0.0000000
zheyou73v0_A03	30275110	30276242	BnaA03T0524300ZY	0	-	0	0	1132	0.0000000
zheyou73v0_A03	30281982	30283080	BnaA03T0524400ZY	0	-	0	0	1098	0.0000000
zheyou73v0_A03	30292450	30295431	BnaA03T0524500ZY	0	+	0	0	2981	0.0000000
zheyou73v0_A03	30298762	30300035	BnaA03T0524600ZY	0	+	0	0	1273	0.0000000
zheyou73v0_A03	30322872	30323136	BnaA03T0524700ZY	0	+	0	0	264	0.0000000
zheyou73v0_A03	30325865	30328820	BnaA03T0524800ZY	0	-	0	0	2955	0.0000000
zheyou73v0_A03	30331510	30335400	BnaA03T0524900ZY	0	+	0	0	3890	0.0000000
zheyou73v0_A03	30348384	30352115	BnaA03T0525000ZY	0	+	0	0	3731	0.0000000
zheyou73v0_A03	30369888	30371322	BnaA03T0525100ZY	0	+	0	0	1434	0.0000000
zheyou73v0_A03	30377906	30383863	BnaA03T0525200ZY	0	+	0	0	5957	0.0000000
zheyou73v0_A03	30386402	30387224	BnaA03T0525300ZY	0	-	0	0	822	0.0000000
zheyou73v0_A03	30402626	30403168	BnaA03T0525400ZY	0	+	0	0	542	0.0000000
zheyou73v0_A03	30404694	30405547	BnaA03T0525500ZY	0	-	0	0	853	0.0000000
zheyou73v0_A03	30413831	30414798	BnaA03T0525600ZY	0	-	0	0	967	0.0000000
zheyou73v0_A03	30415130	30415914	BnaA03T0525700ZY	0	+	0	0	784	0.0000000
zheyou73v0_A03	30416481	30417951	BnaA03T0525800ZY	0	-	0	0	1470	0.0000000
zheyou73v0_A03	30419049	30426855	BnaA03T0525900ZY	0	+	0	0	7806	0.0000000
zheyou73v0_A03	30419049	30420529	BnaA03T0525900ZY.1	0	+	0	0	1480	0.0000000
zheyou73v0_A03	30419049	30426855	BnaA03T0525900ZY.2	0	+	0	0	7806	0.0000000
zheyou73v0_A03	30429654	30437034	BnaA03T0526000ZY	0	-	0	0	7380	0.0000000
zheyou73v0_A03	30429654	30437034	BnaA03T0526000ZY.1	0	-	0	0	7380	0.0000000
zheyou73v0_A03	30453968	30454172	BnaA03T0526100ZY	0	-	0	0	204	0.0000000
zheyou73v0_A03	30464030	30471094	BnaA03T0526200ZY	0	+	0	0	7064	0.0000000
zheyou73v0_A03	30471273	30472120	BnaA03T0526300ZY	0	-	0	0	847	0.0000000
zheyou73v0_A03	30474194	30474695	BnaA03T0526400ZY	0	-	0	0	501	0.0000000
zheyou73v0_A03	30475491	30476549	BnaA03T0526500ZY	0	+	0	0	1058	0.0000000
zheyou73v0_A03	30479064	30483555	BnaA03T0526600ZY.1	0	+	0	0	4491	0.0000000
zheyou73v0_A03	30479633	30483555	BnaA03T0526600ZY	0	+	0	0	3922	0.0000000
zheyou73v0_A03	30484570	30487261	BnaA03T0526700ZY	0	-	0	0	2691	0.0000000
zheyou73v0_A03	30490565	30491261	BnaA03T0526800ZY	0	+	0	0	696	0.0000000
zheyou73v0_A03	30495221	30495753	BnaA03T0526900ZY	0	+	0	0	532	0.0000000
zheyou73v0_A03	30497222	30498172	BnaA03T0527000ZY	0	-	0	0	950	0.0000000
zheyou73v0_A03	30506706	30512150	BnaA03T0527100ZY	0	-	0	0	5444	0.0000000
zheyou73v0_A03	30513758	30519296	BnaA03T0527200ZY	0	+	0	0	5538	0.0000000
zheyou73v0_A03	30519451	30524118	BnaA03T0527300ZY	0	-	0	0	4667	0.0000000
zheyou73v0_A03	30539702	30546704	BnaA03T0527400ZY	0	+	0	0	7002	0.0000000
zheyou73v0_A03	30550202	30553621	BnaA03T0527500ZY	0	+	0	0	3419	0.0000000
zheyou73v0_A03	30559261	30561429	BnaA03T0527600ZY	0	+	0	0	2168	0.0000000
zheyou73v0_A03	30559676	30561429	BnaA03T0527600ZY.1	0	+	0	0	1753	0.0000000
zheyou73v0_A03	30562736	30567114	BnaA03T0527700ZY	0	-	0	0	4378	0.0000000
zheyou73v0_A03	30575230	30579844	BnaA03T0527800ZY	0	+	0	0	4614	0.0000000
zheyou73v0_A03	30580882	30581365	BnaA03T0527900ZY	0	+	0	0	483	0.0000000
zheyou73v0_A03	30594807	30598036	BnaA03T0528000ZY	0	-	0	0	3229	0.0000000
zheyou73v0_A03	30608266	30611931	BnaA03T0528100ZY	0	+	0	0	3665	0.0000000
zheyou73v0_A03	30620729	30622871	BnaA03T0528200ZY	0	-	0	0	2142	0.0000000
zheyou73v0_A03	30622927	30624181	BnaA03T0528300ZY	0	-	0	0	1254	0.0000000
zheyou73v0_A03	30627617	30630595	BnaA03T0528400ZY	0	-	0	0	2978	0.0000000
zheyou73v0_A03	30648396	30649407	BnaA03T0528500ZY	0	+	0	0	1011	0.0000000
zheyou73v0_A03	30651100	30652469	BnaA03T0528600ZY	0	-	0	0	1369	0.0000000
zheyou73v0_A03	30652824	30654213	BnaA03T0528700ZY	0	-	0	0	1389	0.0000000
zheyou73v0_A03	30659373	30660848	BnaA03T0528800ZY	0	-	0	0	1475	0.0000000
zheyou73v0_A03	30662673	30663843	BnaA03T0528900ZY	0	-	0	0	1170	0.0000000
zheyou73v0_A03	30682138	30685427	BnaA03T0529000ZY	0	+	0	0	3289	0.0000000
zheyou73v0_A03	30686141	30686642	BnaA03T0529100ZY	0	+	0	0	501	0.0000000
zheyou73v0_A03	30700173	30703329	BnaA03T0529200ZY	0	+	0	0	3156	0.0000000
zheyou73v0_A03	30714332	30714569	BnaA03T0529300ZY	0	-	0	0	237	0.0000000
zheyou73v0_A03	30717750	30718728	BnaA03T0529400ZY	0	-	0	0	978	0.0000000
zheyou73v0_A03	30728711	30730193	BnaA03T0529500ZY	0	+	0	0	1482	0.0000000
zheyou73v0_A03	30740516	30742288	BnaA03T0529600ZY	0	+	0	0	1772	0.0000000
zheyou73v0_A03	30817091	30818740	BnaA03T0529700ZY	0	+	0	0	1649	0.0000000
zheyou73v0_A03	30820337	30821887	BnaA03T0529800ZY	0	+	0	0	1550	0.0000000
zheyou73v0_A03	30824135	30825696	BnaA03T0529900ZY	0	-	0	0	1561	0.0000000
zheyou73v0_A03	30830787	30831467	BnaA03T0530000ZY	0	-	0	0	680	0.0000000
zheyou73v0_A03	30833486	30834421	BnaA03T0530100ZY	0	-	0	0	935	0.0000000
zheyou73v0_A03	30839673	30842230	BnaA03T0530200ZY	0	+	0	0	2557	0.0000000
zheyou73v0_A03	30845699	30849063	BnaA03T0530300ZY	0	-	0	0	3364	0.0000000
zheyou73v0_A03	30850618	30852054	BnaA03T0530400ZY	0	+	0	0	1436	0.0000000
zheyou73v0_A03	30852063	30854509	BnaA03T0530500ZY	0	-	0	0	2446	0.0000000
zheyou73v0_A03	30852063	30854509	BnaA03T0530500ZY.1	0	-	0	0	2446	0.0000000
zheyou73v0_A03	30852063	30854267	BnaA03T0530500ZY.2	0	-	0	0	2204	0.0000000
zheyou73v0_A03	30852063	30853974	BnaA03T0530500ZY.3	0	-	0	0	1911	0.0000000
zheyou73v0_A03	30856365	30859510	BnaA03T0530600ZY	0	-	0	0	3145	0.0000000
zheyou73v0_A03	30871759	30873624	BnaA03T0530700ZY	0	+	0	0	1865	0.0000000
zheyou73v0_A03	30874155	30876971	BnaA03T0530800ZY	0	-	0	0	2816	0.0000000
zheyou73v0_A03	30878529	30881337	BnaA03T0530900ZY	0	-	0	0	2808	0.0000000
zheyou73v0_A03	30920230	30921648	BnaA03T0531000ZY	0	-	0	0	1418	0.0000000
zheyou73v0_A03	30922528	30923398	BnaA03T0531100ZY	0	-	0	0	870	0.0000000
zheyou73v0_A03	30943412	30945202	BnaA03T0531200ZY	0	-	0	0	1790	0.0000000
zheyou73v0_A03	30945698	30947430	BnaA03T0531300ZY	0	-	0	0	1732	0.0000000
zheyou73v0_A03	30949090	30949928	BnaA03T0531400ZY	0	-	0	0	838	0.0000000
zheyou73v0_A03	30955917	30958912	BnaA03T0531500ZY	0	-	0	0	2995	0.0000000
zheyou73v0_A03	30962119	30963891	BnaA03T0531600ZY	0	-	0	0	1772	0.0000000
zheyou73v0_A03	30966710	30967891	BnaA03T0531700ZY	0	-	0	0	1181	0.0000000
zheyou73v0_A03	30968562	30969693	BnaA03T0531800ZY	0	-	0	0	1131	0.0000000
zheyou73v0_A03	30971379	30976468	BnaA03T0531900ZY	0	+	0	0	5089	0.0000000
zheyou73v0_A03	30971379	30975191	BnaA03T0531900ZY.1	0	+	0	0	3812	0.0000000
zheyou73v0_A03	30977203	30978790	BnaA03T0532000ZY	0	+	0	0	1587	0.0000000
zheyou73v0_A03	30977203	30978790	BnaA03T0532000ZY.1	0	+	0	0	1587	0.0000000
zheyou73v0_A03	30981721	30982774	BnaA03T0532100ZY	0	+	0	0	1053	0.0000000
zheyou73v0_A03	30989790	30990311	BnaA03T0532200ZY	0	-	0	0	521	0.0000000
zheyou73v0_A03	30993401	30994186	BnaA03T0532300ZY	0	+	0	0	785	0.0000000
zheyou73v0_A03	30995680	30996731	BnaA03T0532400ZY	0	+	0	0	1051	0.0000000
zheyou73v0_A03	30997619	30998218	BnaA03T0532500ZY	0	+	0	0	599	0.0000000
zheyou73v0_A03	30999531	30999935	BnaA03T0532600ZY	0	-	0	0	404	0.0000000
zheyou73v0_A03	31001176	31004213	BnaA03T0532700ZY	0	-	0	0	3037	0.0000000
zheyou73v0_A03	31006924	31008702	BnaA03T0532800ZY	0	+	0	0	1778	0.0000000
zheyou73v0_A03	31006924	31008285	BnaA03T0532800ZY.1	0	+	0	0	1361	0.0000000
zheyou73v0_A03	31008509	31011109	BnaA03T0532900ZY	0	-	0	0	2600	0.0000000
zheyou73v0_A03	31014761	31017349	BnaA03T0533000ZY	0	-	0	0	2588	0.0000000
zheyou73v0_A03	31021484	31024856	BnaA03T0533100ZY	0	-	0	0	3372	0.0000000
zheyou73v0_A03	31027017	31027482	BnaA03T0533200ZY	0	-	0	0	465	0.0000000
zheyou73v0_A03	31029604	31032041	BnaA03T0533300ZY	0	+	0	0	2437	0.0000000
zheyou73v0_A03	31029604	31032041	BnaA03T0533300ZY.1	0	+	0	0	2437	0.0000000
zheyou73v0_A03	31032056	31037078	BnaA03T0533400ZY	0	-	0	0	5022	0.0000000
zheyou73v0_A03	31056095	31056317	BnaA03T0533500ZY	0	-	0	0	222	0.0000000
zheyou73v0_A03	31069369	31069561	BnaA03T0533600ZY	0	+	0	0	192	0.0000000
zheyou73v0_A03	31073907	31074847	BnaA03T0533700ZY	0	+	0	0	940	0.0000000
zheyou73v0_A03	31077159	31078861	BnaA03T0533800ZY	0	-	0	0	1702	0.0000000
zheyou73v0_A03	31079576	31081454	BnaA03T0533900ZY	0	-	0	0	1878	0.0000000
zheyou73v0_A03	31082312	31082748	BnaA03T0534000ZY	0	+	0	0	436	0.0000000
zheyou73v0_A03	31082909	31084857	BnaA03T0534100ZY	0	-	0	0	1948	0.0000000
zheyou73v0_A03	31088655	31098336	BnaA03T0534200ZY	0	-	0	0	9681	0.0000000
zheyou73v0_A03	31098811	31101585	BnaA03T0534300ZY.1	0	-	0	0	2774	0.0000000
zheyou73v0_A03	31099042	31101585	BnaA03T0534300ZY	0	-	0	0	2543	0.0000000
zheyou73v0_A03	31104163	31104436	BnaA03T0534400ZY	0	-	0	0	273	0.0000000
zheyou73v0_A03	31140343	31141904	BnaA03T0534500ZY	0	+	0	0	1561	0.0000000
zheyou73v0_A03	31156864	31158742	BnaA03T0534600ZY	0	+	0	0	1878	0.0000000
zheyou73v0_A03	31178642	31191234	BnaA03T0534700ZY	0	+	0	0	12592	0.0000000
zheyou73v0_A03	31193818	31195806	BnaA03T0534800ZY	0	-	0	0	1988	0.0000000
zheyou73v0_A03	31198023	31199644	BnaA03T0534900ZY	0	-	0	0	1621	0.0000000
zheyou73v0_A03	31199947	31201747	BnaA03T0535000ZY	0	-	0	0	1800	0.0000000
zheyou73v0_A03	31208278	31209795	BnaA03T0535100ZY	0	+	0	0	1517	0.0000000
zheyou73v0_A03	31210088	31222127	BnaA03T0535200ZY	0	-	0	0	12039	0.0000000
zheyou73v0_A03	31223248	31230310	BnaA03T0535300ZY	0	+	0	0	7062	0.0000000
zheyou73v0_A03	31230315	31232754	BnaA03T0535400ZY	0	-	0	0	2439	0.0000000
zheyou73v0_A03	31237795	31247812	BnaA03T0535500ZY	0	+	0	0	10017	0.0000000
zheyou73v0_A03	31237795	31247643	BnaA03T0535500ZY.1	0	+	0	0	9848	0.0000000
zheyou73v0_A03	31248215	31251369	BnaA03T0535600ZY	0	-	0	0	3154	0.0000000
zheyou73v0_A03	31261439	31263381	BnaA03T0535700ZY	0	+	0	0	1942	0.0000000
zheyou73v0_A03	31263702	31265205	BnaA03T0535800ZY	0	+	0	0	1503	0.0000000
zheyou73v0_A03	31266577	31267150	BnaA03T0535900ZY	0	-	0	0	573	0.0000000
zheyou73v0_A03	31274196	31275430	BnaA03T0536000ZY	0	+	0	0	1234	0.0000000
zheyou73v0_A03	31277393	31280506	BnaA03T0536100ZY	0	+	0	0	3113	0.0000000
zheyou73v0_A03	31284381	31285272	BnaA03T0536200ZY	0	-	0	0	891	0.0000000
zheyou73v0_A03	31294537	31294912	BnaA03T0536300ZY	0	+	0	0	375	0.0000000
zheyou73v0_A03	31299621	31301208	BnaA03T0536400ZY	0	+	0	0	1587	0.0000000
zheyou73v0_A03	31302348	31303708	BnaA03T0536500ZY	0	-	0	0	1360	0.0000000
zheyou73v0_A03	31321105	31322335	BnaA03T0536600ZY	0	+	0	0	1230	0.0000000
zheyou73v0_A03	31322917	31324656	BnaA03T0536700ZY	0	-	0	0	1739	0.0000000
zheyou73v0_A03	31330658	31332416	BnaA03T0536800ZY	0	+	0	0	1758	0.0000000
zheyou73v0_A03	31333984	31334663	BnaA03T0536900ZY	0	-	0	0	679	0.0000000
zheyou73v0_A03	31344085	31348516	BnaA03T0537000ZY	0	+	0	0	4431	0.0000000
zheyou73v0_A03	31349259	31350557	BnaA03T0537100ZY	0	-	0	0	1298	0.0000000
zheyou73v0_A03	31352540	31354841	BnaA03T0537200ZY	0	-	0	0	2301	0.0000000
zheyou73v0_A03	31356080	31365576	BnaA03T0537300ZY	0	+	0	0	9496	0.0000000
zheyou73v0_A03	31366130	31367947	BnaA03T0537400ZY	0	+	0	0	1817	0.0000000
zheyou73v0_A03	31368206	31369121	BnaA03T0537500ZY	0	-	0	0	915	0.0000000
zheyou73v0_A03	31374958	31376606	BnaA03T0537600ZY	0	-	0	0	1648	0.0000000
zheyou73v0_A03	31382390	31383179	BnaA03T0537700ZY	0	+	0	0	789	0.0000000
zheyou73v0_A03	31383449	31392886	BnaA03T0537800ZY	0	+	0	0	9437	0.0000000
zheyou73v0_A03	31393106	31394729	BnaA03T0537900ZY	0	+	0	0	1623	0.0000000
zheyou73v0_A03	31395016	31397630	BnaA03T0538000ZY	0	-	0	0	2614	0.0000000
zheyou73v0_A03	31403420	31411070	BnaA03T0538100ZY	0	-	0	0	7650	0.0000000
zheyou73v0_A03	31414791	31415258	BnaA03T0538200ZY	0	-	0	0	467	0.0000000
zheyou73v0_A03	31425431	31426446	BnaA03T0538300ZY	0	+	0	0	1015	0.0000000
zheyou73v0_A03	31441407	31442163	BnaA03T0538400ZY	0	+	0	0	756	0.0000000
zheyou73v0_A03	31447526	31448040	BnaA03T0538500ZY	0	+	0	0	514	0.0000000
zheyou73v0_A03	31448099	31449320	BnaA03T0538600ZY	0	+	0	0	1221	0.0000000
zheyou73v0_A03	31450991	31451498	BnaA03T0538700ZY	0	-	0	0	507	0.0000000
zheyou73v0_A03	31455791	31458252	BnaA03T0538800ZY	0	-	0	0	2461	0.0000000
zheyou73v0_A03	31458761	31461649	BnaA03T0538900ZY	0	+	0	0	2888	0.0000000
zheyou73v0_A03	31467060	31468265	BnaA03T0539000ZY	0	+	0	0	1205	0.0000000
zheyou73v0_A03	31472317	31473754	BnaA03T0539100ZY	0	+	0	0	1437	0.0000000
zheyou73v0_A03	31476943	31477626	BnaA03T0539200ZY	0	+	0	0	683	0.0000000
zheyou73v0_A03	31484661	31487958	BnaA03T0539300ZY	0	+	0	0	3297	0.0000000
zheyou73v0_A03	31487883	31490498	BnaA03T0539400ZY	0	-	0	0	2615	0.0000000
zheyou73v0_A03	31487883	31490498	BnaA03T0539400ZY.1	0	-	0	0	2615	0.0000000
zheyou73v0_A03	31493863	31508446	BnaA03T0539500ZY	0	+	0	0	14583	0.0000000
zheyou73v0_A03	31493863	31508446	BnaA03T0539500ZY.1	0	+	0	0	14583	0.0000000
zheyou73v0_A03	31493863	31508446	BnaA03T0539500ZY.2	0	+	0	0	14583	0.0000000
zheyou73v0_A03	31493863	31496254	BnaA03T0539500ZY.3	0	+	0	0	2391	0.0000000
zheyou73v0_A03	31493863	31496254	BnaA03T0539500ZY.4	0	+	0	0	2391	0.0000000
zheyou73v0_A03	31493863	31496254	BnaA03T0539500ZY.5	0	+	0	0	2391	0.0000000
zheyou73v0_A03	31495564	31496085	BnaA03T0539600ZY	0	-	0	0	521	0.0000000
zheyou73v0_A03	31510501	31510672	BnaA03T0539700ZY	0	-	0	0	171	0.0000000
zheyou73v0_A03	31522577	31527804	BnaA03T0539800ZY	0	-	0	0	5227	0.0000000
zheyou73v0_A03	31536556	31541740	BnaA03T0539900ZY	0	+	0	0	5184	0.0000000
zheyou73v0_A03	31556730	31559267	BnaA03T0540000ZY	0	+	0	0	2537	0.0000000
zheyou73v0_A03	31559547	31562234	BnaA03T0540100ZY	0	-	0	0	2687	0.0000000
zheyou73v0_A03	31559547	31561533	BnaA03T0540100ZY.1	0	-	0	0	1986	0.0000000
zheyou73v0_A03	31559547	31562234	BnaA03T0540100ZY.2	0	-	0	0	2687	0.0000000
zheyou73v0_A03	31564903	31566192	BnaA03T0540200ZY	0	-	0	0	1289	0.0000000
zheyou73v0_A03	31566591	31567310	BnaA03T0540300ZY	0	+	0	0	719	0.0000000
zheyou73v0_A03	31567692	31575623	BnaA03T0540400ZY	0	-	0	0	7931	0.0000000
zheyou73v0_A03	31578055	31582636	BnaA03T0540500ZY	0	+	0	0	4581	0.0000000
zheyou73v0_A03	31578055	31582636	BnaA03T0540500ZY.1	0	+	0	0	4581	0.0000000
zheyou73v0_A03	31578055	31582636	BnaA03T0540500ZY.2	0	+	0	0	4581	0.0000000
zheyou73v0_A03	31585004	31585612	BnaA03T0540600ZY	0	+	0	0	608	0.0000000
zheyou73v0_A03	31588819	31590502	BnaA03T0540700ZY	0	+	0	0	1683	0.0000000
zheyou73v0_A03	31593762	31595655	BnaA03T0540800ZY	0	+	0	0	1893	0.0000000
zheyou73v0_A03	31596488	31598684	BnaA03T0540900ZY	0	-	0	0	2196	0.0000000
zheyou73v0_A03	31599498	31599955	BnaA03T0541000ZY	0	-	0	0	457	0.0000000
zheyou73v0_A03	31602122	31603995	BnaA03T0541100ZY	0	+	0	0	1873	0.0000000
zheyou73v0_A03	31604223	31608042	BnaA03T0541200ZY	0	+	0	0	3819	0.0000000
zheyou73v0_A03	31608172	31609647	BnaA03T0541300ZY	0	+	0	0	1475	0.0000000
zheyou73v0_A03	31617276	31617814	BnaA03T0541400ZY	0	-	0	0	538	0.0000000
zheyou73v0_A03	31618618	31620466	BnaA03T0541500ZY	0	-	0	0	1848	0.0000000
zheyou73v0_A03	31626108	31627301	BnaA03T0541600ZY	0	+	0	0	1193	0.0000000
zheyou73v0_A03	31629809	31631225	BnaA03T0541700ZY	0	-	0	0	1416	0.0000000
zheyou73v0_A03	31633612	31637219	BnaA03T0541800ZY	0	+	0	0	3607	0.0000000
zheyou73v0_A03	31639009	31640335	BnaA03T0541900ZY	0	+	0	0	1326	0.0000000
zheyou73v0_A03	31644995	31647571	BnaA03T0542000ZY	0	+	0	0	2576	0.0000000
zheyou73v0_A03	31648119	31650271	BnaA03T0542100ZY	0	+	0	0	2152	0.0000000
zheyou73v0_A03	31648119	31650271	BnaA03T0542100ZY.1	0	+	0	0	2152	0.0000000
zheyou73v0_A03	31652731	31654916	BnaA03T0542200ZY	0	+	0	0	2185	0.0000000
zheyou73v0_A03	31655569	31660253	BnaA03T0542300ZY	0	-	0	0	4684	0.0000000
zheyou73v0_A03	31667348	31669155	BnaA03T0542400ZY	0	+	0	0	1807	0.0000000
zheyou73v0_A03	31671430	31672539	BnaA03T0542500ZY	0	+	0	0	1109	0.0000000
zheyou73v0_A03	31676398	31676827	BnaA03T0542600ZY	0	-	0	0	429	0.0000000
zheyou73v0_A03	31679017	31679446	BnaA03T0542700ZY	0	-	0	0	429	0.0000000
zheyou73v0_A03	31688536	31688968	BnaA03T0542800ZY	0	+	0	0	432	0.0000000
zheyou73v0_A03	31697022	31697391	BnaA03T0542900ZY	0	-	0	0	369	0.0000000
zheyou73v0_A03	31697617	31699028	BnaA03T0543000ZY	0	+	0	0	1411	0.0000000
zheyou73v0_A03	31707208	31709951	BnaA03T0543100ZY	0	-	0	0	2743	0.0000000
zheyou73v0_A03	31710980	31716246	BnaA03T0543200ZY	0	-	0	0	5266	0.0000000
zheyou73v0_A03	31716999	31721550	BnaA03T0543300ZY	0	+	0	0	4551	0.0000000
zheyou73v0_A03	31721674	31723496	BnaA03T0543400ZY	0	-	0	0	1822	0.0000000
zheyou73v0_A03	31726382	31730182	BnaA03T0543500ZY	0	-	0	0	3800	0.0000000
zheyou73v0_A03	31739575	31739971	BnaA03T0543600ZY	0	-	0	0	396	0.0000000
zheyou73v0_A03	31749360	31759786	BnaA03T0543700ZY	0	+	0	0	10426	0.0000000
zheyou73v0_A03	31760111	31761301	BnaA03T0543800ZY	0	-	0	0	1190	0.0000000
zheyou73v0_A03	31767204	31769417	BnaA03T0543900ZY	0	+	0	0	2213	0.0000000
zheyou73v0_A03	31772855	31775990	BnaA03T0544000ZY	0	+	0	0	3135	0.0000000
zheyou73v0_A03	31772855	31775990	BnaA03T0544000ZY.1	0	+	0	0	3135	0.0000000
zheyou73v0_A03	31790650	31791554	BnaA03T0544100ZY	0	+	0	0	904	0.0000000
zheyou73v0_A03	31804407	31805027	BnaA03T0544200ZY	0	+	0	0	620	0.0000000
zheyou73v0_A03	31807475	31808290	BnaA03T0544300ZY	0	-	0	0	815	0.0000000
zheyou73v0_A03	31812457	31812962	BnaA03T0544400ZY	0	+	0	0	505	0.0000000
zheyou73v0_A03	31813831	31815365	BnaA03T0544500ZY	0	+	0	0	1534	0.0000000
zheyou73v0_A03	31820399	31821813	BnaA03T0544600ZY	0	+	0	0	1414	0.0000000
zheyou73v0_A03	31823448	31825004	BnaA03T0544700ZY	0	+	0	0	1556	0.0000000
zheyou73v0_A03	31825031	31831487	BnaA03T0544800ZY	0	-	0	0	6456	0.0000000
zheyou73v0_A03	31837929	31838872	BnaA03T0544900ZY	0	+	0	0	943	0.0000000
zheyou73v0_A03	31839648	31841045	BnaA03T0545000ZY	0	-	0	0	1397	0.0000000
zheyou73v0_A03	31845886	31847582	BnaA03T0545100ZY	0	-	0	0	1696	0.0000000
zheyou73v0_A03	31847876	31850077	BnaA03T0545200ZY	0	-	0	0	2201	0.0000000
zheyou73v0_A03	31853133	31855883	BnaA03T0545300ZY	0	+	0	0	2750	0.0000000
zheyou73v0_A03	31858273	31860546	BnaA03T0545400ZY	0	+	0	0	2273	0.0000000
zheyou73v0_A03	31858273	31860673	BnaA03T0545400ZY.1	0	+	0	0	2400	0.0000000
zheyou73v0_A03	31864217	31864878	BnaA03T0545500ZY	0	-	0	0	661	0.0000000
zheyou73v0_A03	31868413	31871927	BnaA03T0545600ZY	0	-	0	0	3514	0.0000000
zheyou73v0_A03	31891513	31892999	BnaA03T0545700ZY	0	-	0	0	1486	0.0000000
zheyou73v0_A03	31898923	31899344	BnaA03T0545800ZY	0	-	0	0	421	0.0000000
zheyou73v0_A03	31899993	31902214	BnaA03T0545900ZY	0	+	0	0	2221	0.0000000
zheyou73v0_A03	31902626	31910764	BnaA03T0546000ZY	0	-	0	0	8138	0.0000000
zheyou73v0_A03	31914653	31915127	BnaA03T0546100ZY	0	+	0	0	474	0.0000000
zheyou73v0_A03	31929995	31931180	BnaA03T0546200ZY	0	+	0	0	1185	0.0000000
zheyou73v0_A03	31948092	31950179	BnaA03T0546300ZY	0	+	0	0	2087	0.0000000
zheyou73v0_A03	31951098	31993469	BnaA03T0546400ZY	0	-	0	0	42371	0.0000000
zheyou73v0_A03	31998576	31999115	BnaA03T0546500ZY	0	+	0	0	539	0.0000000
zheyou73v0_A03	31999512	32002228	BnaA03T0546600ZY	0	-	0	0	2716	0.0000000
zheyou73v0_A03	32002711	32006896	BnaA03T0546700ZY	0	-	0	0	4185	0.0000000
zheyou73v0_A03	32007230	32011591	BnaA03T0546800ZY	0	-	0	0	4361	0.0000000
zheyou73v0_A03	32012513	32013043	BnaA03T0546900ZY	0	+	0	0	530	0.0000000
zheyou73v0_A03	32013123	32014792	BnaA03T0547000ZY	0	-	0	0	1669	0.0000000
zheyou73v0_A03	32016357	32017519	BnaA03T0547100ZY	0	+	0	0	1162	0.0000000
zheyou73v0_A03	32018049	32020157	BnaA03T0547200ZY	0	+	0	0	2108	0.0000000
zheyou73v0_A03	32022635	32023934	BnaA03T0547300ZY	0	+	0	0	1299	0.0000000
zheyou73v0_A03	32025614	32027193	BnaA03T0547400ZY	0	+	0	0	1579	0.0000000
zheyou73v0_A03	32027540	32030386	BnaA03T0547500ZY	0	-	0	0	2846	0.0000000
zheyou73v0_A03	32040876	32043570	BnaA03T0547600ZY	0	+	0	0	2694	0.0000000
zheyou73v0_A03	32045630	32046465	BnaA03T0547700ZY	0	-	0	0	835	0.0000000
zheyou73v0_A03	32049587	32049948	BnaA03T0547800ZY	0	-	0	0	361	0.0000000
zheyou73v0_A03	32058946	32059300	BnaA03T0547900ZY	0	+	0	0	354	0.0000000
zheyou73v0_A03	32064282	32064879	BnaA03T0548000ZY	0	-	0	0	597	0.0000000
zheyou73v0_A03	32067501	32069189	BnaA03T0548100ZY	0	+	0	0	1688	0.0000000
zheyou73v0_A03	32073457	32074709	BnaA03T0548200ZY	0	+	0	0	1252	0.0000000
zheyou73v0_A03	32126788	32128946	BnaA03T0548300ZY	0	+	0	0	2158	0.0000000
zheyou73v0_A03	32126788	32128946	BnaA03T0548300ZY.1	0	+	0	0	2158	0.0000000
zheyou73v0_A03	32128791	32130186	BnaA03T0548400ZY	0	-	0	0	1395	0.0000000
zheyou73v0_A03	32130927	32131420	BnaA03T0548500ZY	0	-	0	0	493	0.0000000
zheyou73v0_A03	32132006	32134283	BnaA03T0548600ZY	0	-	0	0	2277	0.0000000
zheyou73v0_A03	32135125	32137485	BnaA03T0548700ZY	0	-	0	0	2360	0.0000000
zheyou73v0_A03	32138438	32144716	BnaA03T0548800ZY	0	-	0	0	6278	0.0000000
zheyou73v0_A03	32145023	32148528	BnaA03T0548900ZY	0	+	0	0	3505	0.0000000
zheyou73v0_A03	32148517	32149926	BnaA03T0549000ZY	0	-	0	0	1409	0.0000000
zheyou73v0_A03	32150218	32154136	BnaA03T0549100ZY	0	+	0	0	3918	0.0000000
zheyou73v0_A03	32155228	32160076	BnaA03T0549200ZY	0	+	0	0	4848	0.0000000
zheyou73v0_A03	32160664	32161082	BnaA03T0549300ZY	0	-	0	0	418	0.0000000
zheyou73v0_A03	32161613	32163211	BnaA03T0549400ZY	0	-	0	0	1598	0.0000000
zheyou73v0_A03	32161613	32163211	BnaA03T0549400ZY.1	0	-	0	0	1598	0.0000000
zheyou73v0_A03	32171750	32172362	BnaA03T0549500ZY	0	-	0	0	612	0.0000000
zheyou73v0_A03	32173871	32174183	BnaA03T0549600ZY	0	+	0	0	312	0.0000000
zheyou73v0_A03	32174275	32175354	BnaA03T0549700ZY	0	+	0	0	1079	0.0000000
zheyou73v0_A03	32177780	32183316	BnaA03T0549800ZY	0	-	0	0	5536	0.0000000
zheyou73v0_A03	32186643	32187345	BnaA03T0549900ZY	0	+	0	0	702	0.0000000
zheyou73v0_A03	32199432	32199945	BnaA03T0550000ZY	0	+	0	0	513	0.0000000
zheyou73v0_A03	32200111	32200857	BnaA03T0550100ZY	0	-	0	0	746	0.0000000
zheyou73v0_A03	32202293	32204328	BnaA03T0550200ZY	0	-	0	0	2035	0.0000000
zheyou73v0_A03	32223425	32224095	BnaA03T0550300ZY	0	+	0	0	670	0.0000000
zheyou73v0_A03	32231991	32233879	BnaA03T0550400ZY	0	-	0	0	1888	0.0000000
zheyou73v0_A03	32234352	32235095	BnaA03T0550500ZY	0	-	0	0	743	0.0000000
zheyou73v0_A03	32236644	32237136	BnaA03T0550600ZY	0	+	0	0	492	0.0000000
zheyou73v0_A03	32238523	32238862	BnaA03T0550700ZY	0	+	0	0	339	0.0000000
zheyou73v0_A03	32244412	32245696	BnaA03T0550800ZY	0	+	0	0	1284	0.0000000
zheyou73v0_A03	32245923	32248727	BnaA03T0550900ZY	0	-	0	0	2804	0.0000000
zheyou73v0_A03	32256323	32266297	BnaA03T0551000ZY	0	-	0	0	9974	0.0000000
zheyou73v0_A03	32268134	32270669	BnaA03T0551100ZY	0	-	0	0	2535	0.0000000
zheyou73v0_A03	32271555	32274049	BnaA03T0551200ZY	0	-	0	0	2494	0.0000000
zheyou73v0_A03	32281034	32282782	BnaA03T0551300ZY	0	-	0	0	1748	0.0000000
zheyou73v0_A03	32296020	32298426	BnaA03T0551400ZY	0	+	0	0	2406	0.0000000
zheyou73v0_A03	32297388	32300239	BnaA03T0551500ZY	0	-	0	0	2851	0.0000000
zheyou73v0_A03	32313996	32315509	BnaA03T0551600ZY	0	-	0	0	1513	0.0000000
zheyou73v0_A03	32317281	32319052	BnaA03T0551700ZY	0	+	0	0	1771	0.0000000
zheyou73v0_A03	32325711	32326542	BnaA03T0551800ZY	0	-	0	0	831	0.0000000
zheyou73v0_A03	32335444	32336900	BnaA03T0551900ZY	0	+	0	0	1456	0.0000000
zheyou73v0_A03	32338458	32340840	BnaA03T0552000ZY	0	+	0	0	2382	0.0000000
zheyou73v0_A03	32347083	32349987	BnaA03T0552100ZY	0	+	0	0	2904	0.0000000
zheyou73v0_A03	32353169	32353440	BnaA03T0552200ZY	0	+	0	0	271	0.0000000
zheyou73v0_A03	32358129	32360475	BnaA03T0552300ZY	0	-	0	0	2346	0.0000000
zheyou73v0_A03	32363526	32364616	BnaA03T0552400ZY	0	-	0	0	1090	0.0000000
zheyou73v0_A03	32365741	32366581	BnaA03T0552500ZY	0	-	0	0	840	0.0000000
zheyou73v0_A03	32371504	32373018	BnaA03T0552600ZY	0	-	0	0	1514	0.0000000
zheyou73v0_A03	32376669	32378560	BnaA03T0552700ZY	0	+	0	0	1891	0.0000000
zheyou73v0_A03	32381551	32385209	BnaA03T0552800ZY	0	+	0	0	3658	0.0000000
zheyou73v0_A03	32386501	32387629	BnaA03T0552900ZY	0	+	0	0	1128	0.0000000
zheyou73v0_A03	32388271	32390247	BnaA03T0553000ZY	0	-	0	0	1976	0.0000000
zheyou73v0_A03	32388271	32390247	BnaA03T0553000ZY.1	0	-	0	0	1976	0.0000000
zheyou73v0_A03	32388271	32390247	BnaA03T0553000ZY.2	0	-	0	0	1976	0.0000000
zheyou73v0_A03	32390555	32393861	BnaA03T0553100ZY	0	+	0	0	3306	0.0000000
zheyou73v0_A03	32394657	32396489	BnaA03T0553200ZY	0	+	0	0	1832	0.0000000
zheyou73v0_A03	32396601	32396935	BnaA03T0553300ZY	0	+	0	0	334	0.0000000
zheyou73v0_A03	32397232	32399671	BnaA03T0553400ZY	0	+	0	0	2439	0.0000000
zheyou73v0_A03	32400269	32401590	BnaA03T0553500ZY	0	+	0	0	1321	0.0000000
zheyou73v0_A03	32421271	32423709	BnaA03T0553600ZY	0	+	0	0	2438	0.0000000
zheyou73v0_A03	32424248	32425554	BnaA03T0553700ZY	0	-	0	0	1306	0.0000000
zheyou73v0_A03	32426775	32427218	BnaA03T0553800ZY	0	+	0	0	443	0.0000000
zheyou73v0_A03	32429541	32429970	BnaA03T0553900ZY	0	-	0	0	429	0.0000000
zheyou73v0_A03	32430470	32431641	BnaA03T0554000ZY	0	+	0	0	1171	0.0000000
zheyou73v0_A03	32433894	32441365	BnaA03T0554100ZY	0	+	0	0	7471	0.0000000
zheyou73v0_A03	32441189	32443959	BnaA03T0554200ZY	0	-	0	0	2770	0.0000000
zheyou73v0_A03	32445302	32448382	BnaA03T0554300ZY	0	-	0	0	3080	0.0000000
zheyou73v0_A03	32450492	32452624	BnaA03T0554400ZY	0	-	0	0	2132	0.0000000
zheyou73v0_A03	32454531	32457827	BnaA03T0554500ZY	0	+	0	0	3296	0.0000000
zheyou73v0_A03	32463721	32465334	BnaA03T0554600ZY	0	+	0	0	1613	0.0000000
zheyou73v0_A03	32465705	32474844	BnaA03T0554700ZY	0	-	0	0	9139	0.0000000
zheyou73v0_A03	32492504	32494835	BnaA03T0554800ZY	0	+	0	0	2331	0.0000000
zheyou73v0_A03	32496227	32497545	BnaA03T0554900ZY	0	+	0	0	1318	0.0000000
zheyou73v0_A03	32501490	32503256	BnaA03T0555000ZY	0	+	0	0	1766	0.0000000
zheyou73v0_A03	32504892	32507089	BnaA03T0555100ZY	0	+	0	0	2197	0.0000000
zheyou73v0_A03	32514704	32517237	BnaA03T0555200ZY	0	+	0	0	2533	0.0000000
zheyou73v0_A03	32523052	32525767	BnaA03T0555300ZY	0	+	0	0	2715	0.0000000
zheyou73v0_A03	32527230	32529257	BnaA03T0555400ZY	0	+	0	0	2027	0.0000000
zheyou73v0_A03	32535054	32539478	BnaA03T0555500ZY	0	-	0	0	4424	0.0000000
zheyou73v0_A03	32541763	32542483	BnaA03T0555600ZY	0	+	0	0	720	0.0000000
zheyou73v0_A03	32544044	32549827	BnaA03T0555700ZY	0	-	0	0	5783	0.0000000
zheyou73v0_A03	32551004	32551759	BnaA03T0555800ZY	0	-	0	0	755	0.0000000
zheyou73v0_A03	32559974	32561060	BnaA03T0555900ZY	0	+	0	0	1086	0.0000000
zheyou73v0_A03	32569352	32572241	BnaA03T0556000ZY	0	-	0	0	2889	0.0000000
zheyou73v0_A03	32576699	32577382	BnaA03T0556100ZY	0	+	0	0	683	0.0000000
zheyou73v0_A03	32577655	32579412	BnaA03T0556200ZY	0	+	0	0	1757	0.0000000
zheyou73v0_A03	32583364	32584704	BnaA03T0556300ZY	0	+	0	0	1340	0.0000000
zheyou73v0_A03	32603278	32604334	BnaA03T0556400ZY	0	+	0	0	1056	0.0000000
zheyou73v0_A03	32609060	32609721	BnaA03T0556500ZY	0	+	0	0	661	0.0000000
zheyou73v0_A03	32610244	32617376	BnaA03T0556600ZY	0	-	0	0	7132	0.0000000
zheyou73v0_A03	32617541	32628703	BnaA03T0556700ZY	0	+	0	0	11162	0.0000000
zheyou73v0_A03	32633402	32634922	BnaA03T0556800ZY	0	+	0	0	1520	0.0000000
zheyou73v0_A03	32636840	32638287	BnaA03T0556900ZY	0	-	0	0	1447	0.0000000
zheyou73v0_A03	32645584	32646746	BnaA03T0557000ZY	0	+	0	0	1162	0.0000000
zheyou73v0_A03	32648063	32649624	BnaA03T0557100ZY	0	+	0	0	1561	0.0000000
zheyou73v0_A03	32658374	32661521	BnaA03T0557200ZY	0	-	0	0	3147	0.0000000
zheyou73v0_A03	32672242	32675547	BnaA03T0557300ZY	0	-	0	0	3305	0.0000000
zheyou73v0_A03	32675897	32678482	BnaA03T0557400ZY	0	-	0	0	2585	0.0000000
zheyou73v0_A03	32682324	32682910	BnaA03T0557500ZY	0	-	0	0	586	0.0000000
zheyou73v0_A03	32694072	32694390	BnaA03T0557600ZY	0	+	0	0	318	0.0000000
zheyou73v0_A03	32704506	32707139	BnaA03T0557700ZY	0	+	0	0	2633	0.0000000
zheyou73v0_A03	32715248	32719985	BnaA03T0557800ZY	0	+	0	0	4737	0.0000000
zheyou73v0_A03	32725774	32727320	BnaA03T0557900ZY	0	+	0	0	1546	0.0000000
zheyou73v0_A03	32727511	32728055	BnaA03T0558000ZY	0	-	0	0	544	0.0000000
zheyou73v0_A03	32735419	32735674	BnaA03T0558100ZY	0	+	0	0	255	0.0000000
zheyou73v0_A03	32742711	32745015	BnaA03T0558200ZY	0	-	0	0	2304	0.0000000
zheyou73v0_A03	32747732	32748614	BnaA03T0558300ZY	0	-	0	0	882	0.0000000
zheyou73v0_A03	32755322	32757493	BnaA03T0558400ZY	0	-	0	0	2171	0.0000000
zheyou73v0_A03	32755322	32757493	BnaA03T0558400ZY.1	0	-	0	0	2171	0.0000000
zheyou73v0_A03	32757710	32762179	BnaA03T0558500ZY.1	0	-	0	0	4469	0.0000000
zheyou73v0_A03	32757767	32762179	BnaA03T0558500ZY	0	-	0	0	4412	0.0000000
zheyou73v0_A03	32764661	32766917	BnaA03T0558600ZY	0	-	0	0	2256	0.0000000
zheyou73v0_A03	32770936	32771562	BnaA03T0558700ZY	0	+	0	0	626	0.0000000
zheyou73v0_A03	32788323	32789240	BnaA03T0558800ZY	0	+	0	0	917	0.0000000
zheyou73v0_A03	32796972	32798241	BnaA03T0558900ZY	0	-	0	0	1269	0.0000000
zheyou73v0_A03	32801073	32803711	BnaA03T0559000ZY	0	-	0	0	2638	0.0000000
zheyou73v0_A03	32801073	32803711	BnaA03T0559000ZY.1	0	-	0	0	2638	0.0000000
zheyou73v0_A03	32819058	32820962	BnaA03T0559100ZY	0	+	0	0	1904	0.0000000
zheyou73v0_A03	32822053	32823265	BnaA03T0559200ZY	0	-	0	0	1212	0.0000000
zheyou73v0_A03	32824138	32824740	BnaA03T0559300ZY	0	+	0	0	602	0.0000000
zheyou73v0_A03	32826084	32848507	BnaA03T0559400ZY	0	-	0	0	22423	0.0000000
zheyou73v0_A03	32849691	32853232	BnaA03T0559500ZY	0	-	0	0	3541	0.0000000
zheyou73v0_A03	32879430	32881045	BnaA03T0559600ZY	0	+	0	0	1615	0.0000000
zheyou73v0_A03	32879430	32881045	BnaA03T0559600ZY.1	0	+	0	0	1615	0.0000000
zheyou73v0_A03	32884069	32886041	BnaA03T0559700ZY	0	-	0	0	1972	0.0000000
zheyou73v0_A03	32901438	32902212	BnaA03T0559800ZY	0	+	0	0	774	0.0000000
zheyou73v0_A03	32914186	32917862	BnaA03T0559900ZY	0	-	0	0	3676	0.0000000
zheyou73v0_A03	32914186	32917393	BnaA03T0559900ZY.1	0	-	0	0	3207	0.0000000
zheyou73v0_A03	32930710	32931761	BnaA03T0560000ZY	0	-	0	0	1051	0.0000000
zheyou73v0_A03	32933560	32935210	BnaA03T0560100ZY	0	+	0	0	1650	0.0000000
zheyou73v0_A03	32935307	32935904	BnaA03T0560200ZY	0	+	0	0	597	0.0000000
zheyou73v0_A03	32938451	32957273	BnaA03T0560300ZY	0	+	0	0	18822	0.0000000
zheyou73v0_A03	32962540	32964655	BnaA03T0560400ZY	0	+	0	0	2115	0.0000000
zheyou73v0_A03	32964684	32966592	BnaA03T0560500ZY	0	+	0	0	1908	0.0000000
zheyou73v0_A03	32975368	32977826	BnaA03T0560600ZY	0	+	0	0	2458	0.0000000
zheyou73v0_A03	32984883	32985717	BnaA03T0560700ZY	0	-	0	0	834	0.0000000
zheyou73v0_A03	32995035	32995350	BnaA03T0560800ZY	0	+	0	0	315	0.0000000
zheyou73v0_A03	32996783	32997254	BnaA03T0560900ZY	0	+	0	0	471	0.0000000
zheyou73v0_A03	32997760	32999797	BnaA03T0561000ZY	0	+	0	0	2037	0.0000000
zheyou73v0_A03	32997760	32999797	BnaA03T0561000ZY.1	0	+	0	0	2037	0.0000000
zheyou73v0_A03	33001013	33002640	BnaA03T0561100ZY	0	-	0	0	1627	0.0000000
zheyou73v0_A03	33004707	33010608	BnaA03T0561200ZY	0	+	0	0	5901	0.0000000
zheyou73v0_A03	33010845	33012143	BnaA03T0561300ZY	0	-	0	0	1298	0.0000000
zheyou73v0_A03	33012460	33013743	BnaA03T0561400ZY	0	-	0	0	1283	0.0000000
zheyou73v0_A03	33032458	33038071	BnaA03T0561500ZY	0	+	0	0	5613	0.0000000
zheyou73v0_A03	33038419	33040232	BnaA03T0561600ZY	0	-	0	0	1813	0.0000000
zheyou73v0_A03	33043374	33045859	BnaA03T0561700ZY	0	+	0	0	2485	0.0000000
zheyou73v0_A03	33046607	33049049	BnaA03T0561800ZY	0	+	0	0	2442	0.0000000
zheyou73v0_A03	33080525	33080774	BnaA03T0561900ZY	0	-	0	0	249	0.0000000
zheyou73v0_A03	33081182	33081653	BnaA03T0562000ZY	0	-	0	0	471	0.0000000
zheyou73v0_A03	33084705	33086808	BnaA03T0562100ZY	0	+	0	0	2103	0.0000000
zheyou73v0_A03	33089310	33090156	BnaA03T0562200ZY	0	+	0	0	846	0.0000000
zheyou73v0_A03	33101896	33103078	BnaA03T0562300ZY	0	-	0	0	1182	0.0000000
zheyou73v0_A03	33106941	33113266	BnaA03T0562400ZY	0	+	0	0	6325	0.0000000
zheyou73v0_A03	33115240	33116426	BnaA03T0562500ZY	0	+	0	0	1186	0.0000000
zheyou73v0_A03	33128811	33133518	BnaA03T0562600ZY	0	+	0	0	4707	0.0000000
zheyou73v0_A03	33137026	33137454	BnaA03T0562700ZY	0	-	0	0	428	0.0000000
zheyou73v0_A03	33147828	33151540	BnaA03T0562800ZY	0	-	0	0	3712	0.0000000
zheyou73v0_A03	33156168	33157320	BnaA03T0562900ZY	0	+	0	0	1152	0.0000000
zheyou73v0_A03	33172527	33173909	BnaA03T0563000ZY	0	+	0	0	1382	0.0000000
zheyou73v0_A03	33172527	33173909	BnaA03T0563000ZY.1	0	+	0	0	1382	0.0000000
zheyou73v0_A03	33174237	33175853	BnaA03T0563100ZY	0	-	0	0	1616	0.0000000
zheyou73v0_A03	33174237	33175853	BnaA03T0563100ZY.1	0	-	0	0	1616	0.0000000
zheyou73v0_A03	33179402	33182057	BnaA03T0563200ZY	0	+	0	0	2655	0.0000000
zheyou73v0_A03	33185484	33186774	BnaA03T0563300ZY	0	+	0	0	1290	0.0000000
zheyou73v0_A03	33187965	33188758	BnaA03T0563400ZY	0	-	0	0	793	0.0000000
zheyou73v0_A03	33189448	33191815	BnaA03T0563500ZY	0	-	0	0	2367	0.0000000
zheyou73v0_A03	33196585	33197707	BnaA03T0563600ZY	0	+	0	0	1122	0.0000000
zheyou73v0_A03	33198425	33200260	BnaA03T0563700ZY	0	+	0	0	1835	0.0000000
zheyou73v0_A03	33203765	33206370	BnaA03T0563800ZY	0	-	0	0	2605	0.0000000
zheyou73v0_A03	33208018	33209049	BnaA03T0563900ZY	0	-	0	0	1031	0.0000000
zheyou73v0_A03	33214072	33216462	BnaA03T0564000ZY	0	-	0	0	2390	0.0000000
zheyou73v0_A03	33219858	33220701	BnaA03T0564100ZY	0	-	0	0	843	0.0000000
zheyou73v0_A03	33227401	33230412	BnaA03T0564200ZY	0	+	0	0	3011	0.0000000
zheyou73v0_A03	33227401	33230412	BnaA03T0564200ZY.1	0	+	0	0	3011	0.0000000
zheyou73v0_A03	33230740	33233446	BnaA03T0564300ZY	0	-	0	0	2706	0.0000000
zheyou73v0_A03	33237706	33238006	BnaA03T0564400ZY	0	+	0	0	300	0.0000000
zheyou73v0_A03	33244228	33245796	BnaA03T0564500ZY	0	+	0	0	1568	0.0000000
zheyou73v0_A03	33250817	33252837	BnaA03T0564600ZY	0	-	0	0	2020	0.0000000
zheyou73v0_A03	33257958	33261188	BnaA03T0564700ZY	0	+	0	0	3230	0.0000000
zheyou73v0_A03	33270726	33275352	BnaA03T0564800ZY	0	-	0	0	4626	0.0000000
zheyou73v0_A03	33300316	33302868	BnaA03T0564900ZY	0	+	0	0	2552	0.0000000
zheyou73v0_A03	33300316	33302868	BnaA03T0564900ZY.1	0	+	0	0	2552	0.0000000
zheyou73v0_A03	33305125	33306543	BnaA03T0565000ZY	0	-	0	0	1418	0.0000000
zheyou73v0_A03	33312333	33314072	BnaA03T0565100ZY	0	-	0	0	1739	0.0000000
zheyou73v0_A03	33314460	33318894	BnaA03T0565200ZY	0	-	0	0	4434	0.0000000
zheyou73v0_A03	33318928	33319867	BnaA03T0565300ZY	0	-	0	0	939	0.0000000
zheyou73v0_A03	33322097	33328473	BnaA03T0565400ZY	0	-	0	0	6376	0.0000000
zheyou73v0_A03	33330742	33334561	BnaA03T0565500ZY	0	-	0	0	3819	0.0000000
zheyou73v0_A03	33338956	33339291	BnaA03T0565600ZY	0	+	0	0	335	0.0000000
zheyou73v0_A03	33358245	33363047	BnaA03T0565700ZY	0	-	0	0	4802	0.0000000
zheyou73v0_A03	33358896	33363047	BnaA03T0565700ZY.1	0	-	0	0	4151	0.0000000
zheyou73v0_A03	33359782	33363047	BnaA03T0565700ZY.2	0	-	0	0	3265	0.0000000
zheyou73v0_A03	33365213	33365611	BnaA03T0565800ZY	0	-	0	0	398	0.0000000
zheyou73v0_A03	33368115	33371855	BnaA03T0565900ZY	0	+	0	0	3740	0.0000000
zheyou73v0_A03	33368115	33372265	BnaA03T0565900ZY.1	0	+	0	0	4150	0.0000000
zheyou73v0_A03	33372532	33373529	BnaA03T0566000ZY	0	+	0	0	997	0.0000000
zheyou73v0_A03	33374871	33375387	BnaA03T0566100ZY	0	-	0	0	516	0.0000000
zheyou73v0_A03	33375956	33376482	BnaA03T0566200ZY	0	-	0	0	526	0.0000000
zheyou73v0_A03	33378114	33380948	BnaA03T0566300ZY	0	-	0	0	2834	0.0000000
zheyou73v0_A03	33383546	33385235	BnaA03T0566400ZY	0	+	0	0	1689	0.0000000
zheyou73v0_A03	33385561	33386122	BnaA03T0566500ZY	0	-	0	0	561	0.0000000
zheyou73v0_A03	33408284	33409380	BnaA03T0566600ZY	0	+	0	0	1096	0.0000000
zheyou73v0_A03	33426355	33428130	BnaA03T0566700ZY	0	-	0	0	1775	0.0000000
zheyou73v0_A03	33432171	33433099	BnaA03T0566800ZY	0	-	0	0	928	0.0000000
zheyou73v0_A03	33444997	33449117	BnaA03T0566900ZY	0	-	0	0	4120	0.0000000
zheyou73v0_A03	33449610	33451443	BnaA03T0567000ZY	0	-	0	0	1833	0.0000000
zheyou73v0_A03	33455379	33457500	BnaA03T0567100ZY	0	-	0	0	2121	0.0000000
zheyou73v0_A03	33457745	33458774	BnaA03T0567200ZY	0	-	0	0	1029	0.0000000
zheyou73v0_A03	33458984	33460895	BnaA03T0567300ZY	0	-	0	0	1911	0.0000000
zheyou73v0_A03	33467074	33468716	BnaA03T0567400ZY	0	-	0	0	1642	0.0000000
zheyou73v0_A03	33475103	33475937	BnaA03T0567500ZY	0	+	0	0	834	0.0000000
zheyou73v0_A03	33476111	33476609	BnaA03T0567600ZY	0	+	0	0	498	0.0000000
zheyou73v0_A03	33491390	33493450	BnaA03T0567700ZY	0	+	0	0	2060	0.0000000
zheyou73v0_A03	33495164	33495592	BnaA03T0567800ZY	0	+	0	0	428	0.0000000
zheyou73v0_A03	33496161	33496491	BnaA03T0567900ZY	0	-	0	0	330	0.0000000
zheyou73v0_A03	33502374	33505430	BnaA03T0568000ZY	0	+	0	0	3056	0.0000000
zheyou73v0_A03	33505891	33510006	BnaA03T0568100ZY	0	-	0	0	4115	0.0000000
zheyou73v0_A03	33517112	33518478	BnaA03T0568200ZY	0	+	0	0	1366	0.0000000
zheyou73v0_A03	33527333	33530562	BnaA03T0568300ZY	0	+	0	0	3229	0.0000000
zheyou73v0_A03	33543456	33546956	BnaA03T0568400ZY	0	-	0	0	3500	0.0000000
zheyou73v0_A03	33561388	33563177	BnaA03T0568500ZY	0	+	0	0	1789	0.0000000
zheyou73v0_A03	33563803	33565343	BnaA03T0568600ZY	0	-	0	0	1540	0.0000000
zheyou73v0_A03	33572512	33573356	BnaA03T0568700ZY	0	-	0	0	844	0.0000000
zheyou73v0_A03	33576864	33577173	BnaA03T0568800ZY	0	+	0	0	309	0.0000000
zheyou73v0_A03	33581310	33583133	BnaA03T0568900ZY	0	+	0	0	1823	0.0000000
zheyou73v0_A03	33595283	33596246	BnaA03T0569000ZY	0	+	0	0	963	0.0000000
zheyou73v0_A03	33616265	33616845	BnaA03T0569100ZY	0	-	0	0	580	0.0000000
zheyou73v0_A03	33618570	33619879	BnaA03T0569200ZY	0	-	0	0	1309	0.0000000
zheyou73v0_A03	33620562	33625753	BnaA03T0569300ZY	0	+	0	0	5191	0.0000000
zheyou73v0_A03	33636377	33638573	BnaA03T0569400ZY	0	-	0	0	2196	0.0000000
zheyou73v0_A03	33645983	33647208	BnaA03T0569500ZY	0	-	0	0	1225	0.0000000
zheyou73v0_A03	33654267	33656669	BnaA03T0569600ZY	0	+	0	0	2402	0.0000000
zheyou73v0_A03	33658111	33658451	BnaA03T0569700ZY	0	+	0	0	340	0.0000000
zheyou73v0_A03	33670158	33675492	BnaA03T0569800ZY	0	+	0	0	5334	0.0000000
zheyou73v0_A03	33681720	33684141	BnaA03T0569900ZY	0	+	0	0	2421	0.0000000
zheyou73v0_A03	33692025	33694186	BnaA03T0570000ZY	0	+	0	0	2161	0.0000000
zheyou73v0_A03	33696088	33697188	BnaA03T0570100ZY	0	-	0	0	1100	0.0000000
zheyou73v0_A03	33698511	33698913	BnaA03T0570200ZY	0	+	0	0	402	0.0000000
zheyou73v0_A03	33705649	33707017	BnaA03T0570300ZY	0	-	0	0	1368	0.0000000
zheyou73v0_A03	33709300	33710727	BnaA03T0570400ZY	0	+	0	0	1427	0.0000000
zheyou73v0_A03	33710928	33741358	BnaA03T0570500ZY	0	-	0	0	30430	0.0000000
zheyou73v0_A03	33749626	33750061	BnaA03T0570600ZY	0	+	0	0	435	0.0000000
zheyou73v0_A03	33762519	33765162	BnaA03T0570700ZY	0	+	0	0	2643	0.0000000
zheyou73v0_A03	33768675	33773224	BnaA03T0570800ZY	0	-	0	0	4549	0.0000000
zheyou73v0_A03	33777066	33777700	BnaA03T0570900ZY	0	+	0	0	634	0.0000000
zheyou73v0_A03	33778082	33781513	BnaA03T0571000ZY	0	-	0	0	3431	0.0000000
zheyou73v0_A03	33778082	33781513	BnaA03T0571000ZY.1	0	-	0	0	3431	0.0000000
zheyou73v0_A03	33792415	33795055	BnaA03T0571100ZY	0	-	0	0	2640	0.0000000
zheyou73v0_A03	33792415	33795055	BnaA03T0571100ZY.1	0	-	0	0	2640	0.0000000
zheyou73v0_A03	33792415	33795055	BnaA03T0571100ZY.2	0	-	0	0	2640	0.0000000
zheyou73v0_A03	33804585	33807105	BnaA03T0571200ZY	0	+	0	0	2520	0.0000000
zheyou73v0_A03	33807427	33808393	BnaA03T0571300ZY	0	-	0	0	966	0.0000000
zheyou73v0_A03	33813882	33814600	BnaA03T0571400ZY	0	-	0	0	718	0.0000000
zheyou73v0_A03	33841552	33842526	BnaA03T0571500ZY	0	+	0	0	974	0.0000000
zheyou73v0_A03	33845014	33845272	BnaA03T0571600ZY	0	-	0	0	258	0.0000000
zheyou73v0_A03	33850360	33850615	BnaA03T0571700ZY	0	+	0	0	255	0.0000000
zheyou73v0_A03	33851505	33858827	BnaA03T0571800ZY	0	+	0	0	7322	0.0000000
zheyou73v0_A03	33859731	33862176	BnaA03T0571900ZY	0	-	0	0	2445	0.0000000
zheyou73v0_A03	33867306	33869788	BnaA03T0572000ZY	0	-	0	0	2482	0.0000000
zheyou73v0_A03	33870161	33872565	BnaA03T0572100ZY	0	-	0	0	2404	0.0000000
zheyou73v0_A03	33873208	33874054	BnaA03T0572200ZY	0	-	0	0	846	0.0000000
zheyou73v0_A03	33879617	33880818	BnaA03T0572300ZY	0	-	0	0	1201	0.0000000
zheyou73v0_A03	33882506	33884682	BnaA03T0572400ZY	0	-	0	0	2176	0.0000000
zheyou73v0_A03	33885752	33887083	BnaA03T0572500ZY	0	-	0	0	1331	0.0000000
zheyou73v0_A03	33891000	33896850	BnaA03T0572600ZY	0	+	0	0	5850	0.0000000
zheyou73v0_A03	33897044	33899241	BnaA03T0572700ZY	0	+	0	0	2197	0.0000000
zheyou73v0_A03	33899462	33900453	BnaA03T0572800ZY	0	+	0	0	991	0.0000000
zheyou73v0_A03	33903839	33904040	BnaA03T0572900ZY	0	-	0	0	201	0.0000000
zheyou73v0_A03	33906612	33908419	BnaA03T0573000ZY	0	+	0	0	1807	0.0000000
zheyou73v0_A03	33916351	33916914	BnaA03T0573100ZY	0	-	0	0	563	0.0000000
zheyou73v0_A03	33921907	33923114	BnaA03T0573200ZY	0	-	0	0	1207	0.0000000
zheyou73v0_A03	33928908	33929802	BnaA03T0573300ZY	0	-	0	0	894	0.0000000
zheyou73v0_A03	33939077	33939992	BnaA03T0573400ZY	0	-	0	0	915	0.0000000
zheyou73v0_A03	33970809	33972832	BnaA03T0573500ZY	0	+	0	0	2023	0.0000000
zheyou73v0_A03	33983222	33985226	BnaA03T0573600ZY	0	-	0	0	2004	0.0000000
zheyou73v0_A03	33986780	33989603	BnaA03T0573700ZY	0	+	0	0	2823	0.0000000
zheyou73v0_A03	33989776	33991417	BnaA03T0573800ZY	0	-	0	0	1641	0.0000000
zheyou73v0_A03	33994819	34001650	BnaA03T0573900ZY	0	+	0	0	6831	0.0000000
zheyou73v0_A03	34004890	34006137	BnaA03T0574000ZY	0	+	0	0	1247	0.0000000
zheyou73v0_A03	34043311	34045135	BnaA03T0574100ZY	0	+	0	0	1824	0.0000000
zheyou73v0_A03	34046792	34052937	BnaA03T0574200ZY	0	-	0	0	6145	0.0000000
zheyou73v0_A03	34061865	34063793	BnaA03T0574300ZY	0	+	0	0	1928	0.0000000
zheyou73v0_A03	34065570	34066065	BnaA03T0574400ZY	0	+	0	0	495	0.0000000
zheyou73v0_A03	34066035	34068602	BnaA03T0574500ZY	0	-	0	0	2567	0.0000000
zheyou73v0_A03	34075010	34078309	BnaA03T0574600ZY	0	+	0	0	3299	0.0000000
zheyou73v0_A03	34075164	34078309	BnaA03T0574600ZY.1	0	+	0	0	3145	0.0000000
zheyou73v0_A03	34084562	34085980	BnaA03T0574700ZY	0	+	0	0	1418	0.0000000
zheyou73v0_A03	34086842	34087331	BnaA03T0574800ZY	0	-	0	0	489	0.0000000
zheyou73v0_A03	34098246	34098701	BnaA03T0574900ZY	0	-	0	0	455	0.0000000
zheyou73v0_A03	34104111	34104855	BnaA03T0575000ZY	0	+	0	0	744	0.0000000
zheyou73v0_A03	34105455	34107551	BnaA03T0575100ZY	0	-	0	0	2096	0.0000000
zheyou73v0_A03	34149520	34150009	BnaA03T0575200ZY	0	+	0	0	489	0.0000000
zheyou73v0_A03	34151022	34153039	BnaA03T0575300ZY	0	+	0	0	2017	0.0000000
zheyou73v0_A03	34151022	34153039	BnaA03T0575300ZY.1	0	+	0	0	2017	0.0000000
zheyou73v0_A03	34151022	34153039	BnaA03T0575300ZY.2	0	+	0	0	2017	0.0000000
zheyou73v0_A03	34151022	34153039	BnaA03T0575300ZY.3	0	+	0	0	2017	0.0000000
zheyou73v0_A03	34151022	34153039	BnaA03T0575300ZY.4	0	+	0	0	2017	0.0000000
zheyou73v0_A03	34151022	34153039	BnaA03T0575300ZY.5	0	+	0	0	2017	0.0000000
zheyou73v0_A03	34151022	34153039	BnaA03T0575300ZY.6	0	+	0	0	2017	0.0000000
zheyou73v0_A03	34169591	34172482	BnaA03T0575400ZY	0	+	0	0	2891	0.0000000
zheyou73v0_A03	34194055	34194837	BnaA03T0575500ZY	0	+	0	0	782	0.0000000
zheyou73v0_A03	34210750	34212343	BnaA03T0575600ZY	0	+	0	0	1593	0.0000000
zheyou73v0_A03	34214061	34215119	BnaA03T0575700ZY	0	+	0	0	1058	0.0000000
zheyou73v0_A03	34235175	34237104	BnaA03T0575800ZY	0	-	0	0	1929	0.0000000
zheyou73v0_A03	34235175	34237104	BnaA03T0575800ZY.1	0	-	0	0	1929	0.0000000
zheyou73v0_A03	34262707	34263507	BnaA03T0575900ZY	0	+	0	0	800	0.0000000
zheyou73v0_A03	34265772	34266022	BnaA03T0576000ZY	0	+	0	0	250	0.0000000
zheyou73v0_A03	34278648	34280796	BnaA03T0576100ZY	0	-	0	0	2148	0.0000000
zheyou73v0_A03	34294833	34298841	BnaA03T0576200ZY	0	-	0	0	4008	0.0000000
zheyou73v0_A03	34309501	34309933	BnaA03T0576300ZY	0	+	0	0	432	0.0000000
zheyou73v0_A03	34309941	34312806	BnaA03T0576400ZY	0	+	0	0	2865	0.0000000
zheyou73v0_A03	34335414	34335807	BnaA03T0576500ZY	0	+	0	0	393	0.0000000
zheyou73v0_A03	34338383	34340111	BnaA03T0576600ZY	0	+	0	0	1728	0.0000000
zheyou73v0_A03	34358125	34360500	BnaA03T0576700ZY	0	-	0	0	2375	0.0000000
zheyou73v0_A03	34362895	34364246	BnaA03T0576800ZY	0	-	0	0	1351	0.0000000
zheyou73v0_A03	34365377	34367422	BnaA03T0576900ZY	0	-	0	0	2045	0.0000000
zheyou73v0_A03	34376250	34378106	BnaA03T0577000ZY	0	-	0	0	1856	0.0000000
zheyou73v0_A03	34380515	34381733	BnaA03T0577100ZY	0	-	0	0	1218	0.0000000
zheyou73v0_A03	34382146	34382684	BnaA03T0577200ZY	0	-	0	0	538	0.0000000
zheyou73v0_A03	34384350	34385883	BnaA03T0577300ZY	0	-	0	0	1533	0.0000000
zheyou73v0_A03	34386556	34387081	BnaA03T0577400ZY	0	-	0	0	525	0.0000000
zheyou73v0_A03	34387355	34389392	BnaA03T0577500ZY	0	-	0	0	2037	0.0000000
zheyou73v0_A03	34387355	34389167	BnaA03T0577500ZY.1	0	-	0	0	1812	0.0000000
zheyou73v0_A03	34417093	34418326	BnaA03T0577600ZY	0	-	0	0	1233	0.0000000
zheyou73v0_A03	34420050	34420656	BnaA03T0577700ZY	0	-	0	0	606	0.0000000
zheyou73v0_A03	34442139	34444774	BnaA03T0577800ZY	0	-	0	0	2635	0.0000000
zheyou73v0_A03	34464068	34465426	BnaA03T0577900ZY	0	+	0	0	1358	0.0000000
zheyou73v0_A03	34482277	34482808	BnaA03T0578000ZY	0	-	0	0	531	0.0000000
zheyou73v0_A03	34513517	34532366	BnaA03T0578100ZY	0	-	0	0	18849	0.0000000
zheyou73v0_A03	34581633	34582411	BnaA03T0578200ZY	0	-	0	0	778	0.0000000
zheyou73v0_A03	34630487	34630703	BnaA03T0578300ZY	0	-	0	0	216	0.0000000
zheyou73v0_A03	34634359	34635065	BnaA03T0578400ZY	0	+	0	0	706	0.0000000
zheyou73v0_A03	34641122	34644857	BnaA03T0578500ZY	0	+	0	0	3735	0.0000000
zheyou73v0_A03	34641122	34644857	BnaA03T0578500ZY.1	0	+	0	0	3735	0.0000000
zheyou73v0_A03	34647169	34649217	BnaA03T0578600ZY	0	+	0	0	2048	0.0000000
zheyou73v0_A03	34649714	34652411	BnaA03T0578700ZY	0	-	0	0	2697	0.0000000
zheyou73v0_A03	34654210	34660280	BnaA03T0578800ZY	0	-	0	0	6070	0.0000000
zheyou73v0_A03	34676490	34678228	BnaA03T0578900ZY	0	-	0	0	1738	0.0000000
zheyou73v0_A03	34680684	34684957	BnaA03T0579000ZY	0	-	0	0	4273	0.0000000
zheyou73v0_A03	34692715	34700923	BnaA03T0579100ZY	0	-	0	0	8208	0.0000000
zheyou73v0_A03	34720570	34720723	BnaA03T0579200ZY	0	-	0	0	153	0.0000000
zheyou73v0_A03	34734352	34735212	BnaA03T0579300ZY	0	+	0	0	860	0.0000000
zheyou73v0_A03	34738002	34738747	BnaA03T0579400ZY	0	+	0	0	745	0.0000000
zheyou73v0_A03	34748098	34748355	BnaA03T0579500ZY	0	+	0	0	257	0.0000000
zheyou73v0_A03	34764976	34766997	BnaA03T0579600ZY	0	+	0	0	2021	0.0000000
zheyou73v0_A03	34782450	34790972	BnaA03T0579700ZY	0	-	0	0	8522	0.0000000
zheyou73v0_A03	34792303	34794055	BnaA03T0579800ZY	0	-	0	0	1752	0.0000000
zheyou73v0_A03	34792303	34794055	BnaA03T0579800ZY.1	0	-	0	0	1752	0.0000000
zheyou73v0_A03	34799316	34806845	BnaA03T0579900ZY	0	-	0	0	7529	0.0000000
zheyou73v0_A03	34881079	34884370	BnaA03T0580000ZY	0	+	0	0	3291	0.0000000
zheyou73v0_A03	34887711	34890534	BnaA03T0580100ZY	0	+	0	0	2823	0.0000000
zheyou73v0_A03	34901319	34902527	BnaA03T0580200ZY	0	+	0	0	1208	0.0000000
zheyou73v0_A03	34913231	34919426	BnaA03T0580300ZY	0	+	0	0	6195	0.0000000
zheyou73v0_A03	34963661	34964173	BnaA03T0580400ZY	0	+	0	0	512	0.0000000
zheyou73v0_A03	34975003	34975372	BnaA03T0580500ZY	0	-	0	0	369	0.0000000
zheyou73v0_A03	34977887	34994213	BnaA03T0580600ZY	0	-	0	0	16326	0.0000000
zheyou73v0_A03	35015284	35038159	BnaA03T0580700ZY	0	+	0	0	22875	0.0000000
zheyou73v0_A03	35043885	35044320	BnaA03T0580800ZY	0	+	0	0	435	0.0000000
zheyou73v0_A03	35141981	35142359	BnaA03T0580900ZY	0	+	0	0	378	0.0000000
zheyou73v0_A03	35156817	35159386	BnaA03T0581000ZY	0	-	0	0	2569	0.0000000
zheyou73v0_A03	35199056	35199635	BnaA03T0581100ZY	0	-	0	0	579	0.0000000
zheyou73v0_A03	35221502	35221940	BnaA03T0581200ZY	0	+	0	0	438	0.0000000
zheyou73v0_A03	35273389	35274367	BnaA03T0581300ZY	0	-	0	0	978	0.0000000
zheyou73v0_A03	35275520	35283622	BnaA03T0581400ZY	0	+	0	0	8102	0.0000000
zheyou73v0_A03	35288941	35290909	BnaA03T0581500ZY	0	+	0	0	1968	0.0000000
zheyou73v0_A03	35318369	35319155	BnaA03T0581600ZY	0	-	0	0	786	0.0000000
zheyou73v0_A03	35324285	35326257	BnaA03T0581700ZY	0	-	0	0	1972	0.0000000
zheyou73v0_A03	35326397	35336478	BnaA03T0581800ZY	0	-	0	0	10081	0.0000000
zheyou73v0_A03	35400585	35401146	BnaA03T0581900ZY	0	+	0	0	561	0.0000000
zheyou73v0_A03	35403755	35404151	BnaA03T0582000ZY	0	+	0	0	396	0.0000000
zheyou73v0_A03	35438271	35439537	BnaA03T0582100ZY	0	+	0	0	1266	0.0000000
zheyou73v0_A03	35441177	35455377	BnaA03T0582200ZY	0	-	0	0	14200	0.0000000
zheyou73v0_A03	35477459	35479891	BnaA03T0582300ZY	0	-	0	0	2432	0.0000000
zheyou73v0_A03	35483533	35484305	BnaA03T0582400ZY	0	+	0	0	772	0.0000000
zheyou73v0_A03	35515842	35516421	BnaA03T0582500ZY	0	-	0	0	579	0.0000000
zheyou73v0_A03	35647316	35648410	BnaA03T0582600ZY	0	-	0	0	1094	0.0000000
zheyou73v0_A03	35651405	35656368	BnaA03T0582700ZY	0	-	0	0	4963	0.0000000
zheyou73v0_A03	35651405	35656368	BnaA03T0582700ZY.1	0	-	0	0	4963	0.0000000
zheyou73v0_A03	35708345	35708985	BnaA03T0582800ZY	0	+	0	0	640	0.0000000
zheyou73v0_A03	35849257	35853516	BnaA03T0582900ZY	0	-	0	0	4259	0.0000000
zheyou73v0_A03	35853808	35855715	BnaA03T0583000ZY	0	+	0	0	1907	0.0000000
zheyou73v0_A03	36181585	36182184	BnaA03T0583100ZY	0	-	0	0	599	0.0000000
zheyou73v0_A03	36185608	36186186	BnaA03T0583200ZY	0	-	0	0	578	0.0000000
zheyou73v0_A03	36186515	36193337	BnaA03T0583300ZY	0	+	0	0	6822	0.0000000
zheyou73v0_A03	36193737	36196011	BnaA03T0583400ZY	0	-	0	0	2274	0.0000000
zheyou73v0_A03	36196298	36197564	BnaA03T0583500ZY	0	+	0	0	1266	0.0000000
zheyou73v0_A03	37410313	37410670	BnaA03T0583600ZY	0	+	0	0	357	0.0000000
zheyou73v0_A03	41404602	41405668	BnaA03T0583700ZY	0	-	0	0	1066	0.0000000
zheyou73v0_A03	41412154	41413727	BnaA03T0583800ZY	0	-	0	0	1573	0.0000000
zheyou73v0_A03	41418714	41420009	BnaA03T0583900ZY	0	+	0	0	1295	0.0000000
zheyou73v0_A03	41550579	41551731	BnaA03T0584000ZY	0	+	0	0	1152	0.0000000
zheyou73v0_A03	41559916	41561322	BnaA03T0584100ZY	0	-	0	0	1406	0.0000000
zheyou73v0_A03	41562019	41562741	BnaA03T0584200ZY	0	+	0	0	722	0.0000000
zheyou73v0_A03	41646652	41651021	BnaA03T0584300ZY	0	+	0	0	4369	0.0000000
zheyou73v0_A03	41653344	41653969	BnaA03T0584400ZY	0	+	0	0	625	0.0000000
zheyou73v0_A03	41775360	41783514	BnaA03T0584500ZY	0	-	0	0	8154	0.0000000
zheyou73v0_A03	41874198	41875424	BnaA03T0584600ZY	0	+	0	0	1226	0.0000000
zheyou73v0_A03	41955959	41956550	BnaA03T0584700ZY	0	-	0	0	591	0.0000000
zheyou73v0_A03	42045555	42045942	BnaA03T0584800ZY	0	+	0	0	387	0.0000000
zheyou73v0_A03	42062406	42064010	BnaA03T0584900ZY	0	+	0	0	1604	0.0000000
zheyou73v0_A03	42128012	42130160	BnaA03T0585000ZY	0	+	0	0	2148	0.0000000
zheyou73v0_A03	42141569	42145121	BnaA03T0585100ZY	0	-	0	0	3552	0.0000000
zheyou73v0_A03	42141569	42144137	BnaA03T0585100ZY.1	0	-	0	0	2568	0.0000000
zheyou73v0_A03	42141569	42144137	BnaA03T0585100ZY.2	0	-	0	0	2568	0.0000000
zheyou73v0_A03	42249622	42265803	BnaA03T0585200ZY	0	+	0	0	16181	0.0000000
zheyou73v0_A03	42287476	42287965	BnaA03T0585300ZY	0	-	0	0	489	0.0000000
zheyou73v0_A03	42333251	42333728	BnaA03T0585400ZY	0	-	0	0	477	0.0000000
zheyou73v0_A03	43143468	43149385	BnaA03T0585500ZY	0	+	0	0	5917	0.0000000
zheyou73v0_A03	43143468	43147815	BnaA03T0585500ZY.1	0	+	0	0	4347	0.0000000
zheyou73v0_A03	43214091	43214246	BnaA03T0585600ZY	0	+	0	0	155	0.0000000
zheyou73v0_A03	43282207	43300770	BnaA03T0585700ZY	0	-	0	0	18563	0.0000000
zheyou73v0_A03	43313743	43315346	BnaA03T0585800ZY	0	+	0	0	1603	0.0000000
zheyou73v0_A03	43313743	43315346	BnaA03T0585800ZY.1	0	+	0	0	1603	0.0000000
zheyou73v0_A03	43313743	43315346	BnaA03T0585800ZY.2	0	+	0	0	1603	0.0000000
zheyou73v0_A03	43338879	43339738	BnaA03T0585900ZY	0	+	0	0	859	0.0000000
zheyou73v0_A03	43349019	43352750	BnaA03T0586000ZY	0	+	0	0	3731	0.0000000
zheyou73v0_A03	43377735	43379440	BnaA03T0586100ZY	0	+	0	0	1705	0.0000000
zheyou73v0_A03	43428589	43429025	BnaA03T0586200ZY	0	+	0	0	436	0.0000000
zheyou73v0_A03	43432704	43443919	BnaA03T0586300ZY	0	-	0	0	11215	0.0000000
zheyou73v0_A03	43443992	43451679	BnaA03T0586400ZY	0	-	0	0	7687	0.0000000
zheyou73v0_A03	43481656	43484754	BnaA03T0586500ZY	0	-	0	0	3098	0.0000000
zheyou73v0_A03	43489938	43490429	BnaA03T0586600ZY	0	-	0	0	491	0.0000000
zheyou73v0_A03	43494790	43496288	BnaA03T0586700ZY	0	-	0	0	1498	0.0000000
zheyou73v0_A03	43497921	43498892	BnaA03T0586800ZY	0	+	0	0	971	0.0000000
zheyou73v0_A03	43499815	43500249	BnaA03T0586900ZY	0	+	0	0	434	0.0000000
zheyou73v0_A03	43501002	43501348	BnaA03T0587000ZY	0	-	0	0	346	0.0000000
zheyou73v0_A03	43510131	43511351	BnaA03T0587100ZY	0	-	0	0	1220	0.0000000
zheyou73v0_A03	43513534	43515015	BnaA03T0587200ZY	0	+	0	0	1481	0.0000000
zheyou73v0_A03	43531130	43532410	BnaA03T0587300ZY	0	+	0	0	1280	0.0000000
zheyou73v0_A03	43532567	43538451	BnaA03T0587400ZY	0	-	0	0	5884	0.0000000
zheyou73v0_A03	43542820	43544120	BnaA03T0587500ZY	0	-	0	0	1300	0.0000000
zheyou73v0_A03	43545112	43545954	BnaA03T0587600ZY	0	-	0	0	842	0.0000000
zheyou73v0_A03	43547586	43549389	BnaA03T0587700ZY	0	-	0	0	1803	0.0000000
zheyou73v0_A03	43632893	43633529	BnaA03T0587800ZY	0	-	0	0	636	0.0000000
zheyou73v0_A03	43647459	43648425	BnaA03T0587900ZY	0	-	0	0	966	0.0000000
zheyou73v0_A03	43694960	43695411	BnaA03T0588000ZY	0	-	0	0	451	0.0000000
zheyou73v0_A03	43708691	43710213	BnaA03T0588100ZY	0	+	0	0	1522	0.0000000
zheyou73v0_A03	43748486	43760952	BnaA03T0588200ZY	0	+	0	0	12466	0.0000000
zheyou73v0_A03	43761052	43761414	BnaA03T0588300ZY	0	+	0	0	362	0.0000000
zheyou73v0_A03	43794845	43798039	BnaA03T0588400ZY	0	+	0	0	3194	0.0000000
zheyou73v0_A03	43897155	43900010	BnaA03T0588500ZY	0	-	0	0	2855	0.0000000
zheyou73v0_A03	43906194	43907490	BnaA03T0588600ZY	0	+	0	0	1296	0.0000000
zheyou73v0_A03	43915455	43916809	BnaA03T0588700ZY	0	-	0	0	1354	0.0000000
zheyou73v0_A03	43946535	43949300	BnaA03T0588800ZY	0	-	0	0	2765	0.0000000
zheyou73v0_A03	44053268	44058688	BnaA03T0588900ZY	0	+	0	0	5420	0.0000000
zheyou73v0_A03	44085839	44088162	BnaA03T0589000ZY	0	-	0	0	2323	0.0000000
zheyou73v0_A03	44089327	44090818	BnaA03T0589100ZY	0	-	0	0	1491	0.0000000
zheyou73v0_A03	44093493	44095056	BnaA03T0589200ZY	0	-	0	0	1563	0.0000000
zheyou73v0_A03	44095479	44096592	BnaA03T0589300ZY	0	-	0	0	1113	0.0000000
zheyou73v0_A03	44097676	44098038	BnaA03T0589400ZY	0	+	0	0	362	0.0000000
zheyou73v0_A03	44119521	44119782	BnaA03T0589500ZY	0	-	0	0	261	0.0000000
zheyou73v0_A03	44156092	44156764	BnaA03T0589600ZY	0	+	0	0	672	0.0000000
zheyou73v0_A03	44165528	44166983	BnaA03T0589700ZY	0	+	0	0	1455	0.0000000
zheyou73v0_A03	44184025	44184616	BnaA03T0589800ZY	0	-	0	0	591	0.0000000
zheyou73v0_A03	44188318	44188774	BnaA03T0589900ZY	0	-	0	0	456	0.0000000
zheyou73v0_A03	44198597	44200541	BnaA03T0590000ZY	0	-	0	0	1944	0.0000000
zheyou73v0_A03	44206713	44207304	BnaA03T0590100ZY	0	-	0	0	591	0.0000000
zheyou73v0_A03	44221387	44222481	BnaA03T0590200ZY	0	+	0	0	1094	0.0000000
zheyou73v0_A03	44232358	44233585	BnaA03T0590300ZY	0	+	0	0	1227	0.0000000
zheyou73v0_A03	44234490	44234819	BnaA03T0590400ZY	0	-	0	0	329	0.0000000
zheyou73v0_A03	44243824	44245697	BnaA03T0590500ZY	0	+	0	0	1873	0.0000000
zheyou73v0_A03	44250019	44250850	BnaA03T0590600ZY	0	-	0	0	831	0.0000000
zheyou73v0_A03	44355164	44357125	BnaA03T0590700ZY	0	-	0	0	1961	0.0000000
zheyou73v0_A03	44373049	44373445	BnaA03T0590800ZY	0	-	0	0	396	0.0000000
zheyou73v0_A03	44375041	44377350	BnaA03T0590900ZY	0	+	0	0	2309	0.0000000
zheyou73v0_A03	44377400	44378299	BnaA03T0591000ZY	0	+	0	0	899	0.0000000
zheyou73v0_A03	44386335	44387962	BnaA03T0591100ZY	0	-	0	0	1627	0.0000000
zheyou73v0_A03	44397217	44397559	BnaA03T0591200ZY	0	-	0	0	342	0.0000000
zheyou73v0_A03	44409568	44410824	BnaA03T0591300ZY	0	+	0	0	1256	0.0000000
zheyou73v0_A03	44450173	44452180	BnaA03T0591400ZY	0	+	0	0	2007	0.0000000
zheyou73v0_A03	44466098	44466749	BnaA03T0591500ZY	0	+	0	0	651	0.0000000
zheyou73v0_A03	44474056	44476137	BnaA03T0591600ZY	0	-	0	0	2081	0.0000000
zheyou73v0_A03	44483945	44484861	BnaA03T0591700ZY	0	+	0	0	916	0.0000000
zheyou73v0_A03	44511540	44512947	BnaA03T0591800ZY	0	-	0	0	1407	0.0000000
zheyou73v0_A03	44523714	44525682	BnaA03T0591900ZY	0	-	0	0	1968	0.0000000
zheyou73v0_A03	44527363	44528324	BnaA03T0592000ZY	0	-	0	0	961	0.0000000
zheyou73v0_A03	44547961	44548311	BnaA03T0592100ZY	0	-	0	0	350	0.0000000
zheyou73v0_A03	44628269	44631737	BnaA03T0592200ZY	0	-	0	0	3468	0.0000000
zheyou73v0_A03	44658801	44660134	BnaA03T0592300ZY	0	-	0	0	1333	0.0000000
zheyou73v0_A03	44666081	44667236	BnaA03T0592400ZY	0	+	0	0	1155	0.0000000
zheyou73v0_A03	44688529	44689029	BnaA03T0592500ZY	0	-	0	0	500	0.0000000
zheyou73v0_A03	44692638	44692945	BnaA03T0592600ZY	0	+	0	0	307	0.0000000
zheyou73v0_A03	44698083	44698260	BnaA03T0592700ZY	0	-	0	0	177	0.0000000
zheyou73v0_A03	44725402	44728436	BnaA03T0592800ZY	0	+	0	0	3034	0.0000000
zheyou73v0_A03	44741298	44741793	BnaA03T0592900ZY	0	-	0	0	495	0.0000000
zheyou73v0_A03	44784096	44789499	BnaA03T0593000ZY	0	-	0	0	5403	0.0000000
zheyou73v0_A03	44799651	44802487	BnaA03T0593100ZY	0	-	0	0	2836	0.0000000
zheyou73v0_A03	44805701	44805971	BnaA03T0593200ZY	0	+	0	0	270	0.0000000
zheyou73v0_A03	44851998	44853865	BnaA03T0593300ZY	0	-	0	0	1867	0.0000000
zheyou73v0_A03	44931554	44933742	BnaA03T0593400ZY	0	-	0	0	2188	0.0000000
zheyou73v0_A03	44942198	44942357	BnaA03T0593500ZY	0	+	0	0	159	0.0000000
zheyou73v0_A03	44970219	44971600	BnaA03T0593600ZY	0	+	0	0	1381	0.0000000
zheyou73v0_A03	44973838	44974309	BnaA03T0593700ZY	0	+	0	0	471	0.0000000
zheyou73v0_A03	44998238	44999619	BnaA03T0593800ZY	0	+	0	0	1381	0.0000000
zheyou73v0_A03	45029315	45031064	BnaA03T0593900ZY	0	-	0	0	1749	0.0000000
zheyou73v0_A03	45034876	45038658	BnaA03T0594000ZY	0	-	0	0	3782	0.0000000
zheyou73v0_A03	45050408	45051337	BnaA03T0594100ZY	0	-	0	0	929	0.0000000
zheyou73v0_A03	45062872	45067418	BnaA03T0594200ZY	0	-	0	0	4546	0.0000000
zheyou73v0_A03	45068741	45072624	BnaA03T0594300ZY	0	-	0	0	3883	0.0000000
zheyou73v0_A03	45068741	45072624	BnaA03T0594300ZY.1	0	-	0	0	3883	0.0000000
zheyou73v0_A03	45077761	45078007	BnaA03T0594400ZY	0	+	0	0	246	0.0000000
zheyou73v0_A03	45078687	45078864	BnaA03T0594500ZY	0	+	0	0	177	0.0000000
zheyou73v0_A03	45116907	45119629	BnaA03T0594600ZY	0	+	0	0	2722	0.0000000
zheyou73v0_A03	45127361	45132687	BnaA03T0594700ZY	0	-	0	0	5326	0.0000000
zheyou73v0_A03	45186728	45190195	BnaA03T0594800ZY	0	-	0	0	3467	0.0000000
zheyou73v0_A03	45191198	45192038	BnaA03T0594900ZY	0	+	0	0	840	0.0000000
zheyou73v0_A03	45192741	45199738	BnaA03T0595000ZY	0	+	0	0	6997	0.0000000
zheyou73v0_A03	45232071	45233970	BnaA03T0595100ZY	0	+	0	0	1899	0.0000000
zheyou73v0_A03	45248362	45251349	BnaA03T0595200ZY	0	-	0	0	2987	0.0000000
zheyou73v0_A03	45248362	45250990	BnaA03T0595200ZY.1	0	-	0	0	2628	0.0000000
zheyou73v0_A03	45252001	45253262	BnaA03T0595300ZY	0	+	0	0	1261	0.0000000
zheyou73v0_A03	45256563	45257661	BnaA03T0595400ZY	0	+	0	0	1098	0.0000000
zheyou73v0_A03	45259372	45262963	BnaA03T0595500ZY	0	+	0	0	3591	0.0000000
zheyou73v0_A03	45259372	45262963	BnaA03T0595500ZY.1	0	+	0	0	3591	0.0000000
zheyou73v0_A03	45259372	45262963	BnaA03T0595500ZY.2	0	+	0	0	3591	0.0000000
zheyou73v0_A03	45259372	45262963	BnaA03T0595500ZY.3	0	+	0	0	3591	0.0000000
zheyou73v0_A03	45265357	45265540	BnaA03T0595600ZY	0	+	0	0	183	0.0000000
zheyou73v0_A03	45286545	45286719	BnaA03T0595700ZY	0	+	0	0	174	0.0000000
zheyou73v0_A03	45309764	45311399	BnaA03T0595800ZY	0	-	0	0	1635	0.0000000
zheyou73v0_A03	45472690	45473363	BnaA03T0595900ZY	0	-	0	0	673	0.0000000
zheyou73v0_A03	45483388	45483865	BnaA03T0596000ZY	0	+	0	0	477	0.0000000
zheyou73v0_A03	45550990	45551550	BnaA03T0596100ZY	0	+	0	0	560	0.0000000
zheyou73v0_A03	45558187	45558496	BnaA03T0596200ZY	0	+	0	0	309	0.0000000
zheyou73v0_A03	45637774	45641070	BnaA03T0596300ZY	0	-	0	0	3296	0.0000000
zheyou73v0_A03	45645586	45650316	BnaA03T0596400ZY	0	-	0	0	4730	0.0000000
zheyou73v0_A03	45707511	45720971	BnaA03T0596500ZY	0	+	0	0	13460	0.0000000
zheyou73v0_A03	45722175	45723903	BnaA03T0596600ZY	0	+	0	0	1728	0.0000000
zheyou73v0_A03	45728573	45732531	BnaA03T0596700ZY	0	-	0	0	3958	0.0000000
zheyou73v0_A03	45748387	45749238	BnaA03T0596800ZY	0	+	0	0	851	0.0000000
zheyou73v0_A03	45768065	45769015	BnaA03T0596900ZY	0	+	0	0	950	0.0000000
zheyou73v0_A03	45775105	45775552	BnaA03T0597000ZY	0	+	0	0	447	0.0000000
zheyou73v0_A03	45775628	45790799	BnaA03T0597100ZY	0	+	0	0	15171	0.0000000
zheyou73v0_A03	45819189	45819465	BnaA03T0597200ZY	0	+	0	0	276	0.0000000
zheyou73v0_A03	45833943	45841033	BnaA03T0597300ZY	0	-	0	0	7090	0.0000000
zheyou73v0_A03	45859164	45859356	BnaA03T0597400ZY	0	+	0	0	192	0.0000000
zheyou73v0_A03	46000812	46003182	BnaA03T0597500ZY	0	+	0	0	2370	0.0000000
zheyou73v0_A03	46003939	46005584	BnaA03T0597600ZY	0	-	0	0	1645	0.0000000
zheyou73v0_A03	46009424	46009631	BnaA03T0597700ZY	0	-	0	0	207	0.0000000
zheyou73v0_A03	46031012	46031170	BnaA03T0597800ZY	0	-	0	0	158	0.0000000
zheyou73v0_A04	28557	28718	BnaA04T0000100ZY	0	+	0	0	161	0.0000000
zheyou73v0_A04	108174	111101	BnaA04T0000200ZY	0	-	0	0	2927	0.0000000
zheyou73v0_A04	108174	111101	BnaA04T0000200ZY.1	0	-	0	0	2927	0.0000000
zheyou73v0_A04	147222	147626	BnaA04T0000300ZY	0	-	0	0	404	0.0000000
zheyou73v0_A04	159149	164915	BnaA04T0000400ZY	0	-	0	0	5766	0.0000000
zheyou73v0_A04	166769	167270	BnaA04T0000500ZY	0	+	0	0	501	0.0000000
zheyou73v0_A04	328918	332465	BnaA04T0000600ZY	0	+	0	0	3547	0.0000000
zheyou73v0_A04	328918	332465	BnaA04T0000600ZY.1	0	+	0	0	3547	0.0000000
zheyou73v0_A04	338681	339021	BnaA04T0000700ZY	0	+	0	0	340	0.0000000
zheyou73v0_A04	345735	348765	BnaA04T0000800ZY	0	-	0	0	3030	0.0000000
zheyou73v0_A04	353369	354355	BnaA04T0000900ZY	0	+	0	0	986	0.0000000
zheyou73v0_A04	371008	373853	BnaA04T0001000ZY	0	+	0	0	2845	0.0000000
zheyou73v0_A04	371008	373853	BnaA04T0001000ZY.1	0	+	0	0	2845	0.0000000
zheyou73v0_A04	373963	379897	BnaA04T0001100ZY	0	-	0	0	5934	0.0000000
zheyou73v0_A04	383664	384680	BnaA04T0001200ZY	0	+	0	0	1016	0.0000000
zheyou73v0_A04	397569	399237	BnaA04T0001300ZY	0	+	0	0	1668	0.0000000
zheyou73v0_A04	406005	406798	BnaA04T0001400ZY	0	+	0	0	793	0.0000000
zheyou73v0_A04	410044	411504	BnaA04T0001500ZY	0	-	0	0	1460	0.0000000
zheyou73v0_A04	426349	429735	BnaA04T0001600ZY	0	+	0	0	3386	0.0000000
zheyou73v0_A04	428638	429670	BnaA04T0001700ZY	0	-	0	0	1032	0.0000000
zheyou73v0_A04	444242	453446	BnaA04T0001800ZY	0	+	0	0	9204	0.0000000
zheyou73v0_A04	461577	462639	BnaA04T0001900ZY	0	-	0	0	1062	0.0000000
zheyou73v0_A04	492118	494470	BnaA04T0002000ZY	0	-	0	0	2352	0.0000000
zheyou73v0_A04	492118	494470	BnaA04T0002000ZY.1	0	-	0	0	2352	0.0000000
zheyou73v0_A04	501123	502775	BnaA04T0002100ZY	0	-	0	0	1652	0.0000000
zheyou73v0_A04	516547	516700	BnaA04T0002200ZY	0	+	0	0	153	0.0000000
zheyou73v0_A04	537619	538007	BnaA04T0002300ZY	0	+	0	0	388	0.0000000
zheyou73v0_A04	552365	553671	BnaA04T0002400ZY	0	-	0	0	1306	0.0000000
zheyou73v0_A04	552365	553671	BnaA04T0002400ZY.1	0	-	0	0	1306	0.0000000
zheyou73v0_A04	552365	553671	BnaA04T0002400ZY.2	0	-	0	0	1306	0.0000000
zheyou73v0_A04	555254	557305	BnaA04T0002500ZY	0	-	0	0	2051	0.0000000
zheyou73v0_A04	561027	567122	BnaA04T0002600ZY	0	-	0	0	6095	0.0000000
zheyou73v0_A04	586425	590771	BnaA04T0002700ZY	0	+	0	0	4346	0.0000000
zheyou73v0_A04	617059	618342	BnaA04T0002800ZY	0	-	0	0	1283	0.0000000
zheyou73v0_A04	643635	644415	BnaA04T0002900ZY	0	+	0	0	780	0.0000000
zheyou73v0_A04	651064	651276	BnaA04T0003000ZY	0	-	0	0	212	0.0000000
zheyou73v0_A04	675583	677940	BnaA04T0003100ZY	0	+	0	0	2357	0.0000000
zheyou73v0_A04	678277	680222	BnaA04T0003200ZY	0	-	0	0	1945	0.0000000
zheyou73v0_A04	689577	691285	BnaA04T0003300ZY	0	+	0	0	1708	0.0000000
zheyou73v0_A04	697983	699323	BnaA04T0003400ZY	0	-	0	0	1340	0.0000000
zheyou73v0_A04	711792	712708	BnaA04T0003500ZY	0	-	0	0	916	0.0000000
zheyou73v0_A04	714067	716741	BnaA04T0003600ZY	0	+	0	0	2674	0.0000000
zheyou73v0_A04	734869	736559	BnaA04T0003700ZY	0	+	0	0	1690	0.0000000
zheyou73v0_A04	741912	743935	BnaA04T0003800ZY	0	+	0	0	2023	0.0000000
zheyou73v0_A04	748873	750823	BnaA04T0003900ZY	0	+	0	0	1950	0.0000000
zheyou73v0_A04	765928	797514	BnaA04T0004000ZY	0	-	0	0	31586	0.0000000
zheyou73v0_A04	797930	799106	BnaA04T0004100ZY	0	-	0	0	1176	0.0000000
zheyou73v0_A04	870897	871341	BnaA04T0004200ZY	0	+	0	0	444	0.0000000
zheyou73v0_A04	873948	875148	BnaA04T0004300ZY	0	+	0	0	1200	0.0000000
zheyou73v0_A04	907640	912054	BnaA04T0004400ZY	0	-	0	0	4414	0.0000000
zheyou73v0_A04	918547	920315	BnaA04T0004500ZY	0	-	0	0	1768	0.0000000
zheyou73v0_A04	940505	941396	BnaA04T0004600ZY	0	+	0	0	891	0.0000000
zheyou73v0_A04	942589	943177	BnaA04T0004700ZY	0	+	0	0	588	0.0000000
zheyou73v0_A04	1030824	1031582	BnaA04T0004800ZY	0	+	0	0	758	0.0000000
zheyou73v0_A04	1579293	1579656	BnaA04T0004900ZY	0	+	0	0	363	0.0000000
zheyou73v0_A04	1586577	1586893	BnaA04T0005000ZY	0	-	0	0	316	0.0000000
zheyou73v0_A04	1588428	1589517	BnaA04T0005100ZY	0	+	0	0	1089	0.0000000
zheyou73v0_A04	1594543	1596797	BnaA04T0005200ZY	0	+	0	0	2254	0.0000000
zheyou73v0_A04	1596976	1597469	BnaA04T0005300ZY	0	+	0	0	493	0.0000000
zheyou73v0_A04	1604255	1604571	BnaA04T0005400ZY	0	-	0	0	316	0.0000000
zheyou73v0_A04	1606106	1607195	BnaA04T0005500ZY	0	+	0	0	1089	0.0000000
zheyou73v0_A04	1607579	1609574	BnaA04T0005600ZY	0	+	0	0	1995	0.0000000
zheyou73v0_A04	1617369	1618260	BnaA04T0005700ZY	0	+	0	0	891	0.0000000
zheyou73v0_A04	1621141	1622775	BnaA04T0005800ZY	0	-	0	0	1634	0.0000000
zheyou73v0_A04	1625411	1628602	BnaA04T0005900ZY	0	-	0	0	3191	0.0000000
zheyou73v0_A04	1632481	1633181	BnaA04T0006000ZY	0	-	0	0	700	0.0000000
zheyou73v0_A04	1634315	1634807	BnaA04T0006100ZY	0	-	0	0	492	0.0000000
zheyou73v0_A04	1643842	1644448	BnaA04T0006200ZY	0	-	0	0	606	0.0000000
zheyou73v0_A04	1646230	1647049	BnaA04T0006300ZY	0	-	0	0	819	0.0000000
zheyou73v0_A04	1647823	1650804	BnaA04T0006400ZY	0	+	0	0	2981	0.0000000
zheyou73v0_A04	1653139	1654560	BnaA04T0006500ZY	0	+	0	0	1421	0.0000000
zheyou73v0_A04	1655295	1656738	BnaA04T0006600ZY	0	+	0	0	1443	0.0000000
zheyou73v0_A04	1660507	1662474	BnaA04T0006700ZY	0	+	0	0	1967	0.0000000
zheyou73v0_A04	1663936	1668875	BnaA04T0006800ZY	0	-	0	0	4939	0.0000000
zheyou73v0_A04	1674561	1675198	BnaA04T0006900ZY	0	-	0	0	637	0.0000000
zheyou73v0_A04	1781556	1782206	BnaA04T0007000ZY	0	-	0	0	650	0.0000000
zheyou73v0_A04	3052657	3053901	BnaA04T0007100ZY	0	+	0	0	1244	0.0000000
zheyou73v0_A04	3056548	3057614	BnaA04T0007200ZY	0	-	0	0	1066	0.0000000
zheyou73v0_A04	3064795	3065395	BnaA04T0007300ZY	0	-	0	0	600	0.0000000
zheyou73v0_A04	3065530	3066136	BnaA04T0007400ZY	0	-	0	0	606	0.0000000
zheyou73v0_A04	3066214	3067606	BnaA04T0007500ZY	0	-	0	0	1392	0.0000000
zheyou73v0_A04	3068264	3068667	BnaA04T0007600ZY	0	-	0	0	403	0.0000000
zheyou73v0_A04	3068980	3069556	BnaA04T0007700ZY	0	+	0	0	576	0.0000000
zheyou73v0_A04	3087831	3088419	BnaA04T0007800ZY	0	-	0	0	588	0.0000000
zheyou73v0_A04	3089612	3090503	BnaA04T0007900ZY	0	-	0	0	891	0.0000000
zheyou73v0_A04	3521478	3521973	BnaA04T0008000ZY	0	-	0	0	495	0.0000000
zheyou73v0_A04	3532554	3533186	BnaA04T0008100ZY	0	+	0	0	632	0.0000000
zheyou73v0_A04	3995827	3996502	BnaA04T0008200ZY	0	+	0	0	675	0.0000000
zheyou73v0_A04	4042083	4047921	BnaA04T0008300ZY	0	-	0	0	5838	0.0000000
zheyou73v0_A04	4051589	4054011	BnaA04T0008400ZY	0	+	0	0	2422	0.0000000
zheyou73v0_A04	4051589	4054011	BnaA04T0008400ZY.1	0	+	0	0	2422	0.0000000
zheyou73v0_A04	4051589	4054011	BnaA04T0008400ZY.2	0	+	0	0	2422	0.0000000
zheyou73v0_A04	4051589	4054011	BnaA04T0008400ZY.3	0	+	0	0	2422	0.0000000
zheyou73v0_A04	4054130	4055299	BnaA04T0008500ZY	0	-	0	0	1169	0.0000000
zheyou73v0_A04	4061682	4062042	BnaA04T0008600ZY	0	-	0	0	360	0.0000000
zheyou73v0_A04	4074132	4076857	BnaA04T0008700ZY	0	-	0	0	2725	0.0000000
zheyou73v0_A04	4156231	4163917	BnaA04T0008800ZY	0	-	0	0	7686	0.0000000
zheyou73v0_A04	4177727	4178537	BnaA04T0008900ZY	0	+	0	0	810	0.0000000
zheyou73v0_A04	4182589	4186283	BnaA04T0009000ZY	0	+	0	0	3694	0.0000000
zheyou73v0_A04	4202799	4203552	BnaA04T0009100ZY	0	-	0	0	753	0.0000000
zheyou73v0_A04	4205060	4205222	BnaA04T0009200ZY	0	+	0	0	162	0.0000000
zheyou73v0_A04	4282260	4285954	BnaA04T0009300ZY	0	-	0	0	3694	0.0000000
zheyou73v0_A04	4288748	4290279	BnaA04T0009400ZY	0	-	0	0	1531	0.0000000
zheyou73v0_A04	4288748	4290279	BnaA04T0009400ZY.1	0	-	0	0	1531	0.0000000
zheyou73v0_A04	4296568	4298677	BnaA04T0009500ZY	0	-	0	0	2109	0.0000000
zheyou73v0_A04	4302010	4305938	BnaA04T0009600ZY	0	-	0	0	3928	0.0000000
zheyou73v0_A04	4309257	4312650	BnaA04T0009700ZY	0	-	0	0	3393	0.0000000
zheyou73v0_A04	4318825	4319360	BnaA04T0009800ZY	0	+	0	0	535	0.0000000
zheyou73v0_A04	4321093	4322422	BnaA04T0009900ZY	0	-	0	0	1329	0.0000000
zheyou73v0_A04	4359456	4361381	BnaA04T0010000ZY	0	+	0	0	1925	0.0000000
zheyou73v0_A04	4367430	4369142	BnaA04T0010100ZY	0	-	0	0	1712	0.0000000
zheyou73v0_A04	4375620	4378667	BnaA04T0010200ZY	0	+	0	0	3047	0.0000000
zheyou73v0_A04	4380516	4380870	BnaA04T0010300ZY	0	-	0	0	354	0.0000000
zheyou73v0_A04	4381671	4381824	BnaA04T0010400ZY	0	+	0	0	153	0.0000000
zheyou73v0_A04	4407951	4409493	BnaA04T0010500ZY	0	-	0	0	1542	0.0000000
zheyou73v0_A04	4414677	4417430	BnaA04T0010600ZY	0	-	0	0	2753	0.0000000
zheyou73v0_A04	4421392	4425488	BnaA04T0010700ZY	0	-	0	0	4096	0.0000000
zheyou73v0_A04	4421392	4425286	BnaA04T0010700ZY.1	0	-	0	0	3894	0.0000000
zheyou73v0_A04	4439181	4461535	BnaA04T0010800ZY	0	+	0	0	22354	0.0000000
zheyou73v0_A04	4465027	4468663	BnaA04T0010900ZY	0	+	0	0	3636	0.0000000
zheyou73v0_A04	4465027	4468663	BnaA04T0010900ZY.1	0	+	0	0	3636	0.0000000
zheyou73v0_A04	4475798	4485898	BnaA04T0011000ZY	0	-	0	0	10100	0.0000000
zheyou73v0_A04	4486916	4487584	BnaA04T0011100ZY	0	+	0	0	668	0.0000000
zheyou73v0_A04	4492909	4495624	BnaA04T0011200ZY	0	-	0	0	2715	0.0000000
zheyou73v0_A04	4498387	4498845	BnaA04T0011300ZY	0	+	0	0	458	0.0000000
zheyou73v0_A04	4522366	4523174	BnaA04T0011400ZY	0	-	0	0	808	0.0000000
zheyou73v0_A04	4522366	4523026	BnaA04T0011400ZY.1	0	-	0	0	660	0.0000000
zheyou73v0_A04	4523371	4528421	BnaA04T0011500ZY	0	-	0	0	5050	0.0000000
zheyou73v0_A04	4523371	4528421	BnaA04T0011500ZY.1	0	-	0	0	5050	0.0000000
zheyou73v0_A04	4532755	4535116	BnaA04T0011600ZY	0	-	0	0	2361	0.0000000
zheyou73v0_A04	4532755	4535854	BnaA04T0011600ZY.1	0	-	0	0	3099	0.0000000
zheyou73v0_A04	4538131	4538473	BnaA04T0011700ZY	0	+	0	0	342	0.0000000
zheyou73v0_A04	4539093	4539577	BnaA04T0011800ZY	0	+	0	0	484	0.0000000
zheyou73v0_A04	4577823	4582596	BnaA04T0011900ZY	0	-	0	0	4773	0.0000000
zheyou73v0_A04	4601293	4601709	BnaA04T0012000ZY	0	-	0	0	416	0.0000000
zheyou73v0_A04	4680231	4680804	BnaA04T0012100ZY	0	+	0	0	573	0.0000000
zheyou73v0_A04	4692926	4693388	BnaA04T0012200ZY	0	+	0	0	462	0.0000000
zheyou73v0_A04	4696392	4698357	BnaA04T0012300ZY	0	-	0	0	1965	0.0000000
zheyou73v0_A04	4700337	4700862	BnaA04T0012400ZY	0	-	0	0	525	0.0000000
zheyou73v0_A04	4706558	4710332	BnaA04T0012500ZY	0	-	0	0	3774	0.0000000
zheyou73v0_A04	4723312	4729544	BnaA04T0012600ZY	0	+	0	0	6232	0.0000000
zheyou73v0_A04	4729944	4731726	BnaA04T0012700ZY	0	-	0	0	1782	0.0000000
zheyou73v0_A04	4759922	4762076	BnaA04T0012800ZY	0	+	0	0	2154	0.0000000
zheyou73v0_A04	4764189	4766894	BnaA04T0012900ZY	0	+	0	0	2705	0.0000000
zheyou73v0_A04	4768136	4770613	BnaA04T0013000ZY	0	-	0	0	2477	0.0000000
zheyou73v0_A04	4784576	4786852	BnaA04T0013100ZY	0	+	0	0	2276	0.0000000
zheyou73v0_A04	4789345	4790198	BnaA04T0013200ZY	0	-	0	0	853	0.0000000
zheyou73v0_A04	4813078	4817303	BnaA04T0013300ZY	0	+	0	0	4225	0.0000000
zheyou73v0_A04	4813078	4817303	BnaA04T0013300ZY.1	0	+	0	0	4225	0.0000000
zheyou73v0_A04	4813078	4817303	BnaA04T0013300ZY.2	0	+	0	0	4225	0.0000000
zheyou73v0_A04	4815728	4817922	BnaA04T0013400ZY	0	-	0	0	2194	0.0000000
zheyou73v0_A04	4856757	4857414	BnaA04T0013500ZY	0	+	0	0	657	0.0000000
zheyou73v0_A04	4859165	4859357	BnaA04T0013600ZY	0	+	0	0	192	0.0000000
zheyou73v0_A04	4859963	4862282	BnaA04T0013700ZY	0	+	0	0	2319	0.0000000
zheyou73v0_A04	4859963	4862282	BnaA04T0013700ZY.1	0	+	0	0	2319	0.0000000
zheyou73v0_A04	4859963	4862282	BnaA04T0013700ZY.2	0	+	0	0	2319	0.0000000
zheyou73v0_A04	4859963	4862282	BnaA04T0013700ZY.3	0	+	0	0	2319	0.0000000
zheyou73v0_A04	4893247	4898479	BnaA04T0013800ZY	0	+	0	0	5232	0.0000000
zheyou73v0_A04	4906363	4909389	BnaA04T0013900ZY	0	-	0	0	3026	0.0000000
zheyou73v0_A04	4916288	4920249	BnaA04T0014000ZY	0	-	0	0	3961	0.0000000
zheyou73v0_A04	4956353	4959670	BnaA04T0014100ZY	0	+	0	0	3317	0.0000000
zheyou73v0_A04	4960252	4963094	BnaA04T0014200ZY	0	-	0	0	2842	0.0000000
zheyou73v0_A04	4964043	4966639	BnaA04T0014300ZY	0	-	0	0	2596	0.0000000
zheyou73v0_A04	4969980	4972728	BnaA04T0014400ZY	0	+	0	0	2748	0.0000000
zheyou73v0_A04	4970440	4972728	BnaA04T0014400ZY.1	0	+	0	0	2288	0.0000000
zheyou73v0_A04	4973055	4974499	BnaA04T0014500ZY	0	+	0	0	1444	0.0000000
zheyou73v0_A04	4977507	4978656	BnaA04T0014600ZY	0	-	0	0	1149	0.0000000
zheyou73v0_A04	4987249	4989155	BnaA04T0014700ZY	0	+	0	0	1906	0.0000000
zheyou73v0_A04	5000245	5002158	BnaA04T0014800ZY	0	-	0	0	1913	0.0000000
zheyou73v0_A04	5005787	5009483	BnaA04T0014900ZY	0	-	0	0	3696	0.0000000
zheyou73v0_A04	5020388	5023422	BnaA04T0015000ZY	0	+	0	0	3034	0.0000000
zheyou73v0_A04	5023766	5024604	BnaA04T0015100ZY	0	+	0	0	838	0.0000000
zheyou73v0_A04	5025136	5026927	BnaA04T0015200ZY	0	-	0	0	1791	0.0000000
zheyou73v0_A04	5027048	5029679	BnaA04T0015300ZY	0	-	0	0	2631	0.0000000
zheyou73v0_A04	5040742	5042536	BnaA04T0015400ZY	0	+	0	0	1794	0.0000000
zheyou73v0_A04	5043766	5044604	BnaA04T0015500ZY	0	+	0	0	838	0.0000000
zheyou73v0_A04	5044820	5045231	BnaA04T0015600ZY	0	+	0	0	411	0.0000000
zheyou73v0_A04	5052405	5054190	BnaA04T0015700ZY	0	+	0	0	1785	0.0000000
zheyou73v0_A04	5060490	5061166	BnaA04T0015800ZY	0	+	0	0	676	0.0000000
zheyou73v0_A04	5065765	5067104	BnaA04T0015900ZY	0	-	0	0	1339	0.0000000
zheyou73v0_A04	5068111	5072659	BnaA04T0016000ZY	0	-	0	0	4548	0.0000000
zheyou73v0_A04	5075146	5076437	BnaA04T0016100ZY	0	-	0	0	1291	0.0000000
zheyou73v0_A04	5085982	5088909	BnaA04T0016200ZY	0	+	0	0	2927	0.0000000
zheyou73v0_A04	5091142	5092184	BnaA04T0016300ZY	0	-	0	0	1042	0.0000000
zheyou73v0_A04	5107122	5108513	BnaA04T0016400ZY	0	+	0	0	1391	0.0000000
zheyou73v0_A04	5119843	5121285	BnaA04T0016500ZY	0	-	0	0	1442	0.0000000
zheyou73v0_A04	5120380	5121285	BnaA04T0016500ZY.1	0	-	0	0	905	0.0000000
zheyou73v0_A04	5136149	5138968	BnaA04T0016600ZY	0	+	0	0	2819	0.0000000
zheyou73v0_A04	5154735	5157262	BnaA04T0016700ZY	0	+	0	0	2527	0.0000000
zheyou73v0_A04	5164669	5166367	BnaA04T0016800ZY	0	+	0	0	1698	0.0000000
zheyou73v0_A04	5178702	5179504	BnaA04T0016900ZY	0	-	0	0	802	0.0000000
zheyou73v0_A04	5184367	5186482	BnaA04T0017000ZY	0	-	0	0	2115	0.0000000
zheyou73v0_A04	5188357	5189987	BnaA04T0017100ZY	0	-	0	0	1630	0.0000000
zheyou73v0_A04	5190033	5194326	BnaA04T0017200ZY	0	-	0	0	4293	0.0000000
zheyou73v0_A04	5194820	5197623	BnaA04T0017300ZY	0	-	0	0	2803	0.0000000
zheyou73v0_A04	5194820	5197623	BnaA04T0017300ZY.1	0	-	0	0	2803	0.0000000
zheyou73v0_A04	5194820	5197623	BnaA04T0017300ZY.2	0	-	0	0	2803	0.0000000
zheyou73v0_A04	5216231	5216463	BnaA04T0017400ZY	0	-	0	0	232	0.0000000
zheyou73v0_A04	5216479	5218803	BnaA04T0017500ZY	0	-	0	0	2324	0.0000000
zheyou73v0_A04	5229048	5233450	BnaA04T0017600ZY	0	+	0	0	4402	0.0000000
zheyou73v0_A04	5277511	5278867	BnaA04T0017700ZY	0	+	0	0	1356	0.0000000
zheyou73v0_A04	5287225	5288804	BnaA04T0017800ZY	0	-	0	0	1579	0.0000000
zheyou73v0_A04	5292875	5294737	BnaA04T0017900ZY	0	-	0	0	1862	0.0000000
zheyou73v0_A04	5305941	5310467	BnaA04T0018000ZY	0	+	0	0	4526	0.0000000
zheyou73v0_A04	5310741	5313153	BnaA04T0018100ZY	0	-	0	0	2412	0.0000000
zheyou73v0_A04	5310741	5313153	BnaA04T0018100ZY.1	0	-	0	0	2412	0.0000000
zheyou73v0_A04	5325187	5325923	BnaA04T0018200ZY	0	-	0	0	736	0.0000000
zheyou73v0_A04	5327633	5328205	BnaA04T0018300ZY	0	-	0	0	572	0.0000000
zheyou73v0_A04	5336789	5337704	BnaA04T0018400ZY	0	+	0	0	915	0.0000000
zheyou73v0_A04	5363873	5365679	BnaA04T0018500ZY	0	+	0	0	1806	0.0000000
zheyou73v0_A04	5382842	5385288	BnaA04T0018600ZY	0	-	0	0	2446	0.0000000
zheyou73v0_A04	5417873	5418775	BnaA04T0018700ZY	0	-	0	0	902	0.0000000
zheyou73v0_A04	5432891	5433098	BnaA04T0018800ZY	0	-	0	0	207	0.0000000
zheyou73v0_A04	5434076	5435318	BnaA04T0018900ZY	0	+	0	0	1242	0.0000000
zheyou73v0_A04	5436735	5437520	BnaA04T0019000ZY	0	-	0	0	785	0.0000000
zheyou73v0_A04	5444773	5447598	BnaA04T0019100ZY	0	+	0	0	2825	0.0000000
zheyou73v0_A04	5448373	5449282	BnaA04T0019200ZY	0	-	0	0	909	0.0000000
zheyou73v0_A04	5449937	5450875	BnaA04T0019300ZY	0	-	0	0	938	0.0000000
zheyou73v0_A04	5464541	5465830	BnaA04T0019400ZY	0	+	0	0	1289	0.0000000
zheyou73v0_A04	5476677	5478446	BnaA04T0019500ZY	0	-	0	0	1769	0.0000000
zheyou73v0_A04	5493389	5495621	BnaA04T0019600ZY.1	0	-	0	0	2232	0.0000000
zheyou73v0_A04	5493657	5495759	BnaA04T0019600ZY	0	-	0	0	2102	0.0000000
zheyou73v0_A04	5500058	5504684	BnaA04T0019700ZY	0	+	0	0	4626	0.0000000
zheyou73v0_A04	5513171	5513651	BnaA04T0019800ZY	0	+	0	0	480	0.0000000
zheyou73v0_A04	5516046	5516664	BnaA04T0019900ZY	0	-	0	0	618	0.0000000
zheyou73v0_A04	5519418	5521629	BnaA04T0020000ZY	0	+	0	0	2211	0.0000000
zheyou73v0_A04	5539468	5546500	BnaA04T0020100ZY	0	+	0	0	7032	0.0000000
zheyou73v0_A04	5558025	5559679	BnaA04T0020200ZY	0	-	0	0	1654	0.0000000
zheyou73v0_A04	5563975	5564943	BnaA04T0020300ZY	0	+	0	0	968	0.0000000
zheyou73v0_A04	5574492	5575319	BnaA04T0020400ZY	0	-	0	0	827	0.0000000
zheyou73v0_A04	5605450	5606434	BnaA04T0020500ZY	0	-	0	0	984	0.0000000
zheyou73v0_A04	5609626	5612319	BnaA04T0020600ZY	0	+	0	0	2693	0.0000000
zheyou73v0_A04	5613642	5616794	BnaA04T0020700ZY	0	+	0	0	3152	0.0000000
zheyou73v0_A04	5620018	5621597	BnaA04T0020800ZY	0	-	0	0	1579	0.0000000
zheyou73v0_A04	5628115	5629360	BnaA04T0020900ZY	0	-	0	0	1245	0.0000000
zheyou73v0_A04	5635837	5636815	BnaA04T0021000ZY	0	+	0	0	978	0.0000000
zheyou73v0_A04	5636820	5637846	BnaA04T0021100ZY	0	-	0	0	1026	0.0000000
zheyou73v0_A04	5643439	5644448	BnaA04T0021200ZY	0	-	0	0	1009	0.0000000
zheyou73v0_A04	5658558	5662189	BnaA04T0021300ZY	0	-	0	0	3631	0.0000000
zheyou73v0_A04	5676669	5679339	BnaA04T0021400ZY	0	-	0	0	2670	0.0000000
zheyou73v0_A04	5682771	5685894	BnaA04T0021500ZY	0	+	0	0	3123	0.0000000
zheyou73v0_A04	5706587	5707612	BnaA04T0021600ZY	0	+	0	0	1025	0.0000000
zheyou73v0_A04	5712278	5714280	BnaA04T0021700ZY	0	-	0	0	2002	0.0000000
zheyou73v0_A04	5718636	5719168	BnaA04T0021800ZY	0	-	0	0	532	0.0000000
zheyou73v0_A04	5727559	5728717	BnaA04T0021900ZY	0	-	0	0	1158	0.0000000
zheyou73v0_A04	5746969	5749408	BnaA04T0022000ZY	0	+	0	0	2439	0.0000000
zheyou73v0_A04	5753697	5756724	BnaA04T0022100ZY	0	+	0	0	3027	0.0000000
zheyou73v0_A04	5753697	5756724	BnaA04T0022100ZY.1	0	+	0	0	3027	0.0000000
zheyou73v0_A04	5762747	5764797	BnaA04T0022200ZY	0	+	0	0	2050	0.0000000
zheyou73v0_A04	5762747	5764797	BnaA04T0022200ZY.1	0	+	0	0	2050	0.0000000
zheyou73v0_A04	5765129	5766146	BnaA04T0022300ZY	0	-	0	0	1017	0.0000000
zheyou73v0_A04	5767721	5769057	BnaA04T0022400ZY	0	+	0	0	1336	0.0000000
zheyou73v0_A04	5769379	5772040	BnaA04T0022500ZY	0	-	0	0	2661	0.0000000
zheyou73v0_A04	5780726	5781906	BnaA04T0022600ZY	0	-	0	0	1180	0.0000000
zheyou73v0_A04	5785646	5786531	BnaA04T0022700ZY	0	-	0	0	885	0.0000000
zheyou73v0_A04	5789081	5793449	BnaA04T0022800ZY	0	+	0	0	4368	0.0000000
zheyou73v0_A04	5800075	5805346	BnaA04T0022900ZY	0	+	0	0	5271	0.0000000
zheyou73v0_A04	5806951	5807182	BnaA04T0023000ZY	0	+	0	0	231	0.0000000
zheyou73v0_A04	5809295	5810899	BnaA04T0023100ZY	0	-	0	0	1604	0.0000000
zheyou73v0_A04	5819279	5820473	BnaA04T0023200ZY	0	-	0	0	1194	0.0000000
zheyou73v0_A04	5837293	5840075	BnaA04T0023300ZY	0	+	0	0	2782	0.0000000
zheyou73v0_A04	5842334	5844338	BnaA04T0023400ZY	0	-	0	0	2004	0.0000000
zheyou73v0_A04	5847568	5849559	BnaA04T0023500ZY	0	+	0	0	1991	0.0000000
zheyou73v0_A04	5855730	5856120	BnaA04T0023600ZY	0	+	0	0	390	0.0000000
zheyou73v0_A04	5879406	5879790	BnaA04T0023700ZY	0	+	0	0	384	0.0000000
zheyou73v0_A04	5883452	5887472	BnaA04T0023800ZY	0	+	0	0	4020	0.0000000
zheyou73v0_A04	5887497	5889967	BnaA04T0023900ZY	0	-	0	0	2470	0.0000000
zheyou73v0_A04	5896624	5896956	BnaA04T0024000ZY	0	-	0	0	332	0.0000000
zheyou73v0_A04	5908255	5911874	BnaA04T0024100ZY	0	+	0	0	3619	0.0000000
zheyou73v0_A04	5923643	5924979	BnaA04T0024200ZY	0	-	0	0	1336	0.0000000
zheyou73v0_A04	5951414	5953318	BnaA04T0024300ZY	0	+	0	0	1904	0.0000000
zheyou73v0_A04	5963461	5976553	BnaA04T0024400ZY	0	-	0	0	13092	0.0000000
zheyou73v0_A04	5977610	5980483	BnaA04T0024500ZY	0	+	0	0	2873	0.0000000
zheyou73v0_A04	5981197	5981622	BnaA04T0024600ZY	0	+	0	0	425	0.0000000
zheyou73v0_A04	5985261	5985920	BnaA04T0024700ZY	0	+	0	0	659	0.0000000
zheyou73v0_A04	5987940	5990641	BnaA04T0024800ZY	0	+	0	0	2701	0.0000000
zheyou73v0_A04	5991010	5994495	BnaA04T0024900ZY	0	+	0	0	3485	0.0000000
zheyou73v0_A04	6014537	6016114	BnaA04T0025000ZY	0	+	0	0	1577	0.0000000
zheyou73v0_A04	6026706	6027651	BnaA04T0025100ZY	0	-	0	0	945	0.0000000
zheyou73v0_A04	6032228	6033651	BnaA04T0025200ZY	0	+	0	0	1423	0.0000000
zheyou73v0_A04	6059098	6064281	BnaA04T0025300ZY	0	+	0	0	5183	0.0000000
zheyou73v0_A04	6081482	6082040	BnaA04T0025400ZY	0	-	0	0	558	0.0000000
zheyou73v0_A04	6098684	6100162	BnaA04T0025500ZY	0	-	0	0	1478	0.0000000
zheyou73v0_A04	6100984	6103313	BnaA04T0025600ZY	0	-	0	0	2329	0.0000000
zheyou73v0_A04	6106651	6108571	BnaA04T0025700ZY	0	+	0	0	1920	0.0000000
zheyou73v0_A04	6111291	6112616	BnaA04T0025800ZY	0	-	0	0	1325	0.0000000
zheyou73v0_A04	6130437	6130765	BnaA04T0025900ZY	0	-	0	0	328	0.0000000
zheyou73v0_A04	6135834	6137988	BnaA04T0026000ZY	0	+	0	0	2154	0.0000000
zheyou73v0_A04	6140176	6141671	BnaA04T0026100ZY	0	-	0	0	1495	0.0000000
zheyou73v0_A04	6142122	6142905	BnaA04T0026200ZY	0	+	0	0	783	0.0000000
zheyou73v0_A04	6152673	6154351	BnaA04T0026300ZY	0	+	0	0	1678	0.0000000
zheyou73v0_A04	6158702	6160721	BnaA04T0026400ZY	0	+	0	0	2019	0.0000000
zheyou73v0_A04	6161002	6161755	BnaA04T0026500ZY	0	-	0	0	753	0.0000000
zheyou73v0_A04	6163113	6166070	BnaA04T0026600ZY	0	-	0	0	2957	0.0000000
zheyou73v0_A04	6163113	6166070	BnaA04T0026600ZY.1	0	-	0	0	2957	0.0000000
zheyou73v0_A04	6163113	6166070	BnaA04T0026600ZY.2	0	-	0	0	2957	0.0000000
zheyou73v0_A04	6163113	6165469	BnaA04T0026600ZY.3	0	-	0	0	2356	0.0000000
zheyou73v0_A04	6163113	6165469	BnaA04T0026600ZY.4	0	-	0	0	2356	0.0000000
zheyou73v0_A04	6163113	6166070	BnaA04T0026600ZY.5	0	-	0	0	2957	0.0000000
zheyou73v0_A04	6163113	6165469	BnaA04T0026600ZY.6	0	-	0	0	2356	0.0000000
zheyou73v0_A04	6163113	6165469	BnaA04T0026600ZY.7	0	-	0	0	2356	0.0000000
zheyou73v0_A04	6163113	6166070	BnaA04T0026600ZY.8	0	-	0	0	2957	0.0000000
zheyou73v0_A04	6163113	6166070	BnaA04T0026600ZY.9	0	-	0	0	2957	0.0000000
zheyou73v0_A04	6179327	6179647	BnaA04T0026700ZY	0	+	0	0	320	0.0000000
zheyou73v0_A04	6189746	6192102	BnaA04T0026800ZY	0	+	0	0	2356	0.0000000
zheyou73v0_A04	6220040	6221953	BnaA04T0026900ZY	0	+	0	0	1913	0.0000000
zheyou73v0_A04	6222306	6223975	BnaA04T0027000ZY	0	-	0	0	1669	0.0000000
zheyou73v0_A04	6229076	6232923	BnaA04T0027100ZY	0	+	0	0	3847	0.0000000
zheyou73v0_A04	6229076	6232923	BnaA04T0027100ZY.1	0	+	0	0	3847	0.0000000
zheyou73v0_A04	6238342	6239339	BnaA04T0027200ZY	0	+	0	0	997	0.0000000
zheyou73v0_A04	6240459	6243248	BnaA04T0027300ZY	0	+	0	0	2789	0.0000000
zheyou73v0_A04	6253866	6256890	BnaA04T0027400ZY	0	-	0	0	3024	0.0000000
zheyou73v0_A04	6271704	6275063	BnaA04T0027500ZY	0	+	0	0	3359	0.0000000
zheyou73v0_A04	6281020	6281677	BnaA04T0027600ZY	0	-	0	0	657	0.0000000
zheyou73v0_A04	6288212	6290205	BnaA04T0027700ZY	0	+	0	0	1993	0.0000000
zheyou73v0_A04	6290721	6292278	BnaA04T0027800ZY	0	-	0	0	1557	0.0000000
zheyou73v0_A04	6293586	6295248	BnaA04T0027900ZY	0	-	0	0	1662	0.0000000
zheyou73v0_A04	6295709	6297262	BnaA04T0028000ZY	0	+	0	0	1553	0.0000000
zheyou73v0_A04	6300614	6302510	BnaA04T0028100ZY	0	-	0	0	1896	0.0000000
zheyou73v0_A04	6317069	6317255	BnaA04T0028200ZY	0	-	0	0	186	0.0000000
zheyou73v0_A04	6334762	6338431	BnaA04T0028300ZY	0	+	0	0	3669	0.0000000
zheyou73v0_A04	6358616	6363874	BnaA04T0028400ZY	0	+	0	0	5258	0.0000000
zheyou73v0_A04	6366166	6367365	BnaA04T0028500ZY	0	+	0	0	1199	0.0000000
zheyou73v0_A04	6367613	6368652	BnaA04T0028600ZY	0	-	0	0	1039	0.0000000
zheyou73v0_A04	6369324	6370777	BnaA04T0028700ZY	0	-	0	0	1453	0.0000000
zheyou73v0_A04	6371420	6372885	BnaA04T0028800ZY	0	-	0	0	1465	0.0000000
zheyou73v0_A04	6371420	6372885	BnaA04T0028800ZY.1	0	-	0	0	1465	0.0000000
zheyou73v0_A04	6373941	6376116	BnaA04T0028900ZY	0	+	0	0	2175	0.0000000
zheyou73v0_A04	6376259	6376880	BnaA04T0029000ZY	0	+	0	0	621	0.0000000
zheyou73v0_A04	6382234	6385617	BnaA04T0029100ZY	0	+	0	0	3383	0.0000000
zheyou73v0_A04	6401771	6402251	BnaA04T0029200ZY	0	-	0	0	480	0.0000000
zheyou73v0_A04	6405545	6406850	BnaA04T0029300ZY	0	-	0	0	1305	0.0000000
zheyou73v0_A04	6421046	6421781	BnaA04T0029400ZY	0	+	0	0	735	0.0000000
zheyou73v0_A04	6507913	6508192	BnaA04T0029500ZY	0	-	0	0	279	0.0000000
zheyou73v0_A04	6569185	6569395	BnaA04T0029600ZY	0	+	0	0	210	0.0000000
zheyou73v0_A04	6572994	6575036	BnaA04T0029700ZY	0	+	0	0	2042	0.0000000
zheyou73v0_A04	6588661	6589601	BnaA04T0029800ZY	0	+	0	0	940	0.0000000
zheyou73v0_A04	6612847	6614103	BnaA04T0029900ZY	0	+	0	0	1256	0.0000000
zheyou73v0_A04	6614193	6615220	BnaA04T0030000ZY	0	-	0	0	1027	0.0000000
zheyou73v0_A04	6626446	6629335	BnaA04T0030100ZY	0	+	0	0	2889	0.0000000
zheyou73v0_A04	6632616	6633768	BnaA04T0030200ZY	0	-	0	0	1152	0.0000000
zheyou73v0_A04	6639759	6640656	BnaA04T0030300ZY	0	+	0	0	897	0.0000000
zheyou73v0_A04	6656655	6657835	BnaA04T0030400ZY	0	+	0	0	1180	0.0000000
zheyou73v0_A04	6663749	6664018	BnaA04T0030500ZY	0	-	0	0	269	0.0000000
zheyou73v0_A04	6666471	6667797	BnaA04T0030600ZY	0	+	0	0	1326	0.0000000
zheyou73v0_A04	6682850	6690814	BnaA04T0030700ZY	0	+	0	0	7964	0.0000000
zheyou73v0_A04	6691032	6693423	BnaA04T0030800ZY	0	-	0	0	2391	0.0000000
zheyou73v0_A04	6691032	6693423	BnaA04T0030800ZY.1	0	-	0	0	2391	0.0000000
zheyou73v0_A04	6698366	6701286	BnaA04T0030900ZY	0	+	0	0	2920	0.0000000
zheyou73v0_A04	6698366	6701286	BnaA04T0030900ZY.1	0	+	0	0	2920	0.0000000
zheyou73v0_A04	6715753	6718102	BnaA04T0031000ZY	0	+	0	0	2349	0.0000000
zheyou73v0_A04	6718389	6719639	BnaA04T0031100ZY	0	+	0	0	1250	0.0000000
zheyou73v0_A04	6728286	6728965	BnaA04T0031200ZY	0	-	0	0	679	0.0000000
zheyou73v0_A04	6742413	6744136	BnaA04T0031300ZY	0	-	0	0	1723	0.0000000
zheyou73v0_A04	6750210	6751787	BnaA04T0031400ZY	0	-	0	0	1577	0.0000000
zheyou73v0_A04	6757597	6758793	BnaA04T0031500ZY	0	+	0	0	1196	0.0000000
zheyou73v0_A04	6780572	6783390	BnaA04T0031600ZY	0	-	0	0	2818	0.0000000
zheyou73v0_A04	6784532	6787666	BnaA04T0031700ZY	0	+	0	0	3134	0.0000000
zheyou73v0_A04	6789805	6793044	BnaA04T0031800ZY	0	+	0	0	3239	0.0000000
zheyou73v0_A04	6789805	6791733	BnaA04T0031800ZY.1	0	+	0	0	1928	0.0000000
zheyou73v0_A04	6793243	6793688	BnaA04T0031900ZY	0	-	0	0	445	0.0000000
zheyou73v0_A04	6796275	6798395	BnaA04T0032000ZY	0	+	0	0	2120	0.0000000
zheyou73v0_A04	6807538	6807867	BnaA04T0032100ZY	0	+	0	0	329	0.0000000
zheyou73v0_A04	6818411	6818990	BnaA04T0032200ZY	0	-	0	0	579	0.0000000
zheyou73v0_A04	6821774	6824543	BnaA04T0032300ZY	0	-	0	0	2769	0.0000000
zheyou73v0_A04	6831786	6834854	BnaA04T0032400ZY	0	-	0	0	3068	0.0000000
zheyou73v0_A04	6835475	6835715	BnaA04T0032500ZY	0	-	0	0	240	0.0000000
zheyou73v0_A04	6852187	6854427	BnaA04T0032600ZY	0	-	0	0	2240	0.0000000
zheyou73v0_A04	6865377	6867127	BnaA04T0032700ZY	0	+	0	0	1750	0.0000000
zheyou73v0_A04	6870305	6871151	BnaA04T0032800ZY	0	+	0	0	846	0.0000000
zheyou73v0_A04	6871830	6874294	BnaA04T0032900ZY	0	-	0	0	2464	0.0000000
zheyou73v0_A04	6874501	6876091	BnaA04T0033000ZY	0	-	0	0	1590	0.0000000
zheyou73v0_A04	6874501	6876091	BnaA04T0033000ZY.1	0	-	0	0	1590	0.0000000
zheyou73v0_A04	6876368	6880389	BnaA04T0033100ZY	0	+	0	0	4021	0.0000000
zheyou73v0_A04	6876368	6880389	BnaA04T0033100ZY.1	0	+	0	0	4021	0.0000000
zheyou73v0_A04	6888422	6891237	BnaA04T0033200ZY	0	-	0	0	2815	0.0000000
zheyou73v0_A04	6901046	6901415	BnaA04T0033300ZY	0	+	0	0	369	0.0000000
zheyou73v0_A04	6901705	6903702	BnaA04T0033400ZY	0	+	0	0	1997	0.0000000
zheyou73v0_A04	6901705	6903736	BnaA04T0033400ZY.1	0	+	0	0	2031	0.0000000
zheyou73v0_A04	6901705	6903702	BnaA04T0033400ZY.2	0	+	0	0	1997	0.0000000
zheyou73v0_A04	6905714	6906158	BnaA04T0033500ZY	0	-	0	0	444	0.0000000
zheyou73v0_A04	6911341	6913337	BnaA04T0033600ZY	0	+	0	0	1996	0.0000000
zheyou73v0_A04	6914234	6915155	BnaA04T0033700ZY	0	-	0	0	921	0.0000000
zheyou73v0_A04	6924747	6925797	BnaA04T0033800ZY	0	-	0	0	1050	0.0000000
zheyou73v0_A04	6936045	6938415	BnaA04T0033900ZY	0	+	0	0	2370	0.0000000
zheyou73v0_A04	6940261	6940936	BnaA04T0034000ZY	0	+	0	0	675	0.0000000
zheyou73v0_A04	6944594	6945786	BnaA04T0034100ZY	0	-	0	0	1192	0.0000000
zheyou73v0_A04	6946402	6947965	BnaA04T0034200ZY	0	-	0	0	1563	0.0000000
zheyou73v0_A04	6948558	6950455	BnaA04T0034300ZY	0	-	0	0	1897	0.0000000
zheyou73v0_A04	6951657	6956271	BnaA04T0034400ZY	0	-	0	0	4614	0.0000000
zheyou73v0_A04	6960016	6963057	BnaA04T0034500ZY	0	+	0	0	3041	0.0000000
zheyou73v0_A04	6965752	6967812	BnaA04T0034600ZY	0	-	0	0	2060	0.0000000
zheyou73v0_A04	6969135	6970886	BnaA04T0034700ZY	0	-	0	0	1751	0.0000000
zheyou73v0_A04	6971866	6976544	BnaA04T0034800ZY	0	-	0	0	4678	0.0000000
zheyou73v0_A04	6977268	6977677	BnaA04T0034900ZY	0	-	0	0	409	0.0000000
zheyou73v0_A04	6977927	6987540	BnaA04T0035000ZY	0	-	0	0	9613	0.0000000
zheyou73v0_A04	6988368	6989484	BnaA04T0035100ZY	0	-	0	0	1116	0.0000000
zheyou73v0_A04	6990205	6991546	BnaA04T0035200ZY	0	+	0	0	1341	0.0000000
zheyou73v0_A04	7004228	7005717	BnaA04T0035300ZY	0	+	0	0	1489	0.0000000
zheyou73v0_A04	7006257	7009797	BnaA04T0035400ZY	0	-	0	0	3540	0.0000000
zheyou73v0_A04	7010505	7014036	BnaA04T0035500ZY	0	+	0	0	3531	0.0000000
zheyou73v0_A04	7014332	7015774	BnaA04T0035600ZY	0	+	0	0	1442	0.0000000
zheyou73v0_A04	7017674	7019450	BnaA04T0035700ZY	0	-	0	0	1776	0.0000000
zheyou73v0_A04	7039943	7042608	BnaA04T0035800ZY	0	+	0	0	2665	0.0000000
zheyou73v0_A04	7051726	7054491	BnaA04T0035900ZY	0	+	0	0	2765	0.0000000
zheyou73v0_A04	7062915	7063617	BnaA04T0036000ZY	0	-	0	0	702	0.0000000
zheyou73v0_A04	7070437	7072903	BnaA04T0036100ZY	0	-	0	0	2466	0.0000000
zheyou73v0_A04	7070437	7072920	BnaA04T0036100ZY.1	0	-	0	0	2483	0.0000000
zheyou73v0_A04	7074745	7076371	BnaA04T0036200ZY	0	-	0	0	1626	0.0000000
zheyou73v0_A04	7076885	7078658	BnaA04T0036300ZY	0	-	0	0	1773	0.0000000
zheyou73v0_A04	7080516	7081392	BnaA04T0036400ZY	0	+	0	0	876	0.0000000
zheyou73v0_A04	7082635	7083505	BnaA04T0036500ZY	0	+	0	0	870	0.0000000
zheyou73v0_A04	7107069	7107939	BnaA04T0036600ZY	0	+	0	0	870	0.0000000
zheyou73v0_A04	7112147	7112339	BnaA04T0036700ZY	0	+	0	0	192	0.0000000
zheyou73v0_A04	7118375	7119245	BnaA04T0036800ZY	0	+	0	0	870	0.0000000
zheyou73v0_A04	7143026	7143896	BnaA04T0036900ZY	0	+	0	0	870	0.0000000
zheyou73v0_A04	7150193	7150391	BnaA04T0037000ZY	0	-	0	0	198	0.0000000
zheyou73v0_A04	7169359	7172793	BnaA04T0037100ZY	0	+	0	0	3434	0.0000000
zheyou73v0_A04	7174696	7176989	BnaA04T0037200ZY	0	+	0	0	2293	0.0000000
zheyou73v0_A04	7177728	7178921	BnaA04T0037300ZY	0	-	0	0	1193	0.0000000
zheyou73v0_A04	7182016	7184805	BnaA04T0037400ZY	0	+	0	0	2789	0.0000000
zheyou73v0_A04	7196769	7198127	BnaA04T0037500ZY	0	-	0	0	1358	0.0000000
zheyou73v0_A04	7202861	7204171	BnaA04T0037600ZY	0	-	0	0	1310	0.0000000
zheyou73v0_A04	7208074	7208741	BnaA04T0037700ZY	0	+	0	0	667	0.0000000
zheyou73v0_A04	7221064	7222961	BnaA04T0037800ZY	0	-	0	0	1897	0.0000000
zheyou73v0_A04	7226182	7226548	BnaA04T0037900ZY	0	+	0	0	366	0.0000000
zheyou73v0_A04	7231342	7232945	BnaA04T0038000ZY	0	+	0	0	1603	0.0000000
zheyou73v0_A04	7234389	7235991	BnaA04T0038100ZY	0	+	0	0	1602	0.0000000
zheyou73v0_A04	7246497	7248015	BnaA04T0038200ZY	0	-	0	0	1518	0.0000000
zheyou73v0_A04	7251600	7252678	BnaA04T0038300ZY	0	+	0	0	1078	0.0000000
zheyou73v0_A04	7263201	7265567	BnaA04T0038400ZY	0	+	0	0	2366	0.0000000
zheyou73v0_A04	7268023	7270205	BnaA04T0038500ZY	0	+	0	0	2182	0.0000000
zheyou73v0_A04	7278273	7280116	BnaA04T0038600ZY	0	+	0	0	1843	0.0000000
zheyou73v0_A04	7278273	7280116	BnaA04T0038600ZY.1	0	+	0	0	1843	0.0000000
zheyou73v0_A04	7278273	7280116	BnaA04T0038600ZY.2	0	+	0	0	1843	0.0000000
zheyou73v0_A04	7293045	7294404	BnaA04T0038700ZY	0	+	0	0	1359	0.0000000
zheyou73v0_A04	7300022	7301963	BnaA04T0038800ZY	0	+	0	0	1941	0.0000000
zheyou73v0_A04	7302117	7303640	BnaA04T0038900ZY	0	-	0	0	1523	0.0000000
zheyou73v0_A04	7309290	7314146	BnaA04T0039000ZY	0	-	0	0	4856	0.0000000
zheyou73v0_A04	7319289	7319688	BnaA04T0039100ZY	0	+	0	0	399	0.0000000
zheyou73v0_A04	7349783	7351351	BnaA04T0039200ZY	0	-	0	0	1568	0.0000000
zheyou73v0_A04	7384624	7387391	BnaA04T0039300ZY	0	+	0	0	2767	0.0000000
zheyou73v0_A04	7387656	7388090	BnaA04T0039400ZY	0	-	0	0	434	0.0000000
zheyou73v0_A04	7391290	7393506	BnaA04T0039500ZY	0	-	0	0	2216	0.0000000
zheyou73v0_A04	7394981	7396689	BnaA04T0039600ZY	0	+	0	0	1708	0.0000000
zheyou73v0_A04	7397106	7397772	BnaA04T0039700ZY	0	+	0	0	666	0.0000000
zheyou73v0_A04	7398231	7399660	BnaA04T0039800ZY	0	-	0	0	1429	0.0000000
zheyou73v0_A04	7410898	7411102	BnaA04T0039900ZY	0	+	0	0	204	0.0000000
zheyou73v0_A04	7412183	7415971	BnaA04T0040000ZY	0	-	0	0	3788	0.0000000
zheyou73v0_A04	7419595	7420641	BnaA04T0040100ZY	0	-	0	0	1046	0.0000000
zheyou73v0_A04	7453598	7457104	BnaA04T0040200ZY	0	+	0	0	3506	0.0000000
zheyou73v0_A04	7460715	7460883	BnaA04T0040300ZY	0	+	0	0	168	0.0000000
zheyou73v0_A04	7464916	7465849	BnaA04T0040400ZY	0	-	0	0	933	0.0000000
zheyou73v0_A04	7478296	7479130	BnaA04T0040500ZY	0	-	0	0	834	0.0000000
zheyou73v0_A04	7498270	7501930	BnaA04T0040600ZY	0	+	0	0	3660	0.0000000
zheyou73v0_A04	7502217	7506441	BnaA04T0040700ZY	0	-	0	0	4224	0.0000000
zheyou73v0_A04	7507527	7509540	BnaA04T0040800ZY	0	+	0	0	2013	0.0000000
zheyou73v0_A04	7513539	7514556	BnaA04T0040900ZY	0	-	0	0	1017	0.0000000
zheyou73v0_A04	7520500	7522397	BnaA04T0041000ZY	0	+	0	0	1897	0.0000000
zheyou73v0_A04	7536409	7540649	BnaA04T0041100ZY	0	+	0	0	4240	0.0000000
zheyou73v0_A04	7541539	7542030	BnaA04T0041200ZY	0	-	0	0	491	0.0000000
zheyou73v0_A04	7579822	7580935	BnaA04T0041300ZY	0	-	0	0	1113	0.0000000
zheyou73v0_A04	7581570	7582704	BnaA04T0041400ZY	0	+	0	0	1134	0.0000000
zheyou73v0_A04	7583102	7583690	BnaA04T0041500ZY	0	-	0	0	588	0.0000000
zheyou73v0_A04	7584955	7585165	BnaA04T0041600ZY	0	+	0	0	210	0.0000000
zheyou73v0_A04	7585716	7590338	BnaA04T0041700ZY	0	+	0	0	4622	0.0000000
zheyou73v0_A04	7592510	7593642	BnaA04T0041800ZY	0	-	0	0	1132	0.0000000
zheyou73v0_A04	7593772	7593961	BnaA04T0041900ZY	0	+	0	0	189	0.0000000
zheyou73v0_A04	7596021	7596618	BnaA04T0042000ZY	0	+	0	0	597	0.0000000
zheyou73v0_A04	7600288	7602364	BnaA04T0042100ZY	0	-	0	0	2076	0.0000000
zheyou73v0_A04	7603016	7603682	BnaA04T0042200ZY	0	+	0	0	666	0.0000000
zheyou73v0_A04	7605627	7607488	BnaA04T0042300ZY	0	+	0	0	1861	0.0000000
zheyou73v0_A04	7607663	7608291	BnaA04T0042400ZY	0	-	0	0	628	0.0000000
zheyou73v0_A04	7615472	7617852	BnaA04T0042500ZY	0	+	0	0	2380	0.0000000
zheyou73v0_A04	7618540	7620045	BnaA04T0042600ZY	0	+	0	0	1505	0.0000000
zheyou73v0_A04	7631367	7633342	BnaA04T0042700ZY	0	+	0	0	1975	0.0000000
zheyou73v0_A04	7637722	7638463	BnaA04T0042800ZY	0	+	0	0	741	0.0000000
zheyou73v0_A04	7650429	7656500	BnaA04T0042900ZY	0	+	0	0	6071	0.0000000
zheyou73v0_A04	7658429	7661596	BnaA04T0043000ZY	0	-	0	0	3167	0.0000000
zheyou73v0_A04	7683488	7687820	BnaA04T0043100ZY	0	+	0	0	4332	0.0000000
zheyou73v0_A04	7687795	7691663	BnaA04T0043200ZY	0	-	0	0	3868	0.0000000
zheyou73v0_A04	7702247	7703759	BnaA04T0043300ZY	0	-	0	0	1512	0.0000000
zheyou73v0_A04	7705606	7706972	BnaA04T0043400ZY	0	-	0	0	1366	0.0000000
zheyou73v0_A04	7705606	7706972	BnaA04T0043400ZY.1	0	-	0	0	1366	0.0000000
zheyou73v0_A04	7718175	7719184	BnaA04T0043500ZY	0	+	0	0	1009	0.0000000
zheyou73v0_A04	7757315	7757834	BnaA04T0043600ZY	0	+	0	0	519	0.0000000
zheyou73v0_A04	7759024	7770091	BnaA04T0043700ZY	0	-	0	0	11067	0.0000000
zheyou73v0_A04	7770231	7772297	BnaA04T0043800ZY	0	-	0	0	2066	0.0000000
zheyou73v0_A04	7772537	7774195	BnaA04T0043900ZY	0	-	0	0	1658	0.0000000
zheyou73v0_A04	7774634	7777240	BnaA04T0044000ZY	0	-	0	0	2606	0.0000000
zheyou73v0_A04	7788114	7789359	BnaA04T0044100ZY	0	+	0	0	1245	0.0000000
zheyou73v0_A04	7790033	7796043	BnaA04T0044200ZY	0	-	0	0	6010	0.0000000
zheyou73v0_A04	7797006	7797558	BnaA04T0044300ZY	0	-	0	0	552	0.0000000
zheyou73v0_A04	7825752	7828785	BnaA04T0044400ZY	0	+	0	0	3033	0.0000000
zheyou73v0_A04	7831135	7832425	BnaA04T0044500ZY	0	+	0	0	1290	0.0000000
zheyou73v0_A04	7831818	7834754	BnaA04T0044600ZY	0	-	0	0	2936	0.0000000
zheyou73v0_A04	7831818	7834797	BnaA04T0044600ZY.2	0	-	0	0	2979	0.0000000
zheyou73v0_A04	7832561	7834797	BnaA04T0044600ZY.1	0	-	0	0	2236	0.0000000
zheyou73v0_A04	7835015	7836889	BnaA04T0044700ZY	0	-	0	0	1874	0.0000000
zheyou73v0_A04	7837394	7839766	BnaA04T0044800ZY	0	-	0	0	2372	0.0000000
zheyou73v0_A04	7843654	7848460	BnaA04T0044900ZY	0	+	0	0	4806	0.0000000
zheyou73v0_A04	7860846	7862391	BnaA04T0045000ZY	0	-	0	0	1545	0.0000000
zheyou73v0_A04	7863949	7866333	BnaA04T0045100ZY	0	+	0	0	2384	0.0000000
zheyou73v0_A04	7886143	7890470	BnaA04T0045200ZY	0	+	0	0	4327	0.0000000
zheyou73v0_A04	7886143	7890470	BnaA04T0045200ZY.1	0	+	0	0	4327	0.0000000
zheyou73v0_A04	7896622	7897302	BnaA04T0045300ZY	0	-	0	0	680	0.0000000
zheyou73v0_A04	7898056	7900886	BnaA04T0045400ZY	0	-	0	0	2830	0.0000000
zheyou73v0_A04	7898056	7900886	BnaA04T0045400ZY.1	0	-	0	0	2830	0.0000000
zheyou73v0_A04	7927525	7931793	BnaA04T0045500ZY	0	+	0	0	4268	0.0000000
zheyou73v0_A04	7933721	7935340	BnaA04T0045600ZY	0	-	0	0	1619	0.0000000
zheyou73v0_A04	7939010	7940211	BnaA04T0045700ZY	0	-	0	0	1201	0.0000000
zheyou73v0_A04	7941974	7943653	BnaA04T0045800ZY	0	+	0	0	1679	0.0000000
zheyou73v0_A04	7943814	7947604	BnaA04T0045900ZY	0	-	0	0	3790	0.0000000
zheyou73v0_A04	7947972	7956576	BnaA04T0046000ZY	0	+	0	0	8604	0.0000000
zheyou73v0_A04	7957114	7958760	BnaA04T0046100ZY	0	-	0	0	1646	0.0000000
zheyou73v0_A04	7963635	7966189	BnaA04T0046200ZY	0	-	0	0	2554	0.0000000
zheyou73v0_A04	7975146	7977723	BnaA04T0046300ZY	0	+	0	0	2577	0.0000000
zheyou73v0_A04	7993802	7994224	BnaA04T0046400ZY	0	-	0	0	422	0.0000000
zheyou73v0_A04	7994791	7995058	BnaA04T0046500ZY	0	-	0	0	267	0.0000000
zheyou73v0_A04	8004309	8004771	BnaA04T0046600ZY	0	+	0	0	462	0.0000000
zheyou73v0_A04	8012048	8012516	BnaA04T0046700ZY	0	+	0	0	468	0.0000000
zheyou73v0_A04	8019162	8021070	BnaA04T0046800ZY	0	+	0	0	1908	0.0000000
zheyou73v0_A04	8023817	8025763	BnaA04T0046900ZY	0	-	0	0	1946	0.0000000
zheyou73v0_A04	8030879	8031472	BnaA04T0047000ZY	0	-	0	0	593	0.0000000
zheyou73v0_A04	8051079	8051656	BnaA04T0047100ZY	0	-	0	0	577	0.0000000
zheyou73v0_A04	8080321	8081277	BnaA04T0047200ZY	0	-	0	0	956	0.0000000
zheyou73v0_A04	8103299	8104436	BnaA04T0047300ZY	0	-	0	0	1137	0.0000000
zheyou73v0_A04	8111919	8112450	BnaA04T0047400ZY	0	-	0	0	531	0.0000000
zheyou73v0_A04	8123044	8129435	BnaA04T0047500ZY	0	-	0	0	6391	0.0000000
zheyou73v0_A04	8132450	8134458	BnaA04T0047600ZY	0	+	0	0	2008	0.0000000
zheyou73v0_A04	8135987	8138361	BnaA04T0047700ZY	0	+	0	0	2374	0.0000000
zheyou73v0_A04	8148869	8174076	BnaA04T0047800ZY	0	+	0	0	25207	0.0000000
zheyou73v0_A04	8179954	8182267	BnaA04T0047900ZY	0	+	0	0	2313	0.0000000
zheyou73v0_A04	8192404	8199094	BnaA04T0048000ZY	0	+	0	0	6690	0.0000000
zheyou73v0_A04	8269552	8272093	BnaA04T0048100ZY	0	+	0	0	2541	0.0000000
zheyou73v0_A04	8272466	8273157	BnaA04T0048200ZY	0	-	0	0	691	0.0000000
zheyou73v0_A04	8273554	8273710	BnaA04T0048300ZY	0	-	0	0	156	0.0000000
zheyou73v0_A04	8281194	8284685	BnaA04T0048400ZY	0	+	0	0	3491	0.0000000
zheyou73v0_A04	8301485	8302996	BnaA04T0048500ZY	0	+	0	0	1511	0.0000000
zheyou73v0_A04	8303765	8306604	BnaA04T0048600ZY	0	+	0	0	2839	0.0000000
zheyou73v0_A04	8309820	8316729	BnaA04T0048700ZY	0	+	0	0	6909	0.0000000
zheyou73v0_A04	8318912	8319847	BnaA04T0048800ZY	0	+	0	0	935	0.0000000
zheyou73v0_A04	8320065	8321947	BnaA04T0048900ZY	0	-	0	0	1882	0.0000000
zheyou73v0_A04	8320065	8321947	BnaA04T0048900ZY.1	0	-	0	0	1882	0.0000000
zheyou73v0_A04	8320065	8321947	BnaA04T0048900ZY.2	0	-	0	0	1882	0.0000000
zheyou73v0_A04	8323739	8325396	BnaA04T0049000ZY	0	+	0	0	1657	0.0000000
zheyou73v0_A04	8326940	8329069	BnaA04T0049100ZY	0	-	0	0	2129	0.0000000
zheyou73v0_A04	8328331	8329101	BnaA04T0049100ZY.1	0	-	0	0	770	0.0000000
zheyou73v0_A04	8333086	8337183	BnaA04T0049200ZY	0	-	0	0	4097	0.0000000
zheyou73v0_A04	8343612	8344315	BnaA04T0049300ZY	0	-	0	0	703	0.0000000
zheyou73v0_A04	8345415	8348180	BnaA04T0049400ZY	0	+	0	0	2765	0.0000000
zheyou73v0_A04	8348285	8350281	BnaA04T0049500ZY	0	-	0	0	1996	0.0000000
zheyou73v0_A04	8351001	8351916	BnaA04T0049600ZY	0	+	0	0	915	0.0000000
zheyou73v0_A04	8362394	8365187	BnaA04T0049700ZY	0	+	0	0	2793	0.0000000
zheyou73v0_A04	8373575	8374903	BnaA04T0049800ZY	0	+	0	0	1328	0.0000000
zheyou73v0_A04	8377474	8379246	BnaA04T0049900ZY	0	+	0	0	1772	0.0000000
zheyou73v0_A04	8382799	8385575	BnaA04T0050000ZY	0	-	0	0	2776	0.0000000
zheyou73v0_A04	8387326	8388160	BnaA04T0050100ZY	0	-	0	0	834	0.0000000
zheyou73v0_A04	8389437	8390598	BnaA04T0050200ZY	0	-	0	0	1161	0.0000000
zheyou73v0_A04	8427321	8428670	BnaA04T0050300ZY	0	-	0	0	1349	0.0000000
zheyou73v0_A04	8433529	8436371	BnaA04T0050400ZY	0	+	0	0	2842	0.0000000
zheyou73v0_A04	8448819	8450820	BnaA04T0050500ZY	0	+	0	0	2001	0.0000000
zheyou73v0_A04	8452402	8455772	BnaA04T0050600ZY	0	-	0	0	3370	0.0000000
zheyou73v0_A04	8459371	8462168	BnaA04T0050700ZY	0	-	0	0	2797	0.0000000
zheyou73v0_A04	8459371	8462168	BnaA04T0050700ZY.1	0	-	0	0	2797	0.0000000
zheyou73v0_A04	8465037	8465466	BnaA04T0050800ZY	0	+	0	0	429	0.0000000
zheyou73v0_A04	8479877	8482092	BnaA04T0050900ZY	0	+	0	0	2215	0.0000000
zheyou73v0_A04	8486216	8487669	BnaA04T0051000ZY	0	-	0	0	1453	0.0000000
zheyou73v0_A04	8494211	8495065	BnaA04T0051100ZY	0	+	0	0	854	0.0000000
zheyou73v0_A04	8510389	8511237	BnaA04T0051200ZY	0	+	0	0	848	0.0000000
zheyou73v0_A04	8512851	8517021	BnaA04T0051300ZY	0	-	0	0	4170	0.0000000
zheyou73v0_A04	8512851	8517021	BnaA04T0051300ZY.1	0	-	0	0	4170	0.0000000
zheyou73v0_A04	8533961	8536872	BnaA04T0051400ZY	0	-	0	0	2911	0.0000000
zheyou73v0_A04	8538074	8538578	BnaA04T0051500ZY	0	+	0	0	504	0.0000000
zheyou73v0_A04	8545573	8547230	BnaA04T0051600ZY	0	+	0	0	1657	0.0000000
zheyou73v0_A04	8555532	8556930	BnaA04T0051700ZY	0	+	0	0	1398	0.0000000
zheyou73v0_A04	8574315	8575095	BnaA04T0051800ZY	0	-	0	0	780	0.0000000
zheyou73v0_A04	8578713	8578866	BnaA04T0051900ZY	0	-	0	0	153	0.0000000
zheyou73v0_A04	8581907	8582631	BnaA04T0052000ZY	0	-	0	0	724	0.0000000
zheyou73v0_A04	8593670	8596115	BnaA04T0052100ZY	0	+	0	0	2445	0.0000000
zheyou73v0_A04	8607882	8610416	BnaA04T0052200ZY	0	+	0	0	2534	0.0000000
zheyou73v0_A04	8607882	8610416	BnaA04T0052200ZY.1	0	+	0	0	2534	0.0000000
zheyou73v0_A04	8607882	8610416	BnaA04T0052200ZY.2	0	+	0	0	2534	0.0000000
zheyou73v0_A04	8614219	8615483	BnaA04T0052300ZY	0	-	0	0	1264	0.0000000
zheyou73v0_A04	8616175	8616394	BnaA04T0052400ZY	0	+	0	0	219	0.0000000
zheyou73v0_A04	8617118	8617832	BnaA04T0052500ZY	0	-	0	0	714	0.0000000
zheyou73v0_A04	8619808	8621252	BnaA04T0052600ZY	0	+	0	0	1444	0.0000000
zheyou73v0_A04	8625304	8627575	BnaA04T0052700ZY	0	+	0	0	2271	0.0000000
zheyou73v0_A04	8627623	8628181	BnaA04T0052800ZY	0	-	0	0	558	0.0000000
zheyou73v0_A04	8629991	8632467	BnaA04T0052900ZY	0	-	0	0	2476	0.0000000
zheyou73v0_A04	8648068	8650394	BnaA04T0053000ZY	0	+	0	0	2326	0.0000000
zheyou73v0_A04	8664703	8665810	BnaA04T0053100ZY	0	+	0	0	1107	0.0000000
zheyou73v0_A04	8666361	8668798	BnaA04T0053200ZY	0	-	0	0	2437	0.0000000
zheyou73v0_A04	8691518	8692620	BnaA04T0053300ZY	0	-	0	0	1102	0.0000000
zheyou73v0_A04	8692969	8693584	BnaA04T0053400ZY	0	+	0	0	615	0.0000000
zheyou73v0_A04	8699803	8700719	BnaA04T0053500ZY	0	-	0	0	916	0.0000000
zheyou73v0_A04	8700736	8701278	BnaA04T0053600ZY	0	-	0	0	542	0.0000000
zheyou73v0_A04	8705640	8708224	BnaA04T0053700ZY	0	+	0	0	2584	0.0000000
zheyou73v0_A04	8710524	8712545	BnaA04T0053800ZY	0	-	0	0	2021	0.0000000
zheyou73v0_A04	8710524	8712545	BnaA04T0053800ZY.1	0	-	0	0	2021	0.0000000
zheyou73v0_A04	8714095	8716087	BnaA04T0053900ZY	0	-	0	0	1992	0.0000000
zheyou73v0_A04	8714095	8716087	BnaA04T0053900ZY.1	0	-	0	0	1992	0.0000000
zheyou73v0_A04	8717755	8718212	BnaA04T0054000ZY	0	-	0	0	457	0.0000000
zheyou73v0_A04	8718950	8722039	BnaA04T0054100ZY	0	+	0	0	3089	0.0000000
zheyou73v0_A04	8723793	8727046	BnaA04T0054200ZY	0	-	0	0	3253	0.0000000
zheyou73v0_A04	8730684	8732379	BnaA04T0054300ZY	0	-	0	0	1695	0.0000000
zheyou73v0_A04	8736497	8737673	BnaA04T0054400ZY	0	-	0	0	1176	0.0000000
zheyou73v0_A04	8761909	8763842	BnaA04T0054500ZY	0	+	0	0	1933	0.0000000
zheyou73v0_A04	8764746	8765951	BnaA04T0054600ZY	0	-	0	0	1205	0.0000000
zheyou73v0_A04	8767606	8771592	BnaA04T0054700ZY	0	-	0	0	3986	0.0000000
zheyou73v0_A04	8774840	8775500	BnaA04T0054800ZY	0	+	0	0	660	0.0000000
zheyou73v0_A04	8781966	8786875	BnaA04T0054900ZY	0	+	0	0	4909	0.0000000
zheyou73v0_A04	8787514	8797333	BnaA04T0055000ZY	0	+	0	0	9819	0.0000000
zheyou73v0_A04	8787514	8797333	BnaA04T0055000ZY.1	0	+	0	0	9819	0.0000000
zheyou73v0_A04	8798759	8799098	BnaA04T0055100ZY	0	-	0	0	339	0.0000000
zheyou73v0_A04	8803508	8806166	BnaA04T0055200ZY	0	+	0	0	2658	0.0000000
zheyou73v0_A04	8809213	8809783	BnaA04T0055300ZY	0	+	0	0	570	0.0000000
zheyou73v0_A04	8812740	8813690	BnaA04T0055400ZY	0	-	0	0	950	0.0000000
zheyou73v0_A04	8818380	8820132	BnaA04T0055500ZY	0	+	0	0	1752	0.0000000
zheyou73v0_A04	8820361	8821797	BnaA04T0055600ZY	0	-	0	0	1436	0.0000000
zheyou73v0_A04	8821820	8822820	BnaA04T0055700ZY	0	-	0	0	1000	0.0000000
zheyou73v0_A04	8827951	8830041	BnaA04T0055800ZY	0	-	0	0	2090	0.0000000
zheyou73v0_A04	8837041	8839027	BnaA04T0055900ZY	0	-	0	0	1986	0.0000000
zheyou73v0_A04	8842172	8843535	BnaA04T0056000ZY	0	-	0	0	1363	0.0000000
zheyou73v0_A04	8847223	8859448	BnaA04T0056100ZY	0	+	0	0	12225	0.0000000
zheyou73v0_A04	8860285	8862307	BnaA04T0056200ZY	0	+	0	0	2022	0.0000000
zheyou73v0_A04	8862400	8864370	BnaA04T0056300ZY	0	-	0	0	1970	0.0000000
zheyou73v0_A04	8869675	8870396	BnaA04T0056400ZY	0	+	0	0	721	0.0000000
zheyou73v0_A04	8870881	8872840	BnaA04T0056500ZY	0	-	0	0	1959	0.0000000
zheyou73v0_A04	8874034	8875967	BnaA04T0056600ZY	0	-	0	0	1933	0.0000000
zheyou73v0_A04	8884027	8885332	BnaA04T0056700ZY	0	-	0	0	1305	0.0000000
zheyou73v0_A04	8905503	8907853	BnaA04T0056800ZY	0	-	0	0	2350	0.0000000
zheyou73v0_A04	8938498	8939593	BnaA04T0056900ZY	0	-	0	0	1095	0.0000000
zheyou73v0_A04	8942776	8944537	BnaA04T0057000ZY	0	+	0	0	1761	0.0000000
zheyou73v0_A04	8944420	8946862	BnaA04T0057100ZY	0	-	0	0	2442	0.0000000
zheyou73v0_A04	8947073	8947364	BnaA04T0057200ZY	0	+	0	0	291	0.0000000
zheyou73v0_A04	8950137	8953649	BnaA04T0057300ZY	0	-	0	0	3512	0.0000000
zheyou73v0_A04	8962038	8964152	BnaA04T0057400ZY	0	-	0	0	2114	0.0000000
zheyou73v0_A04	8964655	8966108	BnaA04T0057500ZY	0	-	0	0	1453	0.0000000
zheyou73v0_A04	8964655	8966108	BnaA04T0057500ZY.1	0	-	0	0	1453	0.0000000
zheyou73v0_A04	8965227	8966108	BnaA04T0057500ZY.2	0	-	0	0	881	0.0000000
zheyou73v0_A04	8972306	8973344	BnaA04T0057600ZY	0	+	0	0	1038	0.0000000
zheyou73v0_A04	8978757	8983623	BnaA04T0057700ZY	0	+	0	0	4866	0.0000000
zheyou73v0_A04	8979520	8983623	BnaA04T0057700ZY.1	0	+	0	0	4103	0.0000000
zheyou73v0_A04	8984698	8986115	BnaA04T0057800ZY	0	-	0	0	1417	0.0000000
zheyou73v0_A04	8986480	8991012	BnaA04T0057900ZY	0	-	0	0	4532	0.0000000
zheyou73v0_A04	8994922	8995478	BnaA04T0058000ZY	0	-	0	0	556	0.0000000
zheyou73v0_A04	9004830	9008084	BnaA04T0058100ZY	0	+	0	0	3254	0.0000000
zheyou73v0_A04	9008306	9010993	BnaA04T0058200ZY	0	-	0	0	2687	0.0000000
zheyou73v0_A04	9017418	9019615	BnaA04T0058300ZY	0	+	0	0	2197	0.0000000
zheyou73v0_A04	9019698	9023611	BnaA04T0058400ZY	0	-	0	0	3913	0.0000000
zheyou73v0_A04	9019698	9023611	BnaA04T0058400ZY.1	0	-	0	0	3913	0.0000000
zheyou73v0_A04	9019698	9023611	BnaA04T0058400ZY.2	0	-	0	0	3913	0.0000000
zheyou73v0_A04	9019698	9022758	BnaA04T0058400ZY.3	0	-	0	0	3060	0.0000000
zheyou73v0_A04	9028179	9033495	BnaA04T0058500ZY	0	-	0	0	5316	0.0000000
zheyou73v0_A04	9049469	9050407	BnaA04T0058600ZY	0	+	0	0	938	0.0000000
zheyou73v0_A04	9053507	9056209	BnaA04T0058700ZY	0	+	0	0	2702	0.0000000
zheyou73v0_A04	9058845	9072391	BnaA04T0058800ZY	0	-	0	0	13546	0.0000000
zheyou73v0_A04	9082807	9086573	BnaA04T0058900ZY	0	-	0	0	3766	0.0000000
zheyou73v0_A04	9092003	9093125	BnaA04T0059000ZY	0	-	0	0	1122	0.0000000
zheyou73v0_A04	9100908	9101695	BnaA04T0059100ZY	0	-	0	0	787	0.0000000
zheyou73v0_A04	9103113	9105016	BnaA04T0059200ZY	0	+	0	0	1903	0.0000000
zheyou73v0_A04	9106296	9107268	BnaA04T0059300ZY	0	+	0	0	972	0.0000000
zheyou73v0_A04	9111043	9114297	BnaA04T0059400ZY	0	-	0	0	3254	0.0000000
zheyou73v0_A04	9114578	9117860	BnaA04T0059500ZY	0	+	0	0	3282	0.0000000
zheyou73v0_A04	9121290	9121639	BnaA04T0059600ZY	0	+	0	0	349	0.0000000
zheyou73v0_A04	9122228	9123575	BnaA04T0059700ZY	0	-	0	0	1347	0.0000000
zheyou73v0_A04	9131441	9131911	BnaA04T0059800ZY	0	-	0	0	470	0.0000000
zheyou73v0_A04	9139230	9139682	BnaA04T0059900ZY	0	+	0	0	452	0.0000000
zheyou73v0_A04	9149824	9152357	BnaA04T0060000ZY	0	+	0	0	2533	0.0000000
zheyou73v0_A04	9154493	9156864	BnaA04T0060100ZY	0	-	0	0	2371	0.0000000
zheyou73v0_A04	9157951	9161071	BnaA04T0060200ZY	0	+	0	0	3120	0.0000000
zheyou73v0_A04	9166619	9168342	BnaA04T0060300ZY	0	-	0	0	1723	0.0000000
zheyou73v0_A04	9168509	9170602	BnaA04T0060400ZY	0	-	0	0	2093	0.0000000
zheyou73v0_A04	9171651	9172963	BnaA04T0060500ZY	0	+	0	0	1312	0.0000000
zheyou73v0_A04	9175296	9176615	BnaA04T0060600ZY	0	-	0	0	1319	0.0000000
zheyou73v0_A04	9189232	9191272	BnaA04T0060700ZY	0	-	0	0	2040	0.0000000
zheyou73v0_A04	9202313	9203098	BnaA04T0060800ZY	0	+	0	0	785	0.0000000
zheyou73v0_A04	9207793	9208291	BnaA04T0060900ZY	0	-	0	0	498	0.0000000
zheyou73v0_A04	9211716	9212877	BnaA04T0061000ZY	0	-	0	0	1161	0.0000000
zheyou73v0_A04	9217544	9221671	BnaA04T0061100ZY	0	+	0	0	4127	0.0000000
zheyou73v0_A04	9217544	9221671	BnaA04T0061100ZY.1	0	+	0	0	4127	0.0000000
zheyou73v0_A04	9220513	9221623	BnaA04T0061200ZY	0	-	0	0	1110	0.0000000
zheyou73v0_A04	9226074	9228232	BnaA04T0061300ZY	0	+	0	0	2158	0.0000000
zheyou73v0_A04	9236645	9238148	BnaA04T0061400ZY	0	-	0	0	1503	0.0000000
zheyou73v0_A04	9239945	9245440	BnaA04T0061500ZY	0	+	0	0	5495	0.0000000
zheyou73v0_A04	9248549	9249951	BnaA04T0061600ZY	0	-	0	0	1402	0.0000000
zheyou73v0_A04	9251557	9253701	BnaA04T0061700ZY	0	+	0	0	2144	0.0000000
zheyou73v0_A04	9263162	9263733	BnaA04T0061800ZY	0	+	0	0	571	0.0000000
zheyou73v0_A04	9268826	9276794	BnaA04T0061900ZY	0	+	0	0	7968	0.0000000
zheyou73v0_A04	9278076	9278710	BnaA04T0062000ZY	0	+	0	0	634	0.0000000
zheyou73v0_A04	9287167	9288234	BnaA04T0062100ZY	0	-	0	0	1067	0.0000000
zheyou73v0_A04	9289163	9289549	BnaA04T0062200ZY	0	-	0	0	386	0.0000000
zheyou73v0_A04	9292452	9293571	BnaA04T0062300ZY	0	+	0	0	1119	0.0000000
zheyou73v0_A04	9321687	9324944	BnaA04T0062400ZY	0	-	0	0	3257	0.0000000
zheyou73v0_A04	9321687	9324944	BnaA04T0062400ZY.1	0	-	0	0	3257	0.0000000
zheyou73v0_A04	9359377	9360088	BnaA04T0062500ZY	0	-	0	0	711	0.0000000
zheyou73v0_A04	9366506	9367513	BnaA04T0062600ZY	0	+	0	0	1007	0.0000000
zheyou73v0_A04	9367747	9369813	BnaA04T0062700ZY	0	-	0	0	2066	0.0000000
zheyou73v0_A04	9385485	9387159	BnaA04T0062800ZY	0	+	0	0	1674	0.0000000
zheyou73v0_A04	9389931	9392321	BnaA04T0062900ZY	0	-	0	0	2390	0.0000000
zheyou73v0_A04	9390437	9392321	BnaA04T0062900ZY.1	0	-	0	0	1884	0.0000000
zheyou73v0_A04	9394637	9396607	BnaA04T0063000ZY	0	-	0	0	1970	0.0000000
zheyou73v0_A04	9397629	9399229	BnaA04T0063100ZY	0	+	0	0	1600	0.0000000
zheyou73v0_A04	9397629	9399229	BnaA04T0063100ZY.1	0	+	0	0	1600	0.0000000
zheyou73v0_A04	9403204	9408281	BnaA04T0063200ZY	0	+	0	0	5077	0.0000000
zheyou73v0_A04	9412288	9412624	BnaA04T0063300ZY	0	+	0	0	336	0.0000000
zheyou73v0_A04	9430350	9432624	BnaA04T0063400ZY	0	+	0	0	2274	0.0000000
zheyou73v0_A04	9452733	9455653	BnaA04T0063500ZY	0	+	0	0	2920	0.0000000
zheyou73v0_A04	9456475	9457439	BnaA04T0063600ZY	0	+	0	0	964	0.0000000
zheyou73v0_A04	9457590	9458989	BnaA04T0063700ZY	0	-	0	0	1399	0.0000000
zheyou73v0_A04	9460773	9461487	BnaA04T0063800ZY	0	+	0	0	714	0.0000000
zheyou73v0_A04	9463900	9464071	BnaA04T0063900ZY	0	-	0	0	171	0.0000000
zheyou73v0_A04	9465187	9468831	BnaA04T0064000ZY	0	-	0	0	3644	0.0000000
zheyou73v0_A04	9478275	9479767	BnaA04T0064100ZY	0	+	0	0	1492	0.0000000
zheyou73v0_A04	9505046	9506521	BnaA04T0064200ZY	0	-	0	0	1475	0.0000000
zheyou73v0_A04	9522045	9523266	BnaA04T0064300ZY	0	-	0	0	1221	0.0000000
zheyou73v0_A04	9526015	9526753	BnaA04T0064400ZY	0	-	0	0	738	0.0000000
zheyou73v0_A04	9546102	9546861	BnaA04T0064500ZY	0	-	0	0	759	0.0000000
zheyou73v0_A04	9550389	9552234	BnaA04T0064600ZY	0	+	0	0	1845	0.0000000
zheyou73v0_A04	9558437	9560642	BnaA04T0064700ZY	0	-	0	0	2205	0.0000000
zheyou73v0_A04	9570960	9572677	BnaA04T0064800ZY	0	-	0	0	1717	0.0000000
zheyou73v0_A04	9576685	9577072	BnaA04T0064900ZY	0	-	0	0	387	0.0000000
zheyou73v0_A04	9578023	9589122	BnaA04T0065000ZY	0	-	0	0	11099	0.0000000
zheyou73v0_A04	9593907	9594221	BnaA04T0065100ZY	0	+	0	0	314	0.0000000
zheyou73v0_A04	9597811	9601167	BnaA04T0065200ZY	0	+	0	0	3356	0.0000000
zheyou73v0_A04	9597811	9601167	BnaA04T0065200ZY.1	0	+	0	0	3356	0.0000000
zheyou73v0_A04	9598485	9601172	BnaA04T0065200ZY.2	0	+	0	0	2687	0.0000000
zheyou73v0_A04	9603515	9606863	BnaA04T0065300ZY	0	+	0	0	3348	0.0000000
zheyou73v0_A04	9608980	9611894	BnaA04T0065400ZY	0	+	0	0	2914	0.0000000
zheyou73v0_A04	9612597	9625698	BnaA04T0065500ZY	0	-	0	0	13101	0.0000000
zheyou73v0_A04	9639848	9640844	BnaA04T0065600ZY	0	+	0	0	996	0.0000000
zheyou73v0_A04	9641441	9645031	BnaA04T0065700ZY	0	+	0	0	3590	0.0000000
zheyou73v0_A04	9641441	9645031	BnaA04T0065700ZY.1	0	+	0	0	3590	0.0000000
zheyou73v0_A04	9641441	9645031	BnaA04T0065700ZY.2	0	+	0	0	3590	0.0000000
zheyou73v0_A04	9648484	9650186	BnaA04T0065800ZY	0	+	0	0	1702	0.0000000
zheyou73v0_A04	9648484	9650186	BnaA04T0065800ZY.1	0	+	0	0	1702	0.0000000
zheyou73v0_A04	9661895	9664297	BnaA04T0065900ZY	0	+	0	0	2402	0.0000000
zheyou73v0_A04	9685141	9685961	BnaA04T0066000ZY	0	-	0	0	820	0.0000000
zheyou73v0_A04	9686015	9686683	BnaA04T0066100ZY	0	+	0	0	668	0.0000000
zheyou73v0_A04	9686755	9687822	BnaA04T0066200ZY	0	+	0	0	1067	0.0000000
zheyou73v0_A04	9689318	9692425	BnaA04T0066300ZY	0	+	0	0	3107	0.0000000
zheyou73v0_A04	9689318	9692425	BnaA04T0066300ZY.1	0	+	0	0	3107	0.0000000
zheyou73v0_A04	9699122	9699305	BnaA04T0066400ZY	0	-	0	0	183	0.0000000
zheyou73v0_A04	9699454	9699712	BnaA04T0066500ZY	0	+	0	0	258	0.0000000
zheyou73v0_A04	9702065	9704856	BnaA04T0066600ZY	0	-	0	0	2791	0.0000000
zheyou73v0_A04	9716140	9717833	BnaA04T0066700ZY	0	+	0	0	1693	0.0000000
zheyou73v0_A04	9742836	9744064	BnaA04T0066800ZY	0	+	0	0	1228	0.0000000
zheyou73v0_A04	9767498	9769349	BnaA04T0066900ZY	0	+	0	0	1851	0.0000000
zheyou73v0_A04	9778018	9780697	BnaA04T0067000ZY	0	-	0	0	2679	0.0000000
zheyou73v0_A04	9790255	9791230	BnaA04T0067100ZY	0	+	0	0	975	0.0000000
zheyou73v0_A04	9791540	9794804	BnaA04T0067200ZY	0	+	0	0	3264	0.0000000
zheyou73v0_A04	9802830	9803130	BnaA04T0067300ZY	0	+	0	0	300	0.0000000
zheyou73v0_A04	9817156	9818490	BnaA04T0067400ZY	0	-	0	0	1334	0.0000000
zheyou73v0_A04	9817156	9818490	BnaA04T0067400ZY.1	0	-	0	0	1334	0.0000000
zheyou73v0_A04	9844515	9846397	BnaA04T0067500ZY	0	-	0	0	1882	0.0000000
zheyou73v0_A04	9857312	9859950	BnaA04T0067600ZY	0	-	0	0	2638	0.0000000
zheyou73v0_A04	9862438	9863140	BnaA04T0067700ZY	0	+	0	0	702	0.0000000
zheyou73v0_A04	9866155	9867231	BnaA04T0067800ZY	0	+	0	0	1076	0.0000000
zheyou73v0_A04	9876138	9877449	BnaA04T0067900ZY	0	-	0	0	1311	0.0000000
zheyou73v0_A04	9879375	9881917	BnaA04T0068000ZY	0	+	0	0	2542	0.0000000
zheyou73v0_A04	9891284	9892335	BnaA04T0068100ZY	0	-	0	0	1051	0.0000000
zheyou73v0_A04	9894390	9895276	BnaA04T0068200ZY	0	-	0	0	886	0.0000000
zheyou73v0_A04	9898143	9903799	BnaA04T0068300ZY	0	-	0	0	5656	0.0000000
zheyou73v0_A04	9906943	9908442	BnaA04T0068400ZY	0	-	0	0	1499	0.0000000
zheyou73v0_A04	9908852	9911520	BnaA04T0068500ZY	0	+	0	0	2668	0.0000000
zheyou73v0_A04	9931715	9941931	BnaA04T0068600ZY	0	+	0	0	10216	0.0000000
zheyou73v0_A04	9948237	9951748	BnaA04T0068700ZY	0	-	0	0	3511	0.0000000
zheyou73v0_A04	9958827	9960893	BnaA04T0068800ZY	0	+	0	0	2066	0.0000000
zheyou73v0_A04	9962813	9964537	BnaA04T0068900ZY	0	-	0	0	1724	0.0000000
zheyou73v0_A04	9982330	9982716	BnaA04T0069000ZY	0	+	0	0	386	0.0000000
zheyou73v0_A04	9994437	9998872	BnaA04T0069100ZY	0	-	0	0	4435	0.0000000
zheyou73v0_A04	10000347	10002689	BnaA04T0069200ZY	0	+	0	0	2342	0.0000000
zheyou73v0_A04	10011388	10014374	BnaA04T0069300ZY	0	+	0	0	2986	0.0000000
zheyou73v0_A04	10016507	10019499	BnaA04T0069400ZY	0	-	0	0	2992	0.0000000
zheyou73v0_A04	10027159	10027810	BnaA04T0069500ZY	0	+	0	0	651	0.0000000
zheyou73v0_A04	10027924	10028731	BnaA04T0069600ZY	0	+	0	0	807	0.0000000
zheyou73v0_A04	10034248	10036419	BnaA04T0069700ZY	0	-	0	0	2171	0.0000000
zheyou73v0_A04	10039543	10040926	BnaA04T0069800ZY	0	-	0	0	1383	0.0000000
zheyou73v0_A04	10043332	10043789	BnaA04T0069900ZY	0	-	0	0	457	0.0000000
zheyou73v0_A04	10047896	10048157	BnaA04T0070000ZY	0	+	0	0	261	0.0000000
zheyou73v0_A04	10056613	10057492	BnaA04T0070100ZY	0	-	0	0	879	0.0000000
zheyou73v0_A04	10087862	10090812	BnaA04T0070200ZY	0	+	0	0	2950	0.0000000
zheyou73v0_A04	10093597	10095265	BnaA04T0070300ZY	0	+	0	0	1668	0.0000000
zheyou73v0_A04	10102702	10104173	BnaA04T0070400ZY	0	+	0	0	1471	0.0000000
zheyou73v0_A04	10114688	10115781	BnaA04T0070500ZY	0	+	0	0	1093	0.0000000
zheyou73v0_A04	10134298	10135362	BnaA04T0070600ZY	0	+	0	0	1064	0.0000000
zheyou73v0_A04	10140657	10143755	BnaA04T0070700ZY	0	+	0	0	3098	0.0000000
zheyou73v0_A04	10144844	10147460	BnaA04T0070800ZY	0	-	0	0	2616	0.0000000
zheyou73v0_A04	10154201	10157387	BnaA04T0070900ZY	0	+	0	0	3186	0.0000000
zheyou73v0_A04	10164520	10169402	BnaA04T0071000ZY	0	+	0	0	4882	0.0000000
zheyou73v0_A04	10184478	10184730	BnaA04T0071100ZY	0	+	0	0	252	0.0000000
zheyou73v0_A04	10204319	10207321	BnaA04T0071200ZY	0	-	0	0	3002	0.0000000
zheyou73v0_A04	10212859	10216214	BnaA04T0071300ZY	0	+	0	0	3355	0.0000000
zheyou73v0_A04	10216314	10218448	BnaA04T0071400ZY	0	-	0	0	2134	0.0000000
zheyou73v0_A04	10219753	10222966	BnaA04T0071500ZY	0	-	0	0	3213	0.0000000
zheyou73v0_A04	10224901	10227024	BnaA04T0071600ZY	0	-	0	0	2123	0.0000000
zheyou73v0_A04	10228024	10229634	BnaA04T0071700ZY	0	+	0	0	1610	0.0000000
zheyou73v0_A04	10244981	10251304	BnaA04T0071800ZY	0	-	0	0	6323	0.0000000
zheyou73v0_A04	10266375	10269620	BnaA04T0071900ZY	0	-	0	0	3245	0.0000000
zheyou73v0_A04	10294120	10295732	BnaA04T0072000ZY	0	-	0	0	1612	0.0000000
zheyou73v0_A04	10294120	10295692	BnaA04T0072000ZY.1	0	-	0	0	1572	0.0000000
zheyou73v0_A04	10300522	10301193	BnaA04T0072100ZY	0	-	0	0	671	0.0000000
zheyou73v0_A04	10322233	10322638	BnaA04T0072200ZY	0	+	0	0	405	0.0000000
zheyou73v0_A04	10324357	10325088	BnaA04T0072300ZY	0	+	0	0	731	0.0000000
zheyou73v0_A04	10342535	10344343	BnaA04T0072400ZY	0	-	0	0	1808	0.0000000
zheyou73v0_A04	10347986	10350945	BnaA04T0072500ZY	0	-	0	0	2959	0.0000000
zheyou73v0_A04	10361576	10367639	BnaA04T0072600ZY	0	+	0	0	6063	0.0000000
zheyou73v0_A04	10378510	10383844	BnaA04T0072700ZY	0	-	0	0	5334	0.0000000
zheyou73v0_A04	10378510	10383508	BnaA04T0072700ZY.1	0	-	0	0	4998	0.0000000
zheyou73v0_A04	10378510	10383844	BnaA04T0072700ZY.2	0	-	0	0	5334	0.0000000
zheyou73v0_A04	10398570	10400481	BnaA04T0072800ZY	0	-	0	0	1911	0.0000000
zheyou73v0_A04	10401551	10402925	BnaA04T0072900ZY	0	-	0	0	1374	0.0000000
zheyou73v0_A04	10401551	10402925	BnaA04T0072900ZY.1	0	-	0	0	1374	0.0000000
zheyou73v0_A04	10404035	10405792	BnaA04T0073000ZY	0	-	0	0	1757	0.0000000
zheyou73v0_A04	10408231	10410799	BnaA04T0073100ZY	0	-	0	0	2568	0.0000000
zheyou73v0_A04	10419256	10421482	BnaA04T0073200ZY	0	-	0	0	2226	0.0000000
zheyou73v0_A04	10446211	10447399	BnaA04T0073300ZY	0	-	0	0	1188	0.0000000
zheyou73v0_A04	10450024	10450396	BnaA04T0073400ZY	0	-	0	0	372	0.0000000
zheyou73v0_A04	10452137	10453977	BnaA04T0073500ZY	0	+	0	0	1840	0.0000000
zheyou73v0_A04	10454419	10462736	BnaA04T0073600ZY	0	+	0	0	8317	0.0000000
zheyou73v0_A04	10474289	10476442	BnaA04T0073700ZY	0	+	0	0	2153	0.0000000
zheyou73v0_A04	10474289	10476442	BnaA04T0073700ZY.1	0	+	0	0	2153	0.0000000
zheyou73v0_A04	10479897	10481355	BnaA04T0073800ZY	0	+	0	0	1458	0.0000000
zheyou73v0_A04	10482155	10482906	BnaA04T0073900ZY	0	+	0	0	751	0.0000000
zheyou73v0_A04	10483390	10484749	BnaA04T0074000ZY	0	-	0	0	1359	0.0000000
zheyou73v0_A04	10486240	10489622	BnaA04T0074100ZY	0	-	0	0	3382	0.0000000
zheyou73v0_A04	10500275	10503773	BnaA04T0074200ZY	0	-	0	0	3498	0.0000000
zheyou73v0_A04	10500275	10503773	BnaA04T0074200ZY.1	0	-	0	0	3498	0.0000000
zheyou73v0_A04	10506423	10507444	BnaA04T0074300ZY	0	-	0	0	1021	0.0000000
zheyou73v0_A04	10510543	10512233	BnaA04T0074400ZY	0	-	0	0	1690	0.0000000
zheyou73v0_A04	10515152	10515782	BnaA04T0074500ZY	0	+	0	0	630	0.0000000
zheyou73v0_A04	10516352	10516619	BnaA04T0074600ZY	0	-	0	0	267	0.0000000
zheyou73v0_A04	10524116	10527714	BnaA04T0074700ZY	0	-	0	0	3598	0.0000000
zheyou73v0_A04	10528294	10529811	BnaA04T0074800ZY	0	+	0	0	1517	0.0000000
zheyou73v0_A04	10530125	10532143	BnaA04T0074900ZY	0	-	0	0	2018	0.0000000
zheyou73v0_A04	10541107	10542342	BnaA04T0075000ZY	0	+	0	0	1235	0.0000000
zheyou73v0_A04	10543946	10544411	BnaA04T0075100ZY	0	-	0	0	465	0.0000000
zheyou73v0_A04	10544947	10550246	BnaA04T0075200ZY	0	-	0	0	5299	0.0000000
zheyou73v0_A04	10562026	10562887	BnaA04T0075300ZY	0	-	0	0	861	0.0000000
zheyou73v0_A04	10565642	10566260	BnaA04T0075400ZY	0	-	0	0	618	0.0000000
zheyou73v0_A04	10573417	10575983	BnaA04T0075500ZY	0	-	0	0	2566	0.0000000
zheyou73v0_A04	10577390	10578217	BnaA04T0075600ZY	0	-	0	0	827	0.0000000
zheyou73v0_A04	10583349	10584509	BnaA04T0075700ZY	0	+	0	0	1160	0.0000000
zheyou73v0_A04	10586432	10586831	BnaA04T0075800ZY	0	+	0	0	399	0.0000000
zheyou73v0_A04	10587488	10590423	BnaA04T0075900ZY	0	-	0	0	2935	0.0000000
zheyou73v0_A04	10599347	10600331	BnaA04T0076000ZY	0	+	0	0	984	0.0000000
zheyou73v0_A04	10612323	10615225	BnaA04T0076100ZY	0	-	0	0	2902	0.0000000
zheyou73v0_A04	10630572	10633475	BnaA04T0076200ZY	0	-	0	0	2903	0.0000000
zheyou73v0_A04	10645607	10648401	BnaA04T0076300ZY	0	+	0	0	2794	0.0000000
zheyou73v0_A04	10650094	10650974	BnaA04T0076400ZY	0	+	0	0	880	0.0000000
zheyou73v0_A04	10652027	10654749	BnaA04T0076500ZY	0	+	0	0	2722	0.0000000
zheyou73v0_A04	10655546	10657714	BnaA04T0076600ZY	0	-	0	0	2168	0.0000000
zheyou73v0_A04	10660063	10662063	BnaA04T0076700ZY	0	-	0	0	2000	0.0000000
zheyou73v0_A04	10664805	10665015	BnaA04T0076800ZY	0	-	0	0	210	0.0000000
zheyou73v0_A04	10665399	10666147	BnaA04T0076900ZY	0	-	0	0	748	0.0000000
zheyou73v0_A04	10669219	10671750	BnaA04T0077000ZY	0	+	0	0	2531	0.0000000
zheyou73v0_A04	10681503	10697030	BnaA04T0077100ZY	0	-	0	0	15527	0.0000000
zheyou73v0_A04	10697263	10698847	BnaA04T0077200ZY	0	+	0	0	1584	0.0000000
zheyou73v0_A04	10699145	10703426	BnaA04T0077300ZY	0	-	0	0	4281	0.0000000
zheyou73v0_A04	10704758	10705807	BnaA04T0077400ZY	0	+	0	0	1049	0.0000000
zheyou73v0_A04	10704758	10705807	BnaA04T0077400ZY.1	0	+	0	0	1049	0.0000000
zheyou73v0_A04	10706564	10707298	BnaA04T0077500ZY	0	+	0	0	734	0.0000000
zheyou73v0_A04	10708870	10709401	BnaA04T0077600ZY	0	-	0	0	531	0.0000000
zheyou73v0_A04	10718397	10721290	BnaA04T0077700ZY	0	+	0	0	2893	0.0000000
zheyou73v0_A04	10722672	10725347	BnaA04T0077800ZY	0	-	0	0	2675	0.0000000
zheyou73v0_A04	10744427	10746291	BnaA04T0077900ZY	0	+	0	0	1864	0.0000000
zheyou73v0_A04	10746315	10747325	BnaA04T0078000ZY	0	-	0	0	1010	0.0000000
zheyou73v0_A04	10748243	10752717	BnaA04T0078100ZY	0	+	0	0	4474	0.0000000
zheyou73v0_A04	10754290	10755204	BnaA04T0078200ZY	0	-	0	0	914	0.0000000
zheyou73v0_A04	10759254	10761103	BnaA04T0078300ZY	0	+	0	0	1849	0.0000000
zheyou73v0_A04	10761736	10763322	BnaA04T0078400ZY	0	+	0	0	1586	0.0000000
zheyou73v0_A04	10763804	10764438	BnaA04T0078500ZY	0	-	0	0	634	0.0000000
zheyou73v0_A04	10765750	10766383	BnaA04T0078600ZY	0	-	0	0	633	0.0000000
zheyou73v0_A04	10770147	10771322	BnaA04T0078700ZY	0	-	0	0	1175	0.0000000
zheyou73v0_A04	10774479	10775895	BnaA04T0078800ZY	0	-	0	0	1416	0.0000000
zheyou73v0_A04	10792453	10793695	BnaA04T0078900ZY	0	-	0	0	1242	0.0000000
zheyou73v0_A04	10800683	10801809	BnaA04T0079000ZY	0	+	0	0	1126	0.0000000
zheyou73v0_A04	10804215	10807461	BnaA04T0079100ZY	0	+	0	0	3246	0.0000000
zheyou73v0_A04	10808709	10812120	BnaA04T0079200ZY	0	-	0	0	3411	0.0000000
zheyou73v0_A04	10813110	10820043	BnaA04T0079300ZY	0	-	0	0	6933	0.0000000
zheyou73v0_A04	10820343	10826307	BnaA04T0079400ZY	0	-	0	0	5964	0.0000000
zheyou73v0_A04	10830472	10830688	BnaA04T0079500ZY	0	+	0	0	216	0.0000000
zheyou73v0_A04	10833977	10835715	BnaA04T0079600ZY	0	-	0	0	1738	0.0000000
zheyou73v0_A04	10847841	10850046	BnaA04T0079700ZY	0	-	0	0	2205	0.0000000
zheyou73v0_A04	10851489	10860060	BnaA04T0079800ZY	0	-	0	0	8571	0.0000000
zheyou73v0_A04	10871774	10873450	BnaA04T0079900ZY	0	+	0	0	1676	0.0000000
zheyou73v0_A04	10874789	10881066	BnaA04T0080000ZY	0	+	0	0	6277	0.0000000
zheyou73v0_A04	10939198	10941215	BnaA04T0080100ZY	0	+	0	0	2017	0.0000000
zheyou73v0_A04	10942885	10944032	BnaA04T0080200ZY	0	+	0	0	1147	0.0000000
zheyou73v0_A04	10944701	10945079	BnaA04T0080300ZY	0	-	0	0	378	0.0000000
zheyou73v0_A04	10946275	10949518	BnaA04T0080400ZY	0	-	0	0	3243	0.0000000
zheyou73v0_A04	10963735	10967799	BnaA04T0080500ZY	0	-	0	0	4064	0.0000000
zheyou73v0_A04	10968481	10968637	BnaA04T0080600ZY	0	-	0	0	156	0.0000000
zheyou73v0_A04	10968781	10972669	BnaA04T0080700ZY	0	-	0	0	3888	0.0000000
zheyou73v0_A04	10974132	10974675	BnaA04T0080800ZY	0	+	0	0	543	0.0000000
zheyou73v0_A04	10975957	10976661	BnaA04T0080900ZY	0	-	0	0	704	0.0000000
zheyou73v0_A04	10978408	10979520	BnaA04T0081000ZY	0	+	0	0	1112	0.0000000
zheyou73v0_A04	10981307	10983057	BnaA04T0081100ZY	0	+	0	0	1750	0.0000000
zheyou73v0_A04	10983994	10985608	BnaA04T0081200ZY	0	+	0	0	1614	0.0000000
zheyou73v0_A04	11003995	11006751	BnaA04T0081300ZY	0	+	0	0	2756	0.0000000
zheyou73v0_A04	11006825	11007256	BnaA04T0081400ZY	0	+	0	0	431	0.0000000
zheyou73v0_A04	11009678	11011128	BnaA04T0081500ZY	0	+	0	0	1450	0.0000000
zheyou73v0_A04	11012131	11013534	BnaA04T0081600ZY	0	-	0	0	1403	0.0000000
zheyou73v0_A04	11021588	11023663	BnaA04T0081700ZY	0	+	0	0	2075	0.0000000
zheyou73v0_A04	11023714	11024644	BnaA04T0081800ZY	0	-	0	0	930	0.0000000
zheyou73v0_A04	11029103	11030515	BnaA04T0081900ZY	0	+	0	0	1412	0.0000000
zheyou73v0_A04	11042383	11045863	BnaA04T0082000ZY	0	+	0	0	3480	0.0000000
zheyou73v0_A04	11051258	11052833	BnaA04T0082100ZY	0	-	0	0	1575	0.0000000
zheyou73v0_A04	11056883	11059416	BnaA04T0082200ZY	0	-	0	0	2533	0.0000000
zheyou73v0_A04	11064456	11064915	BnaA04T0082300ZY	0	-	0	0	459	0.0000000
zheyou73v0_A04	11070447	11071985	BnaA04T0082400ZY	0	-	0	0	1538	0.0000000
zheyou73v0_A04	11082443	11084733	BnaA04T0082500ZY	0	+	0	0	2290	0.0000000
zheyou73v0_A04	11089598	11094767	BnaA04T0082600ZY	0	+	0	0	5169	0.0000000
zheyou73v0_A04	11111140	11111612	BnaA04T0082700ZY	0	+	0	0	472	0.0000000
zheyou73v0_A04	11116238	11119015	BnaA04T0082800ZY	0	-	0	0	2777	0.0000000
zheyou73v0_A04	11123840	11125063	BnaA04T0082900ZY	0	+	0	0	1223	0.0000000
zheyou73v0_A04	11126525	11127212	BnaA04T0083000ZY	0	+	0	0	687	0.0000000
zheyou73v0_A04	11128121	11129017	BnaA04T0083100ZY	0	-	0	0	896	0.0000000
zheyou73v0_A04	11129331	11130886	BnaA04T0083200ZY	0	-	0	0	1555	0.0000000
zheyou73v0_A04	11131537	11132082	BnaA04T0083300ZY	0	-	0	0	545	0.0000000
zheyou73v0_A04	11134339	11136421	BnaA04T0083400ZY	0	+	0	0	2082	0.0000000
zheyou73v0_A04	11137550	11139946	BnaA04T0083500ZY	0	-	0	0	2396	0.0000000
zheyou73v0_A04	11140857	11142647	BnaA04T0083600ZY	0	-	0	0	1790	0.0000000
zheyou73v0_A04	11140857	11142647	BnaA04T0083600ZY.1	0	-	0	0	1790	0.0000000
zheyou73v0_A04	11165166	11171141	BnaA04T0083700ZY	0	-	0	0	5975	0.0000000
zheyou73v0_A04	11175301	11177895	BnaA04T0083800ZY	0	+	0	0	2594	0.0000000
zheyou73v0_A04	11179487	11179746	BnaA04T0083900ZY	0	+	0	0	259	0.0000000
zheyou73v0_A04	11184412	11188296	BnaA04T0084000ZY	0	+	0	0	3884	0.0000000
zheyou73v0_A04	11188951	11191868	BnaA04T0084100ZY	0	-	0	0	2917	0.0000000
zheyou73v0_A04	11192090	11194725	BnaA04T0084200ZY	0	+	0	0	2635	0.0000000
zheyou73v0_A04	11194768	11195179	BnaA04T0084300ZY	0	+	0	0	411	0.0000000
zheyou73v0_A04	11199499	11201182	BnaA04T0084400ZY	0	-	0	0	1683	0.0000000
zheyou73v0_A04	11210891	11212115	BnaA04T0084500ZY	0	+	0	0	1224	0.0000000
zheyou73v0_A04	11215421	11217869	BnaA04T0084600ZY	0	-	0	0	2448	0.0000000
zheyou73v0_A04	11219524	11222050	BnaA04T0084700ZY	0	+	0	0	2526	0.0000000
zheyou73v0_A04	11231827	11232840	BnaA04T0084800ZY	0	+	0	0	1013	0.0000000
zheyou73v0_A04	11256225	11256615	BnaA04T0084900ZY	0	+	0	0	390	0.0000000
zheyou73v0_A04	11269640	11271875	BnaA04T0085000ZY	0	+	0	0	2235	0.0000000
zheyou73v0_A04	11277354	11278395	BnaA04T0085100ZY	0	+	0	0	1041	0.0000000
zheyou73v0_A04	11285615	11286665	BnaA04T0085200ZY	0	+	0	0	1050	0.0000000
zheyou73v0_A04	11287429	11288781	BnaA04T0085300ZY	0	+	0	0	1352	0.0000000
zheyou73v0_A04	11287429	11288781	BnaA04T0085300ZY.1	0	+	0	0	1352	0.0000000
zheyou73v0_A04	11289522	11290171	BnaA04T0085400ZY	0	-	0	0	649	0.0000000
zheyou73v0_A04	11291226	11294256	BnaA04T0085500ZY	0	+	0	0	3030	0.0000000
zheyou73v0_A04	11294723	11297100	BnaA04T0085600ZY	0	+	0	0	2377	0.0000000
zheyou73v0_A04	11297322	11307111	BnaA04T0085700ZY	0	-	0	0	9789	0.0000000
zheyou73v0_A04	11335485	11336726	BnaA04T0085800ZY	0	-	0	0	1241	0.0000000
zheyou73v0_A04	11340538	11343545	BnaA04T0085900ZY	0	+	0	0	3007	0.0000000
zheyou73v0_A04	11340538	11343545	BnaA04T0085900ZY.1	0	+	0	0	3007	0.0000000
zheyou73v0_A04	11343760	11347655	BnaA04T0086000ZY	0	-	0	0	3895	0.0000000
zheyou73v0_A04	11353383	11354792	BnaA04T0086100ZY	0	+	0	0	1409	0.0000000
zheyou73v0_A04	11354971	11357029	BnaA04T0086200ZY	0	-	0	0	2058	0.0000000
zheyou73v0_A04	11359319	11359478	BnaA04T0086300ZY	0	-	0	0	159	0.0000000
zheyou73v0_A04	11360868	11361480	BnaA04T0086400ZY	0	+	0	0	612	0.0000000
zheyou73v0_A04	11369570	11371243	BnaA04T0086500ZY	0	-	0	0	1673	0.0000000
zheyou73v0_A04	11371633	11376343	BnaA04T0086600ZY	0	-	0	0	4710	0.0000000
zheyou73v0_A04	11371633	11376343	BnaA04T0086600ZY.1	0	-	0	0	4710	0.0000000
zheyou73v0_A04	11382953	11386008	BnaA04T0086700ZY	0	+	0	0	3055	0.0000000
zheyou73v0_A04	11390970	11394194	BnaA04T0086800ZY	0	+	0	0	3224	0.0000000
zheyou73v0_A04	11395036	11395748	BnaA04T0086900ZY	0	+	0	0	712	0.0000000
zheyou73v0_A04	11398449	11401643	BnaA04T0087000ZY	0	+	0	0	3194	0.0000000
zheyou73v0_A04	11398449	11401643	BnaA04T0087000ZY.1	0	+	0	0	3194	0.0000000
zheyou73v0_A04	11398449	11401643	BnaA04T0087000ZY.2	0	+	0	0	3194	0.0000000
zheyou73v0_A04	11423897	11426315	BnaA04T0087100ZY	0	-	0	0	2418	0.0000000
zheyou73v0_A04	11435227	11438653	BnaA04T0087200ZY	0	+	0	0	3426	0.0000000
zheyou73v0_A04	11439331	11442262	BnaA04T0087300ZY	0	-	0	0	2931	0.0000000
zheyou73v0_A04	11445405	11447237	BnaA04T0087400ZY	0	-	0	0	1832	0.0000000
zheyou73v0_A04	11447325	11448206	BnaA04T0087500ZY	0	-	0	0	881	0.0000000
zheyou73v0_A04	11451200	11452904	BnaA04T0087600ZY	0	+	0	0	1704	0.0000000
zheyou73v0_A04	11455025	11458634	BnaA04T0087700ZY	0	-	0	0	3609	0.0000000
zheyou73v0_A04	11461980	11463886	BnaA04T0087800ZY	0	-	0	0	1906	0.0000000
zheyou73v0_A04	11465254	11466431	BnaA04T0087900ZY	0	+	0	0	1177	0.0000000
zheyou73v0_A04	11465254	11466431	BnaA04T0087900ZY.1	0	+	0	0	1177	0.0000000
zheyou73v0_A04	11469015	11470321	BnaA04T0088000ZY	0	+	0	0	1306	0.0000000
zheyou73v0_A04	11471501	11472872	BnaA04T0088100ZY	0	+	0	0	1371	0.0000000
zheyou73v0_A04	11477481	11480252	BnaA04T0088200ZY	0	-	0	0	2771	0.0000000
zheyou73v0_A04	11481253	11482934	BnaA04T0088300ZY	0	-	0	0	1681	0.0000000
zheyou73v0_A04	11484187	11486826	BnaA04T0088400ZY	0	-	0	0	2639	0.0000000
zheyou73v0_A04	11491308	11494325	BnaA04T0088500ZY	0	+	0	0	3017	0.0000000
zheyou73v0_A04	11494963	11497143	BnaA04T0088600ZY	0	-	0	0	2180	0.0000000
zheyou73v0_A04	11508601	11511249	BnaA04T0088700ZY	0	-	0	0	2648	0.0000000
zheyou73v0_A04	11522425	11525258	BnaA04T0088800ZY	0	+	0	0	2833	0.0000000
zheyou73v0_A04	11525316	11527613	BnaA04T0088900ZY.1	0	-	0	0	2297	0.0000000
zheyou73v0_A04	11525370	11527613	BnaA04T0088900ZY	0	-	0	0	2243	0.0000000
zheyou73v0_A04	11536648	11538998	BnaA04T0089000ZY	0	-	0	0	2350	0.0000000
zheyou73v0_A04	11553127	11553325	BnaA04T0089100ZY	0	-	0	0	198	0.0000000
zheyou73v0_A04	11581760	11582725	BnaA04T0089200ZY	0	-	0	0	965	0.0000000
zheyou73v0_A04	11583779	11586361	BnaA04T0089300ZY	0	-	0	0	2582	0.0000000
zheyou73v0_A04	11589540	11600773	BnaA04T0089400ZY	0	+	0	0	11233	0.0000000
zheyou73v0_A04	11606366	11608587	BnaA04T0089500ZY	0	+	0	0	2221	0.0000000
zheyou73v0_A04	11606366	11608587	BnaA04T0089500ZY.1	0	+	0	0	2221	0.0000000
zheyou73v0_A04	11608756	11610433	BnaA04T0089600ZY	0	-	0	0	1677	0.0000000
zheyou73v0_A04	11621179	11633615	BnaA04T0089700ZY	0	+	0	0	12436	0.0000000
zheyou73v0_A04	11633635	11636722	BnaA04T0089800ZY	0	-	0	0	3087	0.0000000
zheyou73v0_A04	11640326	11640854	BnaA04T0089900ZY	0	-	0	0	528	0.0000000
zheyou73v0_A04	11643027	11644412	BnaA04T0090000ZY	0	+	0	0	1385	0.0000000
zheyou73v0_A04	11647886	11650991	BnaA04T0090100ZY	0	+	0	0	3105	0.0000000
zheyou73v0_A04	11654729	11657200	BnaA04T0090200ZY	0	+	0	0	2471	0.0000000
zheyou73v0_A04	11663047	11665918	BnaA04T0090300ZY	0	-	0	0	2871	0.0000000
zheyou73v0_A04	11671201	11677757	BnaA04T0090400ZY	0	+	0	0	6556	0.0000000
zheyou73v0_A04	11678137	11680945	BnaA04T0090500ZY	0	-	0	0	2808	0.0000000
zheyou73v0_A04	11678137	11680945	BnaA04T0090500ZY.1	0	-	0	0	2808	0.0000000
zheyou73v0_A04	11681961	11684032	BnaA04T0090600ZY	0	-	0	0	2071	0.0000000
zheyou73v0_A04	11685798	11687373	BnaA04T0090700ZY	0	+	0	0	1575	0.0000000
zheyou73v0_A04	11687672	11691162	BnaA04T0090800ZY	0	-	0	0	3490	0.0000000
zheyou73v0_A04	11691501	11692581	BnaA04T0090900ZY	0	-	0	0	1080	0.0000000
zheyou73v0_A04	11696426	11698038	BnaA04T0091000ZY	0	-	0	0	1612	0.0000000
zheyou73v0_A04	11700800	11705463	BnaA04T0091100ZY	0	-	0	0	4663	0.0000000
zheyou73v0_A04	11711458	11720163	BnaA04T0091200ZY	0	+	0	0	8705	0.0000000
zheyou73v0_A04	11723365	11724445	BnaA04T0091300ZY	0	+	0	0	1080	0.0000000
zheyou73v0_A04	11725573	11729141	BnaA04T0091400ZY	0	-	0	0	3568	0.0000000
zheyou73v0_A04	11730248	11731079	BnaA04T0091500ZY	0	-	0	0	831	0.0000000
zheyou73v0_A04	11731631	11732054	BnaA04T0091600ZY	0	-	0	0	423	0.0000000
zheyou73v0_A04	11732688	11734528	BnaA04T0091700ZY	0	+	0	0	1840	0.0000000
zheyou73v0_A04	11735880	11741591	BnaA04T0091800ZY	0	+	0	0	5711	0.0000000
zheyou73v0_A04	11746998	11752294	BnaA04T0091900ZY	0	+	0	0	5296	0.0000000
zheyou73v0_A04	11753337	11760753	BnaA04T0092000ZY	0	-	0	0	7416	0.0000000
zheyou73v0_A04	11767749	11768634	BnaA04T0092100ZY	0	+	0	0	885	0.0000000
zheyou73v0_A04	11769136	11770584	BnaA04T0092200ZY	0	+	0	0	1448	0.0000000
zheyou73v0_A04	11774313	11774978	BnaA04T0092300ZY	0	+	0	0	665	0.0000000
zheyou73v0_A04	11776055	11778693	BnaA04T0092400ZY	0	+	0	0	2638	0.0000000
zheyou73v0_A04	11779505	11785862	BnaA04T0092500ZY	0	+	0	0	6357	0.0000000
zheyou73v0_A04	11779505	11785504	BnaA04T0092500ZY.1	0	+	0	0	5999	0.0000000
zheyou73v0_A04	11792635	11793760	BnaA04T0092600ZY	0	+	0	0	1125	0.0000000
zheyou73v0_A04	11795614	11796870	BnaA04T0092700ZY	0	+	0	0	1256	0.0000000
zheyou73v0_A04	11798442	11800824	BnaA04T0092800ZY	0	-	0	0	2382	0.0000000
zheyou73v0_A04	11809253	11810433	BnaA04T0092900ZY	0	-	0	0	1180	0.0000000
zheyou73v0_A04	11831394	11834949	BnaA04T0093000ZY	0	+	0	0	3555	0.0000000
zheyou73v0_A04	11853776	11854499	BnaA04T0093100ZY	0	-	0	0	723	0.0000000
zheyou73v0_A04	11862760	11863477	BnaA04T0093200ZY	0	+	0	0	717	0.0000000
zheyou73v0_A04	11864099	11864877	BnaA04T0093300ZY	0	+	0	0	778	0.0000000
zheyou73v0_A04	11865612	11867063	BnaA04T0093400ZY	0	-	0	0	1451	0.0000000
zheyou73v0_A04	11868731	11870556	BnaA04T0093500ZY	0	+	0	0	1825	0.0000000
zheyou73v0_A04	11871218	11872334	BnaA04T0093600ZY	0	+	0	0	1116	0.0000000
zheyou73v0_A04	11873140	11874822	BnaA04T0093700ZY	0	-	0	0	1682	0.0000000
zheyou73v0_A04	11876781	11877807	BnaA04T0093800ZY	0	-	0	0	1026	0.0000000
zheyou73v0_A04	11878550	11878882	BnaA04T0093900ZY	0	-	0	0	332	0.0000000
zheyou73v0_A04	11883356	11885732	BnaA04T0094000ZY	0	-	0	0	2376	0.0000000
zheyou73v0_A04	11885759	11886560	BnaA04T0094100ZY	0	-	0	0	801	0.0000000
zheyou73v0_A04	11887494	11888869	BnaA04T0094200ZY	0	-	0	0	1375	0.0000000
zheyou73v0_A04	11899781	11902209	BnaA04T0094300ZY	0	+	0	0	2428	0.0000000
zheyou73v0_A04	11907149	11907404	BnaA04T0094400ZY	0	-	0	0	255	0.0000000
zheyou73v0_A04	11915215	11916848	BnaA04T0094500ZY	0	+	0	0	1633	0.0000000
zheyou73v0_A04	11917239	11918958	BnaA04T0094600ZY	0	-	0	0	1719	0.0000000
zheyou73v0_A04	11919703	11924024	BnaA04T0094700ZY	0	+	0	0	4321	0.0000000
zheyou73v0_A04	11924230	11925510	BnaA04T0094800ZY	0	-	0	0	1280	0.0000000
zheyou73v0_A04	11927178	11933504	BnaA04T0094900ZY	0	-	0	0	6326	0.0000000
zheyou73v0_A04	11944549	11944966	BnaA04T0095000ZY	0	-	0	0	417	0.0000000
zheyou73v0_A04	11958265	11960125	BnaA04T0095100ZY	0	+	0	0	1860	0.0000000
zheyou73v0_A04	11960881	11963121	BnaA04T0095200ZY	0	-	0	0	2240	0.0000000
zheyou73v0_A04	11963980	11964295	BnaA04T0095300ZY	0	+	0	0	315	0.0000000
zheyou73v0_A04	11965171	11967794	BnaA04T0095400ZY	0	-	0	0	2623	0.0000000
zheyou73v0_A04	11968318	11970421	BnaA04T0095500ZY	0	-	0	0	2103	0.0000000
zheyou73v0_A04	11968318	11970192	BnaA04T0095500ZY.1	0	-	0	0	1874	0.0000000
zheyou73v0_A04	11981291	11983822	BnaA04T0095600ZY	0	+	0	0	2531	0.0000000
zheyou73v0_A04	11994443	11995422	BnaA04T0095700ZY	0	+	0	0	979	0.0000000
zheyou73v0_A04	11995832	11996925	BnaA04T0095800ZY	0	-	0	0	1093	0.0000000
zheyou73v0_A04	12000394	12001151	BnaA04T0095900ZY	0	+	0	0	757	0.0000000
zheyou73v0_A04	12001905	12004041	BnaA04T0096000ZY	0	+	0	0	2136	0.0000000
zheyou73v0_A04	12008143	12009389	BnaA04T0096100ZY	0	-	0	0	1246	0.0000000
zheyou73v0_A04	12013576	12014646	BnaA04T0096200ZY	0	-	0	0	1070	0.0000000
zheyou73v0_A04	12015241	12020499	BnaA04T0096300ZY	0	-	0	0	5258	0.0000000
zheyou73v0_A04	12022049	12025485	BnaA04T0096400ZY	0	+	0	0	3436	0.0000000
zheyou73v0_A04	12030232	12031913	BnaA04T0096500ZY	0	+	0	0	1681	0.0000000
zheyou73v0_A04	12033623	12033872	BnaA04T0096600ZY	0	-	0	0	249	0.0000000
zheyou73v0_A04	12033945	12034480	BnaA04T0096700ZY	0	-	0	0	535	0.0000000
zheyou73v0_A04	12051059	12052683	BnaA04T0096800ZY	0	+	0	0	1624	0.0000000
zheyou73v0_A04	12051059	12052683	BnaA04T0096800ZY.1	0	+	0	0	1624	0.0000000
zheyou73v0_A04	12053909	12056103	BnaA04T0096900ZY	0	-	0	0	2194	0.0000000
zheyou73v0_A04	12058601	12066237	BnaA04T0097000ZY	0	+	0	0	7636	0.0000000
zheyou73v0_A04	12066612	12072452	BnaA04T0097100ZY	0	-	0	0	5840	0.0000000
zheyou73v0_A04	12075413	12076286	BnaA04T0097200ZY	0	-	0	0	873	0.0000000
zheyou73v0_A04	12076356	12077353	BnaA04T0097300ZY	0	-	0	0	997	0.0000000
zheyou73v0_A04	12085387	12086732	BnaA04T0097400ZY	0	+	0	0	1345	0.0000000
zheyou73v0_A04	12089090	12089833	BnaA04T0097500ZY	0	-	0	0	743	0.0000000
zheyou73v0_A04	12090353	12096668	BnaA04T0097600ZY	0	-	0	0	6315	0.0000000
zheyou73v0_A04	12100063	12108140	BnaA04T0097700ZY	0	-	0	0	8077	0.0000000
zheyou73v0_A04	12121468	12123853	BnaA04T0097800ZY	0	+	0	0	2385	0.0000000
zheyou73v0_A04	12125403	12125703	BnaA04T0097900ZY	0	+	0	0	300	0.0000000
zheyou73v0_A04	12126627	12128730	BnaA04T0098000ZY	0	+	0	0	2103	0.0000000
zheyou73v0_A04	12126627	12128874	BnaA04T0098000ZY.1	0	+	0	0	2247	0.0000000
zheyou73v0_A04	12140668	12142812	BnaA04T0098100ZY	0	+	0	0	2144	0.0000000
zheyou73v0_A04	12143231	12145673	BnaA04T0098200ZY	0	-	0	0	2442	0.0000000
zheyou73v0_A04	12156372	12157945	BnaA04T0098300ZY	0	-	0	0	1573	0.0000000
zheyou73v0_A04	12159708	12161296	BnaA04T0098400ZY	0	+	0	0	1588	0.0000000
zheyou73v0_A04	12161916	12164245	BnaA04T0098500ZY	0	-	0	0	2329	0.0000000
zheyou73v0_A04	12168492	12170513	BnaA04T0098600ZY	0	+	0	0	2021	0.0000000
zheyou73v0_A04	12174427	12175839	BnaA04T0098700ZY	0	+	0	0	1412	0.0000000
zheyou73v0_A04	12176964	12179790	BnaA04T0098800ZY	0	-	0	0	2826	0.0000000
zheyou73v0_A04	12184626	12185765	BnaA04T0098900ZY	0	+	0	0	1139	0.0000000
zheyou73v0_A04	12197627	12198728	BnaA04T0099000ZY	0	+	0	0	1101	0.0000000
zheyou73v0_A04	12239380	12243012	BnaA04T0099100ZY	0	+	0	0	3632	0.0000000
zheyou73v0_A04	12248874	12251328	BnaA04T0099200ZY	0	+	0	0	2454	0.0000000
zheyou73v0_A04	12253231	12255145	BnaA04T0099300ZY	0	+	0	0	1914	0.0000000
zheyou73v0_A04	12267926	12272753	BnaA04T0099400ZY	0	-	0	0	4827	0.0000000
zheyou73v0_A04	12275226	12276778	BnaA04T0099500ZY	0	+	0	0	1552	0.0000000
zheyou73v0_A04	12276838	12278715	BnaA04T0099600ZY	0	-	0	0	1877	0.0000000
zheyou73v0_A04	12294374	12295393	BnaA04T0099700ZY	0	-	0	0	1019	0.0000000
zheyou73v0_A04	12299877	12300667	BnaA04T0099800ZY	0	+	0	0	790	0.0000000
zheyou73v0_A04	12301426	12302613	BnaA04T0099900ZY	0	-	0	0	1187	0.0000000
zheyou73v0_A04	12304145	12304709	BnaA04T0100000ZY	0	+	0	0	564	0.0000000
zheyou73v0_A04	12331732	12333471	BnaA04T0100100ZY	0	-	0	0	1739	0.0000000
zheyou73v0_A04	12350968	12352009	BnaA04T0100200ZY	0	-	0	0	1041	0.0000000
zheyou73v0_A04	12362491	12366638	BnaA04T0100300ZY	0	-	0	0	4147	0.0000000
zheyou73v0_A04	12368476	12374012	BnaA04T0100400ZY	0	+	0	0	5536	0.0000000
zheyou73v0_A04	12377812	12382225	BnaA04T0100500ZY	0	+	0	0	4413	0.0000000
zheyou73v0_A04	12382433	12386823	BnaA04T0100600ZY	0	-	0	0	4390	0.0000000
zheyou73v0_A04	12389921	12390927	BnaA04T0100700ZY	0	+	0	0	1006	0.0000000
zheyou73v0_A04	12391789	12392980	BnaA04T0100800ZY	0	+	0	0	1191	0.0000000
zheyou73v0_A04	12405653	12407140	BnaA04T0100900ZY	0	+	0	0	1487	0.0000000
zheyou73v0_A04	12413380	12417863	BnaA04T0101000ZY	0	-	0	0	4483	0.0000000
zheyou73v0_A04	12429389	12430690	BnaA04T0101100ZY	0	+	0	0	1301	0.0000000
zheyou73v0_A04	12433888	12434301	BnaA04T0101200ZY	0	+	0	0	413	0.0000000
zheyou73v0_A04	12439393	12441281	BnaA04T0101300ZY	0	-	0	0	1888	0.0000000
zheyou73v0_A04	12449553	12451312	BnaA04T0101400ZY	0	-	0	0	1759	0.0000000
zheyou73v0_A04	12454226	12455704	BnaA04T0101500ZY	0	+	0	0	1478	0.0000000
zheyou73v0_A04	12461366	12462684	BnaA04T0101600ZY	0	-	0	0	1318	0.0000000
zheyou73v0_A04	12464460	12465743	BnaA04T0101700ZY	0	-	0	0	1283	0.0000000
zheyou73v0_A04	12482882	12483431	BnaA04T0101800ZY	0	+	0	0	549	0.0000000
zheyou73v0_A04	12493931	12494261	BnaA04T0101900ZY	0	+	0	0	330	0.0000000
zheyou73v0_A04	12495375	12495829	BnaA04T0102000ZY	0	-	0	0	454	0.0000000
zheyou73v0_A04	12496308	12498634	BnaA04T0102100ZY	0	-	0	0	2326	0.0000000
zheyou73v0_A04	12496308	12498567	BnaA04T0102100ZY.1	0	-	0	0	2259	0.0000000
zheyou73v0_A04	12496308	12498567	BnaA04T0102100ZY.2	0	-	0	0	2259	0.0000000
zheyou73v0_A04	12500886	12504216	BnaA04T0102200ZY	0	-	0	0	3330	0.0000000
zheyou73v0_A04	12519481	12520234	BnaA04T0102300ZY	0	-	0	0	753	0.0000000
zheyou73v0_A04	12522718	12525753	BnaA04T0102400ZY	0	-	0	0	3035	0.0000000
zheyou73v0_A04	12527225	12530581	BnaA04T0102500ZY	0	+	0	0	3356	0.0000000
zheyou73v0_A04	12546628	12548720	BnaA04T0102600ZY	0	+	0	0	2092	0.0000000
zheyou73v0_A04	12546628	12548720	BnaA04T0102600ZY.1	0	+	0	0	2092	0.0000000
zheyou73v0_A04	12554152	12556020	BnaA04T0102700ZY	0	-	0	0	1868	0.0000000
zheyou73v0_A04	12570226	12573072	BnaA04T0102800ZY	0	+	0	0	2846	0.0000000
zheyou73v0_A04	12585019	12589725	BnaA04T0102900ZY	0	-	0	0	4706	0.0000000
zheyou73v0_A04	12590513	12591639	BnaA04T0103000ZY	0	-	0	0	1126	0.0000000
zheyou73v0_A04	12593376	12593849	BnaA04T0103100ZY	0	+	0	0	473	0.0000000
zheyou73v0_A04	12600532	12602983	BnaA04T0103200ZY	0	+	0	0	2451	0.0000000
zheyou73v0_A04	12605594	12608025	BnaA04T0103300ZY	0	-	0	0	2431	0.0000000
zheyou73v0_A04	12618090	12627773	BnaA04T0103400ZY	0	+	0	0	9683	0.0000000
zheyou73v0_A04	12629120	12629842	BnaA04T0103500ZY	0	+	0	0	722	0.0000000
zheyou73v0_A04	12630765	12633634	BnaA04T0103600ZY	0	-	0	0	2869	0.0000000
zheyou73v0_A04	12644837	12647160	BnaA04T0103700ZY	0	+	0	0	2323	0.0000000
zheyou73v0_A04	12647983	12648184	BnaA04T0103800ZY	0	-	0	0	201	0.0000000
zheyou73v0_A04	12648243	12648945	BnaA04T0103900ZY	0	-	0	0	702	0.0000000
zheyou73v0_A04	12650176	12652468	BnaA04T0104000ZY	0	+	0	0	2292	0.0000000
zheyou73v0_A04	12652695	12656238	BnaA04T0104100ZY	0	-	0	0	3543	0.0000000
zheyou73v0_A04	12666085	12669896	BnaA04T0104200ZY	0	-	0	0	3811	0.0000000
zheyou73v0_A04	12672942	12680511	BnaA04T0104300ZY	0	-	0	0	7569	0.0000000
zheyou73v0_A04	12681287	12684835	BnaA04T0104400ZY	0	-	0	0	3548	0.0000000
zheyou73v0_A04	12690489	12691148	BnaA04T0104500ZY	0	-	0	0	659	0.0000000
zheyou73v0_A04	12692102	12697264	BnaA04T0104600ZY	0	-	0	0	5162	0.0000000
zheyou73v0_A04	12692102	12697264	BnaA04T0104600ZY.1	0	-	0	0	5162	0.0000000
zheyou73v0_A04	12702046	12702472	BnaA04T0104700ZY	0	-	0	0	426	0.0000000
zheyou73v0_A04	12705129	12705796	BnaA04T0104800ZY	0	-	0	0	667	0.0000000
zheyou73v0_A04	12719960	12722491	BnaA04T0104900ZY	0	-	0	0	2531	0.0000000
zheyou73v0_A04	12724274	12725134	BnaA04T0105000ZY	0	-	0	0	860	0.0000000
zheyou73v0_A04	12737295	12737735	BnaA04T0105100ZY	0	+	0	0	440	0.0000000
zheyou73v0_A04	12741691	12745070	BnaA04T0105200ZY	0	-	0	0	3379	0.0000000
zheyou73v0_A04	12747169	12751701	BnaA04T0105300ZY	0	+	0	0	4532	0.0000000
zheyou73v0_A04	12753898	12757440	BnaA04T0105400ZY	0	+	0	0	3542	0.0000000
zheyou73v0_A04	12764340	12769416	BnaA04T0105500ZY	0	-	0	0	5076	0.0000000
zheyou73v0_A04	12776719	12781123	BnaA04T0105600ZY	0	-	0	0	4404	0.0000000
zheyou73v0_A04	12782934	12785105	BnaA04T0105700ZY	0	+	0	0	2171	0.0000000
zheyou73v0_A04	12792300	12795251	BnaA04T0105800ZY	0	+	0	0	2951	0.0000000
zheyou73v0_A04	12809677	12811478	BnaA04T0105900ZY	0	+	0	0	1801	0.0000000
zheyou73v0_A04	12812767	12815656	BnaA04T0106000ZY	0	-	0	0	2889	0.0000000
zheyou73v0_A04	12812767	12815625	BnaA04T0106000ZY.1	0	-	0	0	2858	0.0000000
zheyou73v0_A04	12812767	12815625	BnaA04T0106000ZY.2	0	-	0	0	2858	0.0000000
zheyou73v0_A04	12812767	12815656	BnaA04T0106000ZY.3	0	-	0	0	2889	0.0000000
zheyou73v0_A04	12822861	12823522	BnaA04T0106100ZY	0	+	0	0	661	0.0000000
zheyou73v0_A04	12832430	12834248	BnaA04T0106200ZY	0	+	0	0	1818	0.0000000
zheyou73v0_A04	12834482	12836428	BnaA04T0106300ZY	0	-	0	0	1946	0.0000000
zheyou73v0_A04	12839433	12841141	BnaA04T0106400ZY	0	-	0	0	1708	0.0000000
zheyou73v0_A04	12844421	12845142	BnaA04T0106500ZY	0	-	0	0	721	0.0000000
zheyou73v0_A04	12851365	12851841	BnaA04T0106600ZY	0	-	0	0	476	0.0000000
zheyou73v0_A04	12852202	12853862	BnaA04T0106700ZY	0	-	0	0	1660	0.0000000
zheyou73v0_A04	12856744	12857845	BnaA04T0106800ZY	0	-	0	0	1101	0.0000000
zheyou73v0_A04	12859579	12860527	BnaA04T0106900ZY	0	-	0	0	948	0.0000000
zheyou73v0_A04	12867684	12868213	BnaA04T0107000ZY	0	-	0	0	529	0.0000000
zheyou73v0_A04	12870275	12872420	BnaA04T0107100ZY	0	-	0	0	2145	0.0000000
zheyou73v0_A04	12872615	12874260	BnaA04T0107200ZY	0	+	0	0	1645	0.0000000
zheyou73v0_A04	12874537	12875667	BnaA04T0107300ZY	0	-	0	0	1130	0.0000000
zheyou73v0_A04	12878316	12880252	BnaA04T0107400ZY	0	+	0	0	1936	0.0000000
zheyou73v0_A04	12881467	12882679	BnaA04T0107500ZY	0	+	0	0	1212	0.0000000
zheyou73v0_A04	12883528	12891339	BnaA04T0107600ZY	0	+	0	0	7811	0.0000000
zheyou73v0_A04	12897158	12898433	BnaA04T0107700ZY	0	+	0	0	1275	0.0000000
zheyou73v0_A04	12906302	12909303	BnaA04T0107800ZY	0	-	0	0	3001	0.0000000
zheyou73v0_A04	12906302	12909303	BnaA04T0107800ZY.1	0	-	0	0	3001	0.0000000
zheyou73v0_A04	12915843	12916441	BnaA04T0107900ZY	0	-	0	0	598	0.0000000
zheyou73v0_A04	12936213	12936848	BnaA04T0108000ZY	0	-	0	0	635	0.0000000
zheyou73v0_A04	12949992	12956100	BnaA04T0108100ZY	0	+	0	0	6108	0.0000000
zheyou73v0_A04	12957368	12960877	BnaA04T0108200ZY	0	-	0	0	3509	0.0000000
zheyou73v0_A04	12957368	12960877	BnaA04T0108200ZY.1	0	-	0	0	3509	0.0000000
zheyou73v0_A04	12969778	12969958	BnaA04T0108300ZY	0	-	0	0	180	0.0000000
zheyou73v0_A04	12974123	12974453	BnaA04T0108400ZY	0	-	0	0	330	0.0000000
zheyou73v0_A04	12974629	12975087	BnaA04T0108500ZY	0	-	0	0	458	0.0000000
zheyou73v0_A04	12977151	12978338	BnaA04T0108600ZY	0	-	0	0	1187	0.0000000
zheyou73v0_A04	12978764	12984927	BnaA04T0108700ZY	0	+	0	0	6163	0.0000000
zheyou73v0_A04	12987997	12989550	BnaA04T0108800ZY	0	+	0	0	1553	0.0000000
zheyou73v0_A04	12996546	13001860	BnaA04T0108900ZY	0	+	0	0	5314	0.0000000
zheyou73v0_A04	13003822	13004216	BnaA04T0109000ZY	0	+	0	0	394	0.0000000
zheyou73v0_A04	13011221	13012690	BnaA04T0109100ZY	0	-	0	0	1469	0.0000000
zheyou73v0_A04	13013140	13015586	BnaA04T0109200ZY	0	-	0	0	2446	0.0000000
zheyou73v0_A04	13019850	13022140	BnaA04T0109300ZY	0	+	0	0	2290	0.0000000
zheyou73v0_A04	13024267	13025927	BnaA04T0109400ZY	0	+	0	0	1660	0.0000000
zheyou73v0_A04	13042946	13046985	BnaA04T0109500ZY	0	-	0	0	4039	0.0000000
zheyou73v0_A04	13060301	13061483	BnaA04T0109600ZY	0	+	0	0	1182	0.0000000
zheyou73v0_A04	13074663	13075071	BnaA04T0109700ZY	0	-	0	0	408	0.0000000
zheyou73v0_A04	13074663	13075071	BnaA04T0109700ZY.1	0	-	0	0	408	0.0000000
zheyou73v0_A04	13096071	13096561	BnaA04T0109800ZY	0	-	0	0	490	0.0000000
zheyou73v0_A04	13098671	13099313	BnaA04T0109900ZY	0	+	0	0	642	0.0000000
zheyou73v0_A04	13101377	13101835	BnaA04T0110000ZY	0	+	0	0	458	0.0000000
zheyou73v0_A04	13102011	13102590	BnaA04T0110100ZY	0	+	0	0	579	0.0000000
zheyou73v0_A04	13113396	13114875	BnaA04T0110200ZY	0	+	0	0	1479	0.0000000
zheyou73v0_A04	13115775	13116512	BnaA04T0110300ZY	0	-	0	0	737	0.0000000
zheyou73v0_A04	13119837	13122176	BnaA04T0110400ZY	0	-	0	0	2339	0.0000000
zheyou73v0_A04	13122381	13124621	BnaA04T0110500ZY	0	-	0	0	2240	0.0000000
zheyou73v0_A04	13137472	13138467	BnaA04T0110600ZY	0	-	0	0	995	0.0000000
zheyou73v0_A04	13155949	13156765	BnaA04T0110700ZY	0	+	0	0	816	0.0000000
zheyou73v0_A04	13162033	13165917	BnaA04T0110800ZY	0	-	0	0	3884	0.0000000
zheyou73v0_A04	13166319	13168183	BnaA04T0110900ZY	0	-	0	0	1864	0.0000000
zheyou73v0_A04	13170058	13171009	BnaA04T0111000ZY	0	-	0	0	951	0.0000000
zheyou73v0_A04	13183039	13183438	BnaA04T0111100ZY	0	+	0	0	399	0.0000000
zheyou73v0_A04	13183816	13184864	BnaA04T0111200ZY	0	+	0	0	1048	0.0000000
zheyou73v0_A04	13186948	13188215	BnaA04T0111300ZY	0	+	0	0	1267	0.0000000
zheyou73v0_A04	13195899	13196196	BnaA04T0111400ZY	0	-	0	0	297	0.0000000
zheyou73v0_A04	13204007	13205698	BnaA04T0111500ZY	0	+	0	0	1691	0.0000000
zheyou73v0_A04	13206617	13213297	BnaA04T0111600ZY	0	+	0	0	6680	0.0000000
zheyou73v0_A04	13213797	13214784	BnaA04T0111700ZY	0	+	0	0	987	0.0000000
zheyou73v0_A04	13216057	13218734	BnaA04T0111800ZY	0	-	0	0	2677	0.0000000
zheyou73v0_A04	13219034	13219787	BnaA04T0111900ZY	0	-	0	0	753	0.0000000
zheyou73v0_A04	13227209	13229286	BnaA04T0112000ZY	0	-	0	0	2077	0.0000000
zheyou73v0_A04	13227209	13229286	BnaA04T0112000ZY.1	0	-	0	0	2077	0.0000000
zheyou73v0_A04	13231332	13231494	BnaA04T0112100ZY	0	-	0	0	162	0.0000000
zheyou73v0_A04	13236244	13236922	BnaA04T0112200ZY	0	-	0	0	678	0.0000000
zheyou73v0_A04	13238912	13239887	BnaA04T0112300ZY	0	+	0	0	975	0.0000000
zheyou73v0_A04	13242324	13244832	BnaA04T0112400ZY	0	+	0	0	2508	0.0000000
zheyou73v0_A04	13242324	13244832	BnaA04T0112400ZY.1	0	+	0	0	2508	0.0000000
zheyou73v0_A04	13245729	13249882	BnaA04T0112500ZY	0	-	0	0	4153	0.0000000
zheyou73v0_A04	13253397	13257177	BnaA04T0112600ZY	0	-	0	0	3780	0.0000000
zheyou73v0_A04	13263991	13266158	BnaA04T0112700ZY	0	-	0	0	2167	0.0000000
zheyou73v0_A04	13269467	13271691	BnaA04T0112800ZY	0	-	0	0	2224	0.0000000
zheyou73v0_A04	13274296	13275265	BnaA04T0112900ZY	0	-	0	0	969	0.0000000
zheyou73v0_A04	13276174	13277003	BnaA04T0113000ZY	0	+	0	0	829	0.0000000
zheyou73v0_A04	13282065	13284981	BnaA04T0113100ZY	0	+	0	0	2916	0.0000000
zheyou73v0_A04	13285542	13285809	BnaA04T0113200ZY	0	+	0	0	267	0.0000000
zheyou73v0_A04	13296388	13297833	BnaA04T0113300ZY	0	-	0	0	1445	0.0000000
zheyou73v0_A04	13298709	13302442	BnaA04T0113400ZY	0	-	0	0	3733	0.0000000
zheyou73v0_A04	13304887	13308886	BnaA04T0113500ZY	0	+	0	0	3999	0.0000000
zheyou73v0_A04	13309852	13311754	BnaA04T0113600ZY	0	+	0	0	1902	0.0000000
zheyou73v0_A04	13312643	13317137	BnaA04T0113700ZY	0	+	0	0	4494	0.0000000
zheyou73v0_A04	13321971	13323177	BnaA04T0113800ZY	0	+	0	0	1206	0.0000000
zheyou73v0_A04	13323493	13326184	BnaA04T0113900ZY	0	-	0	0	2691	0.0000000
zheyou73v0_A04	13327684	13328858	BnaA04T0114000ZY	0	+	0	0	1174	0.0000000
zheyou73v0_A04	13329939	13332267	BnaA04T0114100ZY	0	+	0	0	2328	0.0000000
zheyou73v0_A04	13332604	13335112	BnaA04T0114200ZY	0	-	0	0	2508	0.0000000
zheyou73v0_A04	13335260	13339684	BnaA04T0114300ZY	0	-	0	0	4424	0.0000000
zheyou73v0_A04	13335260	13339684	BnaA04T0114300ZY.1	0	-	0	0	4424	0.0000000
zheyou73v0_A04	13335260	13339684	BnaA04T0114300ZY.2	0	-	0	0	4424	0.0000000
zheyou73v0_A04	13340474	13343262	BnaA04T0114400ZY	0	-	0	0	2788	0.0000000
zheyou73v0_A04	13343489	13346305	BnaA04T0114500ZY	0	-	0	0	2816	0.0000000
zheyou73v0_A04	13343489	13346305	BnaA04T0114500ZY.1	0	-	0	0	2816	0.0000000
zheyou73v0_A04	13348624	13349572	BnaA04T0114600ZY	0	-	0	0	948	0.0000000
zheyou73v0_A04	13355017	13357873	BnaA04T0114700ZY	0	+	0	0	2856	0.0000000
zheyou73v0_A04	13355703	13357873	BnaA04T0114700ZY.1	0	+	0	0	2170	0.0000000
zheyou73v0_A04	13364439	13366973	BnaA04T0114800ZY	0	+	0	0	2534	0.0000000
zheyou73v0_A04	13367095	13373012	BnaA04T0114900ZY	0	-	0	0	5917	0.0000000
zheyou73v0_A04	13375139	13375961	BnaA04T0115000ZY	0	-	0	0	822	0.0000000
zheyou73v0_A04	13376972	13379454	BnaA04T0115100ZY	0	+	0	0	2482	0.0000000
zheyou73v0_A04	13393890	13394703	BnaA04T0115200ZY	0	-	0	0	813	0.0000000
zheyou73v0_A04	13451622	13452871	BnaA04T0115300ZY	0	+	0	0	1249	0.0000000
zheyou73v0_A04	13451622	13452871	BnaA04T0115300ZY.1	0	+	0	0	1249	0.0000000
zheyou73v0_A04	13453199	13456145	BnaA04T0115400ZY	0	-	0	0	2946	0.0000000
zheyou73v0_A04	13453199	13456145	BnaA04T0115400ZY.1	0	-	0	0	2946	0.0000000
zheyou73v0_A04	13459761	13460721	BnaA04T0115500ZY	0	-	0	0	960	0.0000000
zheyou73v0_A04	13463291	13466243	BnaA04T0115600ZY	0	+	0	0	2952	0.0000000
zheyou73v0_A04	13466221	13468795	BnaA04T0115700ZY	0	-	0	0	2574	0.0000000
zheyou73v0_A04	13471647	13472816	BnaA04T0115800ZY	0	+	0	0	1169	0.0000000
zheyou73v0_A04	13471647	13472816	BnaA04T0115800ZY.1	0	+	0	0	1169	0.0000000
zheyou73v0_A04	13471647	13472816	BnaA04T0115800ZY.2	0	+	0	0	1169	0.0000000
zheyou73v0_A04	13471647	13472816	BnaA04T0115800ZY.3	0	+	0	0	1169	0.0000000
zheyou73v0_A04	13474143	13474644	BnaA04T0115900ZY	0	+	0	0	501	0.0000000
zheyou73v0_A04	13474838	13478201	BnaA04T0116000ZY	0	-	0	0	3363	0.0000000
zheyou73v0_A04	13480598	13481592	BnaA04T0116100ZY	0	+	0	0	994	0.0000000
zheyou73v0_A04	13480598	13481592	BnaA04T0116100ZY.1	0	+	0	0	994	0.0000000
zheyou73v0_A04	13484077	13486114	BnaA04T0116200ZY	0	+	0	0	2037	0.0000000
zheyou73v0_A04	13491603	13494618	BnaA04T0116300ZY	0	+	0	0	3015	0.0000000
zheyou73v0_A04	13504129	13507389	BnaA04T0116400ZY	0	-	0	0	3260	0.0000000
zheyou73v0_A04	13509692	13511279	BnaA04T0116500ZY	0	-	0	0	1587	0.0000000
zheyou73v0_A04	13517304	13521603	BnaA04T0116600ZY	0	+	0	0	4299	0.0000000
zheyou73v0_A04	13522227	13524091	BnaA04T0116700ZY	0	-	0	0	1864	0.0000000
zheyou73v0_A04	13533682	13534237	BnaA04T0116800ZY	0	+	0	0	555	0.0000000
zheyou73v0_A04	13544011	13544527	BnaA04T0116900ZY	0	-	0	0	516	0.0000000
zheyou73v0_A04	13545779	13550188	BnaA04T0117000ZY	0	-	0	0	4409	0.0000000
zheyou73v0_A04	13559800	13560341	BnaA04T0117100ZY	0	+	0	0	541	0.0000000
zheyou73v0_A04	13567671	13569161	BnaA04T0117200ZY	0	-	0	0	1490	0.0000000
zheyou73v0_A04	13569793	13570051	BnaA04T0117300ZY	0	+	0	0	258	0.0000000
zheyou73v0_A04	13599446	13599692	BnaA04T0117400ZY	0	+	0	0	246	0.0000000
zheyou73v0_A04	13602719	13603421	BnaA04T0117500ZY	0	+	0	0	702	0.0000000
zheyou73v0_A04	13603816	13604935	BnaA04T0117600ZY	0	-	0	0	1119	0.0000000
zheyou73v0_A04	13612480	13613879	BnaA04T0117700ZY	0	-	0	0	1399	0.0000000
zheyou73v0_A04	13616916	13617635	BnaA04T0117800ZY	0	-	0	0	719	0.0000000
zheyou73v0_A04	13618921	13626071	BnaA04T0117900ZY	0	+	0	0	7150	0.0000000
zheyou73v0_A04	13657351	13657768	BnaA04T0118000ZY	0	-	0	0	417	0.0000000
zheyou73v0_A04	13662123	13662957	BnaA04T0118100ZY	0	-	0	0	834	0.0000000
zheyou73v0_A04	13668039	13668877	BnaA04T0118200ZY	0	+	0	0	838	0.0000000
zheyou73v0_A04	13676022	13680304	BnaA04T0118300ZY	0	-	0	0	4282	0.0000000
zheyou73v0_A04	13687203	13689495	BnaA04T0118400ZY	0	-	0	0	2292	0.0000000
zheyou73v0_A04	13690464	13691974	BnaA04T0118500ZY	0	+	0	0	1510	0.0000000
zheyou73v0_A04	13695519	13698316	BnaA04T0118600ZY	0	+	0	0	2797	0.0000000
zheyou73v0_A04	13700723	13701204	BnaA04T0118700ZY	0	+	0	0	481	0.0000000
zheyou73v0_A04	13704243	13704981	BnaA04T0118800ZY	0	-	0	0	738	0.0000000
zheyou73v0_A04	13725923	13728169	BnaA04T0118900ZY	0	-	0	0	2246	0.0000000
zheyou73v0_A04	13728915	13733585	BnaA04T0119000ZY	0	-	0	0	4670	0.0000000
zheyou73v0_A04	13740094	13744747	BnaA04T0119100ZY	0	+	0	0	4653	0.0000000
zheyou73v0_A04	13744831	13745421	BnaA04T0119200ZY	0	-	0	0	590	0.0000000
zheyou73v0_A04	13748167	13749406	BnaA04T0119300ZY	0	+	0	0	1239	0.0000000
zheyou73v0_A04	13749752	13750049	BnaA04T0119400ZY	0	-	0	0	297	0.0000000
zheyou73v0_A04	13750194	13752020	BnaA04T0119500ZY	0	-	0	0	1826	0.0000000
zheyou73v0_A04	13752420	13754206	BnaA04T0119600ZY	0	+	0	0	1786	0.0000000
zheyou73v0_A04	13754620	13762012	BnaA04T0119700ZY	0	-	0	0	7392	0.0000000
zheyou73v0_A04	13767273	13773727	BnaA04T0119800ZY	0	+	0	0	6454	0.0000000
zheyou73v0_A04	13774697	13776213	BnaA04T0119900ZY	0	-	0	0	1516	0.0000000
zheyou73v0_A04	13777383	13778740	BnaA04T0120000ZY	0	-	0	0	1357	0.0000000
zheyou73v0_A04	13778986	13780668	BnaA04T0120100ZY	0	-	0	0	1682	0.0000000
zheyou73v0_A04	13781776	13783861	BnaA04T0120200ZY	0	+	0	0	2085	0.0000000
zheyou73v0_A04	13787355	13791760	BnaA04T0120300ZY	0	+	0	0	4405	0.0000000
zheyou73v0_A04	13787355	13791760	BnaA04T0120300ZY.1	0	+	0	0	4405	0.0000000
zheyou73v0_A04	13791975	13794949	BnaA04T0120400ZY	0	-	0	0	2974	0.0000000
zheyou73v0_A04	13797660	13798722	BnaA04T0120500ZY	0	-	0	0	1062	0.0000000
zheyou73v0_A04	13799771	13801118	BnaA04T0120600ZY	0	+	0	0	1347	0.0000000
zheyou73v0_A04	13801755	13803156	BnaA04T0120700ZY	0	-	0	0	1401	0.0000000
zheyou73v0_A04	13805578	13806205	BnaA04T0120800ZY	0	+	0	0	627	0.0000000
zheyou73v0_A04	13806999	13807569	BnaA04T0120900ZY	0	+	0	0	570	0.0000000
zheyou73v0_A04	13809278	13812462	BnaA04T0121000ZY	0	+	0	0	3184	0.0000000
zheyou73v0_A04	13813686	13816365	BnaA04T0121100ZY	0	+	0	0	2679	0.0000000
zheyou73v0_A04	13816502	13817454	BnaA04T0121200ZY	0	-	0	0	952	0.0000000
zheyou73v0_A04	13818520	13820224	BnaA04T0121300ZY	0	-	0	0	1704	0.0000000
zheyou73v0_A04	13826524	13827370	BnaA04T0121400ZY	0	+	0	0	846	0.0000000
zheyou73v0_A04	13827584	13827954	BnaA04T0121500ZY	0	+	0	0	370	0.0000000
zheyou73v0_A04	13833013	13834763	BnaA04T0121600ZY	0	+	0	0	1750	0.0000000
zheyou73v0_A04	13833013	13834763	BnaA04T0121600ZY.1	0	+	0	0	1750	0.0000000
zheyou73v0_A04	13842637	13845107	BnaA04T0121700ZY	0	-	0	0	2470	0.0000000
zheyou73v0_A04	13847923	13849138	BnaA04T0121800ZY	0	-	0	0	1215	0.0000000
zheyou73v0_A04	13852913	13857379	BnaA04T0121900ZY	0	+	0	0	4466	0.0000000
zheyou73v0_A04	13858389	13860234	BnaA04T0122000ZY	0	+	0	0	1845	0.0000000
zheyou73v0_A04	13862359	13864161	BnaA04T0122100ZY	0	+	0	0	1802	0.0000000
zheyou73v0_A04	13874332	13876967	BnaA04T0122200ZY	0	+	0	0	2635	0.0000000
zheyou73v0_A04	13875784	13880026	BnaA04T0122300ZY	0	-	0	0	4242	0.0000000
zheyou73v0_A04	13882214	13885339	BnaA04T0122400ZY	0	+	0	0	3125	0.0000000
zheyou73v0_A04	13889929	13890969	BnaA04T0122500ZY	0	+	0	0	1040	0.0000000
zheyou73v0_A04	13908203	13911570	BnaA04T0122600ZY	0	+	0	0	3367	0.0000000
zheyou73v0_A04	13912027	13913263	BnaA04T0122700ZY	0	+	0	0	1236	0.0000000
zheyou73v0_A04	13913513	13916182	BnaA04T0122800ZY	0	-	0	0	2669	0.0000000
zheyou73v0_A04	13919774	13922419	BnaA04T0122900ZY	0	-	0	0	2645	0.0000000
zheyou73v0_A04	13922862	13926238	BnaA04T0123000ZY	0	-	0	0	3376	0.0000000
zheyou73v0_A04	13964883	13965392	BnaA04T0123100ZY	0	-	0	0	509	0.0000000
zheyou73v0_A04	13967218	13970682	BnaA04T0123200ZY	0	-	0	0	3464	0.0000000
zheyou73v0_A04	13971178	13972940	BnaA04T0123300ZY	0	-	0	0	1762	0.0000000
zheyou73v0_A04	13980686	13982370	BnaA04T0123400ZY	0	-	0	0	1684	0.0000000
zheyou73v0_A04	13986344	13989606	BnaA04T0123500ZY	0	+	0	0	3262	0.0000000
zheyou73v0_A04	13995663	13996888	BnaA04T0123600ZY	0	+	0	0	1225	0.0000000
zheyou73v0_A04	14010703	14010898	BnaA04T0123700ZY	0	+	0	0	195	0.0000000
zheyou73v0_A04	14011619	14012837	BnaA04T0123800ZY	0	+	0	0	1218	0.0000000
zheyou73v0_A04	14013626	14014182	BnaA04T0123900ZY	0	-	0	0	556	0.0000000
zheyou73v0_A04	14015761	14016584	BnaA04T0124000ZY	0	-	0	0	823	0.0000000
zheyou73v0_A04	14017956	14019129	BnaA04T0124100ZY	0	+	0	0	1173	0.0000000
zheyou73v0_A04	14023113	14024081	BnaA04T0124200ZY	0	-	0	0	968	0.0000000
zheyou73v0_A04	14028916	14033424	BnaA04T0124300ZY	0	+	0	0	4508	0.0000000
zheyou73v0_A04	14035834	14036558	BnaA04T0124400ZY	0	+	0	0	724	0.0000000
zheyou73v0_A04	14039615	14041451	BnaA04T0124500ZY	0	+	0	0	1836	0.0000000
zheyou73v0_A04	14066852	14068053	BnaA04T0124600ZY	0	-	0	0	1201	0.0000000
zheyou73v0_A04	14075049	14079048	BnaA04T0124700ZY	0	+	0	0	3999	0.0000000
zheyou73v0_A04	14079427	14082879	BnaA04T0124800ZY	0	-	0	0	3452	0.0000000
zheyou73v0_A04	14087115	14088530	BnaA04T0124900ZY	0	-	0	0	1415	0.0000000
zheyou73v0_A04	14093375	14094870	BnaA04T0125000ZY	0	-	0	0	1495	0.0000000
zheyou73v0_A04	14097355	14097762	BnaA04T0125100ZY	0	-	0	0	407	0.0000000
zheyou73v0_A04	14107259	14108417	BnaA04T0125200ZY	0	-	0	0	1158	0.0000000
zheyou73v0_A04	14113889	14117263	BnaA04T0125300ZY	0	-	0	0	3374	0.0000000
zheyou73v0_A04	14113889	14117556	BnaA04T0125300ZY.1	0	-	0	0	3667	0.0000000
zheyou73v0_A04	14117353	14117911	BnaA04T0125400ZY	0	-	0	0	558	0.0000000
zheyou73v0_A04	14119294	14119480	BnaA04T0125500ZY	0	+	0	0	186	0.0000000
zheyou73v0_A04	14119596	14119899	BnaA04T0125600ZY	0	-	0	0	303	0.0000000
zheyou73v0_A04	14122258	14125851	BnaA04T0125700ZY	0	-	0	0	3593	0.0000000
zheyou73v0_A04	14127448	14129572	BnaA04T0125800ZY	0	-	0	0	2124	0.0000000
zheyou73v0_A04	14160489	14161824	BnaA04T0125900ZY	0	-	0	0	1335	0.0000000
zheyou73v0_A04	14169581	14171196	BnaA04T0126000ZY	0	-	0	0	1615	0.0000000
zheyou73v0_A04	14206257	14206666	BnaA04T0126100ZY	0	-	0	0	409	0.0000000
zheyou73v0_A04	14207703	14211145	BnaA04T0126200ZY	0	-	0	0	3442	0.0000000
zheyou73v0_A04	14217346	14219744	BnaA04T0126300ZY	0	+	0	0	2398	0.0000000
zheyou73v0_A04	14220345	14222661	BnaA04T0126400ZY	0	+	0	0	2316	0.0000000
zheyou73v0_A04	14227060	14229289	BnaA04T0126500ZY	0	-	0	0	2229	0.0000000
zheyou73v0_A04	14232719	14234614	BnaA04T0126600ZY	0	+	0	0	1895	0.0000000
zheyou73v0_A04	14258413	14259415	BnaA04T0126700ZY	0	-	0	0	1002	0.0000000
zheyou73v0_A04	14260891	14264411	BnaA04T0126800ZY	0	+	0	0	3520	0.0000000
zheyou73v0_A04	14265966	14267911	BnaA04T0126900ZY	0	+	0	0	1945	0.0000000
zheyou73v0_A04	14268604	14270279	BnaA04T0127000ZY	0	-	0	0	1675	0.0000000
zheyou73v0_A04	14271228	14276142	BnaA04T0127100ZY	0	+	0	0	4914	0.0000000
zheyou73v0_A04	14277436	14284887	BnaA04T0127200ZY	0	+	0	0	7451	0.0000000
zheyou73v0_A04	14284915	14286049	BnaA04T0127300ZY	0	+	0	0	1134	0.0000000
zheyou73v0_A04	14286957	14287185	BnaA04T0127400ZY	0	+	0	0	228	0.0000000
zheyou73v0_A04	14291770	14297416	BnaA04T0127500ZY	0	-	0	0	5646	0.0000000
zheyou73v0_A04	14299899	14303130	BnaA04T0127600ZY	0	+	0	0	3231	0.0000000
zheyou73v0_A04	14303686	14304218	BnaA04T0127700ZY	0	-	0	0	532	0.0000000
zheyou73v0_A04	14307131	14309612	BnaA04T0127800ZY	0	-	0	0	2481	0.0000000
zheyou73v0_A04	14319889	14321199	BnaA04T0127900ZY	0	+	0	0	1310	0.0000000
zheyou73v0_A04	14332802	14335986	BnaA04T0128000ZY	0	+	0	0	3184	0.0000000
zheyou73v0_A04	14336617	14337499	BnaA04T0128100ZY	0	-	0	0	882	0.0000000
zheyou73v0_A04	14346466	14349428	BnaA04T0128200ZY	0	+	0	0	2962	0.0000000
zheyou73v0_A04	14378678	14385290	BnaA04T0128300ZY	0	-	0	0	6612	0.0000000
zheyou73v0_A04	14383170	14385290	BnaA04T0128300ZY.1	0	-	0	0	2120	0.0000000
zheyou73v0_A04	14386122	14392030	BnaA04T0128400ZY	0	-	0	0	5908	0.0000000
zheyou73v0_A04	14392714	14394268	BnaA04T0128500ZY	0	-	0	0	1554	0.0000000
zheyou73v0_A04	14395712	14398956	BnaA04T0128600ZY	0	-	0	0	3244	0.0000000
zheyou73v0_A04	14403255	14404714	BnaA04T0128700ZY	0	+	0	0	1459	0.0000000
zheyou73v0_A04	14408550	14412964	BnaA04T0128800ZY	0	-	0	0	4414	0.0000000
zheyou73v0_A04	14415565	14416152	BnaA04T0128900ZY	0	+	0	0	587	0.0000000
zheyou73v0_A04	14422076	14422913	BnaA04T0129000ZY	0	+	0	0	837	0.0000000
zheyou73v0_A04	14431746	14432069	BnaA04T0129100ZY	0	-	0	0	323	0.0000000
zheyou73v0_A04	14432570	14438263	BnaA04T0129200ZY	0	-	0	0	5693	0.0000000
zheyou73v0_A04	14440996	14444585	BnaA04T0129300ZY	0	-	0	0	3589	0.0000000
zheyou73v0_A04	14444990	14446042	BnaA04T0129400ZY	0	+	0	0	1052	0.0000000
zheyou73v0_A04	14446124	14447419	BnaA04T0129500ZY	0	+	0	0	1295	0.0000000
zheyou73v0_A04	14448310	14449962	BnaA04T0129600ZY	0	+	0	0	1652	0.0000000
zheyou73v0_A04	14452591	14466251	BnaA04T0129700ZY	0	+	0	0	13660	0.0000000
zheyou73v0_A04	14471589	14473503	BnaA04T0129800ZY	0	+	0	0	1914	0.0000000
zheyou73v0_A04	14474810	14477794	BnaA04T0129900ZY	0	-	0	0	2984	0.0000000
zheyou73v0_A04	14482712	14485037	BnaA04T0130000ZY	0	-	0	0	2325	0.0000000
zheyou73v0_A04	14485133	14489702	BnaA04T0130100ZY	0	-	0	0	4569	0.0000000
zheyou73v0_A04	14510466	14513840	BnaA04T0130200ZY	0	+	0	0	3374	0.0000000
zheyou73v0_A04	14511663	14513840	BnaA04T0130200ZY.1	0	+	0	0	2177	0.0000000
zheyou73v0_A04	14514530	14516295	BnaA04T0130300ZY	0	-	0	0	1765	0.0000000
zheyou73v0_A04	14522826	14524647	BnaA04T0130400ZY	0	+	0	0	1821	0.0000000
zheyou73v0_A04	14524627	14525844	BnaA04T0130500ZY	0	-	0	0	1217	0.0000000
zheyou73v0_A04	14527699	14529012	BnaA04T0130600ZY	0	+	0	0	1313	0.0000000
zheyou73v0_A04	14529871	14534312	BnaA04T0130700ZY	0	+	0	0	4441	0.0000000
zheyou73v0_A04	14534997	14536872	BnaA04T0130800ZY	0	+	0	0	1875	0.0000000
zheyou73v0_A04	14537291	14538111	BnaA04T0130900ZY	0	+	0	0	820	0.0000000
zheyou73v0_A04	14538285	14538793	BnaA04T0131000ZY	0	-	0	0	508	0.0000000
zheyou73v0_A04	14543126	14543953	BnaA04T0131100ZY	0	+	0	0	827	0.0000000
zheyou73v0_A04	14547056	14548432	BnaA04T0131200ZY	0	+	0	0	1376	0.0000000
zheyou73v0_A04	14550462	14552348	BnaA04T0131300ZY	0	-	0	0	1886	0.0000000
zheyou73v0_A04	14550462	14552210	BnaA04T0131300ZY.1	0	-	0	0	1748	0.0000000
zheyou73v0_A04	14564277	14567448	BnaA04T0131400ZY	0	+	0	0	3171	0.0000000
zheyou73v0_A04	14572760	14574189	BnaA04T0131500ZY	0	+	0	0	1429	0.0000000
zheyou73v0_A04	14578585	14580443	BnaA04T0131600ZY	0	-	0	0	1858	0.0000000
zheyou73v0_A04	14583917	14586110	BnaA04T0131700ZY	0	-	0	0	2193	0.0000000
zheyou73v0_A04	14587212	14587870	BnaA04T0131800ZY	0	-	0	0	658	0.0000000
zheyou73v0_A04	14588179	14589684	BnaA04T0131900ZY	0	+	0	0	1505	0.0000000
zheyou73v0_A04	14590456	14592856	BnaA04T0132000ZY	0	+	0	0	2400	0.0000000
zheyou73v0_A04	14592944	14595900	BnaA04T0132100ZY	0	+	0	0	2956	0.0000000
zheyou73v0_A04	14597120	14599659	BnaA04T0132200ZY	0	+	0	0	2539	0.0000000
zheyou73v0_A04	14600245	14603275	BnaA04T0132300ZY	0	+	0	0	3030	0.0000000
zheyou73v0_A04	14617201	14617594	BnaA04T0132400ZY	0	+	0	0	393	0.0000000
zheyou73v0_A04	14618760	14620940	BnaA04T0132500ZY	0	+	0	0	2180	0.0000000
zheyou73v0_A04	14621991	14623505	BnaA04T0132600ZY	0	-	0	0	1514	0.0000000
zheyou73v0_A04	14627838	14629965	BnaA04T0132700ZY	0	-	0	0	2127	0.0000000
zheyou73v0_A04	14631405	14633145	BnaA04T0132800ZY	0	+	0	0	1740	0.0000000
zheyou73v0_A04	14631520	14638102	BnaA04T0132900ZY	0	-	0	0	6582	0.0000000
zheyou73v0_A04	14643688	14646975	BnaA04T0133000ZY	0	-	0	0	3287	0.0000000
zheyou73v0_A04	14650010	14650610	BnaA04T0133100ZY	0	-	0	0	600	0.0000000
zheyou73v0_A04	14655844	14657098	BnaA04T0133200ZY	0	-	0	0	1254	0.0000000
zheyou73v0_A04	14669202	14671331	BnaA04T0133300ZY	0	+	0	0	2129	0.0000000
zheyou73v0_A04	14671416	14671620	BnaA04T0133400ZY	0	+	0	0	204	0.0000000
zheyou73v0_A04	14672071	14673429	BnaA04T0133500ZY	0	-	0	0	1358	0.0000000
zheyou73v0_A04	14675873	14676423	BnaA04T0133600ZY	0	+	0	0	550	0.0000000
zheyou73v0_A04	14676767	14678356	BnaA04T0133700ZY	0	-	0	0	1589	0.0000000
zheyou73v0_A04	14679181	14680268	BnaA04T0133800ZY	0	+	0	0	1087	0.0000000
zheyou73v0_A04	14680700	14681018	BnaA04T0133900ZY	0	-	0	0	318	0.0000000
zheyou73v0_A04	14681223	14681508	BnaA04T0134000ZY	0	-	0	0	285	0.0000000
zheyou73v0_A04	14683936	14684669	BnaA04T0134100ZY	0	-	0	0	733	0.0000000
zheyou73v0_A04	14685477	14688023	BnaA04T0134200ZY	0	-	0	0	2546	0.0000000
zheyou73v0_A04	14693104	14694169	BnaA04T0134300ZY	0	-	0	0	1065	0.0000000
zheyou73v0_A04	14695742	14697344	BnaA04T0134400ZY	0	+	0	0	1602	0.0000000
zheyou73v0_A04	14699576	14700038	BnaA04T0134500ZY	0	+	0	0	462	0.0000000
zheyou73v0_A04	14701372	14704972	BnaA04T0134600ZY	0	-	0	0	3600	0.0000000
zheyou73v0_A04	14706347	14707556	BnaA04T0134700ZY	0	-	0	0	1209	0.0000000
zheyou73v0_A04	14708494	14711416	BnaA04T0134800ZY	0	-	0	0	2922	0.0000000
zheyou73v0_A04	14720365	14721760	BnaA04T0134900ZY	0	+	0	0	1395	0.0000000
zheyou73v0_A04	14723083	14723590	BnaA04T0135000ZY	0	-	0	0	507	0.0000000
zheyou73v0_A04	14726288	14727861	BnaA04T0135100ZY	0	+	0	0	1573	0.0000000
zheyou73v0_A04	14726288	14727861	BnaA04T0135100ZY.1	0	+	0	0	1573	0.0000000
zheyou73v0_A04	14728735	14730507	BnaA04T0135200ZY	0	-	0	0	1772	0.0000000
zheyou73v0_A04	14739263	14742258	BnaA04T0135300ZY	0	+	0	0	2995	0.0000000
zheyou73v0_A04	14743280	14745636	BnaA04T0135400ZY	0	+	0	0	2356	0.0000000
zheyou73v0_A04	14745649	14750089	BnaA04T0135500ZY	0	-	0	0	4440	0.0000000
zheyou73v0_A04	14752968	14755309	BnaA04T0135600ZY	0	+	0	0	2341	0.0000000
zheyou73v0_A04	14755373	14757201	BnaA04T0135700ZY	0	-	0	0	1828	0.0000000
zheyou73v0_A04	14760096	14761093	BnaA04T0135800ZY	0	-	0	0	997	0.0000000
zheyou73v0_A04	14761722	14762148	BnaA04T0135900ZY	0	-	0	0	426	0.0000000
zheyou73v0_A04	14772462	14774663	BnaA04T0136000ZY	0	+	0	0	2201	0.0000000
zheyou73v0_A04	14780428	14782917	BnaA04T0136100ZY	0	+	0	0	2489	0.0000000
zheyou73v0_A04	14783618	14784872	BnaA04T0136200ZY	0	+	0	0	1254	0.0000000
zheyou73v0_A04	14785485	14788120	BnaA04T0136300ZY	0	+	0	0	2635	0.0000000
zheyou73v0_A04	14788889	14792123	BnaA04T0136400ZY	0	+	0	0	3234	0.0000000
zheyou73v0_A04	14788889	14792123	BnaA04T0136400ZY.1	0	+	0	0	3234	0.0000000
zheyou73v0_A04	14796417	14797014	BnaA04T0136500ZY	0	+	0	0	597	0.0000000
zheyou73v0_A04	14797232	14798757	BnaA04T0136600ZY	0	-	0	0	1525	0.0000000
zheyou73v0_A04	14797232	14798757	BnaA04T0136600ZY.1	0	-	0	0	1525	0.0000000
zheyou73v0_A04	14798926	14800167	BnaA04T0136700ZY	0	+	0	0	1241	0.0000000
zheyou73v0_A04	14803795	14805167	BnaA04T0136800ZY	0	-	0	0	1372	0.0000000
zheyou73v0_A04	14805487	14806805	BnaA04T0136900ZY	0	-	0	0	1318	0.0000000
zheyou73v0_A04	14813103	14814609	BnaA04T0137000ZY	0	-	0	0	1506	0.0000000
zheyou73v0_A04	14819062	14819972	BnaA04T0137100ZY.1	0	-	0	0	910	0.0000000
zheyou73v0_A04	14819260	14819972	BnaA04T0137100ZY	0	-	0	0	712	0.0000000
zheyou73v0_A04	14820466	14821592	BnaA04T0137200ZY	0	-	0	0	1126	0.0000000
zheyou73v0_A04	14822181	14822421	BnaA04T0137300ZY	0	-	0	0	240	0.0000000
zheyou73v0_A04	14823334	14823708	BnaA04T0137400ZY	0	+	0	0	374	0.0000000
zheyou73v0_A04	14834248	14836118	BnaA04T0137500ZY	0	+	0	0	1870	0.0000000
zheyou73v0_A04	14839966	14840682	BnaA04T0137600ZY	0	-	0	0	716	0.0000000
zheyou73v0_A04	14843234	14843685	BnaA04T0137700ZY	0	+	0	0	451	0.0000000
zheyou73v0_A04	14849912	14850794	BnaA04T0137800ZY	0	+	0	0	882	0.0000000
zheyou73v0_A04	14858983	14860671	BnaA04T0137900ZY	0	-	0	0	1688	0.0000000
zheyou73v0_A04	14872182	14876745	BnaA04T0138000ZY	0	-	0	0	4563	0.0000000
zheyou73v0_A04	14872182	14876745	BnaA04T0138000ZY.1	0	-	0	0	4563	0.0000000
zheyou73v0_A04	14889761	14890173	BnaA04T0138100ZY	0	+	0	0	412	0.0000000
zheyou73v0_A04	14890531	14894194	BnaA04T0138200ZY	0	-	0	0	3663	0.0000000
zheyou73v0_A04	14896281	14904249	BnaA04T0138300ZY	0	+	0	0	7968	0.0000000
zheyou73v0_A04	14904609	14907821	BnaA04T0138400ZY	0	-	0	0	3212	0.0000000
zheyou73v0_A04	14912387	14912720	BnaA04T0138500ZY	0	-	0	0	333	0.0000000
zheyou73v0_A04	14913972	14914245	BnaA04T0138600ZY	0	-	0	0	273	0.0000000
zheyou73v0_A04	14915874	14916833	BnaA04T0138700ZY	0	+	0	0	959	0.0000000
zheyou73v0_A04	14920046	14922708	BnaA04T0138800ZY	0	-	0	0	2662	0.0000000
zheyou73v0_A04	14930194	14932204	BnaA04T0138900ZY	0	+	0	0	2010	0.0000000
zheyou73v0_A04	14932421	14933878	BnaA04T0139000ZY	0	+	0	0	1457	0.0000000
zheyou73v0_A04	14934292	14937864	BnaA04T0139100ZY	0	-	0	0	3572	0.0000000
zheyou73v0_A04	14945575	14946424	BnaA04T0139200ZY	0	+	0	0	849	0.0000000
zheyou73v0_A04	14946990	14949590	BnaA04T0139300ZY	0	-	0	0	2600	0.0000000
zheyou73v0_A04	14953529	14954236	BnaA04T0139400ZY	0	+	0	0	707	0.0000000
zheyou73v0_A04	14958345	14961539	BnaA04T0139500ZY	0	+	0	0	3194	0.0000000
zheyou73v0_A04	14961764	14963669	BnaA04T0139600ZY	0	-	0	0	1905	0.0000000
zheyou73v0_A04	14964858	14966227	BnaA04T0139700ZY	0	+	0	0	1369	0.0000000
zheyou73v0_A04	14964858	14966227	BnaA04T0139700ZY.1	0	+	0	0	1369	0.0000000
zheyou73v0_A04	14966567	14973474	BnaA04T0139800ZY	0	+	0	0	6907	0.0000000
zheyou73v0_A04	14973651	14974694	BnaA04T0139900ZY	0	-	0	0	1043	0.0000000
zheyou73v0_A04	14975864	14980942	BnaA04T0140000ZY	0	+	0	0	5078	0.0000000
zheyou73v0_A04	14981281	14981887	BnaA04T0140100ZY	0	-	0	0	606	0.0000000
zheyou73v0_A04	14994067	14995997	BnaA04T0140200ZY	0	+	0	0	1930	0.0000000
zheyou73v0_A04	14996993	14998180	BnaA04T0140300ZY	0	-	0	0	1187	0.0000000
zheyou73v0_A04	15000370	15002891	BnaA04T0140400ZY	0	-	0	0	2521	0.0000000
zheyou73v0_A04	15004573	15005747	BnaA04T0140500ZY	0	-	0	0	1174	0.0000000
zheyou73v0_A04	15017821	15018909	BnaA04T0140600ZY	0	+	0	0	1088	0.0000000
zheyou73v0_A04	15019027	15019833	BnaA04T0140700ZY	0	+	0	0	806	0.0000000
zheyou73v0_A04	15020871	15023227	BnaA04T0140800ZY	0	+	0	0	2356	0.0000000
zheyou73v0_A04	15030880	15031525	BnaA04T0140900ZY	0	+	0	0	645	0.0000000
zheyou73v0_A04	15032269	15033687	BnaA04T0141000ZY	0	+	0	0	1418	0.0000000
zheyou73v0_A04	15034068	15041970	BnaA04T0141100ZY	0	-	0	0	7902	0.0000000
zheyou73v0_A04	15045088	15049977	BnaA04T0141200ZY	0	-	0	0	4889	0.0000000
zheyou73v0_A04	15045088	15049977	BnaA04T0141200ZY.1	0	-	0	0	4889	0.0000000
zheyou73v0_A04	15045088	15049977	BnaA04T0141200ZY.2	0	-	0	0	4889	0.0000000
zheyou73v0_A04	15045579	15049977	BnaA04T0141200ZY.3	0	-	0	0	4398	0.0000000
zheyou73v0_A04	15050517	15051397	BnaA04T0141300ZY	0	-	0	0	880	0.0000000
zheyou73v0_A04	15052017	15056211	BnaA04T0141400ZY	0	-	0	0	4194	0.0000000
zheyou73v0_A04	15063641	15065332	BnaA04T0141500ZY	0	-	0	0	1691	0.0000000
zheyou73v0_A04	15063641	15065332	BnaA04T0141500ZY.1	0	-	0	0	1691	0.0000000
zheyou73v0_A04	15063641	15065332	BnaA04T0141500ZY.2	0	-	0	0	1691	0.0000000
zheyou73v0_A04	15066966	15068507	BnaA04T0141600ZY	0	+	0	0	1541	0.0000000
zheyou73v0_A04	15069495	15071894	BnaA04T0141700ZY	0	-	0	0	2399	0.0000000
zheyou73v0_A04	15073534	15080568	BnaA04T0141800ZY	0	+	0	0	7034	0.0000000
zheyou73v0_A04	15081012	15082441	BnaA04T0141900ZY	0	-	0	0	1429	0.0000000
zheyou73v0_A04	15084019	15086159	BnaA04T0142000ZY	0	-	0	0	2140	0.0000000
zheyou73v0_A04	15086307	15087833	BnaA04T0142100ZY	0	+	0	0	1526	0.0000000
zheyou73v0_A04	15088611	15089832	BnaA04T0142200ZY	0	+	0	0	1221	0.0000000
zheyou73v0_A04	15089882	15092227	BnaA04T0142300ZY	0	-	0	0	2345	0.0000000
zheyou73v0_A04	15095716	15096375	BnaA04T0142400ZY	0	+	0	0	659	0.0000000
zheyou73v0_A04	15097461	15100445	BnaA04T0142500ZY	0	+	0	0	2984	0.0000000
zheyou73v0_A04	15102306	15103576	BnaA04T0142600ZY	0	+	0	0	1270	0.0000000
zheyou73v0_A04	15103701	15105250	BnaA04T0142700ZY	0	-	0	0	1549	0.0000000
zheyou73v0_A04	15106405	15111667	BnaA04T0142800ZY	0	+	0	0	5262	0.0000000
zheyou73v0_A04	15113301	15113844	BnaA04T0142900ZY	0	+	0	0	543	0.0000000
zheyou73v0_A04	15125924	15129046	BnaA04T0143000ZY	0	+	0	0	3122	0.0000000
zheyou73v0_A04	15134713	15136767	BnaA04T0143100ZY	0	-	0	0	2054	0.0000000
zheyou73v0_A04	15148838	15151417	BnaA04T0143200ZY	0	-	0	0	2579	0.0000000
zheyou73v0_A04	15157527	15159420	BnaA04T0143300ZY	0	-	0	0	1893	0.0000000
zheyou73v0_A04	15162318	15163083	BnaA04T0143400ZY	0	+	0	0	765	0.0000000
zheyou73v0_A04	15163368	15166308	BnaA04T0143500ZY	0	-	0	0	2940	0.0000000
zheyou73v0_A04	15166785	15171847	BnaA04T0143600ZY	0	-	0	0	5062	0.0000000
zheyou73v0_A04	15172714	15176027	BnaA04T0143700ZY	0	+	0	0	3313	0.0000000
zheyou73v0_A04	15180718	15183697	BnaA04T0143800ZY	0	-	0	0	2979	0.0000000
zheyou73v0_A04	15185044	15186894	BnaA04T0143900ZY	0	-	0	0	1850	0.0000000
zheyou73v0_A04	15187984	15188512	BnaA04T0144000ZY	0	-	0	0	528	0.0000000
zheyou73v0_A04	15215553	15217344	BnaA04T0144100ZY	0	+	0	0	1791	0.0000000
zheyou73v0_A04	15221925	15222871	BnaA04T0144200ZY	0	-	0	0	946	0.0000000
zheyou73v0_A04	15225376	15226198	BnaA04T0144300ZY	0	-	0	0	822	0.0000000
zheyou73v0_A04	15229741	15230243	BnaA04T0144400ZY	0	-	0	0	502	0.0000000
zheyou73v0_A04	15232462	15233752	BnaA04T0144500ZY	0	+	0	0	1290	0.0000000
zheyou73v0_A04	15235259	15237119	BnaA04T0144600ZY	0	-	0	0	1860	0.0000000
zheyou73v0_A04	15237993	15241286	BnaA04T0144700ZY	0	-	0	0	3293	0.0000000
zheyou73v0_A04	15242602	15243717	BnaA04T0144800ZY	0	-	0	0	1115	0.0000000
zheyou73v0_A04	15244182	15246451	BnaA04T0144900ZY	0	-	0	0	2269	0.0000000
zheyou73v0_A04	15246834	15250455	BnaA04T0145000ZY	0	+	0	0	3621	0.0000000
zheyou73v0_A04	15250762	15267071	BnaA04T0145100ZY	0	-	0	0	16309	0.0000000
zheyou73v0_A04	15282815	15283192	BnaA04T0145200ZY	0	-	0	0	377	0.0000000
zheyou73v0_A04	15286294	15287197	BnaA04T0145300ZY	0	-	0	0	903	0.0000000
zheyou73v0_A04	15290235	15290842	BnaA04T0145400ZY	0	+	0	0	607	0.0000000
zheyou73v0_A04	15292737	15292997	BnaA04T0145500ZY	0	+	0	0	260	0.0000000
zheyou73v0_A04	15295305	15295653	BnaA04T0145600ZY	0	+	0	0	348	0.0000000
zheyou73v0_A04	15301124	15301493	BnaA04T0145700ZY	0	-	0	0	369	0.0000000
zheyou73v0_A04	15304082	15304726	BnaA04T0145800ZY	0	+	0	0	644	0.0000000
zheyou73v0_A04	15307073	15307826	BnaA04T0145900ZY	0	+	0	0	753	0.0000000
zheyou73v0_A04	15308354	15309911	BnaA04T0146000ZY	0	-	0	0	1557	0.0000000
zheyou73v0_A04	15310902	15311220	BnaA04T0146100ZY	0	+	0	0	318	0.0000000
zheyou73v0_A04	15313204	15315229	BnaA04T0146200ZY.1	0	+	0	0	2025	0.0000000
zheyou73v0_A04	15313430	15315361	BnaA04T0146200ZY	0	+	0	0	1931	0.0000000
zheyou73v0_A04	15320607	15322177	BnaA04T0146300ZY	0	+	0	0	1570	0.0000000
zheyou73v0_A04	15327101	15328213	BnaA04T0146400ZY	0	+	0	0	1112	0.0000000
zheyou73v0_A04	15331577	15333689	BnaA04T0146500ZY	0	-	0	0	2112	0.0000000
zheyou73v0_A04	15335770	15337096	BnaA04T0146600ZY	0	-	0	0	1326	0.0000000
zheyou73v0_A04	15337387	15339812	BnaA04T0146700ZY	0	-	0	0	2425	0.0000000
zheyou73v0_A04	15341603	15342443	BnaA04T0146800ZY	0	+	0	0	840	0.0000000
zheyou73v0_A04	15342613	15346940	BnaA04T0146900ZY	0	-	0	0	4327	0.0000000
zheyou73v0_A04	15353522	15355619	BnaA04T0147000ZY	0	+	0	0	2097	0.0000000
zheyou73v0_A04	15356133	15359428	BnaA04T0147100ZY	0	+	0	0	3295	0.0000000
zheyou73v0_A04	15359667	15360670	BnaA04T0147200ZY	0	-	0	0	1003	0.0000000
zheyou73v0_A04	15361433	15364777	BnaA04T0147300ZY	0	-	0	0	3344	0.0000000
zheyou73v0_A04	15368872	15370931	BnaA04T0147400ZY	0	+	0	0	2059	0.0000000
zheyou73v0_A04	15376418	15379068	BnaA04T0147500ZY	0	+	0	0	2650	0.0000000
zheyou73v0_A04	15385023	15387476	BnaA04T0147600ZY	0	+	0	0	2453	0.0000000
zheyou73v0_A04	15403363	15406071	BnaA04T0147700ZY	0	-	0	0	2708	0.0000000
zheyou73v0_A04	15431086	15435026	BnaA04T0147800ZY	0	+	0	0	3940	0.0000000
zheyou73v0_A04	15438722	15440853	BnaA04T0147900ZY	0	-	0	0	2131	0.0000000
zheyou73v0_A04	15441523	15445334	BnaA04T0148000ZY	0	-	0	0	3811	0.0000000
zheyou73v0_A04	15441523	15445334	BnaA04T0148000ZY.1	0	-	0	0	3811	0.0000000
zheyou73v0_A04	15441523	15445334	BnaA04T0148000ZY.2	0	-	0	0	3811	0.0000000
zheyou73v0_A04	15461916	15463331	BnaA04T0148100ZY	0	+	0	0	1415	0.0000000
zheyou73v0_A04	15463878	15465179	BnaA04T0148200ZY	0	+	0	0	1301	0.0000000
zheyou73v0_A04	15466170	15468414	BnaA04T0148300ZY	0	-	0	0	2244	0.0000000
zheyou73v0_A04	15473297	15477415	BnaA04T0148400ZY	0	-	0	0	4118	0.0000000
zheyou73v0_A04	15479113	15482068	BnaA04T0148500ZY	0	-	0	0	2955	0.0000000
zheyou73v0_A04	15487191	15488148	BnaA04T0148600ZY	0	-	0	0	957	0.0000000
zheyou73v0_A04	15490660	15491724	BnaA04T0148700ZY	0	+	0	0	1064	0.0000000
zheyou73v0_A04	15495256	15497935	BnaA04T0148800ZY	0	+	0	0	2679	0.0000000
zheyou73v0_A04	15504920	15506835	BnaA04T0148900ZY	0	-	0	0	1915	0.0000000
zheyou73v0_A04	15508594	15510703	BnaA04T0149000ZY	0	+	0	0	2109	0.0000000
zheyou73v0_A04	15518650	15520535	BnaA04T0149100ZY	0	+	0	0	1885	0.0000000
zheyou73v0_A04	15522289	15524474	BnaA04T0149200ZY	0	+	0	0	2185	0.0000000
zheyou73v0_A04	15525023	15530761	BnaA04T0149300ZY	0	-	0	0	5738	0.0000000
zheyou73v0_A04	15531854	15533691	BnaA04T0149400ZY	0	+	0	0	1837	0.0000000
zheyou73v0_A04	15533863	15534855	BnaA04T0149500ZY	0	-	0	0	992	0.0000000
zheyou73v0_A04	15548096	15549545	BnaA04T0149600ZY	0	+	0	0	1449	0.0000000
zheyou73v0_A04	15568625	15569704	BnaA04T0149700ZY	0	-	0	0	1079	0.0000000
zheyou73v0_A04	15573611	15576464	BnaA04T0149800ZY	0	-	0	0	2853	0.0000000
zheyou73v0_A04	15576678	15578826	BnaA04T0149900ZY	0	+	0	0	2148	0.0000000
zheyou73v0_A04	15583621	15585584	BnaA04T0150000ZY	0	-	0	0	1963	0.0000000
zheyou73v0_A04	15583621	15585127	BnaA04T0150000ZY.1	0	-	0	0	1506	0.0000000
zheyou73v0_A04	15586540	15589818	BnaA04T0150100ZY	0	+	0	0	3278	0.0000000
zheyou73v0_A04	15589881	15591613	BnaA04T0150200ZY	0	-	0	0	1732	0.0000000
zheyou73v0_A04	15592060	15593983	BnaA04T0150300ZY	0	-	0	0	1923	0.0000000
zheyou73v0_A04	15594868	15597122	BnaA04T0150400ZY	0	-	0	0	2254	0.0000000
zheyou73v0_A04	15599873	15601308	BnaA04T0150500ZY	0	+	0	0	1435	0.0000000
zheyou73v0_A04	15602947	15603477	BnaA04T0150600ZY	0	-	0	0	530	0.0000000
zheyou73v0_A04	15603511	15603879	BnaA04T0150700ZY	0	-	0	0	368	0.0000000
zheyou73v0_A04	15614622	15617426	BnaA04T0150800ZY	0	+	0	0	2804	0.0000000
zheyou73v0_A04	15617640	15623840	BnaA04T0150900ZY	0	-	0	0	6200	0.0000000
zheyou73v0_A04	15625558	15626893	BnaA04T0151000ZY	0	+	0	0	1335	0.0000000
zheyou73v0_A04	15628165	15629426	BnaA04T0151100ZY	0	+	0	0	1261	0.0000000
zheyou73v0_A04	15629818	15634333	BnaA04T0151200ZY	0	+	0	0	4515	0.0000000
zheyou73v0_A04	15642087	15645976	BnaA04T0151300ZY	0	+	0	0	3889	0.0000000
zheyou73v0_A04	15652571	15652739	BnaA04T0151400ZY	0	-	0	0	168	0.0000000
zheyou73v0_A04	15657753	15659959	BnaA04T0151500ZY	0	-	0	0	2206	0.0000000
zheyou73v0_A04	15657753	15659959	BnaA04T0151500ZY.1	0	-	0	0	2206	0.0000000
zheyou73v0_A04	15657753	15659959	BnaA04T0151500ZY.2	0	-	0	0	2206	0.0000000
zheyou73v0_A04	15657753	15659959	BnaA04T0151500ZY.3	0	-	0	0	2206	0.0000000
zheyou73v0_A04	15657753	15659824	BnaA04T0151500ZY.4	0	-	0	0	2071	0.0000000
zheyou73v0_A04	15657753	15659824	BnaA04T0151500ZY.5	0	-	0	0	2071	0.0000000
zheyou73v0_A04	15671486	15671884	BnaA04T0151600ZY	0	+	0	0	398	0.0000000
zheyou73v0_A04	15678152	15678550	BnaA04T0151700ZY	0	-	0	0	398	0.0000000
zheyou73v0_A04	15687599	15688939	BnaA04T0151800ZY	0	-	0	0	1340	0.0000000
zheyou73v0_A04	15687599	15688939	BnaA04T0151800ZY.1	0	-	0	0	1340	0.0000000
zheyou73v0_A04	15687599	15688939	BnaA04T0151800ZY.2	0	-	0	0	1340	0.0000000
zheyou73v0_A04	15693892	15694297	BnaA04T0151900ZY	0	-	0	0	405	0.0000000
zheyou73v0_A04	15697405	15698670	BnaA04T0152000ZY	0	+	0	0	1265	0.0000000
zheyou73v0_A04	15699840	15701248	BnaA04T0152100ZY	0	+	0	0	1408	0.0000000
zheyou73v0_A04	15701972	15703160	BnaA04T0152200ZY	0	+	0	0	1188	0.0000000
zheyou73v0_A04	15703320	15706804	BnaA04T0152300ZY	0	-	0	0	3484	0.0000000
zheyou73v0_A04	15722899	15724644	BnaA04T0152400ZY	0	+	0	0	1745	0.0000000
zheyou73v0_A04	15726337	15730552	BnaA04T0152500ZY	0	-	0	0	4215	0.0000000
zheyou73v0_A04	15756143	15758292	BnaA04T0152600ZY	0	-	0	0	2149	0.0000000
zheyou73v0_A04	15769891	15772821	BnaA04T0152700ZY	0	+	0	0	2930	0.0000000
zheyou73v0_A04	15774554	15777206	BnaA04T0152800ZY	0	+	0	0	2652	0.0000000
zheyou73v0_A04	15777639	15778500	BnaA04T0152900ZY	0	-	0	0	861	0.0000000
zheyou73v0_A04	15782758	15783239	BnaA04T0153000ZY	0	-	0	0	481	0.0000000
zheyou73v0_A04	15792716	15794652	BnaA04T0153100ZY	0	+	0	0	1936	0.0000000
zheyou73v0_A04	15792716	15794652	BnaA04T0153100ZY.1	0	+	0	0	1936	0.0000000
zheyou73v0_A04	15795599	15797727	BnaA04T0153200ZY	0	-	0	0	2128	0.0000000
zheyou73v0_A04	15810149	15811442	BnaA04T0153300ZY	0	+	0	0	1293	0.0000000
zheyou73v0_A04	15813136	15813630	BnaA04T0153400ZY	0	+	0	0	494	0.0000000
zheyou73v0_A04	15813952	15815505	BnaA04T0153500ZY	0	-	0	0	1553	0.0000000
zheyou73v0_A04	15820299	15824299	BnaA04T0153600ZY	0	-	0	0	4000	0.0000000
zheyou73v0_A04	15825992	15826277	BnaA04T0153700ZY	0	+	0	0	285	0.0000000
zheyou73v0_A04	15830927	15833408	BnaA04T0153800ZY	0	+	0	0	2481	0.0000000
zheyou73v0_A04	15834473	15836489	BnaA04T0153900ZY	0	+	0	0	2016	0.0000000
zheyou73v0_A04	15837260	15838043	BnaA04T0154000ZY	0	-	0	0	783	0.0000000
zheyou73v0_A04	15839870	15841514	BnaA04T0154100ZY	0	+	0	0	1644	0.0000000
zheyou73v0_A04	15850411	15851177	BnaA04T0154200ZY	0	-	0	0	766	0.0000000
zheyou73v0_A04	15851969	15852749	BnaA04T0154300ZY	0	-	0	0	780	0.0000000
zheyou73v0_A04	15853568	15855311	BnaA04T0154400ZY	0	-	0	0	1743	0.0000000
zheyou73v0_A04	15853568	15855311	BnaA04T0154400ZY.1	0	-	0	0	1743	0.0000000
zheyou73v0_A04	15853568	15855311	BnaA04T0154400ZY.2	0	-	0	0	1743	0.0000000
zheyou73v0_A04	15853568	15855311	BnaA04T0154400ZY.3	0	-	0	0	1743	0.0000000
zheyou73v0_A04	15857659	15860103	BnaA04T0154500ZY	0	-	0	0	2444	0.0000000
zheyou73v0_A04	15863931	15865738	BnaA04T0154600ZY	0	+	0	0	1807	0.0000000
zheyou73v0_A04	15863931	15865738	BnaA04T0154600ZY.1	0	+	0	0	1807	0.0000000
zheyou73v0_A04	15866584	15867085	BnaA04T0154700ZY	0	+	0	0	501	0.0000000
zheyou73v0_A04	15868614	15869982	BnaA04T0154800ZY	0	+	0	0	1368	0.0000000
zheyou73v0_A04	15870031	15871313	BnaA04T0154900ZY	0	-	0	0	1282	0.0000000
zheyou73v0_A04	15878111	15879478	BnaA04T0155000ZY	0	+	0	0	1367	0.0000000
zheyou73v0_A04	15883057	15883664	BnaA04T0155100ZY	0	+	0	0	607	0.0000000
zheyou73v0_A04	15892514	15894150	BnaA04T0155200ZY	0	+	0	0	1636	0.0000000
zheyou73v0_A04	15895003	15897638	BnaA04T0155300ZY	0	+	0	0	2635	0.0000000
zheyou73v0_A04	15898055	15899842	BnaA04T0155400ZY	0	+	0	0	1787	0.0000000
zheyou73v0_A04	15898055	15899842	BnaA04T0155400ZY.1	0	+	0	0	1787	0.0000000
zheyou73v0_A04	15906666	15916779	BnaA04T0155500ZY	0	-	0	0	10113	0.0000000
zheyou73v0_A04	15920462	15922009	BnaA04T0155600ZY	0	-	0	0	1547	0.0000000
zheyou73v0_A04	15926594	15928256	BnaA04T0155700ZY	0	-	0	0	1662	0.0000000
zheyou73v0_A04	15926594	15928256	BnaA04T0155700ZY.1	0	-	0	0	1662	0.0000000
zheyou73v0_A04	15926594	15928256	BnaA04T0155700ZY.2	0	-	0	0	1662	0.0000000
zheyou73v0_A04	15926594	15928256	BnaA04T0155700ZY.3	0	-	0	0	1662	0.0000000
zheyou73v0_A04	15926594	15928256	BnaA04T0155700ZY.4	0	-	0	0	1662	0.0000000
zheyou73v0_A04	15931966	15936535	BnaA04T0155800ZY	0	-	0	0	4569	0.0000000
zheyou73v0_A04	15931966	15936535	BnaA04T0155800ZY.1	0	-	0	0	4569	0.0000000
zheyou73v0_A04	15936789	15938695	BnaA04T0155900ZY	0	+	0	0	1906	0.0000000
zheyou73v0_A04	15946545	15950673	BnaA04T0156000ZY	0	+	0	0	4128	0.0000000
zheyou73v0_A04	15951639	15954106	BnaA04T0156100ZY	0	-	0	0	2467	0.0000000
zheyou73v0_A04	15963292	15965800	BnaA04T0156200ZY	0	-	0	0	2508	0.0000000
zheyou73v0_A04	15968052	15971175	BnaA04T0156300ZY	0	+	0	0	3123	0.0000000
zheyou73v0_A04	15968052	15971175	BnaA04T0156300ZY.1	0	+	0	0	3123	0.0000000
zheyou73v0_A04	15971352	15972243	BnaA04T0156400ZY	0	-	0	0	891	0.0000000
zheyou73v0_A04	15976200	15977090	BnaA04T0156500ZY	0	-	0	0	890	0.0000000
zheyou73v0_A04	15980787	15982582	BnaA04T0156600ZY	0	+	0	0	1795	0.0000000
zheyou73v0_A04	15987242	15988096	BnaA04T0156700ZY	0	-	0	0	854	0.0000000
zheyou73v0_A04	16000391	16001747	BnaA04T0156800ZY	0	+	0	0	1356	0.0000000
zheyou73v0_A04	16002976	16005637	BnaA04T0156900ZY	0	-	0	0	2661	0.0000000
zheyou73v0_A04	16006814	16008609	BnaA04T0157000ZY	0	-	0	0	1795	0.0000000
zheyou73v0_A04	16011137	16017069	BnaA04T0157100ZY	0	-	0	0	5932	0.0000000
zheyou73v0_A04	16018529	16020302	BnaA04T0157200ZY	0	-	0	0	1773	0.0000000
zheyou73v0_A04	16022792	16023467	BnaA04T0157300ZY	0	+	0	0	675	0.0000000
zheyou73v0_A04	16026677	16027833	BnaA04T0157400ZY	0	+	0	0	1156	0.0000000
zheyou73v0_A04	16029626	16032223	BnaA04T0157500ZY	0	+	0	0	2597	0.0000000
zheyou73v0_A04	16036592	16038401	BnaA04T0157600ZY	0	+	0	0	1809	0.0000000
zheyou73v0_A04	16046639	16047815	BnaA04T0157700ZY	0	-	0	0	1176	0.0000000
zheyou73v0_A04	16048170	16050046	BnaA04T0157800ZY	0	+	0	0	1876	0.0000000
zheyou73v0_A04	16048170	16050046	BnaA04T0157800ZY.1	0	+	0	0	1876	0.0000000
zheyou73v0_A04	16050630	16051243	BnaA04T0157900ZY	0	+	0	0	613	0.0000000
zheyou73v0_A04	16056654	16057584	BnaA04T0158000ZY	0	-	0	0	930	0.0000000
zheyou73v0_A04	16057813	16060514	BnaA04T0158100ZY	0	-	0	0	2701	0.0000000
zheyou73v0_A04	16062712	16068127	BnaA04T0158200ZY	0	-	0	0	5415	0.0000000
zheyou73v0_A04	16069430	16070104	BnaA04T0158300ZY	0	+	0	0	674	0.0000000
zheyou73v0_A04	16084160	16086816	BnaA04T0158400ZY	0	+	0	0	2656	0.0000000
zheyou73v0_A04	16088659	16093735	BnaA04T0158500ZY	0	-	0	0	5076	0.0000000
zheyou73v0_A04	16088659	16093735	BnaA04T0158500ZY.1	0	-	0	0	5076	0.0000000
zheyou73v0_A04	16096570	16098700	BnaA04T0158600ZY	0	+	0	0	2130	0.0000000
zheyou73v0_A04	16101298	16103770	BnaA04T0158700ZY	0	+	0	0	2472	0.0000000
zheyou73v0_A04	16105889	16107718	BnaA04T0158800ZY	0	+	0	0	1829	0.0000000
zheyou73v0_A04	16111221	16115174	BnaA04T0158900ZY	0	+	0	0	3953	0.0000000
zheyou73v0_A04	16115685	16118868	BnaA04T0159000ZY	0	-	0	0	3183	0.0000000
zheyou73v0_A04	16128037	16128281	BnaA04T0159100ZY	0	+	0	0	244	0.0000000
zheyou73v0_A04	16132870	16134619	BnaA04T0159200ZY	0	+	0	0	1749	0.0000000
zheyou73v0_A04	16135735	16137609	BnaA04T0159300ZY	0	+	0	0	1874	0.0000000
zheyou73v0_A04	16140600	16141732	BnaA04T0159400ZY	0	-	0	0	1132	0.0000000
zheyou73v0_A04	16147054	16149004	BnaA04T0159500ZY	0	-	0	0	1950	0.0000000
zheyou73v0_A04	16150786	16153147	BnaA04T0159600ZY	0	-	0	0	2361	0.0000000
zheyou73v0_A04	16157721	16158531	BnaA04T0159700ZY	0	-	0	0	810	0.0000000
zheyou73v0_A04	16159327	16163240	BnaA04T0159800ZY	0	+	0	0	3913	0.0000000
zheyou73v0_A04	16163516	16165561	BnaA04T0159900ZY	0	-	0	0	2045	0.0000000
zheyou73v0_A04	16166382	16167309	BnaA04T0160000ZY	0	-	0	0	927	0.0000000
zheyou73v0_A04	16168939	16171087	BnaA04T0160100ZY	0	+	0	0	2148	0.0000000
zheyou73v0_A04	16171339	16173815	BnaA04T0160200ZY	0	-	0	0	2476	0.0000000
zheyou73v0_A04	16185615	16191186	BnaA04T0160300ZY	0	+	0	0	5571	0.0000000
zheyou73v0_A04	16204848	16207836	BnaA04T0160400ZY	0	+	0	0	2988	0.0000000
zheyou73v0_A04	16212564	16213872	BnaA04T0160500ZY	0	-	0	0	1308	0.0000000
zheyou73v0_A04	16216665	16217869	BnaA04T0160600ZY	0	-	0	0	1204	0.0000000
zheyou73v0_A04	16220060	16222537	BnaA04T0160700ZY	0	+	0	0	2477	0.0000000
zheyou73v0_A04	16223297	16225283	BnaA04T0160800ZY	0	+	0	0	1986	0.0000000
zheyou73v0_A04	16229709	16231890	BnaA04T0160900ZY	0	+	0	0	2181	0.0000000
zheyou73v0_A04	16234368	16235110	BnaA04T0161000ZY	0	+	0	0	742	0.0000000
zheyou73v0_A04	16237787	16241510	BnaA04T0161100ZY	0	+	0	0	3723	0.0000000
zheyou73v0_A04	16238038	16241510	BnaA04T0161100ZY.1	0	+	0	0	3472	0.0000000
zheyou73v0_A04	16242252	16245476	BnaA04T0161200ZY	0	+	0	0	3224	0.0000000
zheyou73v0_A04	16246045	16247080	BnaA04T0161300ZY	0	-	0	0	1035	0.0000000
zheyou73v0_A04	16248975	16251672	BnaA04T0161400ZY	0	+	0	0	2697	0.0000000
zheyou73v0_A04	16252958	16262002	BnaA04T0161500ZY	0	-	0	0	9044	0.0000000
zheyou73v0_A04	16264559	16267232	BnaA04T0161600ZY	0	-	0	0	2673	0.0000000
zheyou73v0_A04	16268433	16269786	BnaA04T0161700ZY	0	+	0	0	1353	0.0000000
zheyou73v0_A04	16273718	16274669	BnaA04T0161800ZY	0	-	0	0	951	0.0000000
zheyou73v0_A04	16300747	16302805	BnaA04T0161900ZY	0	-	0	0	2058	0.0000000
zheyou73v0_A04	16303598	16305794	BnaA04T0162000ZY	0	+	0	0	2196	0.0000000
zheyou73v0_A04	16303598	16305794	BnaA04T0162000ZY.1	0	+	0	0	2196	0.0000000
zheyou73v0_A04	16306040	16311285	BnaA04T0162100ZY	0	-	0	0	5245	0.0000000
zheyou73v0_A04	16306040	16311199	BnaA04T0162100ZY.1	0	-	0	0	5159	0.0000000
zheyou73v0_A04	16311505	16324014	BnaA04T0162200ZY	0	+	0	0	12509	0.0000000
zheyou73v0_A04	16324534	16326468	BnaA04T0162300ZY	0	-	0	0	1934	0.0000000
zheyou73v0_A04	16334560	16337172	BnaA04T0162400ZY	0	+	0	0	2612	0.0000000
zheyou73v0_A04	16337378	16338202	BnaA04T0162500ZY	0	+	0	0	824	0.0000000
zheyou73v0_A04	16338579	16344689	BnaA04T0162600ZY	0	-	0	0	6110	0.0000000
zheyou73v0_A04	16345208	16346537	BnaA04T0162700ZY	0	+	0	0	1329	0.0000000
zheyou73v0_A04	16346646	16349210	BnaA04T0162800ZY	0	-	0	0	2564	0.0000000
zheyou73v0_A04	16358611	16359364	BnaA04T0162900ZY	0	+	0	0	753	0.0000000
zheyou73v0_A04	16362998	16363485	BnaA04T0163000ZY	0	+	0	0	487	0.0000000
zheyou73v0_A04	16368513	16368994	BnaA04T0163100ZY	0	+	0	0	481	0.0000000
zheyou73v0_A04	16389605	16392020	BnaA04T0163200ZY	0	+	0	0	2415	0.0000000
zheyou73v0_A04	16392272	16395362	BnaA04T0163300ZY	0	-	0	0	3090	0.0000000
zheyou73v0_A04	16396770	16398922	BnaA04T0163400ZY	0	+	0	0	2152	0.0000000
zheyou73v0_A04	16399159	16400720	BnaA04T0163500ZY	0	+	0	0	1561	0.0000000
zheyou73v0_A04	16400208	16402554	BnaA04T0163600ZY	0	-	0	0	2346	0.0000000
zheyou73v0_A04	16405430	16407805	BnaA04T0163700ZY	0	-	0	0	2375	0.0000000
zheyou73v0_A04	16411603	16413006	BnaA04T0163800ZY	0	-	0	0	1403	0.0000000
zheyou73v0_A04	16413370	16418670	BnaA04T0163900ZY	0	-	0	0	5300	0.0000000
zheyou73v0_A04	16421743	16422426	BnaA04T0164000ZY	0	+	0	0	683	0.0000000
zheyou73v0_A04	16422901	16425083	BnaA04T0164100ZY	0	-	0	0	2182	0.0000000
zheyou73v0_A04	16427095	16428927	BnaA04T0164200ZY	0	-	0	0	1832	0.0000000
zheyou73v0_A04	16431296	16432873	BnaA04T0164300ZY	0	+	0	0	1577	0.0000000
zheyou73v0_A04	16433269	16434211	BnaA04T0164400ZY	0	-	0	0	942	0.0000000
zheyou73v0_A04	16439735	16442535	BnaA04T0164500ZY.1	0	+	0	0	2800	0.0000000
zheyou73v0_A04	16439901	16442188	BnaA04T0164500ZY	0	+	0	0	2287	0.0000000
zheyou73v0_A04	16442930	16447927	BnaA04T0164600ZY	0	+	0	0	4997	0.0000000
zheyou73v0_A04	16449968	16451291	BnaA04T0164700ZY	0	+	0	0	1323	0.0000000
zheyou73v0_A04	16453715	16454644	BnaA04T0164800ZY	0	+	0	0	929	0.0000000
zheyou73v0_A04	16454844	16455855	BnaA04T0164900ZY	0	-	0	0	1011	0.0000000
zheyou73v0_A04	16456735	16458369	BnaA04T0165000ZY	0	+	0	0	1634	0.0000000
zheyou73v0_A04	16462189	16464113	BnaA04T0165100ZY	0	+	0	0	1924	0.0000000
zheyou73v0_A04	16464656	16467487	BnaA04T0165200ZY	0	-	0	0	2831	0.0000000
zheyou73v0_A04	16471376	16481138	BnaA04T0165300ZY	0	+	0	0	9762	0.0000000
zheyou73v0_A04	16483113	16483525	BnaA04T0165400ZY	0	-	0	0	412	0.0000000
zheyou73v0_A04	16490078	16490841	BnaA04T0165500ZY	0	-	0	0	763	0.0000000
zheyou73v0_A04	16493269	16494582	BnaA04T0165600ZY	0	-	0	0	1313	0.0000000
zheyou73v0_A04	16495513	16497945	BnaA04T0165700ZY	0	-	0	0	2432	0.0000000
zheyou73v0_A04	16495513	16497945	BnaA04T0165700ZY.1	0	-	0	0	2432	0.0000000
zheyou73v0_A04	16502562	16503307	BnaA04T0165800ZY	0	+	0	0	745	0.0000000
zheyou73v0_A04	16505916	16507277	BnaA04T0165900ZY	0	+	0	0	1361	0.0000000
zheyou73v0_A04	16514609	16516336	BnaA04T0166000ZY	0	+	0	0	1727	0.0000000
zheyou73v0_A04	16517064	16518382	BnaA04T0166100ZY	0	+	0	0	1318	0.0000000
zheyou73v0_A04	16518661	16519463	BnaA04T0166200ZY	0	+	0	0	802	0.0000000
zheyou73v0_A04	16522842	16525208	BnaA04T0166300ZY	0	-	0	0	2366	0.0000000
zheyou73v0_A04	16553608	16554040	BnaA04T0166400ZY	0	+	0	0	432	0.0000000
zheyou73v0_A04	16556061	16557026	BnaA04T0166500ZY	0	+	0	0	965	0.0000000
zheyou73v0_A04	16572236	16572890	BnaA04T0166600ZY	0	-	0	0	654	0.0000000
zheyou73v0_A04	16578407	16579468	BnaA04T0166700ZY	0	+	0	0	1061	0.0000000
zheyou73v0_A04	16582332	16583575	BnaA04T0166800ZY	0	-	0	0	1243	0.0000000
zheyou73v0_A04	16585889	16587383	BnaA04T0166900ZY	0	+	0	0	1494	0.0000000
zheyou73v0_A04	16585889	16587383	BnaA04T0166900ZY.1	0	+	0	0	1494	0.0000000
zheyou73v0_A04	16588483	16590983	BnaA04T0167000ZY	0	+	0	0	2500	0.0000000
zheyou73v0_A04	16591274	16594030	BnaA04T0167100ZY	0	+	0	0	2756	0.0000000
zheyou73v0_A04	16594771	16595948	BnaA04T0167200ZY	0	-	0	0	1177	0.0000000
zheyou73v0_A04	16597381	16599157	BnaA04T0167300ZY	0	-	0	0	1776	0.0000000
zheyou73v0_A04	16600390	16603172	BnaA04T0167400ZY	0	-	0	0	2782	0.0000000
zheyou73v0_A04	16612168	16613883	BnaA04T0167500ZY	0	+	0	0	1715	0.0000000
zheyou73v0_A04	16615170	16617114	BnaA04T0167600ZY.1	0	-	0	0	1944	0.0000000
zheyou73v0_A04	16615326	16617114	BnaA04T0167600ZY	0	-	0	0	1788	0.0000000
zheyou73v0_A04	16615326	16617114	BnaA04T0167600ZY.2	0	-	0	0	1788	0.0000000
zheyou73v0_A04	16618631	16624509	BnaA04T0167700ZY	0	-	0	0	5878	0.0000000
zheyou73v0_A04	16626061	16627405	BnaA04T0167800ZY	0	-	0	0	1344	0.0000000
zheyou73v0_A04	16627861	16632269	BnaA04T0167900ZY	0	-	0	0	4408	0.0000000
zheyou73v0_A04	16633882	16634794	BnaA04T0168000ZY	0	+	0	0	912	0.0000000
zheyou73v0_A04	16642262	16642564	BnaA04T0168100ZY	0	+	0	0	302	0.0000000
zheyou73v0_A04	16644001	16646664	BnaA04T0168200ZY	0	+	0	0	2663	0.0000000
zheyou73v0_A04	16650251	16653747	BnaA04T0168300ZY	0	-	0	0	3496	0.0000000
zheyou73v0_A04	16659140	16660483	BnaA04T0168400ZY	0	+	0	0	1343	0.0000000
zheyou73v0_A04	16661351	16664890	BnaA04T0168500ZY	0	-	0	0	3539	0.0000000
zheyou73v0_A04	16666056	16667656	BnaA04T0168600ZY	0	-	0	0	1600	0.0000000
zheyou73v0_A04	16666056	16667656	BnaA04T0168600ZY.1	0	-	0	0	1600	0.0000000
zheyou73v0_A04	16667843	16669664	BnaA04T0168700ZY	0	-	0	0	1821	0.0000000
zheyou73v0_A04	16670503	16672664	BnaA04T0168800ZY	0	-	0	0	2161	0.0000000
zheyou73v0_A04	16677741	16679341	BnaA04T0168900ZY	0	+	0	0	1600	0.0000000
zheyou73v0_A04	16680994	16682116	BnaA04T0169000ZY	0	-	0	0	1122	0.0000000
zheyou73v0_A04	16683494	16685436	BnaA04T0169100ZY	0	-	0	0	1942	0.0000000
zheyou73v0_A04	16699569	16700156	BnaA04T0169200ZY	0	+	0	0	587	0.0000000
zheyou73v0_A04	16700461	16702810	BnaA04T0169300ZY	0	+	0	0	2349	0.0000000
zheyou73v0_A04	16706157	16708665	BnaA04T0169400ZY	0	-	0	0	2508	0.0000000
zheyou73v0_A04	16716050	16719180	BnaA04T0169500ZY	0	+	0	0	3130	0.0000000
zheyou73v0_A04	16721469	16722314	BnaA04T0169600ZY	0	+	0	0	845	0.0000000
zheyou73v0_A04	16722361	16723542	BnaA04T0169700ZY	0	+	0	0	1181	0.0000000
zheyou73v0_A04	16727582	16728511	BnaA04T0169800ZY	0	+	0	0	929	0.0000000
zheyou73v0_A04	16731787	16732404	BnaA04T0169900ZY	0	-	0	0	617	0.0000000
zheyou73v0_A04	16732754	16734755	BnaA04T0170000ZY	0	-	0	0	2001	0.0000000
zheyou73v0_A04	16735700	16737033	BnaA04T0170100ZY	0	-	0	0	1333	0.0000000
zheyou73v0_A04	16743365	16745170	BnaA04T0170200ZY	0	+	0	0	1805	0.0000000
zheyou73v0_A04	16745240	16749946	BnaA04T0170300ZY	0	-	0	0	4706	0.0000000
zheyou73v0_A04	16752099	16757087	BnaA04T0170400ZY	0	+	0	0	4988	0.0000000
zheyou73v0_A04	16757489	16759953	BnaA04T0170500ZY	0	-	0	0	2464	0.0000000
zheyou73v0_A04	16760645	16763555	BnaA04T0170600ZY	0	+	0	0	2910	0.0000000
zheyou73v0_A04	16763899	16765557	BnaA04T0170700ZY	0	+	0	0	1658	0.0000000
zheyou73v0_A04	16769990	16772456	BnaA04T0170800ZY	0	+	0	0	2466	0.0000000
zheyou73v0_A04	16772987	16774381	BnaA04T0170900ZY	0	+	0	0	1394	0.0000000
zheyou73v0_A04	16774625	16776000	BnaA04T0171000ZY	0	+	0	0	1375	0.0000000
zheyou73v0_A04	16776242	16778179	BnaA04T0171100ZY	0	-	0	0	1937	0.0000000
zheyou73v0_A04	16778792	16779273	BnaA04T0171200ZY	0	-	0	0	481	0.0000000
zheyou73v0_A04	16780601	16781976	BnaA04T0171300ZY	0	+	0	0	1375	0.0000000
zheyou73v0_A04	16783697	16786082	BnaA04T0171400ZY	0	-	0	0	2385	0.0000000
zheyou73v0_A04	16788782	16791475	BnaA04T0171500ZY	0	-	0	0	2693	0.0000000
zheyou73v0_A04	16793975	16795587	BnaA04T0171600ZY	0	+	0	0	1612	0.0000000
zheyou73v0_A04	16797288	16800950	BnaA04T0171700ZY	0	+	0	0	3662	0.0000000
zheyou73v0_A04	16797288	16800950	BnaA04T0171700ZY.1	0	+	0	0	3662	0.0000000
zheyou73v0_A04	16800222	16801224	BnaA04T0171800ZY	0	-	0	0	1002	0.0000000
zheyou73v0_A04	16806286	16806853	BnaA04T0171900ZY	0	+	0	0	567	0.0000000
zheyou73v0_A04	16808021	16808714	BnaA04T0172000ZY	0	+	0	0	693	0.0000000
zheyou73v0_A04	16808909	16811022	BnaA04T0172100ZY	0	-	0	0	2113	0.0000000
zheyou73v0_A04	16812886	16813519	BnaA04T0172200ZY	0	+	0	0	633	0.0000000
zheyou73v0_A04	16818215	16819639	BnaA04T0172300ZY	0	+	0	0	1424	0.0000000
zheyou73v0_A04	16824942	16825806	BnaA04T0172400ZY	0	-	0	0	864	0.0000000
zheyou73v0_A04	16831802	16832836	BnaA04T0172500ZY	0	-	0	0	1034	0.0000000
zheyou73v0_A04	16833272	16834350	BnaA04T0172600ZY	0	+	0	0	1078	0.0000000
zheyou73v0_A04	16834805	16840278	BnaA04T0172700ZY	0	-	0	0	5473	0.0000000
zheyou73v0_A04	16841059	16844968	BnaA04T0172800ZY	0	-	0	0	3909	0.0000000
zheyou73v0_A04	16846679	16850004	BnaA04T0172900ZY	0	-	0	0	3325	0.0000000
zheyou73v0_A04	16851879	16854493	BnaA04T0173000ZY	0	+	0	0	2614	0.0000000
zheyou73v0_A04	16854784	16857273	BnaA04T0173100ZY	0	-	0	0	2489	0.0000000
zheyou73v0_A04	16857768	16860203	BnaA04T0173200ZY	0	-	0	0	2435	0.0000000
zheyou73v0_A04	16879611	16881945	BnaA04T0173300ZY	0	+	0	0	2334	0.0000000
zheyou73v0_A04	16888615	16891285	BnaA04T0173400ZY	0	+	0	0	2670	0.0000000
zheyou73v0_A04	16891516	16896189	BnaA04T0173500ZY	0	-	0	0	4673	0.0000000
zheyou73v0_A04	16896596	16898328	BnaA04T0173600ZY	0	-	0	0	1732	0.0000000
zheyou73v0_A04	16900461	16901342	BnaA04T0173700ZY	0	-	0	0	881	0.0000000
zheyou73v0_A04	16907728	16909551	BnaA04T0173800ZY	0	-	0	0	1823	0.0000000
zheyou73v0_A04	16910554	16915505	BnaA04T0173900ZY	0	-	0	0	4951	0.0000000
zheyou73v0_A04	16917023	16918334	BnaA04T0174000ZY	0	-	0	0	1311	0.0000000
zheyou73v0_A04	16927441	16928017	BnaA04T0174100ZY	0	-	0	0	576	0.0000000
zheyou73v0_A04	16940285	16941290	BnaA04T0174200ZY	0	-	0	0	1005	0.0000000
zheyou73v0_A04	16942978	16943764	BnaA04T0174300ZY	0	-	0	0	786	0.0000000
zheyou73v0_A04	16988795	16989690	BnaA04T0174400ZY	0	+	0	0	895	0.0000000
zheyou73v0_A04	16989936	16990358	BnaA04T0174500ZY	0	+	0	0	422	0.0000000
zheyou73v0_A04	16997997	17000313	BnaA04T0174600ZY	0	+	0	0	2316	0.0000000
zheyou73v0_A04	16997997	17000313	BnaA04T0174600ZY.1	0	+	0	0	2316	0.0000000
zheyou73v0_A04	17000399	17001017	BnaA04T0174700ZY	0	+	0	0	618	0.0000000
zheyou73v0_A04	17001802	17003066	BnaA04T0174800ZY	0	+	0	0	1264	0.0000000
zheyou73v0_A04	17006140	17007919	BnaA04T0174900ZY	0	-	0	0	1779	0.0000000
zheyou73v0_A04	17015751	17017691	BnaA04T0175000ZY	0	+	0	0	1940	0.0000000
zheyou73v0_A04	17020474	17020633	BnaA04T0175100ZY	0	+	0	0	159	0.0000000
zheyou73v0_A04	17020642	17024343	BnaA04T0175200ZY	0	+	0	0	3701	0.0000000
zheyou73v0_A04	17025669	17026005	BnaA04T0175300ZY	0	-	0	0	336	0.0000000
zheyou73v0_A04	17031474	17033801	BnaA04T0175400ZY	0	+	0	0	2327	0.0000000
zheyou73v0_A04	17038677	17039454	BnaA04T0175500ZY	0	+	0	0	777	0.0000000
zheyou73v0_A04	17039979	17042466	BnaA04T0175600ZY	0	-	0	0	2487	0.0000000
zheyou73v0_A04	17044182	17046746	BnaA04T0175700ZY	0	+	0	0	2564	0.0000000
zheyou73v0_A04	17048316	17055728	BnaA04T0175800ZY	0	+	0	0	7412	0.0000000
zheyou73v0_A04	17059172	17059717	BnaA04T0175900ZY	0	+	0	0	545	0.0000000
zheyou73v0_A04	17059848	17063392	BnaA04T0176000ZY	0	-	0	0	3544	0.0000000
zheyou73v0_A04	17068787	17072910	BnaA04T0176100ZY	0	-	0	0	4123	0.0000000
zheyou73v0_A04	17095274	17100494	BnaA04T0176200ZY.2	0	+	0	0	5220	0.0000000
zheyou73v0_A04	17095283	17100494	BnaA04T0176200ZY	0	+	0	0	5211	0.0000000
zheyou73v0_A04	17095445	17100494	BnaA04T0176200ZY.1	0	+	0	0	5049	0.0000000
zheyou73v0_A04	17101258	17103777	BnaA04T0176300ZY	0	+	0	0	2519	0.0000000
zheyou73v0_A04	17101258	17103777	BnaA04T0176300ZY.1	0	+	0	0	2519	0.0000000
zheyou73v0_A04	17108549	17111023	BnaA04T0176400ZY	0	+	0	0	2474	0.0000000
zheyou73v0_A04	17111736	17114689	BnaA04T0176500ZY	0	-	0	0	2953	0.0000000
zheyou73v0_A04	17116656	17118846	BnaA04T0176600ZY	0	+	0	0	2190	0.0000000
zheyou73v0_A04	17119688	17120183	BnaA04T0176700ZY	0	-	0	0	495	0.0000000
zheyou73v0_A04	17122997	17123417	BnaA04T0176800ZY	0	-	0	0	420	0.0000000
zheyou73v0_A04	17125206	17126291	BnaA04T0176900ZY	0	+	0	0	1085	0.0000000
zheyou73v0_A04	17126666	17127096	BnaA04T0177000ZY	0	-	0	0	430	0.0000000
zheyou73v0_A04	17132834	17135698	BnaA04T0177100ZY	0	+	0	0	2864	0.0000000
zheyou73v0_A04	17132834	17135698	BnaA04T0177100ZY.1	0	+	0	0	2864	0.0000000
zheyou73v0_A04	17132834	17135698	BnaA04T0177100ZY.2	0	+	0	0	2864	0.0000000
zheyou73v0_A04	17137056	17137353	BnaA04T0177200ZY	0	+	0	0	297	0.0000000
zheyou73v0_A04	17141955	17142374	BnaA04T0177300ZY	0	-	0	0	419	0.0000000
zheyou73v0_A04	17144333	17159207	BnaA04T0177400ZY	0	-	0	0	14874	0.0000000
zheyou73v0_A04	17160308	17160947	BnaA04T0177500ZY	0	+	0	0	639	0.0000000
zheyou73v0_A04	17161358	17163144	BnaA04T0177600ZY	0	-	0	0	1786	0.0000000
zheyou73v0_A04	17164729	17167088	BnaA04T0177700ZY	0	+	0	0	2359	0.0000000
zheyou73v0_A04	17172652	17173577	BnaA04T0177800ZY	0	+	0	0	925	0.0000000
zheyou73v0_A04	17178207	17179865	BnaA04T0177900ZY	0	+	0	0	1658	0.0000000
zheyou73v0_A04	17181642	17183667	BnaA04T0178000ZY	0	+	0	0	2025	0.0000000
zheyou73v0_A04	17184909	17185251	BnaA04T0178100ZY	0	-	0	0	342	0.0000000
zheyou73v0_A04	17188617	17191299	BnaA04T0178200ZY	0	-	0	0	2682	0.0000000
zheyou73v0_A04	17192488	17193406	BnaA04T0178300ZY	0	-	0	0	918	0.0000000
zheyou73v0_A04	17196853	17198654	BnaA04T0178400ZY	0	+	0	0	1801	0.0000000
zheyou73v0_A04	17199269	17202529	BnaA04T0178500ZY	0	-	0	0	3260	0.0000000
zheyou73v0_A04	17223994	17224487	BnaA04T0178600ZY	0	+	0	0	493	0.0000000
zheyou73v0_A04	17226275	17226959	BnaA04T0178700ZY	0	+	0	0	684	0.0000000
zheyou73v0_A04	17227819	17229561	BnaA04T0178800ZY	0	-	0	0	1742	0.0000000
zheyou73v0_A04	17231306	17234329	BnaA04T0178900ZY	0	+	0	0	3023	0.0000000
zheyou73v0_A04	17234999	17236395	BnaA04T0179000ZY	0	-	0	0	1396	0.0000000
zheyou73v0_A04	17237501	17238318	BnaA04T0179100ZY	0	-	0	0	817	0.0000000
zheyou73v0_A04	17247426	17248651	BnaA04T0179200ZY	0	-	0	0	1225	0.0000000
zheyou73v0_A04	17252562	17254253	BnaA04T0179300ZY	0	+	0	0	1691	0.0000000
zheyou73v0_A04	17254429	17255672	BnaA04T0179400ZY	0	-	0	0	1243	0.0000000
zheyou73v0_A04	17255918	17257144	BnaA04T0179500ZY	0	+	0	0	1226	0.0000000
zheyou73v0_A04	17257902	17259349	BnaA04T0179600ZY	0	-	0	0	1447	0.0000000
zheyou73v0_A04	17259365	17262929	BnaA04T0179700ZY	0	+	0	0	3564	0.0000000
zheyou73v0_A04	17267578	17268916	BnaA04T0179800ZY	0	+	0	0	1338	0.0000000
zheyou73v0_A04	17271094	17271848	BnaA04T0179900ZY	0	-	0	0	754	0.0000000
zheyou73v0_A04	17273199	17275805	BnaA04T0180000ZY	0	+	0	0	2606	0.0000000
zheyou73v0_A04	17276364	17278347	BnaA04T0180100ZY	0	+	0	0	1983	0.0000000
zheyou73v0_A04	17289875	17291826	BnaA04T0180200ZY	0	-	0	0	1951	0.0000000
zheyou73v0_A04	17296386	17297852	BnaA04T0180300ZY	0	+	0	0	1466	0.0000000
zheyou73v0_A04	17300162	17301637	BnaA04T0180400ZY	0	+	0	0	1475	0.0000000
zheyou73v0_A04	17301941	17304475	BnaA04T0180500ZY	0	-	0	0	2534	0.0000000
zheyou73v0_A04	17307160	17308781	BnaA04T0180600ZY	0	-	0	0	1621	0.0000000
zheyou73v0_A04	17307160	17308781	BnaA04T0180600ZY.1	0	-	0	0	1621	0.0000000
zheyou73v0_A04	17307160	17308781	BnaA04T0180600ZY.3	0	-	0	0	1621	0.0000000
zheyou73v0_A04	17307535	17308781	BnaA04T0180600ZY.2	0	-	0	0	1246	0.0000000
zheyou73v0_A04	17311780	17313942	BnaA04T0180700ZY	0	-	0	0	2162	0.0000000
zheyou73v0_A04	17318415	17320141	BnaA04T0180800ZY	0	-	0	0	1726	0.0000000
zheyou73v0_A04	17320887	17322401	BnaA04T0180900ZY	0	+	0	0	1514	0.0000000
zheyou73v0_A04	17332517	17333240	BnaA04T0181000ZY	0	+	0	0	723	0.0000000
zheyou73v0_A04	17334364	17338073	BnaA04T0181100ZY	0	-	0	0	3709	0.0000000
zheyou73v0_A04	17335156	17338073	BnaA04T0181100ZY.1	0	-	0	0	2917	0.0000000
zheyou73v0_A04	17339052	17340679	BnaA04T0181200ZY	0	-	0	0	1627	0.0000000
zheyou73v0_A04	17341669	17344663	BnaA04T0181300ZY	0	+	0	0	2994	0.0000000
zheyou73v0_A04	17344775	17345923	BnaA04T0181400ZY	0	-	0	0	1148	0.0000000
zheyou73v0_A04	17346956	17348644	BnaA04T0181500ZY	0	+	0	0	1688	0.0000000
zheyou73v0_A04	17353980	17357988	BnaA04T0181600ZY	0	+	0	0	4008	0.0000000
zheyou73v0_A04	17358493	17360434	BnaA04T0181700ZY	0	+	0	0	1941	0.0000000
zheyou73v0_A04	17360577	17363538	BnaA04T0181800ZY	0	-	0	0	2961	0.0000000
zheyou73v0_A04	17370372	17370915	BnaA04T0181900ZY	0	+	0	0	543	0.0000000
zheyou73v0_A04	17372867	17376672	BnaA04T0182000ZY	0	+	0	0	3805	0.0000000
zheyou73v0_A04	17377070	17377588	BnaA04T0182100ZY	0	-	0	0	518	0.0000000
zheyou73v0_A04	17378235	17378982	BnaA04T0182200ZY	0	-	0	0	747	0.0000000
zheyou73v0_A04	17381509	17382366	BnaA04T0182300ZY	0	-	0	0	857	0.0000000
zheyou73v0_A04	17383016	17384244	BnaA04T0182400ZY	0	+	0	0	1228	0.0000000
zheyou73v0_A04	17387362	17390824	BnaA04T0182500ZY	0	+	0	0	3462	0.0000000
zheyou73v0_A04	17392612	17393494	BnaA04T0182600ZY	0	+	0	0	882	0.0000000
zheyou73v0_A04	17396390	17399432	BnaA04T0182700ZY	0	+	0	0	3042	0.0000000
zheyou73v0_A04	17406973	17414661	BnaA04T0182800ZY	0	+	0	0	7688	0.0000000
zheyou73v0_A04	17415633	17418012	BnaA04T0182900ZY	0	+	0	0	2379	0.0000000
zheyou73v0_A04	17418808	17421267	BnaA04T0183000ZY	0	+	0	0	2459	0.0000000
zheyou73v0_A04	17439409	17439928	BnaA04T0183100ZY	0	-	0	0	519	0.0000000
zheyou73v0_A04	17441668	17445299	BnaA04T0183200ZY	0	-	0	0	3631	0.0000000
zheyou73v0_A04	17447406	17448479	BnaA04T0183300ZY	0	+	0	0	1073	0.0000000
zheyou73v0_A04	17450542	17451775	BnaA04T0183400ZY	0	-	0	0	1233	0.0000000
zheyou73v0_A04	17452841	17453858	BnaA04T0183500ZY	0	-	0	0	1017	0.0000000
zheyou73v0_A04	17457944	17458622	BnaA04T0183600ZY	0	+	0	0	678	0.0000000
zheyou73v0_A04	17460219	17461192	BnaA04T0183700ZY	0	-	0	0	973	0.0000000
zheyou73v0_A04	17465724	17466170	BnaA04T0183800ZY	0	-	0	0	446	0.0000000
zheyou73v0_A04	17475942	17478891	BnaA04T0183900ZY	0	+	0	0	2949	0.0000000
zheyou73v0_A04	17479344	17479987	BnaA04T0184000ZY	0	-	0	0	643	0.0000000
zheyou73v0_A04	17481317	17482808	BnaA04T0184100ZY	0	+	0	0	1491	0.0000000
zheyou73v0_A04	17505523	17508822	BnaA04T0184200ZY	0	+	0	0	3299	0.0000000
zheyou73v0_A04	17511105	17511825	BnaA04T0184300ZY	0	+	0	0	720	0.0000000
zheyou73v0_A04	17546140	17547429	BnaA04T0184400ZY	0	+	0	0	1289	0.0000000
zheyou73v0_A04	17547686	17551472	BnaA04T0184500ZY	0	-	0	0	3786	0.0000000
zheyou73v0_A04	17547686	17551472	BnaA04T0184500ZY.1	0	-	0	0	3786	0.0000000
zheyou73v0_A04	17553610	17555525	BnaA04T0184600ZY	0	-	0	0	1915	0.0000000
zheyou73v0_A04	17566642	17567605	BnaA04T0184700ZY	0	+	0	0	963	0.0000000
zheyou73v0_A04	17573244	17574266	BnaA04T0184800ZY	0	+	0	0	1022	0.0000000
zheyou73v0_A04	17577841	17582601	BnaA04T0184900ZY	0	-	0	0	4760	0.0000000
zheyou73v0_A04	17583967	17586894	BnaA04T0185000ZY	0	-	0	0	2927	0.0000000
zheyou73v0_A04	17589104	17592106	BnaA04T0185100ZY	0	+	0	0	3002	0.0000000
zheyou73v0_A04	17599583	17600443	BnaA04T0185200ZY	0	+	0	0	860	0.0000000
zheyou73v0_A04	17601676	17602998	BnaA04T0185300ZY	0	+	0	0	1322	0.0000000
zheyou73v0_A04	17603177	17605991	BnaA04T0185400ZY	0	-	0	0	2814	0.0000000
zheyou73v0_A04	17609333	17610179	BnaA04T0185500ZY	0	+	0	0	846	0.0000000
zheyou73v0_A04	17613115	17614510	BnaA04T0185600ZY	0	-	0	0	1395	0.0000000
zheyou73v0_A04	17616086	17618789	BnaA04T0185700ZY	0	+	0	0	2703	0.0000000
zheyou73v0_A04	17619392	17620087	BnaA04T0185800ZY	0	+	0	0	695	0.0000000
zheyou73v0_A04	17621721	17624369	BnaA04T0185900ZY	0	-	0	0	2648	0.0000000
zheyou73v0_A04	17633124	17635048	BnaA04T0186000ZY	0	-	0	0	1924	0.0000000
zheyou73v0_A04	17637289	17638222	BnaA04T0186100ZY	0	-	0	0	933	0.0000000
zheyou73v0_A04	17644499	17647526	BnaA04T0186200ZY	0	+	0	0	3027	0.0000000
zheyou73v0_A04	17647812	17649063	BnaA04T0186300ZY	0	+	0	0	1251	0.0000000
zheyou73v0_A04	17647812	17649063	BnaA04T0186300ZY.1	0	+	0	0	1251	0.0000000
zheyou73v0_A04	17647812	17649063	BnaA04T0186300ZY.2	0	+	0	0	1251	0.0000000
zheyou73v0_A04	17649198	17650349	BnaA04T0186400ZY	0	-	0	0	1151	0.0000000
zheyou73v0_A04	17655805	17658691	BnaA04T0186500ZY	0	+	0	0	2886	0.0000000
zheyou73v0_A04	17661430	17662339	BnaA04T0186600ZY	0	+	0	0	909	0.0000000
zheyou73v0_A04	17663473	17667850	BnaA04T0186700ZY	0	-	0	0	4377	0.0000000
zheyou73v0_A04	17670348	17670944	BnaA04T0186800ZY	0	-	0	0	596	0.0000000
zheyou73v0_A04	17676902	17677288	BnaA04T0186900ZY	0	+	0	0	386	0.0000000
zheyou73v0_A04	17680845	17682667	BnaA04T0187000ZY	0	+	0	0	1822	0.0000000
zheyou73v0_A04	17722384	17723839	BnaA04T0187100ZY	0	+	0	0	1455	0.0000000
zheyou73v0_A04	17727291	17729306	BnaA04T0187200ZY	0	+	0	0	2015	0.0000000
zheyou73v0_A04	17729308	17729947	BnaA04T0187300ZY	0	-	0	0	639	0.0000000
zheyou73v0_A04	17733412	17734748	BnaA04T0187400ZY	0	-	0	0	1336	0.0000000
zheyou73v0_A04	17736789	17738644	BnaA04T0187500ZY	0	+	0	0	1855	0.0000000
zheyou73v0_A04	17738635	17740017	BnaA04T0187600ZY	0	-	0	0	1382	0.0000000
zheyou73v0_A04	17740535	17754059	BnaA04T0187700ZY	0	-	0	0	13524	0.0000000
zheyou73v0_A04	17756251	17758553	BnaA04T0187800ZY	0	-	0	0	2302	0.0000000
zheyou73v0_A04	17760933	17763305	BnaA04T0187900ZY	0	+	0	0	2372	0.0000000
zheyou73v0_A04	17764154	17767020	BnaA04T0188000ZY	0	+	0	0	2866	0.0000000
zheyou73v0_A04	17767813	17771252	BnaA04T0188100ZY	0	-	0	0	3439	0.0000000
zheyou73v0_A04	17767813	17770696	BnaA04T0188100ZY.1	0	-	0	0	2883	0.0000000
zheyou73v0_A04	17775704	17779455	BnaA04T0188200ZY	0	-	0	0	3751	0.0000000
zheyou73v0_A04	17779634	17781209	BnaA04T0188300ZY	0	+	0	0	1575	0.0000000
zheyou73v0_A04	17781235	17784180	BnaA04T0188400ZY	0	-	0	0	2945	0.0000000
zheyou73v0_A04	17785233	17786066	BnaA04T0188500ZY	0	+	0	0	833	0.0000000
zheyou73v0_A04	17786166	17788478	BnaA04T0188600ZY	0	-	0	0	2312	0.0000000
zheyou73v0_A04	17788931	17790868	BnaA04T0188700ZY	0	+	0	0	1937	0.0000000
zheyou73v0_A04	17788931	17790868	BnaA04T0188700ZY.1	0	+	0	0	1937	0.0000000
zheyou73v0_A04	17791355	17794055	BnaA04T0188800ZY	0	+	0	0	2700	0.0000000
zheyou73v0_A04	17794727	17796401	BnaA04T0188900ZY	0	+	0	0	1674	0.0000000
zheyou73v0_A04	17797146	17797932	BnaA04T0189000ZY	0	-	0	0	786	0.0000000
zheyou73v0_A04	17802466	17804517	BnaA04T0189100ZY	0	+	0	0	2051	0.0000000
zheyou73v0_A04	17805065	17806652	BnaA04T0189200ZY	0	+	0	0	1587	0.0000000
zheyou73v0_A04	17806765	17808099	BnaA04T0189300ZY	0	-	0	0	1334	0.0000000
zheyou73v0_A04	17808709	17811095	BnaA04T0189400ZY	0	+	0	0	2386	0.0000000
zheyou73v0_A04	17811623	17813343	BnaA04T0189500ZY	0	-	0	0	1720	0.0000000
zheyou73v0_A04	17814903	17816875	BnaA04T0189600ZY	0	+	0	0	1972	0.0000000
zheyou73v0_A04	17817067	17818747	BnaA04T0189700ZY	0	-	0	0	1680	0.0000000
zheyou73v0_A04	17820084	17820540	BnaA04T0189800ZY	0	-	0	0	456	0.0000000
zheyou73v0_A04	17820979	17822669	BnaA04T0189900ZY	0	+	0	0	1690	0.0000000
zheyou73v0_A04	17822964	17825451	BnaA04T0190000ZY	0	-	0	0	2487	0.0000000
zheyou73v0_A04	17830648	17834540	BnaA04T0190100ZY	0	+	0	0	3892	0.0000000
zheyou73v0_A04	17835343	17836758	BnaA04T0190200ZY	0	+	0	0	1415	0.0000000
zheyou73v0_A04	17839145	17840372	BnaA04T0190300ZY	0	-	0	0	1227	0.0000000
zheyou73v0_A04	17842800	17843797	BnaA04T0190400ZY	0	+	0	0	997	0.0000000
zheyou73v0_A04	17844765	17845747	BnaA04T0190500ZY	0	-	0	0	982	0.0000000
zheyou73v0_A04	17846302	17847021	BnaA04T0190600ZY	0	+	0	0	719	0.0000000
zheyou73v0_A04	17847093	17847601	BnaA04T0190700ZY	0	-	0	0	508	0.0000000
zheyou73v0_A04	17848699	17849681	BnaA04T0190800ZY	0	-	0	0	982	0.0000000
zheyou73v0_A04	17850606	17859215	BnaA04T0190900ZY	0	+	0	0	8609	0.0000000
zheyou73v0_A04	17859623	17860817	BnaA04T0191000ZY	0	-	0	0	1194	0.0000000
zheyou73v0_A04	17890404	17892732	BnaA04T0191100ZY	0	-	0	0	2328	0.0000000
zheyou73v0_A04	17893369	17897339	BnaA04T0191200ZY	0	-	0	0	3970	0.0000000
zheyou73v0_A04	17898092	17899705	BnaA04T0191300ZY	0	-	0	0	1613	0.0000000
zheyou73v0_A04	17900004	17901556	BnaA04T0191400ZY	0	-	0	0	1552	0.0000000
zheyou73v0_A04	17903726	17905947	BnaA04T0191500ZY	0	+	0	0	2221	0.0000000
zheyou73v0_A04	17906251	17907938	BnaA04T0191600ZY	0	+	0	0	1687	0.0000000
zheyou73v0_A04	17910603	17911487	BnaA04T0191700ZY	0	+	0	0	884	0.0000000
zheyou73v0_A04	17912197	17913025	BnaA04T0191800ZY	0	+	0	0	828	0.0000000
zheyou73v0_A04	17914326	17915687	BnaA04T0191900ZY	0	+	0	0	1361	0.0000000
zheyou73v0_A04	17917412	17918750	BnaA04T0192000ZY	0	-	0	0	1338	0.0000000
zheyou73v0_A04	17917412	17918750	BnaA04T0192000ZY.1	0	-	0	0	1338	0.0000000
zheyou73v0_A04	17919354	17920403	BnaA04T0192100ZY	0	+	0	0	1049	0.0000000
zheyou73v0_A04	17927760	17928816	BnaA04T0192200ZY	0	-	0	0	1056	0.0000000
zheyou73v0_A04	17936176	17937655	BnaA04T0192300ZY	0	-	0	0	1479	0.0000000
zheyou73v0_A04	17942115	17943199	BnaA04T0192400ZY	0	-	0	0	1084	0.0000000
zheyou73v0_A04	17952186	17953445	BnaA04T0192500ZY	0	-	0	0	1259	0.0000000
zheyou73v0_A04	17956131	17960247	BnaA04T0192600ZY	0	-	0	0	4116	0.0000000
zheyou73v0_A04	17962036	17962653	BnaA04T0192700ZY	0	+	0	0	617	0.0000000
zheyou73v0_A04	17963024	17963857	BnaA04T0192800ZY	0	-	0	0	833	0.0000000
zheyou73v0_A04	17964058	17965938	BnaA04T0192900ZY	0	-	0	0	1880	0.0000000
zheyou73v0_A04	17964058	17965938	BnaA04T0192900ZY.1	0	-	0	0	1880	0.0000000
zheyou73v0_A04	17964058	17965938	BnaA04T0192900ZY.2	0	-	0	0	1880	0.0000000
zheyou73v0_A04	17968185	17970336	BnaA04T0193000ZY	0	+	0	0	2151	0.0000000
zheyou73v0_A04	17970672	17971959	BnaA04T0193100ZY	0	-	0	0	1287	0.0000000
zheyou73v0_A04	17974281	17976608	BnaA04T0193200ZY	0	+	0	0	2327	0.0000000
zheyou73v0_A04	17981447	17982380	BnaA04T0193300ZY	0	+	0	0	933	0.0000000
zheyou73v0_A04	17982851	17983151	BnaA04T0193400ZY	0	-	0	0	300	0.0000000
zheyou73v0_A04	17984364	17984643	BnaA04T0193500ZY	0	-	0	0	279	0.0000000
zheyou73v0_A04	17987098	17988217	BnaA04T0193600ZY	0	+	0	0	1119	0.0000000
zheyou73v0_A04	17988873	17990088	BnaA04T0193700ZY	0	+	0	0	1215	0.0000000
zheyou73v0_A04	17988873	17990088	BnaA04T0193700ZY.1	0	+	0	0	1215	0.0000000
zheyou73v0_A04	17988873	17990088	BnaA04T0193700ZY.2	0	+	0	0	1215	0.0000000
zheyou73v0_A04	17991471	17993350	BnaA04T0193800ZY	0	-	0	0	1879	0.0000000
zheyou73v0_A04	18025336	18026538	BnaA04T0193900ZY	0	-	0	0	1202	0.0000000
zheyou73v0_A04	18027693	18029722	BnaA04T0194000ZY	0	+	0	0	2029	0.0000000
zheyou73v0_A04	18063651	18064011	BnaA04T0194100ZY	0	+	0	0	360	0.0000000
zheyou73v0_A04	18065472	18068890	BnaA04T0194200ZY	0	-	0	0	3418	0.0000000
zheyou73v0_A04	18075222	18077892	BnaA04T0194300ZY	0	+	0	0	2670	0.0000000
zheyou73v0_A04	18079060	18079831	BnaA04T0194400ZY	0	+	0	0	771	0.0000000
zheyou73v0_A04	18110853	18113491	BnaA04T0194500ZY	0	-	0	0	2638	0.0000000
zheyou73v0_A04	18125096	18126553	BnaA04T0194600ZY	0	+	0	0	1457	0.0000000
zheyou73v0_A04	18128332	18130668	BnaA04T0194700ZY.1	0	+	0	0	2336	0.0000000
zheyou73v0_A04	18129128	18130668	BnaA04T0194700ZY	0	+	0	0	1540	0.0000000
zheyou73v0_A04	18130848	18133089	BnaA04T0194800ZY	0	+	0	0	2241	0.0000000
zheyou73v0_A04	18134241	18135585	BnaA04T0194900ZY	0	+	0	0	1344	0.0000000
zheyou73v0_A04	18135822	18137441	BnaA04T0195000ZY	0	+	0	0	1619	0.0000000
zheyou73v0_A04	18135822	18137441	BnaA04T0195000ZY.1	0	+	0	0	1619	0.0000000
zheyou73v0_A04	18135822	18137441	BnaA04T0195000ZY.2	0	+	0	0	1619	0.0000000
zheyou73v0_A04	18135822	18137441	BnaA04T0195000ZY.3	0	+	0	0	1619	0.0000000
zheyou73v0_A04	18144490	18145285	BnaA04T0195100ZY	0	+	0	0	795	0.0000000
zheyou73v0_A04	18147636	18149438	BnaA04T0195200ZY	0	+	0	0	1802	0.0000000
zheyou73v0_A04	18150510	18152215	BnaA04T0195300ZY	0	+	0	0	1705	0.0000000
zheyou73v0_A04	18162946	18164401	BnaA04T0195400ZY	0	+	0	0	1455	0.0000000
zheyou73v0_A04	18166877	18167505	BnaA04T0195500ZY	0	+	0	0	628	0.0000000
zheyou73v0_A04	18167698	18169195	BnaA04T0195600ZY	0	-	0	0	1497	0.0000000
zheyou73v0_A04	18170884	18171171	BnaA04T0195700ZY	0	-	0	0	287	0.0000000
zheyou73v0_A04	18176571	18177584	BnaA04T0195800ZY	0	+	0	0	1013	0.0000000
zheyou73v0_A04	18180538	18182352	BnaA04T0195900ZY	0	-	0	0	1814	0.0000000
zheyou73v0_A04	18186307	18190062	BnaA04T0196000ZY	0	-	0	0	3755	0.0000000
zheyou73v0_A04	18193720	18195977	BnaA04T0196100ZY	0	-	0	0	2257	0.0000000
zheyou73v0_A04	18197446	18198344	BnaA04T0196200ZY	0	-	0	0	898	0.0000000
zheyou73v0_A04	18199054	18200371	BnaA04T0196300ZY	0	-	0	0	1317	0.0000000
zheyou73v0_A04	18226074	18228857	BnaA04T0196400ZY	0	-	0	0	2783	0.0000000
zheyou73v0_A04	18234458	18235349	BnaA04T0196500ZY	0	+	0	0	891	0.0000000
zheyou73v0_A04	18235669	18237198	BnaA04T0196600ZY	0	-	0	0	1529	0.0000000
zheyou73v0_A04	18242659	18243734	BnaA04T0196700ZY	0	+	0	0	1075	0.0000000
zheyou73v0_A04	18244402	18244672	BnaA04T0196800ZY	0	-	0	0	270	0.0000000
zheyou73v0_A04	18245477	18248692	BnaA04T0196900ZY	0	+	0	0	3215	0.0000000
zheyou73v0_A04	18245477	18248498	BnaA04T0196900ZY.1	0	+	0	0	3021	0.0000000
zheyou73v0_A04	18250232	18255722	BnaA04T0197000ZY	0	+	0	0	5490	0.0000000
zheyou73v0_A04	18256518	18258014	BnaA04T0197100ZY	0	-	0	0	1496	0.0000000
zheyou73v0_A04	18262176	18262581	BnaA04T0197200ZY	0	-	0	0	405	0.0000000
zheyou73v0_A04	18267361	18268048	BnaA04T0197300ZY	0	+	0	0	687	0.0000000
zheyou73v0_A04	18269733	18277633	BnaA04T0197400ZY	0	+	0	0	7900	0.0000000
zheyou73v0_A04	18281328	18281746	BnaA04T0197500ZY	0	+	0	0	418	0.0000000
zheyou73v0_A04	18285745	18286201	BnaA04T0197600ZY	0	+	0	0	456	0.0000000
zheyou73v0_A04	18287193	18289706	BnaA04T0197700ZY	0	+	0	0	2513	0.0000000
zheyou73v0_A04	18290328	18291359	BnaA04T0197800ZY	0	-	0	0	1031	0.0000000
zheyou73v0_A04	18292470	18293430	BnaA04T0197900ZY	0	+	0	0	960	0.0000000
zheyou73v0_A04	18298213	18300743	BnaA04T0198000ZY	0	+	0	0	2530	0.0000000
zheyou73v0_A04	18301085	18301760	BnaA04T0198100ZY	0	-	0	0	675	0.0000000
zheyou73v0_A04	18348035	18350535	BnaA04T0198200ZY	0	+	0	0	2500	0.0000000
zheyou73v0_A04	18350782	18352180	BnaA04T0198300ZY	0	-	0	0	1398	0.0000000
zheyou73v0_A04	18353456	18354182	BnaA04T0198400ZY	0	-	0	0	726	0.0000000
zheyou73v0_A04	18355233	18356760	BnaA04T0198500ZY	0	-	0	0	1527	0.0000000
zheyou73v0_A04	18356960	18359899	BnaA04T0198600ZY	0	-	0	0	2939	0.0000000
zheyou73v0_A04	18364680	18365444	BnaA04T0198700ZY	0	+	0	0	764	0.0000000
zheyou73v0_A04	18365633	18367146	BnaA04T0198800ZY	0	-	0	0	1513	0.0000000
zheyou73v0_A04	18369023	18370256	BnaA04T0198900ZY	0	+	0	0	1233	0.0000000
zheyou73v0_A04	18370497	18371051	BnaA04T0199000ZY	0	+	0	0	554	0.0000000
zheyou73v0_A04	18374992	18375518	BnaA04T0199100ZY	0	+	0	0	526	0.0000000
zheyou73v0_A04	18375869	18377303	BnaA04T0199200ZY	0	-	0	0	1434	0.0000000
zheyou73v0_A04	18378738	18379666	BnaA04T0199300ZY	0	+	0	0	928	0.0000000
zheyou73v0_A04	18383750	18384173	BnaA04T0199400ZY	0	-	0	0	423	0.0000000
zheyou73v0_A04	18384841	18388291	BnaA04T0199500ZY	0	-	0	0	3450	0.0000000
zheyou73v0_A04	18389466	18389878	BnaA04T0199600ZY	0	+	0	0	412	0.0000000
zheyou73v0_A04	18391204	18411919	BnaA04T0199700ZY	0	-	0	0	20715	0.0000000
zheyou73v0_A04	18412125	18413366	BnaA04T0199800ZY	0	+	0	0	1241	0.0000000
zheyou73v0_A04	18413573	18414376	BnaA04T0199900ZY	0	-	0	0	803	0.0000000
zheyou73v0_A04	18415767	18418168	BnaA04T0200000ZY	0	-	0	0	2401	0.0000000
zheyou73v0_A04	18418338	18419697	BnaA04T0200100ZY	0	+	0	0	1359	0.0000000
zheyou73v0_A04	18420109	18421143	BnaA04T0200200ZY	0	-	0	0	1034	0.0000000
zheyou73v0_A05	567	6663	BnaA05T0000100ZY	0	-	0	0	6096	0.0000000
zheyou73v0_A05	9258	9973	BnaA05T0000200ZY	0	+	0	0	715	0.0000000
zheyou73v0_A05	12711	15159	BnaA05T0000300ZY	0	+	0	0	2448	0.0000000
zheyou73v0_A05	16168	16926	BnaA05T0000400ZY	0	-	0	0	758	0.0000000
zheyou73v0_A05	17204	28068	BnaA05T0000500ZY	0	+	0	0	10864	0.0000000
zheyou73v0_A05	30811	32979	BnaA05T0000600ZY	0	+	0	0	2168	0.0000000
zheyou73v0_A05	63899	72352	BnaA05T0000700ZY	0	-	0	0	8453	0.0000000
zheyou73v0_A05	73483	74158	BnaA05T0000800ZY	0	+	0	0	675	0.0000000
zheyou73v0_A05	74370	75027	BnaA05T0000900ZY	0	-	0	0	657	0.0000000
zheyou73v0_A05	75841	77090	BnaA05T0001000ZY	0	-	0	0	1249	0.0000000
zheyou73v0_A05	78199	80862	BnaA05T0001100ZY	0	-	0	0	2663	0.0000000
zheyou73v0_A05	82363	82947	BnaA05T0001200ZY	0	-	0	0	584	0.0000000
zheyou73v0_A05	84692	85004	BnaA05T0001300ZY	0	-	0	0	312	0.0000000
zheyou73v0_A05	86748	91339	BnaA05T0001400ZY	0	+	0	0	4591	0.0000000
zheyou73v0_A05	91189	93428	BnaA05T0001500ZY	0	-	0	0	2239	0.0000000
zheyou73v0_A05	102082	102550	BnaA05T0001600ZY	0	+	0	0	468	0.0000000
zheyou73v0_A05	106689	107441	BnaA05T0001700ZY	0	-	0	0	752	0.0000000
zheyou73v0_A05	107822	108577	BnaA05T0001800ZY	0	-	0	0	755	0.0000000
zheyou73v0_A05	108922	111302	BnaA05T0001900ZY	0	+	0	0	2380	0.0000000
zheyou73v0_A05	111439	111743	BnaA05T0002000ZY	0	+	0	0	304	0.0000000
zheyou73v0_A05	114232	116940	BnaA05T0002100ZY	0	+	0	0	2708	0.0000000
zheyou73v0_A05	117620	118398	BnaA05T0002200ZY	0	+	0	0	778	0.0000000
zheyou73v0_A05	119378	120370	BnaA05T0002300ZY	0	-	0	0	992	0.0000000
zheyou73v0_A05	121278	122635	BnaA05T0002400ZY	0	+	0	0	1357	0.0000000
zheyou73v0_A05	122975	124902	BnaA05T0002500ZY	0	+	0	0	1927	0.0000000
zheyou73v0_A05	125359	126147	BnaA05T0002600ZY	0	-	0	0	788	0.0000000
zheyou73v0_A05	126527	131803	BnaA05T0002700ZY	0	+	0	0	5276	0.0000000
zheyou73v0_A05	141065	142213	BnaA05T0002800ZY	0	+	0	0	1148	0.0000000
zheyou73v0_A05	157969	158884	BnaA05T0002900ZY	0	-	0	0	915	0.0000000
zheyou73v0_A05	159036	161458	BnaA05T0003000ZY	0	-	0	0	2422	0.0000000
zheyou73v0_A05	161703	163193	BnaA05T0003100ZY	0	-	0	0	1490	0.0000000
zheyou73v0_A05	164659	166919	BnaA05T0003200ZY	0	+	0	0	2260	0.0000000
zheyou73v0_A05	167121	169110	BnaA05T0003300ZY	0	-	0	0	1989	0.0000000
zheyou73v0_A05	172807	174214	BnaA05T0003400ZY	0	-	0	0	1407	0.0000000
zheyou73v0_A05	178084	178774	BnaA05T0003500ZY	0	+	0	0	690	0.0000000
zheyou73v0_A05	178801	181736	BnaA05T0003600ZY	0	-	0	0	2935	0.0000000
zheyou73v0_A05	185388	185850	BnaA05T0003700ZY	0	-	0	0	462	0.0000000
zheyou73v0_A05	185844	188169	BnaA05T0003800ZY	0	+	0	0	2325	0.0000000
zheyou73v0_A05	188244	188807	BnaA05T0003900ZY	0	-	0	0	563	0.0000000
zheyou73v0_A05	189625	192706	BnaA05T0004000ZY	0	-	0	0	3081	0.0000000
zheyou73v0_A05	189625	192706	BnaA05T0004000ZY.1	0	-	0	0	3081	0.0000000
zheyou73v0_A05	193563	202006	BnaA05T0004100ZY	0	-	0	0	8443	0.0000000
zheyou73v0_A05	206260	207846	BnaA05T0004200ZY	0	-	0	0	1586	0.0000000
zheyou73v0_A05	209657	210818	BnaA05T0004300ZY	0	-	0	0	1161	0.0000000
zheyou73v0_A05	211165	211738	BnaA05T0004400ZY	0	-	0	0	573	0.0000000
zheyou73v0_A05	213337	213833	BnaA05T0004500ZY	0	+	0	0	496	0.0000000
zheyou73v0_A05	214492	216802	BnaA05T0004600ZY	0	-	0	0	2310	0.0000000
zheyou73v0_A05	240221	244722	BnaA05T0004700ZY	0	-	0	0	4501	0.0000000
zheyou73v0_A05	248013	250422	BnaA05T0004800ZY	0	-	0	0	2409	0.0000000
zheyou73v0_A05	248013	250422	BnaA05T0004800ZY.1	0	-	0	0	2409	0.0000000
zheyou73v0_A05	248013	250422	BnaA05T0004800ZY.2	0	-	0	0	2409	0.0000000
zheyou73v0_A05	251524	264559	BnaA05T0004900ZY	0	+	0	0	13035	0.0000000
zheyou73v0_A05	264765	266239	BnaA05T0005000ZY	0	-	0	0	1474	0.0000000
zheyou73v0_A05	266728	267437	BnaA05T0005100ZY	0	-	0	0	709	0.0000000
zheyou73v0_A05	267666	272050	BnaA05T0005200ZY	0	+	0	0	4384	0.0000000
zheyou73v0_A05	267666	272050	BnaA05T0005200ZY.1	0	+	0	0	4384	0.0000000
zheyou73v0_A05	272794	273978	BnaA05T0005300ZY	0	+	0	0	1184	0.0000000
zheyou73v0_A05	274171	275089	BnaA05T0005400ZY	0	-	0	0	918	0.0000000
zheyou73v0_A05	275483	277920	BnaA05T0005500ZY	0	-	0	0	2437	0.0000000
zheyou73v0_A05	278890	281771	BnaA05T0005600ZY	0	+	0	0	2881	0.0000000
zheyou73v0_A05	284725	285318	BnaA05T0005700ZY	0	+	0	0	593	0.0000000
zheyou73v0_A05	290446	291984	BnaA05T0005800ZY	0	+	0	0	1538	0.0000000
zheyou73v0_A05	294974	295729	BnaA05T0005900ZY	0	-	0	0	755	0.0000000
zheyou73v0_A05	323321	327305	BnaA05T0006000ZY	0	-	0	0	3984	0.0000000
zheyou73v0_A05	330172	330983	BnaA05T0006100ZY	0	+	0	0	811	0.0000000
zheyou73v0_A05	331088	331331	BnaA05T0006200ZY	0	+	0	0	243	0.0000000
zheyou73v0_A05	337295	338965	BnaA05T0006300ZY	0	-	0	0	1670	0.0000000
zheyou73v0_A05	339624	341536	BnaA05T0006400ZY	0	-	0	0	1912	0.0000000
zheyou73v0_A05	343043	344543	BnaA05T0006500ZY	0	+	0	0	1500	0.0000000
zheyou73v0_A05	343952	347577	BnaA05T0006600ZY	0	-	0	0	3625	0.0000000
zheyou73v0_A05	348429	348717	BnaA05T0006700ZY	0	+	0	0	288	0.0000000
zheyou73v0_A05	354142	355453	BnaA05T0006800ZY	0	-	0	0	1311	0.0000000
zheyou73v0_A05	362114	363609	BnaA05T0006900ZY	0	+	0	0	1495	0.0000000
zheyou73v0_A05	363597	365529	BnaA05T0007000ZY	0	-	0	0	1932	0.0000000
zheyou73v0_A05	370735	373912	BnaA05T0007100ZY	0	+	0	0	3177	0.0000000
zheyou73v0_A05	384172	386224	BnaA05T0007200ZY	0	+	0	0	2052	0.0000000
zheyou73v0_A05	384172	386224	BnaA05T0007200ZY.1	0	+	0	0	2052	0.0000000
zheyou73v0_A05	388038	390877	BnaA05T0007300ZY	0	+	0	0	2839	0.0000000
zheyou73v0_A05	411211	413375	BnaA05T0007400ZY	0	+	0	0	2164	0.0000000
zheyou73v0_A05	413453	417441	BnaA05T0007500ZY	0	-	0	0	3988	0.0000000
zheyou73v0_A05	421194	423229	BnaA05T0007600ZY	0	+	0	0	2035	0.0000000
zheyou73v0_A05	423794	424743	BnaA05T0007700ZY	0	+	0	0	949	0.0000000
zheyou73v0_A05	426373	428706	BnaA05T0007800ZY	0	+	0	0	2333	0.0000000
zheyou73v0_A05	428936	431271	BnaA05T0007900ZY	0	+	0	0	2335	0.0000000
zheyou73v0_A05	431773	433802	BnaA05T0008000ZY	0	-	0	0	2029	0.0000000
zheyou73v0_A05	437181	442780	BnaA05T0008100ZY	0	+	0	0	5599	0.0000000
zheyou73v0_A05	458917	460507	BnaA05T0008200ZY	0	-	0	0	1590	0.0000000
zheyou73v0_A05	461268	461752	BnaA05T0008300ZY	0	+	0	0	484	0.0000000
zheyou73v0_A05	484793	486383	BnaA05T0008400ZY	0	-	0	0	1590	0.0000000
zheyou73v0_A05	487475	489374	BnaA05T0008500ZY	0	+	0	0	1899	0.0000000
zheyou73v0_A05	512446	514036	BnaA05T0008600ZY	0	-	0	0	1590	0.0000000
zheyou73v0_A05	515128	517027	BnaA05T0008700ZY	0	+	0	0	1899	0.0000000
zheyou73v0_A05	534051	535641	BnaA05T0008800ZY	0	-	0	0	1590	0.0000000
zheyou73v0_A05	537114	539007	BnaA05T0008900ZY	0	+	0	0	1893	0.0000000
zheyou73v0_A05	557237	559538	BnaA05T0009000ZY	0	+	0	0	2301	0.0000000
zheyou73v0_A05	560673	561405	BnaA05T0009100ZY	0	-	0	0	732	0.0000000
zheyou73v0_A05	564025	566192	BnaA05T0009200ZY	0	+	0	0	2167	0.0000000
zheyou73v0_A05	564025	566192	BnaA05T0009200ZY.1	0	+	0	0	2167	0.0000000
zheyou73v0_A05	569030	569725	BnaA05T0009300ZY	0	+	0	0	695	0.0000000
zheyou73v0_A05	572753	573667	BnaA05T0009400ZY	0	+	0	0	914	0.0000000
zheyou73v0_A05	576670	579008	BnaA05T0009500ZY	0	-	0	0	2338	0.0000000
zheyou73v0_A05	582087	585898	BnaA05T0009600ZY	0	+	0	0	3811	0.0000000
zheyou73v0_A05	586410	590049	BnaA05T0009700ZY	0	+	0	0	3639	0.0000000
zheyou73v0_A05	590212	591593	BnaA05T0009800ZY	0	-	0	0	1381	0.0000000
zheyou73v0_A05	592029	594309	BnaA05T0009900ZY	0	-	0	0	2280	0.0000000
zheyou73v0_A05	595134	598546	BnaA05T0010000ZY	0	+	0	0	3412	0.0000000
zheyou73v0_A05	600016	601244	BnaA05T0010100ZY	0	-	0	0	1228	0.0000000
zheyou73v0_A05	607407	612250	BnaA05T0010200ZY	0	-	0	0	4843	0.0000000
zheyou73v0_A05	609732	612521	BnaA05T0010200ZY.1	0	-	0	0	2789	0.0000000
zheyou73v0_A05	614902	616563	BnaA05T0010300ZY	0	-	0	0	1661	0.0000000
zheyou73v0_A05	625147	626775	BnaA05T0010400ZY	0	-	0	0	1628	0.0000000
zheyou73v0_A05	632932	634063	BnaA05T0010500ZY	0	-	0	0	1131	0.0000000
zheyou73v0_A05	635798	637539	BnaA05T0010600ZY	0	-	0	0	1741	0.0000000
zheyou73v0_A05	641177	643458	BnaA05T0010700ZY	0	-	0	0	2281	0.0000000
zheyou73v0_A05	641177	643458	BnaA05T0010700ZY.1	0	-	0	0	2281	0.0000000
zheyou73v0_A05	641177	643458	BnaA05T0010700ZY.2	0	-	0	0	2281	0.0000000
zheyou73v0_A05	655711	657904	BnaA05T0010800ZY	0	+	0	0	2193	0.0000000
zheyou73v0_A05	674903	678395	BnaA05T0010900ZY	0	+	0	0	3492	0.0000000
zheyou73v0_A05	679660	682347	BnaA05T0011000ZY	0	+	0	0	2687	0.0000000
zheyou73v0_A05	689119	691501	BnaA05T0011100ZY	0	+	0	0	2382	0.0000000
zheyou73v0_A05	691833	693973	BnaA05T0011200ZY	0	-	0	0	2140	0.0000000
zheyou73v0_A05	707661	711044	BnaA05T0011300ZY	0	-	0	0	3383	0.0000000
zheyou73v0_A05	718240	719715	BnaA05T0011400ZY	0	-	0	0	1475	0.0000000
zheyou73v0_A05	719850	720639	BnaA05T0011500ZY	0	-	0	0	789	0.0000000
zheyou73v0_A05	722668	723737	BnaA05T0011600ZY	0	+	0	0	1069	0.0000000
zheyou73v0_A05	726352	727254	BnaA05T0011700ZY	0	-	0	0	902	0.0000000
zheyou73v0_A05	758141	760170	BnaA05T0011800ZY	0	+	0	0	2029	0.0000000
zheyou73v0_A05	761275	761846	BnaA05T0011900ZY	0	-	0	0	571	0.0000000
zheyou73v0_A05	765019	765533	BnaA05T0012000ZY	0	+	0	0	514	0.0000000
zheyou73v0_A05	767454	769608	BnaA05T0012100ZY.1	0	-	0	0	2154	0.0000000
zheyou73v0_A05	767454	769544	BnaA05T0012100ZY.2	0	-	0	0	2090	0.0000000
zheyou73v0_A05	767897	769608	BnaA05T0012100ZY	0	-	0	0	1711	0.0000000
zheyou73v0_A05	772061	773033	BnaA05T0012200ZY	0	-	0	0	972	0.0000000
zheyou73v0_A05	773768	774326	BnaA05T0012300ZY	0	-	0	0	558	0.0000000
zheyou73v0_A05	779531	780938	BnaA05T0012400ZY	0	+	0	0	1407	0.0000000
zheyou73v0_A05	781390	782983	BnaA05T0012500ZY	0	+	0	0	1593	0.0000000
zheyou73v0_A05	783329	783710	BnaA05T0012600ZY	0	-	0	0	381	0.0000000
zheyou73v0_A05	786244	789951	BnaA05T0012700ZY	0	-	0	0	3707	0.0000000
zheyou73v0_A05	790808	791906	BnaA05T0012800ZY	0	+	0	0	1098	0.0000000
zheyou73v0_A05	807120	817100	BnaA05T0012900ZY	0	+	0	0	9980	0.0000000
zheyou73v0_A05	818511	820283	BnaA05T0013000ZY	0	+	0	0	1772	0.0000000
zheyou73v0_A05	821165	822001	BnaA05T0013100ZY	0	+	0	0	836	0.0000000
zheyou73v0_A05	822471	823128	BnaA05T0013200ZY	0	-	0	0	657	0.0000000
zheyou73v0_A05	823587	825413	BnaA05T0013300ZY	0	+	0	0	1826	0.0000000
zheyou73v0_A05	825553	826143	BnaA05T0013400ZY	0	+	0	0	590	0.0000000
zheyou73v0_A05	826452	830668	BnaA05T0013500ZY	0	-	0	0	4216	0.0000000
zheyou73v0_A05	843961	847436	BnaA05T0013600ZY	0	-	0	0	3475	0.0000000
zheyou73v0_A05	851473	853387	BnaA05T0013700ZY	0	+	0	0	1914	0.0000000
zheyou73v0_A05	855064	855984	BnaA05T0013800ZY	0	-	0	0	920	0.0000000
zheyou73v0_A05	856421	859156	BnaA05T0013900ZY	0	+	0	0	2735	0.0000000
zheyou73v0_A05	860341	861528	BnaA05T0014000ZY	0	+	0	0	1187	0.0000000
zheyou73v0_A05	861795	865374	BnaA05T0014100ZY	0	-	0	0	3579	0.0000000
zheyou73v0_A05	861795	865119	BnaA05T0014100ZY.1	0	-	0	0	3324	0.0000000
zheyou73v0_A05	861795	865374	BnaA05T0014100ZY.2	0	-	0	0	3579	0.0000000
zheyou73v0_A05	866033	869595	BnaA05T0014200ZY	0	-	0	0	3562	0.0000000
zheyou73v0_A05	866033	869595	BnaA05T0014200ZY.1	0	-	0	0	3562	0.0000000
zheyou73v0_A05	866033	869595	BnaA05T0014200ZY.2	0	-	0	0	3562	0.0000000
zheyou73v0_A05	873537	874531	BnaA05T0014300ZY	0	+	0	0	994	0.0000000
zheyou73v0_A05	878109	879184	BnaA05T0014400ZY	0	+	0	0	1075	0.0000000
zheyou73v0_A05	880941	883450	BnaA05T0014500ZY	0	-	0	0	2509	0.0000000
zheyou73v0_A05	884673	885048	BnaA05T0014600ZY	0	-	0	0	375	0.0000000
zheyou73v0_A05	885238	893465	BnaA05T0014700ZY	0	-	0	0	8227	0.0000000
zheyou73v0_A05	905820	906505	BnaA05T0014800ZY	0	-	0	0	685	0.0000000
zheyou73v0_A05	908775	913522	BnaA05T0014900ZY	0	+	0	0	4747	0.0000000
zheyou73v0_A05	917338	917709	BnaA05T0015000ZY	0	+	0	0	371	0.0000000
zheyou73v0_A05	918447	920361	BnaA05T0015100ZY	0	-	0	0	1914	0.0000000
zheyou73v0_A05	924642	925452	BnaA05T0015200ZY	0	-	0	0	810	0.0000000
zheyou73v0_A05	926559	927787	BnaA05T0015300ZY	0	+	0	0	1228	0.0000000
zheyou73v0_A05	929697	933970	BnaA05T0015400ZY	0	-	0	0	4273	0.0000000
zheyou73v0_A05	971878	973109	BnaA05T0015500ZY	0	-	0	0	1231	0.0000000
zheyou73v0_A05	974227	975210	BnaA05T0015600ZY	0	-	0	0	983	0.0000000
zheyou73v0_A05	977135	979281	BnaA05T0015700ZY	0	-	0	0	2146	0.0000000
zheyou73v0_A05	982307	984956	BnaA05T0015800ZY	0	-	0	0	2649	0.0000000
zheyou73v0_A05	982307	984500	BnaA05T0015800ZY.1	0	-	0	0	2193	0.0000000
zheyou73v0_A05	987330	988920	BnaA05T0015900ZY	0	-	0	0	1590	0.0000000
zheyou73v0_A05	990797	994614	BnaA05T0016000ZY	0	-	0	0	3817	0.0000000
zheyou73v0_A05	994919	996228	BnaA05T0016100ZY	0	+	0	0	1309	0.0000000
zheyou73v0_A05	996627	998216	BnaA05T0016200ZY	0	-	0	0	1589	0.0000000
zheyou73v0_A05	999769	1000910	BnaA05T0016300ZY	0	-	0	0	1141	0.0000000
zheyou73v0_A05	1003049	1003358	BnaA05T0016400ZY	0	-	0	0	309	0.0000000
zheyou73v0_A05	1004464	1006020	BnaA05T0016500ZY	0	+	0	0	1556	0.0000000
zheyou73v0_A05	1006483	1008136	BnaA05T0016600ZY	0	-	0	0	1653	0.0000000
zheyou73v0_A05	1011116	1012795	BnaA05T0016700ZY	0	+	0	0	1679	0.0000000
zheyou73v0_A05	1014896	1016474	BnaA05T0016800ZY	0	-	0	0	1578	0.0000000
zheyou73v0_A05	1018112	1019100	BnaA05T0016900ZY	0	-	0	0	988	0.0000000
zheyou73v0_A05	1019705	1020853	BnaA05T0017000ZY	0	-	0	0	1148	0.0000000
zheyou73v0_A05	1022749	1023995	BnaA05T0017100ZY	0	-	0	0	1246	0.0000000
zheyou73v0_A05	1034460	1034748	BnaA05T0017200ZY	0	-	0	0	288	0.0000000
zheyou73v0_A05	1036834	1038929	BnaA05T0017300ZY	0	-	0	0	2095	0.0000000
zheyou73v0_A05	1049882	1051677	BnaA05T0017400ZY	0	+	0	0	1795	0.0000000
zheyou73v0_A05	1049882	1051677	BnaA05T0017400ZY.1	0	+	0	0	1795	0.0000000
zheyou73v0_A05	1052664	1053404	BnaA05T0017500ZY	0	-	0	0	740	0.0000000
zheyou73v0_A05	1055699	1056431	BnaA05T0017600ZY	0	-	0	0	732	0.0000000
zheyou73v0_A05	1059659	1064003	BnaA05T0017700ZY	0	+	0	0	4344	0.0000000
zheyou73v0_A05	1066613	1067386	BnaA05T0017800ZY	0	-	0	0	773	0.0000000
zheyou73v0_A05	1070263	1071072	BnaA05T0017900ZY	0	-	0	0	809	0.0000000
zheyou73v0_A05	1072841	1073866	BnaA05T0018000ZY	0	+	0	0	1025	0.0000000
zheyou73v0_A05	1079075	1080545	BnaA05T0018100ZY	0	+	0	0	1470	0.0000000
zheyou73v0_A05	1082325	1085571	BnaA05T0018200ZY	0	+	0	0	3246	0.0000000
zheyou73v0_A05	1087087	1087579	BnaA05T0018300ZY	0	+	0	0	492	0.0000000
zheyou73v0_A05	1092103	1092598	BnaA05T0018400ZY	0	+	0	0	495	0.0000000
zheyou73v0_A05	1092856	1094218	BnaA05T0018500ZY	0	-	0	0	1362	0.0000000
zheyou73v0_A05	1094878	1096065	BnaA05T0018600ZY	0	-	0	0	1187	0.0000000
zheyou73v0_A05	1098887	1100445	BnaA05T0018700ZY	0	-	0	0	1558	0.0000000
zheyou73v0_A05	1102617	1104910	BnaA05T0018800ZY	0	-	0	0	2293	0.0000000
zheyou73v0_A05	1105993	1108325	BnaA05T0018900ZY	0	+	0	0	2332	0.0000000
zheyou73v0_A05	1108570	1109084	BnaA05T0019000ZY	0	-	0	0	514	0.0000000
zheyou73v0_A05	1110107	1113088	BnaA05T0019100ZY	0	+	0	0	2981	0.0000000
zheyou73v0_A05	1114429	1114663	BnaA05T0019200ZY	0	-	0	0	234	0.0000000
zheyou73v0_A05	1116381	1118185	BnaA05T0019300ZY	0	-	0	0	1804	0.0000000
zheyou73v0_A05	1122581	1123442	BnaA05T0019400ZY	0	+	0	0	861	0.0000000
zheyou73v0_A05	1123575	1125611	BnaA05T0019500ZY	0	-	0	0	2036	0.0000000
zheyou73v0_A05	1132929	1135926	BnaA05T0019600ZY	0	-	0	0	2997	0.0000000
zheyou73v0_A05	1132929	1136182	BnaA05T0019600ZY.1	0	-	0	0	3253	0.0000000
zheyou73v0_A05	1138981	1140947	BnaA05T0019700ZY	0	+	0	0	1966	0.0000000
zheyou73v0_A05	1141060	1146329	BnaA05T0019800ZY	0	+	0	0	5269	0.0000000
zheyou73v0_A05	1141328	1146329	BnaA05T0019800ZY.1	0	+	0	0	5001	0.0000000
zheyou73v0_A05	1146718	1149307	BnaA05T0019900ZY	0	-	0	0	2589	0.0000000
zheyou73v0_A05	1152367	1154821	BnaA05T0020000ZY	0	-	0	0	2454	0.0000000
zheyou73v0_A05	1152367	1154821	BnaA05T0020000ZY.1	0	-	0	0	2454	0.0000000
zheyou73v0_A05	1164997	1165807	BnaA05T0020100ZY	0	-	0	0	810	0.0000000
zheyou73v0_A05	1173736	1176771	BnaA05T0020200ZY	0	+	0	0	3035	0.0000000
zheyou73v0_A05	1177391	1179567	BnaA05T0020300ZY	0	-	0	0	2176	0.0000000
zheyou73v0_A05	1180503	1183015	BnaA05T0020400ZY	0	-	0	0	2512	0.0000000
zheyou73v0_A05	1180819	1183015	BnaA05T0020400ZY.1	0	-	0	0	2196	0.0000000
zheyou73v0_A05	1188435	1190564	BnaA05T0020500ZY	0	+	0	0	2129	0.0000000
zheyou73v0_A05	1191474	1193027	BnaA05T0020600ZY	0	+	0	0	1553	0.0000000
zheyou73v0_A05	1200150	1205671	BnaA05T0020700ZY	0	-	0	0	5521	0.0000000
zheyou73v0_A05	1203857	1205669	BnaA05T0020700ZY.1	0	-	0	0	1812	0.0000000
zheyou73v0_A05	1203857	1205671	BnaA05T0020700ZY.2	0	-	0	0	1814	0.0000000
zheyou73v0_A05	1209847	1213425	BnaA05T0020800ZY	0	+	0	0	3578	0.0000000
zheyou73v0_A05	1213915	1215845	BnaA05T0020900ZY	0	+	0	0	1930	0.0000000
zheyou73v0_A05	1216337	1218354	BnaA05T0021000ZY	0	-	0	0	2017	0.0000000
zheyou73v0_A05	1223479	1225139	BnaA05T0021100ZY	0	-	0	0	1660	0.0000000
zheyou73v0_A05	1236450	1236873	BnaA05T0021200ZY	0	+	0	0	423	0.0000000
zheyou73v0_A05	1239256	1241894	BnaA05T0021300ZY	0	-	0	0	2638	0.0000000
zheyou73v0_A05	1243258	1244164	BnaA05T0021400ZY	0	+	0	0	906	0.0000000
zheyou73v0_A05	1244654	1247965	BnaA05T0021500ZY	0	+	0	0	3311	0.0000000
zheyou73v0_A05	1253654	1253843	BnaA05T0021600ZY	0	+	0	0	189	0.0000000
zheyou73v0_A05	1255530	1256038	BnaA05T0021700ZY	0	-	0	0	508	0.0000000
zheyou73v0_A05	1264444	1265072	BnaA05T0021800ZY	0	+	0	0	628	0.0000000
zheyou73v0_A05	1268201	1269131	BnaA05T0021900ZY	0	+	0	0	930	0.0000000
zheyou73v0_A05	1269029	1270646	BnaA05T0022000ZY	0	-	0	0	1617	0.0000000
zheyou73v0_A05	1275938	1276716	BnaA05T0022100ZY	0	+	0	0	778	0.0000000
zheyou73v0_A05	1278155	1279113	BnaA05T0022200ZY	0	+	0	0	958	0.0000000
zheyou73v0_A05	1279776	1282301	BnaA05T0022300ZY	0	-	0	0	2525	0.0000000
zheyou73v0_A05	1285816	1288243	BnaA05T0022400ZY	0	-	0	0	2427	0.0000000
zheyou73v0_A05	1293046	1294472	BnaA05T0022500ZY	0	+	0	0	1426	0.0000000
zheyou73v0_A05	1296355	1296845	BnaA05T0022600ZY	0	+	0	0	490	0.0000000
zheyou73v0_A05	1298610	1302272	BnaA05T0022700ZY	0	-	0	0	3662	0.0000000
zheyou73v0_A05	1309235	1309510	BnaA05T0022800ZY	0	-	0	0	275	0.0000000
zheyou73v0_A05	1318348	1319558	BnaA05T0022900ZY	0	+	0	0	1210	0.0000000
zheyou73v0_A05	1328527	1329841	BnaA05T0023000ZY	0	-	0	0	1314	0.0000000
zheyou73v0_A05	1332725	1333155	BnaA05T0023100ZY	0	+	0	0	430	0.0000000
zheyou73v0_A05	1333429	1334642	BnaA05T0023200ZY	0	-	0	0	1213	0.0000000
zheyou73v0_A05	1335449	1338267	BnaA05T0023300ZY	0	+	0	0	2818	0.0000000
zheyou73v0_A05	1338210	1339544	BnaA05T0023400ZY	0	-	0	0	1334	0.0000000
zheyou73v0_A05	1340454	1342487	BnaA05T0023500ZY	0	+	0	0	2033	0.0000000
zheyou73v0_A05	1343424	1345178	BnaA05T0023600ZY	0	-	0	0	1754	0.0000000
zheyou73v0_A05	1349540	1351980	BnaA05T0023700ZY	0	+	0	0	2440	0.0000000
zheyou73v0_A05	1352122	1356386	BnaA05T0023800ZY	0	+	0	0	4264	0.0000000
zheyou73v0_A05	1356591	1358003	BnaA05T0023900ZY	0	-	0	0	1412	0.0000000
zheyou73v0_A05	1358792	1361483	BnaA05T0024000ZY	0	+	0	0	2691	0.0000000
zheyou73v0_A05	1358792	1361483	BnaA05T0024000ZY.1	0	+	0	0	2691	0.0000000
zheyou73v0_A05	1361803	1362139	BnaA05T0024100ZY	0	-	0	0	336	0.0000000
zheyou73v0_A05	1362373	1364536	BnaA05T0024200ZY.1	0	-	0	0	2163	0.0000000
zheyou73v0_A05	1362566	1364455	BnaA05T0024200ZY	0	-	0	0	1889	0.0000000
zheyou73v0_A05	1371111	1373279	BnaA05T0024300ZY	0	+	0	0	2168	0.0000000
zheyou73v0_A05	1376300	1377182	BnaA05T0024400ZY	0	+	0	0	882	0.0000000
zheyou73v0_A05	1381225	1383085	BnaA05T0024500ZY	0	+	0	0	1860	0.0000000
zheyou73v0_A05	1383262	1386439	BnaA05T0024600ZY	0	-	0	0	3177	0.0000000
zheyou73v0_A05	1388331	1390135	BnaA05T0024700ZY	0	+	0	0	1804	0.0000000
zheyou73v0_A05	1390212	1392767	BnaA05T0024800ZY	0	-	0	0	2555	0.0000000
zheyou73v0_A05	1390212	1392767	BnaA05T0024800ZY.1	0	-	0	0	2555	0.0000000
zheyou73v0_A05	1393184	1397393	BnaA05T0024900ZY	0	-	0	0	4209	0.0000000
zheyou73v0_A05	1400856	1401337	BnaA05T0025000ZY	0	+	0	0	481	0.0000000
zheyou73v0_A05	1402216	1402725	BnaA05T0025100ZY	0	+	0	0	509	0.0000000
zheyou73v0_A05	1404260	1404921	BnaA05T0025200ZY	0	+	0	0	661	0.0000000
zheyou73v0_A05	1406164	1406715	BnaA05T0025300ZY	0	+	0	0	551	0.0000000
zheyou73v0_A05	1407986	1414606	BnaA05T0025400ZY	0	-	0	0	6620	0.0000000
zheyou73v0_A05	1417921	1418799	BnaA05T0025500ZY	0	-	0	0	878	0.0000000
zheyou73v0_A05	1419002	1422139	BnaA05T0025600ZY	0	-	0	0	3137	0.0000000
zheyou73v0_A05	1423948	1429622	BnaA05T0025700ZY	0	-	0	0	5674	0.0000000
zheyou73v0_A05	1436172	1437529	BnaA05T0025800ZY	0	-	0	0	1357	0.0000000
zheyou73v0_A05	1453427	1456389	BnaA05T0025900ZY	0	+	0	0	2962	0.0000000
zheyou73v0_A05	1459305	1464592	BnaA05T0026000ZY	0	-	0	0	5287	0.0000000
zheyou73v0_A05	1464914	1466265	BnaA05T0026100ZY	0	-	0	0	1351	0.0000000
zheyou73v0_A05	1466716	1469638	BnaA05T0026200ZY	0	-	0	0	2922	0.0000000
zheyou73v0_A05	1477355	1478974	BnaA05T0026300ZY	0	-	0	0	1619	0.0000000
zheyou73v0_A05	1481002	1481324	BnaA05T0026400ZY	0	+	0	0	322	0.0000000
zheyou73v0_A05	1484919	1485930	BnaA05T0026500ZY	0	+	0	0	1011	0.0000000
zheyou73v0_A05	1490246	1491579	BnaA05T0026600ZY	0	+	0	0	1333	0.0000000
zheyou73v0_A05	1493347	1495301	BnaA05T0026700ZY	0	+	0	0	1954	0.0000000
zheyou73v0_A05	1494842	1499062	BnaA05T0026800ZY	0	-	0	0	4220	0.0000000
zheyou73v0_A05	1500020	1504418	BnaA05T0026900ZY	0	-	0	0	4398	0.0000000
zheyou73v0_A05	1505248	1507522	BnaA05T0027000ZY	0	-	0	0	2274	0.0000000
zheyou73v0_A05	1508612	1510439	BnaA05T0027100ZY	0	-	0	0	1827	0.0000000
zheyou73v0_A05	1513285	1515125	BnaA05T0027200ZY	0	+	0	0	1840	0.0000000
zheyou73v0_A05	1515533	1517184	BnaA05T0027300ZY	0	-	0	0	1651	0.0000000
zheyou73v0_A05	1520071	1521922	BnaA05T0027400ZY	0	-	0	0	1851	0.0000000
zheyou73v0_A05	1523059	1523696	BnaA05T0027500ZY	0	-	0	0	637	0.0000000
zheyou73v0_A05	1524966	1526789	BnaA05T0027600ZY	0	+	0	0	1823	0.0000000
zheyou73v0_A05	1527850	1528342	BnaA05T0027700ZY	0	-	0	0	492	0.0000000
zheyou73v0_A05	1529445	1530653	BnaA05T0027800ZY.1	0	+	0	0	1208	0.0000000
zheyou73v0_A05	1529445	1530653	BnaA05T0027800ZY.2	0	+	0	0	1208	0.0000000
zheyou73v0_A05	1529518	1530653	BnaA05T0027800ZY	0	+	0	0	1135	0.0000000
zheyou73v0_A05	1533732	1536361	BnaA05T0027900ZY	0	+	0	0	2629	0.0000000
zheyou73v0_A05	1537624	1538667	BnaA05T0028000ZY	0	+	0	0	1043	0.0000000
zheyou73v0_A05	1538821	1543056	BnaA05T0028100ZY	0	-	0	0	4235	0.0000000
zheyou73v0_A05	1543805	1545195	BnaA05T0028200ZY	0	-	0	0	1390	0.0000000
zheyou73v0_A05	1549363	1551303	BnaA05T0028300ZY	0	+	0	0	1940	0.0000000
zheyou73v0_A05	1552596	1555147	BnaA05T0028400ZY	0	+	0	0	2551	0.0000000
zheyou73v0_A05	1555950	1556542	BnaA05T0028500ZY	0	+	0	0	592	0.0000000
zheyou73v0_A05	1558247	1561180	BnaA05T0028600ZY	0	+	0	0	2933	0.0000000
zheyou73v0_A05	1561704	1562697	BnaA05T0028700ZY	0	-	0	0	993	0.0000000
zheyou73v0_A05	1563124	1563862	BnaA05T0028800ZY	0	+	0	0	738	0.0000000
zheyou73v0_A05	1564351	1565359	BnaA05T0028900ZY	0	-	0	0	1008	0.0000000
zheyou73v0_A05	1573003	1573654	BnaA05T0029000ZY	0	+	0	0	651	0.0000000
zheyou73v0_A05	1574980	1575631	BnaA05T0029100ZY	0	+	0	0	651	0.0000000
zheyou73v0_A05	1576564	1578451	BnaA05T0029200ZY	0	-	0	0	1887	0.0000000
zheyou73v0_A05	1576675	1577386	BnaA05T0029300ZY	0	+	0	0	711	0.0000000
zheyou73v0_A05	1582936	1591534	BnaA05T0029400ZY	0	-	0	0	8598	0.0000000
zheyou73v0_A05	1593696	1594843	BnaA05T0029500ZY	0	-	0	0	1147	0.0000000
zheyou73v0_A05	1593696	1594843	BnaA05T0029500ZY.1	0	-	0	0	1147	0.0000000
zheyou73v0_A05	1595723	1597986	BnaA05T0029600ZY	0	-	0	0	2263	0.0000000
zheyou73v0_A05	1599887	1600529	BnaA05T0029700ZY	0	+	0	0	642	0.0000000
zheyou73v0_A05	1604163	1605197	BnaA05T0029800ZY	0	+	0	0	1034	0.0000000
zheyou73v0_A05	1608415	1611056	BnaA05T0029900ZY	0	-	0	0	2641	0.0000000
zheyou73v0_A05	1625090	1627414	BnaA05T0030000ZY	0	-	0	0	2324	0.0000000
zheyou73v0_A05	1632601	1634148	BnaA05T0030100ZY	0	-	0	0	1547	0.0000000
zheyou73v0_A05	1638174	1639274	BnaA05T0030200ZY	0	-	0	0	1100	0.0000000
zheyou73v0_A05	1643153	1643465	BnaA05T0030300ZY	0	+	0	0	312	0.0000000
zheyou73v0_A05	1647890	1649354	BnaA05T0030400ZY	0	-	0	0	1464	0.0000000
zheyou73v0_A05	1653225	1653537	BnaA05T0030500ZY	0	+	0	0	312	0.0000000
zheyou73v0_A05	1663508	1663988	BnaA05T0030600ZY	0	+	0	0	480	0.0000000
zheyou73v0_A05	1664005	1665736	BnaA05T0030700ZY	0	+	0	0	1731	0.0000000
zheyou73v0_A05	1666165	1667695	BnaA05T0030800ZY	0	-	0	0	1530	0.0000000
zheyou73v0_A05	1666165	1667695	BnaA05T0030800ZY.1	0	-	0	0	1530	0.0000000
zheyou73v0_A05	1667772	1669003	BnaA05T0030900ZY	0	-	0	0	1231	0.0000000
zheyou73v0_A05	1669422	1671460	BnaA05T0031000ZY	0	+	0	0	2038	0.0000000
zheyou73v0_A05	1672731	1674700	BnaA05T0031100ZY.1	0	+	0	0	1969	0.0000000
zheyou73v0_A05	1672774	1674700	BnaA05T0031100ZY	0	+	0	0	1926	0.0000000
zheyou73v0_A05	1684238	1684548	BnaA05T0031200ZY	0	+	0	0	310	0.0000000
zheyou73v0_A05	1687324	1689006	BnaA05T0031300ZY	0	+	0	0	1682	0.0000000
zheyou73v0_A05	1689267	1690200	BnaA05T0031400ZY	0	-	0	0	933	0.0000000
zheyou73v0_A05	1709576	1710782	BnaA05T0031500ZY	0	+	0	0	1206	0.0000000
zheyou73v0_A05	1714834	1721325	BnaA05T0031600ZY	0	-	0	0	6491	0.0000000
zheyou73v0_A05	1721748	1724402	BnaA05T0031700ZY	0	+	0	0	2654	0.0000000
zheyou73v0_A05	1725085	1726381	BnaA05T0031800ZY	0	+	0	0	1296	0.0000000
zheyou73v0_A05	1726663	1729881	BnaA05T0031900ZY	0	-	0	0	3218	0.0000000
zheyou73v0_A05	1739784	1741598	BnaA05T0032000ZY	0	-	0	0	1814	0.0000000
zheyou73v0_A05	1746711	1749650	BnaA05T0032100ZY	0	+	0	0	2939	0.0000000
zheyou73v0_A05	1769642	1770179	BnaA05T0032200ZY	0	+	0	0	537	0.0000000
zheyou73v0_A05	1771714	1772500	BnaA05T0032300ZY	0	+	0	0	786	0.0000000
zheyou73v0_A05	1777234	1777585	BnaA05T0032400ZY	0	+	0	0	351	0.0000000
zheyou73v0_A05	1779514	1784003	BnaA05T0032500ZY	0	-	0	0	4489	0.0000000
zheyou73v0_A05	1779532	1780456	BnaA05T0032600ZY	0	+	0	0	924	0.0000000
zheyou73v0_A05	1787820	1789581	BnaA05T0032700ZY	0	+	0	0	1761	0.0000000
zheyou73v0_A05	1791998	1795765	BnaA05T0032800ZY	0	-	0	0	3767	0.0000000
zheyou73v0_A05	1791998	1795765	BnaA05T0032800ZY.1	0	-	0	0	3767	0.0000000
zheyou73v0_A05	1791998	1795765	BnaA05T0032800ZY.2	0	-	0	0	3767	0.0000000
zheyou73v0_A05	1791998	1795765	BnaA05T0032800ZY.3	0	-	0	0	3767	0.0000000
zheyou73v0_A05	1791998	1795765	BnaA05T0032800ZY.4	0	-	0	0	3767	0.0000000
zheyou73v0_A05	1797781	1798849	BnaA05T0032900ZY	0	+	0	0	1068	0.0000000
zheyou73v0_A05	1797781	1798849	BnaA05T0032900ZY.1	0	+	0	0	1068	0.0000000
zheyou73v0_A05	1799943	1803575	BnaA05T0033000ZY	0	+	0	0	3632	0.0000000
zheyou73v0_A05	1806785	1808359	BnaA05T0033100ZY	0	+	0	0	1574	0.0000000
zheyou73v0_A05	1810888	1814016	BnaA05T0033200ZY	0	+	0	0	3128	0.0000000
zheyou73v0_A05	1813882	1815947	BnaA05T0033300ZY	0	-	0	0	2065	0.0000000
zheyou73v0_A05	1816918	1819521	BnaA05T0033400ZY	0	-	0	0	2603	0.0000000
zheyou73v0_A05	1820420	1824029	BnaA05T0033500ZY	0	-	0	0	3609	0.0000000
zheyou73v0_A05	1827272	1828574	BnaA05T0033600ZY	0	-	0	0	1302	0.0000000
zheyou73v0_A05	1828782	1831291	BnaA05T0033700ZY	0	+	0	0	2509	0.0000000
zheyou73v0_A05	1831354	1832105	BnaA05T0033800ZY	0	-	0	0	751	0.0000000
zheyou73v0_A05	1832606	1836818	BnaA05T0033900ZY	0	-	0	0	4212	0.0000000
zheyou73v0_A05	1840217	1844344	BnaA05T0034000ZY	0	+	0	0	4127	0.0000000
zheyou73v0_A05	1844678	1845568	BnaA05T0034100ZY	0	+	0	0	890	0.0000000
zheyou73v0_A05	1846634	1848088	BnaA05T0034200ZY	0	+	0	0	1454	0.0000000
zheyou73v0_A05	1848486	1851381	BnaA05T0034300ZY	0	+	0	0	2895	0.0000000
zheyou73v0_A05	1848486	1851381	BnaA05T0034300ZY.1	0	+	0	0	2895	0.0000000
zheyou73v0_A05	1852070	1855528	BnaA05T0034400ZY	0	-	0	0	3458	0.0000000
zheyou73v0_A05	1856413	1857982	BnaA05T0034500ZY	0	-	0	0	1569	0.0000000
zheyou73v0_A05	1860851	1862146	BnaA05T0034600ZY	0	+	0	0	1295	0.0000000
zheyou73v0_A05	1862416	1865536	BnaA05T0034700ZY	0	-	0	0	3120	0.0000000
zheyou73v0_A05	1872630	1872789	BnaA05T0034800ZY	0	+	0	0	159	0.0000000
zheyou73v0_A05	1872803	1875312	BnaA05T0034900ZY	0	+	0	0	2509	0.0000000
zheyou73v0_A05	1875865	1878919	BnaA05T0035000ZY	0	-	0	0	3054	0.0000000
zheyou73v0_A05	1881929	1884192	BnaA05T0035100ZY	0	+	0	0	2263	0.0000000
zheyou73v0_A05	1885484	1885875	BnaA05T0035200ZY	0	+	0	0	391	0.0000000
zheyou73v0_A05	1892362	1893468	BnaA05T0035300ZY	0	+	0	0	1106	0.0000000
zheyou73v0_A05	1894494	1897598	BnaA05T0035400ZY	0	-	0	0	3104	0.0000000
zheyou73v0_A05	1894494	1897598	BnaA05T0035400ZY.1	0	-	0	0	3104	0.0000000
zheyou73v0_A05	1894494	1897598	BnaA05T0035400ZY.2	0	-	0	0	3104	0.0000000
zheyou73v0_A05	1898169	1901069	BnaA05T0035500ZY	0	+	0	0	2900	0.0000000
zheyou73v0_A05	1902981	1904481	BnaA05T0035600ZY	0	+	0	0	1500	0.0000000
zheyou73v0_A05	1904638	1906028	BnaA05T0035700ZY	0	-	0	0	1390	0.0000000
zheyou73v0_A05	1907251	1908306	BnaA05T0035800ZY	0	+	0	0	1055	0.0000000
zheyou73v0_A05	1913227	1915637	BnaA05T0035900ZY	0	+	0	0	2410	0.0000000
zheyou73v0_A05	1913227	1915637	BnaA05T0035900ZY.1	0	+	0	0	2410	0.0000000
zheyou73v0_A05	1919250	1920963	BnaA05T0036000ZY	0	+	0	0	1713	0.0000000
zheyou73v0_A05	1921605	1924329	BnaA05T0036100ZY	0	-	0	0	2724	0.0000000
zheyou73v0_A05	1922945	1924329	BnaA05T0036100ZY.1	0	-	0	0	1384	0.0000000
zheyou73v0_A05	1924887	1928982	BnaA05T0036200ZY	0	-	0	0	4095	0.0000000
zheyou73v0_A05	1951149	1967835	BnaA05T0036300ZY	0	+	0	0	16686	0.0000000
zheyou73v0_A05	1951149	1967835	BnaA05T0036300ZY.1	0	+	0	0	16686	0.0000000
zheyou73v0_A05	1952488	1967835	BnaA05T0036300ZY.2	0	+	0	0	15347	0.0000000
zheyou73v0_A05	1968380	1970518	BnaA05T0036400ZY	0	+	0	0	2138	0.0000000
zheyou73v0_A05	1971207	1973579	BnaA05T0036500ZY	0	+	0	0	2372	0.0000000
zheyou73v0_A05	1974379	1978539	BnaA05T0036600ZY	0	+	0	0	4160	0.0000000
zheyou73v0_A05	1979410	1981638	BnaA05T0036700ZY	0	+	0	0	2228	0.0000000
zheyou73v0_A05	1984413	1986368	BnaA05T0036800ZY	0	+	0	0	1955	0.0000000
zheyou73v0_A05	1991375	1992006	BnaA05T0036900ZY	0	+	0	0	631	0.0000000
zheyou73v0_A05	1992528	1994655	BnaA05T0037000ZY	0	-	0	0	2127	0.0000000
zheyou73v0_A05	1999501	2002827	BnaA05T0037100ZY	0	+	0	0	3326	0.0000000
zheyou73v0_A05	2003281	2007111	BnaA05T0037200ZY	0	+	0	0	3830	0.0000000
zheyou73v0_A05	2007879	2017316	BnaA05T0037300ZY	0	-	0	0	9437	0.0000000
zheyou73v0_A05	2017845	2020327	BnaA05T0037400ZY	0	-	0	0	2482	0.0000000
zheyou73v0_A05	2017845	2020327	BnaA05T0037400ZY.1	0	-	0	0	2482	0.0000000
zheyou73v0_A05	2021235	2021765	BnaA05T0037500ZY	0	-	0	0	530	0.0000000
zheyou73v0_A05	2021974	2024078	BnaA05T0037600ZY	0	-	0	0	2104	0.0000000
zheyou73v0_A05	2024525	2027112	BnaA05T0037700ZY	0	-	0	0	2587	0.0000000
zheyou73v0_A05	2027353	2028860	BnaA05T0037800ZY	0	-	0	0	1507	0.0000000
zheyou73v0_A05	2031554	2035137	BnaA05T0037900ZY	0	-	0	0	3583	0.0000000
zheyou73v0_A05	2031554	2035137	BnaA05T0037900ZY.1	0	-	0	0	3583	0.0000000
zheyou73v0_A05	2045485	2052578	BnaA05T0038000ZY	0	+	0	0	7093	0.0000000
zheyou73v0_A05	2056372	2063344	BnaA05T0038100ZY	0	-	0	0	6972	0.0000000
zheyou73v0_A05	2065850	2067290	BnaA05T0038200ZY	0	-	0	0	1440	0.0000000
zheyou73v0_A05	2070054	2071267	BnaA05T0038300ZY	0	-	0	0	1213	0.0000000
zheyou73v0_A05	2081423	2082534	BnaA05T0038400ZY	0	-	0	0	1111	0.0000000
zheyou73v0_A05	2087862	2092397	BnaA05T0038500ZY	0	-	0	0	4535	0.0000000
zheyou73v0_A05	2092219	2095707	BnaA05T0038600ZY	0	+	0	0	3488	0.0000000
zheyou73v0_A05	2093011	2095546	BnaA05T0038600ZY.1	0	+	0	0	2535	0.0000000
zheyou73v0_A05	2095925	2097872	BnaA05T0038700ZY	0	+	0	0	1947	0.0000000
zheyou73v0_A05	2111443	2114363	BnaA05T0038800ZY	0	+	0	0	2920	0.0000000
zheyou73v0_A05	2115904	2116733	BnaA05T0038900ZY	0	-	0	0	829	0.0000000
zheyou73v0_A05	2117093	2119382	BnaA05T0039000ZY	0	-	0	0	2289	0.0000000
zheyou73v0_A05	2119739	2122229	BnaA05T0039100ZY	0	-	0	0	2490	0.0000000
zheyou73v0_A05	2120124	2120655	BnaA05T0039200ZY	0	+	0	0	531	0.0000000
zheyou73v0_A05	2124498	2126428	BnaA05T0039300ZY	0	+	0	0	1930	0.0000000
zheyou73v0_A05	2126757	2128148	BnaA05T0039400ZY	0	-	0	0	1391	0.0000000
zheyou73v0_A05	2131727	2134515	BnaA05T0039500ZY	0	+	0	0	2788	0.0000000
zheyou73v0_A05	2139637	2141215	BnaA05T0039600ZY	0	+	0	0	1578	0.0000000
zheyou73v0_A05	2146519	2147339	BnaA05T0039700ZY	0	+	0	0	820	0.0000000
zheyou73v0_A05	2150970	2157327	BnaA05T0039800ZY	0	+	0	0	6357	0.0000000
zheyou73v0_A05	2158603	2159059	BnaA05T0039900ZY	0	+	0	0	456	0.0000000
zheyou73v0_A05	2160459	2162469	BnaA05T0040000ZY	0	-	0	0	2010	0.0000000
zheyou73v0_A05	2160459	2162733	BnaA05T0040000ZY.1	0	-	0	0	2274	0.0000000
zheyou73v0_A05	2160459	2162733	BnaA05T0040000ZY.2	0	-	0	0	2274	0.0000000
zheyou73v0_A05	2160459	2162469	BnaA05T0040000ZY.3	0	-	0	0	2010	0.0000000
zheyou73v0_A05	2163419	2163719	BnaA05T0040100ZY	0	-	0	0	300	0.0000000
zheyou73v0_A05	2166908	2167574	BnaA05T0040200ZY	0	-	0	0	666	0.0000000
zheyou73v0_A05	2171895	2173242	BnaA05T0040300ZY	0	-	0	0	1347	0.0000000
zheyou73v0_A05	2174415	2176258	BnaA05T0040400ZY	0	-	0	0	1843	0.0000000
zheyou73v0_A05	2178463	2181235	BnaA05T0040500ZY	0	-	0	0	2772	0.0000000
zheyou73v0_A05	2181423	2184237	BnaA05T0040600ZY	0	-	0	0	2814	0.0000000
zheyou73v0_A05	2181423	2184237	BnaA05T0040600ZY.1	0	-	0	0	2814	0.0000000
zheyou73v0_A05	2184511	2186029	BnaA05T0040700ZY	0	+	0	0	1518	0.0000000
zheyou73v0_A05	2186788	2187397	BnaA05T0040800ZY	0	+	0	0	609	0.0000000
zheyou73v0_A05	2188812	2189506	BnaA05T0040900ZY	0	+	0	0	694	0.0000000
zheyou73v0_A05	2190049	2191869	BnaA05T0041000ZY	0	-	0	0	1820	0.0000000
zheyou73v0_A05	2193054	2194729	BnaA05T0041100ZY	0	+	0	0	1675	0.0000000
zheyou73v0_A05	2199314	2200255	BnaA05T0041200ZY	0	+	0	0	941	0.0000000
zheyou73v0_A05	2200732	2203453	BnaA05T0041300ZY	0	-	0	0	2721	0.0000000
zheyou73v0_A05	2204559	2207567	BnaA05T0041400ZY	0	+	0	0	3008	0.0000000
zheyou73v0_A05	2208734	2209800	BnaA05T0041500ZY	0	-	0	0	1066	0.0000000
zheyou73v0_A05	2213177	2214543	BnaA05T0041600ZY	0	+	0	0	1366	0.0000000
zheyou73v0_A05	2214728	2216264	BnaA05T0041700ZY	0	-	0	0	1536	0.0000000
zheyou73v0_A05	2217392	2220093	BnaA05T0041800ZY	0	+	0	0	2701	0.0000000
zheyou73v0_A05	2220497	2223256	BnaA05T0041900ZY	0	+	0	0	2759	0.0000000
zheyou73v0_A05	2223957	2225940	BnaA05T0042000ZY	0	+	0	0	1983	0.0000000
zheyou73v0_A05	2226309	2228318	BnaA05T0042100ZY	0	+	0	0	2009	0.0000000
zheyou73v0_A05	2232914	2233991	BnaA05T0042200ZY	0	+	0	0	1077	0.0000000
zheyou73v0_A05	2237874	2239948	BnaA05T0042300ZY	0	+	0	0	2074	0.0000000
zheyou73v0_A05	2250226	2261364	BnaA05T0042400ZY	0	+	0	0	11138	0.0000000
zheyou73v0_A05	2261388	2261762	BnaA05T0042500ZY	0	-	0	0	374	0.0000000
zheyou73v0_A05	2264529	2265852	BnaA05T0042600ZY	0	+	0	0	1323	0.0000000
zheyou73v0_A05	2281053	2283461	BnaA05T0042700ZY	0	-	0	0	2408	0.0000000
zheyou73v0_A05	2284478	2287006	BnaA05T0042800ZY	0	-	0	0	2528	0.0000000
zheyou73v0_A05	2288044	2289548	BnaA05T0042900ZY	0	-	0	0	1504	0.0000000
zheyou73v0_A05	2293561	2294104	BnaA05T0043000ZY	0	+	0	0	543	0.0000000
zheyou73v0_A05	2296814	2297613	BnaA05T0043100ZY	0	-	0	0	799	0.0000000
zheyou73v0_A05	2301651	2302413	BnaA05T0043200ZY	0	+	0	0	762	0.0000000
zheyou73v0_A05	2304200	2305862	BnaA05T0043300ZY	0	+	0	0	1662	0.0000000
zheyou73v0_A05	2306540	2307895	BnaA05T0043400ZY	0	+	0	0	1355	0.0000000
zheyou73v0_A05	2309565	2312326	BnaA05T0043500ZY	0	+	0	0	2761	0.0000000
zheyou73v0_A05	2312377	2315167	BnaA05T0043600ZY	0	-	0	0	2790	0.0000000
zheyou73v0_A05	2319635	2322520	BnaA05T0043700ZY	0	+	0	0	2885	0.0000000
zheyou73v0_A05	2326294	2330885	BnaA05T0043800ZY	0	+	0	0	4591	0.0000000
zheyou73v0_A05	2334276	2338229	BnaA05T0043900ZY	0	+	0	0	3953	0.0000000
zheyou73v0_A05	2343753	2347939	BnaA05T0044000ZY	0	+	0	0	4186	0.0000000
zheyou73v0_A05	2343753	2347939	BnaA05T0044000ZY.1	0	+	0	0	4186	0.0000000
zheyou73v0_A05	2350949	2378288	BnaA05T0044100ZY	0	+	0	0	27339	0.0000000
zheyou73v0_A05	2386106	2394659	BnaA05T0044200ZY	0	+	0	0	8553	0.0000000
zheyou73v0_A05	2398085	2401365	BnaA05T0044300ZY	0	+	0	0	3280	0.0000000
zheyou73v0_A05	2411035	2413397	BnaA05T0044400ZY	0	+	0	0	2362	0.0000000
zheyou73v0_A05	2415497	2417044	BnaA05T0044500ZY	0	+	0	0	1547	0.0000000
zheyou73v0_A05	2415497	2417044	BnaA05T0044500ZY.1	0	+	0	0	1547	0.0000000
zheyou73v0_A05	2417945	2419676	BnaA05T0044600ZY	0	-	0	0	1731	0.0000000
zheyou73v0_A05	2420629	2421598	BnaA05T0044700ZY	0	+	0	0	969	0.0000000
zheyou73v0_A05	2422134	2428562	BnaA05T0044800ZY	0	-	0	0	6428	0.0000000
zheyou73v0_A05	2435049	2435831	BnaA05T0044900ZY	0	-	0	0	782	0.0000000
zheyou73v0_A05	2437932	2439118	BnaA05T0045000ZY	0	-	0	0	1186	0.0000000
zheyou73v0_A05	2441942	2443163	BnaA05T0045100ZY	0	+	0	0	1221	0.0000000
zheyou73v0_A05	2444993	2447585	BnaA05T0045200ZY	0	-	0	0	2592	0.0000000
zheyou73v0_A05	2448519	2449319	BnaA05T0045300ZY	0	+	0	0	800	0.0000000
zheyou73v0_A05	2449887	2452152	BnaA05T0045400ZY	0	+	0	0	2265	0.0000000
zheyou73v0_A05	2452339	2453536	BnaA05T0045500ZY	0	-	0	0	1197	0.0000000
zheyou73v0_A05	2455441	2457503	BnaA05T0045600ZY	0	-	0	0	2062	0.0000000
zheyou73v0_A05	2459943	2460658	BnaA05T0045700ZY	0	+	0	0	715	0.0000000
zheyou73v0_A05	2461504	2462769	BnaA05T0045800ZY	0	-	0	0	1265	0.0000000
zheyou73v0_A05	2463947	2465431	BnaA05T0045900ZY	0	+	0	0	1484	0.0000000
zheyou73v0_A05	2466063	2470089	BnaA05T0046000ZY	0	+	0	0	4026	0.0000000
zheyou73v0_A05	2470651	2472341	BnaA05T0046100ZY	0	-	0	0	1690	0.0000000
zheyou73v0_A05	2475010	2475781	BnaA05T0046200ZY	0	+	0	0	771	0.0000000
zheyou73v0_A05	2477206	2484258	BnaA05T0046300ZY	0	+	0	0	7052	0.0000000
zheyou73v0_A05	2484651	2486071	BnaA05T0046400ZY	0	-	0	0	1420	0.0000000
zheyou73v0_A05	2490320	2491068	BnaA05T0046500ZY	0	-	0	0	748	0.0000000
zheyou73v0_A05	2495371	2497426	BnaA05T0046600ZY	0	-	0	0	2055	0.0000000
zheyou73v0_A05	2499094	2500261	BnaA05T0046700ZY	0	-	0	0	1167	0.0000000
zheyou73v0_A05	2503669	2505275	BnaA05T0046800ZY	0	+	0	0	1606	0.0000000
zheyou73v0_A05	2532387	2532972	BnaA05T0046900ZY	0	-	0	0	585	0.0000000
zheyou73v0_A05	2534202	2535817	BnaA05T0047000ZY	0	+	0	0	1615	0.0000000
zheyou73v0_A05	2543810	2544981	BnaA05T0047100ZY	0	-	0	0	1171	0.0000000
zheyou73v0_A05	2549199	2550072	BnaA05T0047200ZY	0	+	0	0	873	0.0000000
zheyou73v0_A05	2556572	2559616	BnaA05T0047300ZY	0	+	0	0	3044	0.0000000
zheyou73v0_A05	2562236	2562935	BnaA05T0047400ZY	0	+	0	0	699	0.0000000
zheyou73v0_A05	2572661	2573477	BnaA05T0047500ZY	0	-	0	0	816	0.0000000
zheyou73v0_A05	2573810	2574221	BnaA05T0047600ZY	0	+	0	0	411	0.0000000
zheyou73v0_A05	2574252	2576080	BnaA05T0047700ZY	0	-	0	0	1828	0.0000000
zheyou73v0_A05	2582616	2584305	BnaA05T0047800ZY	0	+	0	0	1689	0.0000000
zheyou73v0_A05	2584900	2585717	BnaA05T0047900ZY	0	+	0	0	817	0.0000000
zheyou73v0_A05	2588423	2590328	BnaA05T0048000ZY	0	-	0	0	1905	0.0000000
zheyou73v0_A05	2590589	2590955	BnaA05T0048100ZY	0	-	0	0	366	0.0000000
zheyou73v0_A05	2591170	2596329	BnaA05T0048200ZY	0	-	0	0	5159	0.0000000
zheyou73v0_A05	2601445	2602307	BnaA05T0048300ZY	0	+	0	0	862	0.0000000
zheyou73v0_A05	2608106	2613083	BnaA05T0048400ZY	0	-	0	0	4977	0.0000000
zheyou73v0_A05	2608106	2613083	BnaA05T0048400ZY.1	0	-	0	0	4977	0.0000000
zheyou73v0_A05	2613356	2616178	BnaA05T0048500ZY	0	-	0	0	2822	0.0000000
zheyou73v0_A05	2613356	2616178	BnaA05T0048500ZY.1	0	-	0	0	2822	0.0000000
zheyou73v0_A05	2613356	2616178	BnaA05T0048500ZY.2	0	-	0	0	2822	0.0000000
zheyou73v0_A05	2613356	2616178	BnaA05T0048500ZY.3	0	-	0	0	2822	0.0000000
zheyou73v0_A05	2616224	2620573	BnaA05T0048600ZY	0	-	0	0	4349	0.0000000
zheyou73v0_A05	2620824	2624393	BnaA05T0048700ZY	0	+	0	0	3569	0.0000000
zheyou73v0_A05	2624480	2626526	BnaA05T0048800ZY	0	+	0	0	2046	0.0000000
zheyou73v0_A05	2627886	2632454	BnaA05T0048900ZY	0	+	0	0	4568	0.0000000
zheyou73v0_A05	2633239	2634262	BnaA05T0049000ZY	0	+	0	0	1023	0.0000000
zheyou73v0_A05	2638737	2640038	BnaA05T0049100ZY	0	+	0	0	1301	0.0000000
zheyou73v0_A05	2641645	2642549	BnaA05T0049200ZY	0	-	0	0	904	0.0000000
zheyou73v0_A05	2646671	2647670	BnaA05T0049300ZY	0	+	0	0	999	0.0000000
zheyou73v0_A05	2650765	2651860	BnaA05T0049400ZY	0	+	0	0	1095	0.0000000
zheyou73v0_A05	2652800	2654036	BnaA05T0049500ZY	0	+	0	0	1236	0.0000000
zheyou73v0_A05	2654304	2657894	BnaA05T0049600ZY	0	-	0	0	3590	0.0000000
zheyou73v0_A05	2658377	2660871	BnaA05T0049700ZY	0	-	0	0	2494	0.0000000
zheyou73v0_A05	2664664	2667780	BnaA05T0049800ZY	0	+	0	0	3116	0.0000000
zheyou73v0_A05	2664664	2667780	BnaA05T0049800ZY.1	0	+	0	0	3116	0.0000000
zheyou73v0_A05	2667981	2669286	BnaA05T0049900ZY	0	-	0	0	1305	0.0000000
zheyou73v0_A05	2669906	2672398	BnaA05T0050000ZY	0	+	0	0	2492	0.0000000
zheyou73v0_A05	2672701	2683543	BnaA05T0050100ZY	0	+	0	0	10842	0.0000000
zheyou73v0_A05	2689562	2691809	BnaA05T0050200ZY	0	+	0	0	2247	0.0000000
zheyou73v0_A05	2692329	2695142	BnaA05T0050300ZY	0	+	0	0	2813	0.0000000
zheyou73v0_A05	2695868	2700061	BnaA05T0050400ZY	0	+	0	0	4193	0.0000000
zheyou73v0_A05	2702320	2703305	BnaA05T0050500ZY	0	+	0	0	985	0.0000000
zheyou73v0_A05	2726442	2727923	BnaA05T0050600ZY	0	-	0	0	1481	0.0000000
zheyou73v0_A05	2733640	2736327	BnaA05T0050700ZY	0	+	0	0	2687	0.0000000
zheyou73v0_A05	2736498	2738331	BnaA05T0050800ZY	0	-	0	0	1833	0.0000000
zheyou73v0_A05	2741052	2741815	BnaA05T0050900ZY	0	+	0	0	763	0.0000000
zheyou73v0_A05	2744363	2745130	BnaA05T0051000ZY	0	-	0	0	767	0.0000000
zheyou73v0_A05	2745505	2746895	BnaA05T0051100ZY	0	-	0	0	1390	0.0000000
zheyou73v0_A05	2747558	2749140	BnaA05T0051200ZY	0	-	0	0	1582	0.0000000
zheyou73v0_A05	2749789	2751991	BnaA05T0051300ZY	0	-	0	0	2202	0.0000000
zheyou73v0_A05	2755553	2756211	BnaA05T0051400ZY	0	-	0	0	658	0.0000000
zheyou73v0_A05	2769477	2771310	BnaA05T0051500ZY	0	+	0	0	1833	0.0000000
zheyou73v0_A05	2781495	2782947	BnaA05T0051600ZY	0	+	0	0	1452	0.0000000
zheyou73v0_A05	2793130	2794833	BnaA05T0051700ZY	0	+	0	0	1703	0.0000000
zheyou73v0_A05	2795318	2796033	BnaA05T0051800ZY	0	-	0	0	715	0.0000000
zheyou73v0_A05	2798821	2803001	BnaA05T0051900ZY	0	-	0	0	4180	0.0000000
zheyou73v0_A05	2805178	2806680	BnaA05T0052000ZY	0	-	0	0	1502	0.0000000
zheyou73v0_A05	2807537	2809046	BnaA05T0052100ZY	0	-	0	0	1509	0.0000000
zheyou73v0_A05	2810200	2814359	BnaA05T0052200ZY	0	-	0	0	4159	0.0000000
zheyou73v0_A05	2815306	2818024	BnaA05T0052300ZY	0	+	0	0	2718	0.0000000
zheyou73v0_A05	2818127	2820589	BnaA05T0052400ZY	0	-	0	0	2462	0.0000000
zheyou73v0_A05	2821456	2835388	BnaA05T0052500ZY	0	-	0	0	13932	0.0000000
zheyou73v0_A05	2836963	2840098	BnaA05T0052600ZY	0	-	0	0	3135	0.0000000
zheyou73v0_A05	2836963	2839237	BnaA05T0052600ZY.1	0	-	0	0	2274	0.0000000
zheyou73v0_A05	2848808	2849919	BnaA05T0052700ZY	0	-	0	0	1111	0.0000000
zheyou73v0_A05	2849977	2850798	BnaA05T0052800ZY	0	-	0	0	821	0.0000000
zheyou73v0_A05	2852560	2852980	BnaA05T0052900ZY	0	+	0	0	420	0.0000000
zheyou73v0_A05	2854773	2855926	BnaA05T0053000ZY	0	+	0	0	1153	0.0000000
zheyou73v0_A05	2856380	2857817	BnaA05T0053100ZY	0	-	0	0	1437	0.0000000
zheyou73v0_A05	2860979	2863079	BnaA05T0053200ZY	0	+	0	0	2100	0.0000000
zheyou73v0_A05	2860979	2863079	BnaA05T0053200ZY.1	0	+	0	0	2100	0.0000000
zheyou73v0_A05	2860979	2863079	BnaA05T0053200ZY.2	0	+	0	0	2100	0.0000000
zheyou73v0_A05	2864884	2868361	BnaA05T0053300ZY	0	-	0	0	3477	0.0000000
zheyou73v0_A05	2874257	2875715	BnaA05T0053400ZY	0	-	0	0	1458	0.0000000
zheyou73v0_A05	2876949	2879378	BnaA05T0053500ZY	0	-	0	0	2429	0.0000000
zheyou73v0_A05	2881955	2883946	BnaA05T0053600ZY	0	+	0	0	1991	0.0000000
zheyou73v0_A05	2884966	2886217	BnaA05T0053700ZY	0	+	0	0	1251	0.0000000
zheyou73v0_A05	2887163	2890136	BnaA05T0053800ZY	0	+	0	0	2973	0.0000000
zheyou73v0_A05	2891506	2894890	BnaA05T0053900ZY	0	+	0	0	3384	0.0000000
zheyou73v0_A05	2892990	2894890	BnaA05T0053900ZY.1	0	+	0	0	1900	0.0000000
zheyou73v0_A05	2896704	2898230	BnaA05T0054000ZY	0	+	0	0	1526	0.0000000
zheyou73v0_A05	2900371	2901660	BnaA05T0054100ZY	0	-	0	0	1289	0.0000000
zheyou73v0_A05	2909063	2911717	BnaA05T0054200ZY	0	+	0	0	2654	0.0000000
zheyou73v0_A05	2911838	2913919	BnaA05T0054300ZY	0	+	0	0	2081	0.0000000
zheyou73v0_A05	2914147	2914922	BnaA05T0054400ZY	0	-	0	0	775	0.0000000
zheyou73v0_A05	2915797	2917796	BnaA05T0054500ZY	0	-	0	0	1999	0.0000000
zheyou73v0_A05	2918946	2920163	BnaA05T0054600ZY	0	+	0	0	1217	0.0000000
zheyou73v0_A05	2921892	2923973	BnaA05T0054700ZY	0	+	0	0	2081	0.0000000
zheyou73v0_A05	2926017	2928816	BnaA05T0054800ZY	0	+	0	0	2799	0.0000000
zheyou73v0_A05	2930225	2930723	BnaA05T0054900ZY	0	-	0	0	498	0.0000000
zheyou73v0_A05	2931089	2934904	BnaA05T0055000ZY	0	-	0	0	3815	0.0000000
zheyou73v0_A05	2935704	2938564	BnaA05T0055100ZY	0	+	0	0	2860	0.0000000
zheyou73v0_A05	2938660	2941340	BnaA05T0055200ZY	0	-	0	0	2680	0.0000000
zheyou73v0_A05	2947251	2950659	BnaA05T0055300ZY	0	+	0	0	3408	0.0000000
zheyou73v0_A05	2951308	2952726	BnaA05T0055400ZY	0	+	0	0	1418	0.0000000
zheyou73v0_A05	2952892	2955670	BnaA05T0055500ZY	0	-	0	0	2778	0.0000000
zheyou73v0_A05	2958350	2959705	BnaA05T0055600ZY	0	+	0	0	1355	0.0000000
zheyou73v0_A05	2967186	2967539	BnaA05T0055700ZY	0	-	0	0	353	0.0000000
zheyou73v0_A05	2974466	2976239	BnaA05T0055800ZY	0	-	0	0	1773	0.0000000
zheyou73v0_A05	2974466	2976239	BnaA05T0055800ZY.1	0	-	0	0	1773	0.0000000
zheyou73v0_A05	2976453	2978028	BnaA05T0055900ZY	0	+	0	0	1575	0.0000000
zheyou73v0_A05	2978124	2979039	BnaA05T0056000ZY	0	-	0	0	915	0.0000000
zheyou73v0_A05	2979451	2981391	BnaA05T0056100ZY	0	-	0	0	1940	0.0000000
zheyou73v0_A05	2983173	2984847	BnaA05T0056200ZY	0	+	0	0	1674	0.0000000
zheyou73v0_A05	2984363	2987727	BnaA05T0056300ZY	0	-	0	0	3364	0.0000000
zheyou73v0_A05	2989391	2991538	BnaA05T0056400ZY	0	-	0	0	2147	0.0000000
zheyou73v0_A05	2991914	2993656	BnaA05T0056500ZY	0	-	0	0	1742	0.0000000
zheyou73v0_A05	2994102	2996406	BnaA05T0056600ZY	0	+	0	0	2304	0.0000000
zheyou73v0_A05	2994102	2996406	BnaA05T0056600ZY.1	0	+	0	0	2304	0.0000000
zheyou73v0_A05	2994102	2996406	BnaA05T0056600ZY.2	0	+	0	0	2304	0.0000000
zheyou73v0_A05	2994102	2996406	BnaA05T0056600ZY.3	0	+	0	0	2304	0.0000000
zheyou73v0_A05	2996429	2997603	BnaA05T0056700ZY	0	+	0	0	1174	0.0000000
zheyou73v0_A05	2997976	2998432	BnaA05T0056800ZY	0	-	0	0	456	0.0000000
zheyou73v0_A05	3000351	3003337	BnaA05T0056900ZY	0	-	0	0	2986	0.0000000
zheyou73v0_A05	3003783	3006087	BnaA05T0057000ZY	0	+	0	0	2304	0.0000000
zheyou73v0_A05	3003783	3006087	BnaA05T0057000ZY.1	0	+	0	0	2304	0.0000000
zheyou73v0_A05	3003783	3006087	BnaA05T0057000ZY.2	0	+	0	0	2304	0.0000000
zheyou73v0_A05	3003783	3006087	BnaA05T0057000ZY.3	0	+	0	0	2304	0.0000000
zheyou73v0_A05	3006110	3007284	BnaA05T0057100ZY	0	+	0	0	1174	0.0000000
zheyou73v0_A05	3007657	3008113	BnaA05T0057200ZY	0	-	0	0	456	0.0000000
zheyou73v0_A05	3010032	3012430	BnaA05T0057300ZY	0	-	0	0	2398	0.0000000
zheyou73v0_A05	3014239	3014881	BnaA05T0057400ZY	0	+	0	0	642	0.0000000
zheyou73v0_A05	3020297	3022687	BnaA05T0057500ZY	0	+	0	0	2390	0.0000000
zheyou73v0_A05	3028047	3028735	BnaA05T0057600ZY	0	+	0	0	688	0.0000000
zheyou73v0_A05	3031400	3032210	BnaA05T0057700ZY	0	+	0	0	810	0.0000000
zheyou73v0_A05	3038374	3040452	BnaA05T0057800ZY.1	0	-	0	0	2078	0.0000000
zheyou73v0_A05	3038541	3040452	BnaA05T0057800ZY	0	-	0	0	1911	0.0000000
zheyou73v0_A05	3044184	3046330	BnaA05T0057900ZY	0	-	0	0	2146	0.0000000
zheyou73v0_A05	3048258	3050909	BnaA05T0058000ZY	0	+	0	0	2651	0.0000000
zheyou73v0_A05	3052757	3053690	BnaA05T0058100ZY	0	+	0	0	933	0.0000000
zheyou73v0_A05	3055253	3055964	BnaA05T0058200ZY	0	+	0	0	711	0.0000000
zheyou73v0_A05	3059906	3060650	BnaA05T0058300ZY	0	+	0	0	744	0.0000000
zheyou73v0_A05	3067004	3069545	BnaA05T0058400ZY	0	+	0	0	2541	0.0000000
zheyou73v0_A05	3069761	3081933	BnaA05T0058500ZY	0	-	0	0	12172	0.0000000
zheyou73v0_A05	3103081	3103638	BnaA05T0058600ZY	0	-	0	0	557	0.0000000
zheyou73v0_A05	3104438	3105895	BnaA05T0058700ZY	0	+	0	0	1457	0.0000000
zheyou73v0_A05	3120773	3121727	BnaA05T0058800ZY	0	+	0	0	954	0.0000000
zheyou73v0_A05	3123912	3126911	BnaA05T0058900ZY	0	-	0	0	2999	0.0000000
zheyou73v0_A05	3123912	3126911	BnaA05T0058900ZY.1	0	-	0	0	2999	0.0000000
zheyou73v0_A05	3134795	3136523	BnaA05T0059000ZY	0	-	0	0	1728	0.0000000
zheyou73v0_A05	3140240	3140602	BnaA05T0059100ZY	0	+	0	0	362	0.0000000
zheyou73v0_A05	3141126	3143025	BnaA05T0059200ZY	0	-	0	0	1899	0.0000000
zheyou73v0_A05	3146546	3150462	BnaA05T0059300ZY	0	-	0	0	3916	0.0000000
zheyou73v0_A05	3146546	3150462	BnaA05T0059300ZY.1	0	-	0	0	3916	0.0000000
zheyou73v0_A05	3167347	3167677	BnaA05T0059400ZY	0	+	0	0	330	0.0000000
zheyou73v0_A05	3175369	3177738	BnaA05T0059500ZY	0	+	0	0	2369	0.0000000
zheyou73v0_A05	3179235	3181561	BnaA05T0059600ZY	0	+	0	0	2326	0.0000000
zheyou73v0_A05	3183296	3183953	BnaA05T0059700ZY	0	-	0	0	657	0.0000000
zheyou73v0_A05	3185188	3188189	BnaA05T0059800ZY	0	+	0	0	3001	0.0000000
zheyou73v0_A05	3189574	3191307	BnaA05T0059900ZY	0	-	0	0	1733	0.0000000
zheyou73v0_A05	3192206	3193072	BnaA05T0060000ZY	0	-	0	0	866	0.0000000
zheyou73v0_A05	3193452	3194898	BnaA05T0060100ZY	0	-	0	0	1446	0.0000000
zheyou73v0_A05	3195937	3198836	BnaA05T0060200ZY	0	+	0	0	2899	0.0000000
zheyou73v0_A05	3202751	3203582	BnaA05T0060300ZY	0	+	0	0	831	0.0000000
zheyou73v0_A05	3207740	3210346	BnaA05T0060400ZY	0	+	0	0	2606	0.0000000
zheyou73v0_A05	3210662	3214258	BnaA05T0060500ZY	0	-	0	0	3596	0.0000000
zheyou73v0_A05	3222682	3224063	BnaA05T0060600ZY	0	+	0	0	1381	0.0000000
zheyou73v0_A05	3225278	3226900	BnaA05T0060700ZY	0	+	0	0	1622	0.0000000
zheyou73v0_A05	3241361	3242919	BnaA05T0060800ZY	0	+	0	0	1558	0.0000000
zheyou73v0_A05	3259511	3262387	BnaA05T0060900ZY	0	+	0	0	2876	0.0000000
zheyou73v0_A05	3263647	3266252	BnaA05T0061000ZY	0	+	0	0	2605	0.0000000
zheyou73v0_A05	3275334	3276929	BnaA05T0061100ZY	0	+	0	0	1595	0.0000000
zheyou73v0_A05	3277916	3281745	BnaA05T0061200ZY	0	+	0	0	3829	0.0000000
zheyou73v0_A05	3277916	3281745	BnaA05T0061200ZY.1	0	+	0	0	3829	0.0000000
zheyou73v0_A05	3286397	3292079	BnaA05T0061300ZY	0	-	0	0	5682	0.0000000
zheyou73v0_A05	3294621	3295990	BnaA05T0061400ZY	0	+	0	0	1369	0.0000000
zheyou73v0_A05	3294621	3296186	BnaA05T0061400ZY.1	0	+	0	0	1565	0.0000000
zheyou73v0_A05	3294621	3296186	BnaA05T0061400ZY.2	0	+	0	0	1565	0.0000000
zheyou73v0_A05	3294621	3296186	BnaA05T0061400ZY.3	0	+	0	0	1565	0.0000000
zheyou73v0_A05	3294621	3296150	BnaA05T0061400ZY.4	0	+	0	0	1529	0.0000000
zheyou73v0_A05	3294621	3296186	BnaA05T0061400ZY.5	0	+	0	0	1565	0.0000000
zheyou73v0_A05	3294621	3296186	BnaA05T0061400ZY.6	0	+	0	0	1565	0.0000000
zheyou73v0_A05	3294621	3296032	BnaA05T0061400ZY.7	0	+	0	0	1411	0.0000000
zheyou73v0_A05	3294621	3296032	BnaA05T0061400ZY.8	0	+	0	0	1411	0.0000000
zheyou73v0_A05	3296537	3302987	BnaA05T0061500ZY	0	-	0	0	6450	0.0000000
zheyou73v0_A05	3303686	3306274	BnaA05T0061600ZY	0	-	0	0	2588	0.0000000
zheyou73v0_A05	3303686	3306274	BnaA05T0061600ZY.1	0	-	0	0	2588	0.0000000
zheyou73v0_A05	3313025	3316023	BnaA05T0061700ZY	0	+	0	0	2998	0.0000000
zheyou73v0_A05	3321445	3322992	BnaA05T0061800ZY	0	+	0	0	1547	0.0000000
zheyou73v0_A05	3325769	3327324	BnaA05T0061900ZY	0	-	0	0	1555	0.0000000
zheyou73v0_A05	3331388	3333253	BnaA05T0062000ZY	0	-	0	0	1865	0.0000000
zheyou73v0_A05	3337000	3338711	BnaA05T0062100ZY	0	-	0	0	1711	0.0000000
zheyou73v0_A05	3343211	3347594	BnaA05T0062200ZY	0	+	0	0	4383	0.0000000
zheyou73v0_A05	3347839	3349100	BnaA05T0062300ZY	0	-	0	0	1261	0.0000000
zheyou73v0_A05	3370325	3374471	BnaA05T0062400ZY	0	+	0	0	4146	0.0000000
zheyou73v0_A05	3374859	3376265	BnaA05T0062500ZY	0	-	0	0	1406	0.0000000
zheyou73v0_A05	3377193	3378951	BnaA05T0062600ZY	0	-	0	0	1758	0.0000000
zheyou73v0_A05	3379902	3380730	BnaA05T0062700ZY	0	+	0	0	828	0.0000000
zheyou73v0_A05	3383841	3384696	BnaA05T0062800ZY	0	+	0	0	855	0.0000000
zheyou73v0_A05	3385686	3386469	BnaA05T0062900ZY	0	+	0	0	783	0.0000000
zheyou73v0_A05	3387782	3391692	BnaA05T0063000ZY	0	+	0	0	3910	0.0000000
zheyou73v0_A05	3392753	3395714	BnaA05T0063100ZY	0	+	0	0	2961	0.0000000
zheyou73v0_A05	3396098	3397500	BnaA05T0063200ZY	0	+	0	0	1402	0.0000000
zheyou73v0_A05	3401191	3402520	BnaA05T0063300ZY	0	+	0	0	1329	0.0000000
zheyou73v0_A05	3409750	3410810	BnaA05T0063400ZY	0	-	0	0	1060	0.0000000
zheyou73v0_A05	3418164	3420651	BnaA05T0063500ZY	0	-	0	0	2487	0.0000000
zheyou73v0_A05	3423716	3423941	BnaA05T0063600ZY	0	+	0	0	225	0.0000000
zheyou73v0_A05	3423965	3424286	BnaA05T0063700ZY	0	+	0	0	321	0.0000000
zheyou73v0_A05	3424592	3425890	BnaA05T0063800ZY	0	+	0	0	1298	0.0000000
zheyou73v0_A05	3425963	3426688	BnaA05T0063900ZY	0	+	0	0	725	0.0000000
zheyou73v0_A05	3429774	3430615	BnaA05T0064000ZY	0	-	0	0	841	0.0000000
zheyou73v0_A05	3437841	3439756	BnaA05T0064100ZY	0	+	0	0	1915	0.0000000
zheyou73v0_A05	3440922	3443514	BnaA05T0064200ZY	0	-	0	0	2592	0.0000000
zheyou73v0_A05	3444169	3445911	BnaA05T0064300ZY	0	-	0	0	1742	0.0000000
zheyou73v0_A05	3458605	3460711	BnaA05T0064400ZY	0	+	0	0	2106	0.0000000
zheyou73v0_A05	3469371	3471528	BnaA05T0064500ZY	0	+	0	0	2157	0.0000000
zheyou73v0_A05	3473744	3474855	BnaA05T0064600ZY	0	+	0	0	1111	0.0000000
zheyou73v0_A05	3475775	3478216	BnaA05T0064700ZY	0	-	0	0	2441	0.0000000
zheyou73v0_A05	3480161	3481401	BnaA05T0064800ZY	0	+	0	0	1240	0.0000000
zheyou73v0_A05	3485768	3487793	BnaA05T0064900ZY	0	+	0	0	2025	0.0000000
zheyou73v0_A05	3488990	3489493	BnaA05T0065000ZY	0	-	0	0	503	0.0000000
zheyou73v0_A05	3490834	3492218	BnaA05T0065100ZY	0	+	0	0	1384	0.0000000
zheyou73v0_A05	3501709	3508407	BnaA05T0065200ZY	0	+	0	0	6698	0.0000000
zheyou73v0_A05	3508413	3509943	BnaA05T0065300ZY	0	-	0	0	1530	0.0000000
zheyou73v0_A05	3511670	3513708	BnaA05T0065400ZY	0	+	0	0	2038	0.0000000
zheyou73v0_A05	3523547	3526292	BnaA05T0065500ZY	0	+	0	0	2745	0.0000000
zheyou73v0_A05	3527187	3529334	BnaA05T0065600ZY	0	+	0	0	2147	0.0000000
zheyou73v0_A05	3528578	3529511	BnaA05T0065700ZY	0	-	0	0	933	0.0000000
zheyou73v0_A05	3593742	3596227	BnaA05T0065800ZY	0	+	0	0	2485	0.0000000
zheyou73v0_A05	3596265	3602009	BnaA05T0065900ZY	0	-	0	0	5744	0.0000000
zheyou73v0_A05	3605691	3606517	BnaA05T0066000ZY	0	+	0	0	826	0.0000000
zheyou73v0_A05	3608167	3610216	BnaA05T0066100ZY	0	+	0	0	2049	0.0000000
zheyou73v0_A05	3613785	3617377	BnaA05T0066200ZY	0	+	0	0	3592	0.0000000
zheyou73v0_A05	3617685	3618214	BnaA05T0066300ZY	0	-	0	0	529	0.0000000
zheyou73v0_A05	3618450	3621223	BnaA05T0066400ZY	0	+	0	0	2773	0.0000000
zheyou73v0_A05	3621717	3622879	BnaA05T0066500ZY	0	-	0	0	1162	0.0000000
zheyou73v0_A05	3626852	3629161	BnaA05T0066600ZY	0	+	0	0	2309	0.0000000
zheyou73v0_A05	3630276	3632367	BnaA05T0066700ZY	0	+	0	0	2091	0.0000000
zheyou73v0_A05	3650587	3653805	BnaA05T0066800ZY	0	-	0	0	3218	0.0000000
zheyou73v0_A05	3657407	3661860	BnaA05T0066900ZY	0	+	0	0	4453	0.0000000
zheyou73v0_A05	3657407	3661860	BnaA05T0066900ZY.1	0	+	0	0	4453	0.0000000
zheyou73v0_A05	3662520	3664526	BnaA05T0067000ZY	0	-	0	0	2006	0.0000000
zheyou73v0_A05	3666165	3670183	BnaA05T0067100ZY	0	+	0	0	4018	0.0000000
zheyou73v0_A05	3670297	3672421	BnaA05T0067200ZY	0	+	0	0	2124	0.0000000
zheyou73v0_A05	3670297	3672421	BnaA05T0067200ZY.1	0	+	0	0	2124	0.0000000
zheyou73v0_A05	3675258	3675792	BnaA05T0067300ZY	0	-	0	0	534	0.0000000
zheyou73v0_A05	3675865	3677266	BnaA05T0067400ZY	0	-	0	0	1401	0.0000000
zheyou73v0_A05	3684267	3687162	BnaA05T0067500ZY	0	-	0	0	2895	0.0000000
zheyou73v0_A05	3692129	3695153	BnaA05T0067600ZY	0	-	0	0	3024	0.0000000
zheyou73v0_A05	3696014	3709732	BnaA05T0067700ZY	0	-	0	0	13718	0.0000000
zheyou73v0_A05	3724884	3726257	BnaA05T0067800ZY	0	+	0	0	1373	0.0000000
zheyou73v0_A05	3727258	3728286	BnaA05T0067900ZY	0	-	0	0	1028	0.0000000
zheyou73v0_A05	3728806	3729610	BnaA05T0068000ZY	0	+	0	0	804	0.0000000
zheyou73v0_A05	3731870	3739453	BnaA05T0068100ZY	0	+	0	0	7583	0.0000000
zheyou73v0_A05	3739734	3741312	BnaA05T0068200ZY	0	-	0	0	1578	0.0000000
zheyou73v0_A05	3742637	3743063	BnaA05T0068300ZY	0	-	0	0	426	0.0000000
zheyou73v0_A05	3745079	3746358	BnaA05T0068400ZY	0	+	0	0	1279	0.0000000
zheyou73v0_A05	3764492	3771214	BnaA05T0068500ZY	0	+	0	0	6722	0.0000000
zheyou73v0_A05	3771416	3773957	BnaA05T0068600ZY	0	-	0	0	2541	0.0000000
zheyou73v0_A05	3774479	3776498	BnaA05T0068700ZY	0	+	0	0	2019	0.0000000
zheyou73v0_A05	3779321	3779913	BnaA05T0068800ZY	0	+	0	0	592	0.0000000
zheyou73v0_A05	3784856	3787911	BnaA05T0068900ZY	0	+	0	0	3055	0.0000000
zheyou73v0_A05	3784856	3787710	BnaA05T0068900ZY.1	0	+	0	0	2854	0.0000000
zheyou73v0_A05	3791941	3792967	BnaA05T0069000ZY	0	+	0	0	1026	0.0000000
zheyou73v0_A05	3799042	3801542	BnaA05T0069100ZY	0	+	0	0	2500	0.0000000
zheyou73v0_A05	3799042	3800695	BnaA05T0069100ZY.1	0	+	0	0	1653	0.0000000
zheyou73v0_A05	3801713	3802915	BnaA05T0069200ZY	0	-	0	0	1202	0.0000000
zheyou73v0_A05	3804153	3806003	BnaA05T0069300ZY	0	-	0	0	1850	0.0000000
zheyou73v0_A05	3806929	3810437	BnaA05T0069400ZY	0	+	0	0	3508	0.0000000
zheyou73v0_A05	3810835	3812979	BnaA05T0069500ZY	0	-	0	0	2144	0.0000000
zheyou73v0_A05	3825052	3825355	BnaA05T0069600ZY	0	+	0	0	303	0.0000000
zheyou73v0_A05	3825906	3827358	BnaA05T0069700ZY	0	-	0	0	1452	0.0000000
zheyou73v0_A05	3838097	3839483	BnaA05T0069800ZY	0	+	0	0	1386	0.0000000
zheyou73v0_A05	3842364	3844496	BnaA05T0069900ZY	0	+	0	0	2132	0.0000000
zheyou73v0_A05	3844461	3846834	BnaA05T0070000ZY	0	-	0	0	2373	0.0000000
zheyou73v0_A05	3847473	3848280	BnaA05T0070100ZY	0	+	0	0	807	0.0000000
zheyou73v0_A05	3848377	3855138	BnaA05T0070200ZY	0	-	0	0	6761	0.0000000
zheyou73v0_A05	3862449	3868063	BnaA05T0070300ZY	0	-	0	0	5614	0.0000000
zheyou73v0_A05	3869252	3870884	BnaA05T0070400ZY	0	+	0	0	1632	0.0000000
zheyou73v0_A05	3878673	3880156	BnaA05T0070500ZY	0	-	0	0	1483	0.0000000
zheyou73v0_A05	3882209	3886098	BnaA05T0070600ZY	0	+	0	0	3889	0.0000000
zheyou73v0_A05	3886379	3888935	BnaA05T0070700ZY	0	-	0	0	2556	0.0000000
zheyou73v0_A05	3894851	3895459	BnaA05T0070800ZY	0	+	0	0	608	0.0000000
zheyou73v0_A05	3896995	3897739	BnaA05T0070900ZY	0	+	0	0	744	0.0000000
zheyou73v0_A05	3907414	3908479	BnaA05T0071000ZY	0	-	0	0	1065	0.0000000
zheyou73v0_A05	3919892	3925434	BnaA05T0071100ZY	0	-	0	0	5542	0.0000000
zheyou73v0_A05	3927053	3928077	BnaA05T0071200ZY	0	+	0	0	1024	0.0000000
zheyou73v0_A05	3928683	3929225	BnaA05T0071300ZY	0	-	0	0	542	0.0000000
zheyou73v0_A05	3933382	3934822	BnaA05T0071400ZY	0	+	0	0	1440	0.0000000
zheyou73v0_A05	3948257	3952035	BnaA05T0071500ZY	0	-	0	0	3778	0.0000000
zheyou73v0_A05	3960943	3962657	BnaA05T0071600ZY	0	+	0	0	1714	0.0000000
zheyou73v0_A05	3965027	3968054	BnaA05T0071700ZY	0	+	0	0	3027	0.0000000
zheyou73v0_A05	3969092	3974009	BnaA05T0071800ZY	0	+	0	0	4917	0.0000000
zheyou73v0_A05	3969092	3974009	BnaA05T0071800ZY.1	0	+	0	0	4917	0.0000000
zheyou73v0_A05	3975414	3976630	BnaA05T0071900ZY	0	-	0	0	1216	0.0000000
zheyou73v0_A05	3983233	4000393	BnaA05T0072000ZY	0	-	0	0	17160	0.0000000
zheyou73v0_A05	4012854	4016505	BnaA05T0072100ZY	0	+	0	0	3651	0.0000000
zheyou73v0_A05	4018594	4019785	BnaA05T0072200ZY	0	+	0	0	1191	0.0000000
zheyou73v0_A05	4020456	4021671	BnaA05T0072300ZY	0	+	0	0	1215	0.0000000
zheyou73v0_A05	4021730	4022441	BnaA05T0072400ZY	0	-	0	0	711	0.0000000
zheyou73v0_A05	4021730	4022441	BnaA05T0072400ZY.1	0	-	0	0	711	0.0000000
zheyou73v0_A05	4022645	4024263	BnaA05T0072500ZY	0	+	0	0	1618	0.0000000
zheyou73v0_A05	4026950	4031122	BnaA05T0072600ZY	0	-	0	0	4172	0.0000000
zheyou73v0_A05	4073682	4076762	BnaA05T0072700ZY	0	+	0	0	3080	0.0000000
zheyou73v0_A05	4080664	4082564	BnaA05T0072800ZY	0	+	0	0	1900	0.0000000
zheyou73v0_A05	4085025	4087136	BnaA05T0072900ZY	0	-	0	0	2111	0.0000000
zheyou73v0_A05	4094613	4097727	BnaA05T0073000ZY	0	-	0	0	3114	0.0000000
zheyou73v0_A05	4094937	4097727	BnaA05T0073000ZY.1	0	-	0	0	2790	0.0000000
zheyou73v0_A05	4102386	4106469	BnaA05T0073100ZY	0	-	0	0	4083	0.0000000
zheyou73v0_A05	4102386	4106469	BnaA05T0073100ZY.1	0	-	0	0	4083	0.0000000
zheyou73v0_A05	4107126	4107643	BnaA05T0073200ZY	0	+	0	0	517	0.0000000
zheyou73v0_A05	4111831	4115158	BnaA05T0073300ZY	0	-	0	0	3327	0.0000000
zheyou73v0_A05	4116053	4118329	BnaA05T0073400ZY	0	+	0	0	2276	0.0000000
zheyou73v0_A05	4118975	4120740	BnaA05T0073500ZY	0	-	0	0	1765	0.0000000
zheyou73v0_A05	4121080	4121717	BnaA05T0073600ZY	0	+	0	0	637	0.0000000
zheyou73v0_A05	4121788	4122618	BnaA05T0073700ZY	0	-	0	0	830	0.0000000
zheyou73v0_A05	4124419	4126024	BnaA05T0073800ZY	0	+	0	0	1605	0.0000000
zheyou73v0_A05	4130058	4131048	BnaA05T0073900ZY	0	+	0	0	990	0.0000000
zheyou73v0_A05	4131417	4133641	BnaA05T0074000ZY	0	-	0	0	2224	0.0000000
zheyou73v0_A05	4139309	4140872	BnaA05T0074100ZY	0	-	0	0	1563	0.0000000
zheyou73v0_A05	4141483	4142179	BnaA05T0074200ZY	0	+	0	0	696	0.0000000
zheyou73v0_A05	4152435	4155280	BnaA05T0074300ZY	0	+	0	0	2845	0.0000000
zheyou73v0_A05	4155568	4155823	BnaA05T0074400ZY	0	-	0	0	255	0.0000000
zheyou73v0_A05	4156501	4157213	BnaA05T0074500ZY	0	-	0	0	712	0.0000000
zheyou73v0_A05	4157530	4159553	BnaA05T0074600ZY	0	-	0	0	2023	0.0000000
zheyou73v0_A05	4161171	4161748	BnaA05T0074700ZY	0	+	0	0	577	0.0000000
zheyou73v0_A05	4162978	4163884	BnaA05T0074800ZY	0	+	0	0	906	0.0000000
zheyou73v0_A05	4169718	4170613	BnaA05T0074900ZY	0	+	0	0	895	0.0000000
zheyou73v0_A05	4186920	4187755	BnaA05T0075000ZY	0	-	0	0	835	0.0000000
zheyou73v0_A05	4189707	4190833	BnaA05T0075100ZY	0	+	0	0	1126	0.0000000
zheyou73v0_A05	4197721	4198213	BnaA05T0075200ZY	0	+	0	0	492	0.0000000
zheyou73v0_A05	4202003	4204554	BnaA05T0075300ZY	0	+	0	0	2551	0.0000000
zheyou73v0_A05	4209498	4211756	BnaA05T0075400ZY	0	+	0	0	2258	0.0000000
zheyou73v0_A05	4216199	4220506	BnaA05T0075500ZY	0	+	0	0	4307	0.0000000
zheyou73v0_A05	4216199	4220506	BnaA05T0075500ZY.1	0	+	0	0	4307	0.0000000
zheyou73v0_A05	4220654	4221053	BnaA05T0075600ZY	0	-	0	0	399	0.0000000
zheyou73v0_A05	4221499	4221816	BnaA05T0075700ZY	0	-	0	0	317	0.0000000
zheyou73v0_A05	4225177	4226417	BnaA05T0075800ZY	0	+	0	0	1240	0.0000000
zheyou73v0_A05	4225177	4226504	BnaA05T0075800ZY.1	0	+	0	0	1327	0.0000000
zheyou73v0_A05	4225177	4226694	BnaA05T0075800ZY.2	0	+	0	0	1517	0.0000000
zheyou73v0_A05	4225177	4226417	BnaA05T0075800ZY.3	0	+	0	0	1240	0.0000000
zheyou73v0_A05	4229145	4231531	BnaA05T0075900ZY	0	+	0	0	2386	0.0000000
zheyou73v0_A05	4229145	4231531	BnaA05T0075900ZY.1	0	+	0	0	2386	0.0000000
zheyou73v0_A05	4229145	4231531	BnaA05T0075900ZY.2	0	+	0	0	2386	0.0000000
zheyou73v0_A05	4232894	4235019	BnaA05T0076000ZY	0	+	0	0	2125	0.0000000
zheyou73v0_A05	4232894	4235019	BnaA05T0076000ZY.1	0	+	0	0	2125	0.0000000
zheyou73v0_A05	4237916	4240168	BnaA05T0076100ZY	0	+	0	0	2252	0.0000000
zheyou73v0_A05	4251228	4252637	BnaA05T0076200ZY	0	+	0	0	1409	0.0000000
zheyou73v0_A05	4252710	4254665	BnaA05T0076300ZY	0	-	0	0	1955	0.0000000
zheyou73v0_A05	4257284	4257728	BnaA05T0076400ZY	0	+	0	0	444	0.0000000
zheyou73v0_A05	4259316	4260269	BnaA05T0076500ZY	0	+	0	0	953	0.0000000
zheyou73v0_A05	4264287	4265450	BnaA05T0076600ZY	0	-	0	0	1163	0.0000000
zheyou73v0_A05	4267573	4269678	BnaA05T0076700ZY	0	-	0	0	2105	0.0000000
zheyou73v0_A05	4272836	4275089	BnaA05T0076800ZY	0	-	0	0	2253	0.0000000
zheyou73v0_A05	4274868	4275830	BnaA05T0076900ZY	0	+	0	0	962	0.0000000
zheyou73v0_A05	4283546	4285895	BnaA05T0077000ZY	0	+	0	0	2349	0.0000000
zheyou73v0_A05	4291208	4294177	BnaA05T0077100ZY	0	+	0	0	2969	0.0000000
zheyou73v0_A05	4295095	4296206	BnaA05T0077200ZY	0	+	0	0	1111	0.0000000
zheyou73v0_A05	4296430	4299150	BnaA05T0077300ZY	0	+	0	0	2720	0.0000000
zheyou73v0_A05	4299215	4300478	BnaA05T0077400ZY	0	-	0	0	1263	0.0000000
zheyou73v0_A05	4299215	4300478	BnaA05T0077400ZY.1	0	-	0	0	1263	0.0000000
zheyou73v0_A05	4316372	4319590	BnaA05T0077500ZY	0	+	0	0	3218	0.0000000
zheyou73v0_A05	4317953	4319590	BnaA05T0077500ZY.1	0	+	0	0	1637	0.0000000
zheyou73v0_A05	4319990	4321447	BnaA05T0077600ZY	0	-	0	0	1457	0.0000000
zheyou73v0_A05	4322621	4325419	BnaA05T0077700ZY	0	-	0	0	2798	0.0000000
zheyou73v0_A05	4343646	4344285	BnaA05T0077800ZY	0	-	0	0	639	0.0000000
zheyou73v0_A05	4345751	4347771	BnaA05T0077900ZY	0	-	0	0	2020	0.0000000
zheyou73v0_A05	4348364	4349666	BnaA05T0078000ZY	0	+	0	0	1302	0.0000000
zheyou73v0_A05	4350612	4352964	BnaA05T0078100ZY	0	+	0	0	2352	0.0000000
zheyou73v0_A05	4353198	4354444	BnaA05T0078200ZY	0	-	0	0	1246	0.0000000
zheyou73v0_A05	4364257	4365401	BnaA05T0078300ZY	0	-	0	0	1144	0.0000000
zheyou73v0_A05	4377173	4382013	BnaA05T0078400ZY	0	-	0	0	4840	0.0000000
zheyou73v0_A05	4378231	4382013	BnaA05T0078400ZY.1	0	-	0	0	3782	0.0000000
zheyou73v0_A05	4388380	4389720	BnaA05T0078500ZY	0	-	0	0	1340	0.0000000
zheyou73v0_A05	4390613	4392090	BnaA05T0078600ZY	0	-	0	0	1477	0.0000000
zheyou73v0_A05	4393361	4394064	BnaA05T0078700ZY	0	+	0	0	703	0.0000000
zheyou73v0_A05	4400239	4405762	BnaA05T0078800ZY	0	+	0	0	5523	0.0000000
zheyou73v0_A05	4405618	4417969	BnaA05T0078900ZY	0	-	0	0	12351	0.0000000
zheyou73v0_A05	4423010	4423994	BnaA05T0079000ZY	0	-	0	0	984	0.0000000
zheyou73v0_A05	4427011	4428406	BnaA05T0079100ZY	0	+	0	0	1395	0.0000000
zheyou73v0_A05	4430838	4432303	BnaA05T0079200ZY	0	-	0	0	1465	0.0000000
zheyou73v0_A05	4434002	4435409	BnaA05T0079300ZY	0	+	0	0	1407	0.0000000
zheyou73v0_A05	4437188	4438912	BnaA05T0079400ZY	0	+	0	0	1724	0.0000000
zheyou73v0_A05	4441475	4442870	BnaA05T0079500ZY	0	+	0	0	1395	0.0000000
zheyou73v0_A05	4441553	4442870	BnaA05T0079500ZY.1	0	+	0	0	1317	0.0000000
zheyou73v0_A05	4445302	4446767	BnaA05T0079600ZY	0	-	0	0	1465	0.0000000
zheyou73v0_A05	4448466	4449873	BnaA05T0079700ZY	0	+	0	0	1407	0.0000000
zheyou73v0_A05	4451652	4453376	BnaA05T0079800ZY	0	+	0	0	1724	0.0000000
zheyou73v0_A05	4464085	4468407	BnaA05T0079900ZY	0	+	0	0	4322	0.0000000
zheyou73v0_A05	4472290	4472542	BnaA05T0080000ZY	0	+	0	0	252	0.0000000
zheyou73v0_A05	4476861	4478284	BnaA05T0080100ZY	0	-	0	0	1423	0.0000000
zheyou73v0_A05	4481462	4482844	BnaA05T0080200ZY	0	+	0	0	1382	0.0000000
zheyou73v0_A05	4481462	4482844	BnaA05T0080200ZY.1	0	+	0	0	1382	0.0000000
zheyou73v0_A05	4484636	4485580	BnaA05T0080300ZY	0	-	0	0	944	0.0000000
zheyou73v0_A05	4487276	4489159	BnaA05T0080400ZY	0	+	0	0	1883	0.0000000
zheyou73v0_A05	4492375	4498693	BnaA05T0080500ZY	0	+	0	0	6318	0.0000000
zheyou73v0_A05	4499069	4503408	BnaA05T0080600ZY	0	-	0	0	4339	0.0000000
zheyou73v0_A05	4515073	4518230	BnaA05T0080700ZY	0	+	0	0	3157	0.0000000
zheyou73v0_A05	4519953	4521983	BnaA05T0080800ZY	0	+	0	0	2030	0.0000000
zheyou73v0_A05	4522110	4522488	BnaA05T0080900ZY	0	-	0	0	378	0.0000000
zheyou73v0_A05	4525769	4530539	BnaA05T0081000ZY	0	-	0	0	4770	0.0000000
zheyou73v0_A05	4535153	4535315	BnaA05T0081100ZY	0	+	0	0	162	0.0000000
zheyou73v0_A05	4538007	4541079	BnaA05T0081200ZY	0	-	0	0	3072	0.0000000
zheyou73v0_A05	4544959	4546819	BnaA05T0081300ZY	0	-	0	0	1860	0.0000000
zheyou73v0_A05	4548018	4549826	BnaA05T0081400ZY	0	-	0	0	1808	0.0000000
zheyou73v0_A05	4564039	4565757	BnaA05T0081500ZY	0	-	0	0	1718	0.0000000
zheyou73v0_A05	4567487	4571420	BnaA05T0081600ZY	0	-	0	0	3933	0.0000000
zheyou73v0_A05	4576595	4578448	BnaA05T0081700ZY	0	-	0	0	1853	0.0000000
zheyou73v0_A05	4576595	4578303	BnaA05T0081700ZY.1	0	-	0	0	1708	0.0000000
zheyou73v0_A05	4592123	4592935	BnaA05T0081800ZY	0	+	0	0	812	0.0000000
zheyou73v0_A05	4593783	4595166	BnaA05T0081900ZY	0	+	0	0	1383	0.0000000
zheyou73v0_A05	4597757	4599356	BnaA05T0082000ZY	0	-	0	0	1599	0.0000000
zheyou73v0_A05	4605786	4607150	BnaA05T0082100ZY	0	+	0	0	1364	0.0000000
zheyou73v0_A05	4607833	4609885	BnaA05T0082200ZY	0	+	0	0	2052	0.0000000
zheyou73v0_A05	4611796	4613455	BnaA05T0082300ZY	0	-	0	0	1659	0.0000000
zheyou73v0_A05	4627746	4629728	BnaA05T0082400ZY	0	+	0	0	1982	0.0000000
zheyou73v0_A05	4633855	4647664	BnaA05T0082500ZY	0	+	0	0	13809	0.0000000
zheyou73v0_A05	4649416	4650830	BnaA05T0082600ZY	0	+	0	0	1414	0.0000000
zheyou73v0_A05	4672977	4675437	BnaA05T0082700ZY	0	+	0	0	2460	0.0000000
zheyou73v0_A05	4677212	4678790	BnaA05T0082800ZY	0	-	0	0	1578	0.0000000
zheyou73v0_A05	4679683	4680103	BnaA05T0082900ZY	0	-	0	0	420	0.0000000
zheyou73v0_A05	4682349	4683961	BnaA05T0083000ZY	0	-	0	0	1612	0.0000000
zheyou73v0_A05	4689639	4696444	BnaA05T0083100ZY	0	-	0	0	6805	0.0000000
zheyou73v0_A05	4702387	4706114	BnaA05T0083200ZY	0	+	0	0	3727	0.0000000
zheyou73v0_A05	4702387	4706114	BnaA05T0083200ZY.1	0	+	0	0	3727	0.0000000
zheyou73v0_A05	4702387	4706114	BnaA05T0083200ZY.2	0	+	0	0	3727	0.0000000
zheyou73v0_A05	4709414	4711455	BnaA05T0083300ZY	0	+	0	0	2041	0.0000000
zheyou73v0_A05	4712746	4715236	BnaA05T0083400ZY	0	+	0	0	2490	0.0000000
zheyou73v0_A05	4715250	4716890	BnaA05T0083500ZY	0	-	0	0	1640	0.0000000
zheyou73v0_A05	4723380	4725702	BnaA05T0083600ZY	0	+	0	0	2322	0.0000000
zheyou73v0_A05	4727671	4729015	BnaA05T0083700ZY	0	+	0	0	1344	0.0000000
zheyou73v0_A05	4729168	4729938	BnaA05T0083800ZY	0	-	0	0	770	0.0000000
zheyou73v0_A05	4730025	4730250	BnaA05T0083900ZY	0	-	0	0	225	0.0000000
zheyou73v0_A05	4735444	4738601	BnaA05T0084000ZY	0	-	0	0	3157	0.0000000
zheyou73v0_A05	4739911	4743140	BnaA05T0084100ZY	0	+	0	0	3229	0.0000000
zheyou73v0_A05	4747368	4750041	BnaA05T0084200ZY	0	+	0	0	2673	0.0000000
zheyou73v0_A05	4751198	4753324	BnaA05T0084300ZY	0	-	0	0	2126	0.0000000
zheyou73v0_A05	4767569	4778768	BnaA05T0084400ZY	0	+	0	0	11199	0.0000000
zheyou73v0_A05	4767773	4778768	BnaA05T0084400ZY.1	0	+	0	0	10995	0.0000000
zheyou73v0_A05	4781767	4782879	BnaA05T0084500ZY	0	+	0	0	1112	0.0000000
zheyou73v0_A05	4783851	4784100	BnaA05T0084600ZY	0	-	0	0	249	0.0000000
zheyou73v0_A05	4786353	4787721	BnaA05T0084700ZY	0	-	0	0	1368	0.0000000
zheyou73v0_A05	4788715	4791437	BnaA05T0084800ZY	0	-	0	0	2722	0.0000000
zheyou73v0_A05	4831768	4834266	BnaA05T0084900ZY	0	+	0	0	2498	0.0000000
zheyou73v0_A05	4834572	4839841	BnaA05T0085000ZY	0	-	0	0	5269	0.0000000
zheyou73v0_A05	4834572	4838297	BnaA05T0085000ZY.1	0	-	0	0	3725	0.0000000
zheyou73v0_A05	4847730	4851769	BnaA05T0085100ZY	0	+	0	0	4039	0.0000000
zheyou73v0_A05	4852181	4856235	BnaA05T0085200ZY	0	-	0	0	4054	0.0000000
zheyou73v0_A05	4857798	4859390	BnaA05T0085300ZY	0	-	0	0	1592	0.0000000
zheyou73v0_A05	4858300	4859390	BnaA05T0085300ZY.1	0	-	0	0	1090	0.0000000
zheyou73v0_A05	4861817	4863015	BnaA05T0085400ZY	0	-	0	0	1198	0.0000000
zheyou73v0_A05	4866475	4868711	BnaA05T0085500ZY	0	+	0	0	2236	0.0000000
zheyou73v0_A05	4866475	4868445	BnaA05T0085500ZY.1	0	+	0	0	1970	0.0000000
zheyou73v0_A05	4877139	4878467	BnaA05T0085600ZY	0	+	0	0	1328	0.0000000
zheyou73v0_A05	4879285	4880437	BnaA05T0085700ZY	0	+	0	0	1152	0.0000000
zheyou73v0_A05	4885921	4888312	BnaA05T0085800ZY	0	+	0	0	2391	0.0000000
zheyou73v0_A05	4889163	4891945	BnaA05T0085900ZY	0	+	0	0	2782	0.0000000
zheyou73v0_A05	4889976	4891945	BnaA05T0085900ZY.1	0	+	0	0	1969	0.0000000
zheyou73v0_A05	4889976	4891945	BnaA05T0085900ZY.2	0	+	0	0	1969	0.0000000
zheyou73v0_A05	4892001	4892592	BnaA05T0086000ZY	0	-	0	0	591	0.0000000
zheyou73v0_A05	4894663	4898769	BnaA05T0086100ZY	0	+	0	0	4106	0.0000000
zheyou73v0_A05	4894663	4898221	BnaA05T0086100ZY.1	0	+	0	0	3558	0.0000000
zheyou73v0_A05	4894989	4896489	BnaA05T0086200ZY	0	-	0	0	1500	0.0000000
zheyou73v0_A05	4899398	4900169	BnaA05T0086300ZY	0	-	0	0	771	0.0000000
zheyou73v0_A05	4912520	4913246	BnaA05T0086400ZY	0	+	0	0	726	0.0000000
zheyou73v0_A05	4914049	4919338	BnaA05T0086500ZY	0	+	0	0	5289	0.0000000
zheyou73v0_A05	4922736	4923529	BnaA05T0086600ZY	0	+	0	0	793	0.0000000
zheyou73v0_A05	4935915	4936871	BnaA05T0086700ZY	0	-	0	0	956	0.0000000
zheyou73v0_A05	4937899	4939146	BnaA05T0086800ZY	0	-	0	0	1247	0.0000000
zheyou73v0_A05	4939960	4941418	BnaA05T0086900ZY	0	-	0	0	1458	0.0000000
zheyou73v0_A05	4943751	4944640	BnaA05T0087000ZY	0	-	0	0	889	0.0000000
zheyou73v0_A05	4948658	4949809	BnaA05T0087100ZY	0	+	0	0	1151	0.0000000
zheyou73v0_A05	4951289	4951577	BnaA05T0087200ZY	0	+	0	0	288	0.0000000
zheyou73v0_A05	4952283	4953315	BnaA05T0087300ZY	0	-	0	0	1032	0.0000000
zheyou73v0_A05	4972762	4975971	BnaA05T0087400ZY	0	+	0	0	3209	0.0000000
zheyou73v0_A05	4972762	4974840	BnaA05T0087400ZY.1	0	+	0	0	2078	0.0000000
zheyou73v0_A05	4992861	4993929	BnaA05T0087500ZY	0	+	0	0	1068	0.0000000
zheyou73v0_A05	5004486	5005451	BnaA05T0087600ZY	0	-	0	0	965	0.0000000
zheyou73v0_A05	5006851	5008997	BnaA05T0087700ZY	0	+	0	0	2146	0.0000000
zheyou73v0_A05	5009270	5012196	BnaA05T0087800ZY	0	-	0	0	2926	0.0000000
zheyou73v0_A05	5014867	5018070	BnaA05T0087900ZY	0	-	0	0	3203	0.0000000
zheyou73v0_A05	5023531	5024161	BnaA05T0088000ZY	0	-	0	0	630	0.0000000
zheyou73v0_A05	5035101	5036892	BnaA05T0088100ZY	0	-	0	0	1791	0.0000000
zheyou73v0_A05	5053747	5056757	BnaA05T0088200ZY	0	-	0	0	3010	0.0000000
zheyou73v0_A05	5079949	5083008	BnaA05T0088300ZY	0	+	0	0	3059	0.0000000
zheyou73v0_A05	5090699	5091743	BnaA05T0088400ZY	0	-	0	0	1044	0.0000000
zheyou73v0_A05	5093316	5094057	BnaA05T0088500ZY	0	+	0	0	741	0.0000000
zheyou73v0_A05	5101762	5103410	BnaA05T0088600ZY	0	+	0	0	1648	0.0000000
zheyou73v0_A05	5103529	5106214	BnaA05T0088700ZY	0	-	0	0	2685	0.0000000
zheyou73v0_A05	5122759	5124518	BnaA05T0088800ZY	0	-	0	0	1759	0.0000000
zheyou73v0_A05	5129120	5142482	BnaA05T0088900ZY	0	-	0	0	13362	0.0000000
zheyou73v0_A05	5151678	5155234	BnaA05T0089000ZY	0	+	0	0	3556	0.0000000
zheyou73v0_A05	5158200	5160588	BnaA05T0089100ZY	0	+	0	0	2388	0.0000000
zheyou73v0_A05	5170402	5171767	BnaA05T0089200ZY	0	+	0	0	1365	0.0000000
zheyou73v0_A05	5173616	5175432	BnaA05T0089300ZY	0	+	0	0	1816	0.0000000
zheyou73v0_A05	5196320	5198805	BnaA05T0089400ZY	0	+	0	0	2485	0.0000000
zheyou73v0_A05	5200848	5203878	BnaA05T0089500ZY	0	+	0	0	3030	0.0000000
zheyou73v0_A05	5209622	5211194	BnaA05T0089600ZY	0	-	0	0	1572	0.0000000
zheyou73v0_A05	5211821	5223446	BnaA05T0089700ZY	0	+	0	0	11625	0.0000000
zheyou73v0_A05	5225825	5228837	BnaA05T0089800ZY	0	+	0	0	3012	0.0000000
zheyou73v0_A05	5229670	5231581	BnaA05T0089900ZY	0	+	0	0	1911	0.0000000
zheyou73v0_A05	5241033	5242600	BnaA05T0090000ZY	0	+	0	0	1567	0.0000000
zheyou73v0_A05	5242986	5243749	BnaA05T0090100ZY	0	-	0	0	763	0.0000000
zheyou73v0_A05	5245604	5246708	BnaA05T0090200ZY	0	+	0	0	1104	0.0000000
zheyou73v0_A05	5249784	5250489	BnaA05T0090300ZY	0	-	0	0	705	0.0000000
zheyou73v0_A05	5251341	5253372	BnaA05T0090400ZY	0	+	0	0	2031	0.0000000
zheyou73v0_A05	5253675	5255108	BnaA05T0090500ZY	0	+	0	0	1433	0.0000000
zheyou73v0_A05	5255523	5256363	BnaA05T0090600ZY	0	+	0	0	840	0.0000000
zheyou73v0_A05	5257776	5260407	BnaA05T0090700ZY	0	+	0	0	2631	0.0000000
zheyou73v0_A05	5261889	5264681	BnaA05T0090800ZY	0	+	0	0	2792	0.0000000
zheyou73v0_A05	5267359	5267823	BnaA05T0090900ZY	0	+	0	0	464	0.0000000
zheyou73v0_A05	5277661	5278912	BnaA05T0091000ZY	0	-	0	0	1251	0.0000000
zheyou73v0_A05	5279177	5280189	BnaA05T0091100ZY	0	-	0	0	1012	0.0000000
zheyou73v0_A05	5281382	5282795	BnaA05T0091200ZY	0	+	0	0	1413	0.0000000
zheyou73v0_A05	5287876	5289266	BnaA05T0091300ZY	0	+	0	0	1390	0.0000000
zheyou73v0_A05	5291806	5294517	BnaA05T0091400ZY	0	+	0	0	2711	0.0000000
zheyou73v0_A05	5295899	5297148	BnaA05T0091500ZY	0	-	0	0	1249	0.0000000
zheyou73v0_A05	5297874	5300219	BnaA05T0091600ZY	0	-	0	0	2345	0.0000000
zheyou73v0_A05	5297874	5300219	BnaA05T0091600ZY.1	0	-	0	0	2345	0.0000000
zheyou73v0_A05	5297874	5300219	BnaA05T0091600ZY.2	0	-	0	0	2345	0.0000000
zheyou73v0_A05	5300800	5301097	BnaA05T0091700ZY	0	+	0	0	297	0.0000000
zheyou73v0_A05	5302520	5303111	BnaA05T0091800ZY	0	+	0	0	591	0.0000000
zheyou73v0_A05	5305230	5306138	BnaA05T0091900ZY	0	-	0	0	908	0.0000000
zheyou73v0_A05	5321764	5323993	BnaA05T0092000ZY	0	-	0	0	2229	0.0000000
zheyou73v0_A05	5331495	5332538	BnaA05T0092100ZY	0	+	0	0	1043	0.0000000
zheyou73v0_A05	5333642	5334842	BnaA05T0092200ZY	0	-	0	0	1200	0.0000000
zheyou73v0_A05	5341566	5342158	BnaA05T0092300ZY	0	-	0	0	592	0.0000000
zheyou73v0_A05	5344122	5344668	BnaA05T0092400ZY	0	-	0	0	546	0.0000000
zheyou73v0_A05	5345790	5347854	BnaA05T0092500ZY	0	-	0	0	2064	0.0000000
zheyou73v0_A05	5349233	5352027	BnaA05T0092600ZY	0	-	0	0	2794	0.0000000
zheyou73v0_A05	5356421	5359499	BnaA05T0092700ZY	0	+	0	0	3078	0.0000000
zheyou73v0_A05	5360551	5361625	BnaA05T0092800ZY	0	+	0	0	1074	0.0000000
zheyou73v0_A05	5361701	5365082	BnaA05T0092900ZY	0	-	0	0	3381	0.0000000
zheyou73v0_A05	5366285	5369444	BnaA05T0093000ZY	0	+	0	0	3159	0.0000000
zheyou73v0_A05	5369593	5371003	BnaA05T0093100ZY	0	+	0	0	1410	0.0000000
zheyou73v0_A05	5372805	5380567	BnaA05T0093200ZY	0	+	0	0	7762	0.0000000
zheyou73v0_A05	5383011	5385103	BnaA05T0093300ZY	0	+	0	0	2092	0.0000000
zheyou73v0_A05	5389966	5393930	BnaA05T0093400ZY	0	+	0	0	3964	0.0000000
zheyou73v0_A05	5389966	5393930	BnaA05T0093400ZY.1	0	+	0	0	3964	0.0000000
zheyou73v0_A05	5395014	5397870	BnaA05T0093500ZY	0	+	0	0	2856	0.0000000
zheyou73v0_A05	5398169	5399965	BnaA05T0093600ZY	0	+	0	0	1796	0.0000000
zheyou73v0_A05	5398169	5399965	BnaA05T0093600ZY.1	0	+	0	0	1796	0.0000000
zheyou73v0_A05	5407739	5409817	BnaA05T0093700ZY	0	+	0	0	2078	0.0000000
zheyou73v0_A05	5409983	5413753	BnaA05T0093800ZY	0	-	0	0	3770	0.0000000
zheyou73v0_A05	5416052	5417342	BnaA05T0093900ZY	0	+	0	0	1290	0.0000000
zheyou73v0_A05	5420175	5421117	BnaA05T0094000ZY	0	+	0	0	942	0.0000000
zheyou73v0_A05	5422067	5423162	BnaA05T0094100ZY	0	-	0	0	1095	0.0000000
zheyou73v0_A05	5423754	5426217	BnaA05T0094200ZY	0	-	0	0	2463	0.0000000
zheyou73v0_A05	5427397	5430112	BnaA05T0094300ZY	0	+	0	0	2715	0.0000000
zheyou73v0_A05	5439227	5439624	BnaA05T0094400ZY	0	-	0	0	397	0.0000000
zheyou73v0_A05	5444152	5446017	BnaA05T0094500ZY	0	+	0	0	1865	0.0000000
zheyou73v0_A05	5446190	5446643	BnaA05T0094600ZY	0	+	0	0	453	0.0000000
zheyou73v0_A05	5447123	5448011	BnaA05T0094700ZY	0	-	0	0	888	0.0000000
zheyou73v0_A05	5449391	5451708	BnaA05T0094800ZY	0	+	0	0	2317	0.0000000
zheyou73v0_A05	5449391	5451708	BnaA05T0094800ZY.1	0	+	0	0	2317	0.0000000
zheyou73v0_A05	5455795	5459730	BnaA05T0094900ZY	0	+	0	0	3935	0.0000000
zheyou73v0_A05	5460373	5460682	BnaA05T0095000ZY	0	-	0	0	309	0.0000000
zheyou73v0_A05	5461841	5463487	BnaA05T0095100ZY	0	-	0	0	1646	0.0000000
zheyou73v0_A05	5461841	5463487	BnaA05T0095100ZY.1	0	-	0	0	1646	0.0000000
zheyou73v0_A05	5461841	5463487	BnaA05T0095100ZY.2	0	-	0	0	1646	0.0000000
zheyou73v0_A05	5465641	5468084	BnaA05T0095200ZY	0	+	0	0	2443	0.0000000
zheyou73v0_A05	5474591	5477225	BnaA05T0095300ZY	0	+	0	0	2634	0.0000000
zheyou73v0_A05	5479590	5480539	BnaA05T0095400ZY	0	-	0	0	949	0.0000000
zheyou73v0_A05	5486306	5488129	BnaA05T0095500ZY	0	-	0	0	1823	0.0000000
zheyou73v0_A05	5502258	5505799	BnaA05T0095600ZY	0	+	0	0	3541	0.0000000
zheyou73v0_A05	5506181	5511217	BnaA05T0095700ZY	0	-	0	0	5036	0.0000000
zheyou73v0_A05	5512954	5525504	BnaA05T0095800ZY	0	-	0	0	12550	0.0000000
zheyou73v0_A05	5533157	5535594	BnaA05T0095900ZY	0	+	0	0	2437	0.0000000
zheyou73v0_A05	5533157	5535594	BnaA05T0095900ZY.1	0	+	0	0	2437	0.0000000
zheyou73v0_A05	5536282	5539257	BnaA05T0096000ZY	0	+	0	0	2975	0.0000000
zheyou73v0_A05	5540883	5542406	BnaA05T0096100ZY	0	+	0	0	1523	0.0000000
zheyou73v0_A05	5549717	5554310	BnaA05T0096200ZY	0	+	0	0	4593	0.0000000
zheyou73v0_A05	5555460	5556940	BnaA05T0096300ZY	0	+	0	0	1480	0.0000000
zheyou73v0_A05	5564842	5565888	BnaA05T0096400ZY	0	+	0	0	1046	0.0000000
zheyou73v0_A05	5565954	5566467	BnaA05T0096500ZY	0	+	0	0	513	0.0000000
zheyou73v0_A05	5567346	5569247	BnaA05T0096600ZY	0	+	0	0	1901	0.0000000
zheyou73v0_A05	5584163	5586361	BnaA05T0096700ZY	0	-	0	0	2198	0.0000000
zheyou73v0_A05	5593569	5594619	BnaA05T0096800ZY	0	-	0	0	1050	0.0000000
zheyou73v0_A05	5598017	5606859	BnaA05T0096900ZY	0	-	0	0	8842	0.0000000
zheyou73v0_A05	5598017	5606236	BnaA05T0096900ZY.1	0	-	0	0	8219	0.0000000
zheyou73v0_A05	5598017	5606629	BnaA05T0096900ZY.3	0	-	0	0	8612	0.0000000
zheyou73v0_A05	5598377	5606236	BnaA05T0096900ZY.2	0	-	0	0	7859	0.0000000
zheyou73v0_A05	5638049	5639960	BnaA05T0097000ZY	0	+	0	0	1911	0.0000000
zheyou73v0_A05	5651055	5653554	BnaA05T0097100ZY	0	+	0	0	2499	0.0000000
zheyou73v0_A05	5653972	5659131	BnaA05T0097200ZY	0	-	0	0	5159	0.0000000
zheyou73v0_A05	5660144	5660969	BnaA05T0097300ZY	0	-	0	0	825	0.0000000
zheyou73v0_A05	5663558	5664114	BnaA05T0097400ZY	0	-	0	0	556	0.0000000
zheyou73v0_A05	5672460	5673928	BnaA05T0097500ZY	0	+	0	0	1468	0.0000000
zheyou73v0_A05	5674252	5701712	BnaA05T0097600ZY	0	+	0	0	27460	0.0000000
zheyou73v0_A05	5701848	5704489	BnaA05T0097700ZY	0	-	0	0	2641	0.0000000
zheyou73v0_A05	5701848	5704489	BnaA05T0097700ZY.1	0	-	0	0	2641	0.0000000
zheyou73v0_A05	5705317	5707048	BnaA05T0097800ZY	0	-	0	0	1731	0.0000000
zheyou73v0_A05	5713175	5714980	BnaA05T0097900ZY	0	-	0	0	1805	0.0000000
zheyou73v0_A05	5715596	5716859	BnaA05T0098000ZY	0	+	0	0	1263	0.0000000
zheyou73v0_A05	5717627	5718541	BnaA05T0098100ZY	0	+	0	0	914	0.0000000
zheyou73v0_A05	5719412	5722668	BnaA05T0098200ZY	0	+	0	0	3256	0.0000000
zheyou73v0_A05	5720664	5722668	BnaA05T0098200ZY.1	0	+	0	0	2004	0.0000000
zheyou73v0_A05	5728612	5730226	BnaA05T0098300ZY	0	+	0	0	1614	0.0000000
zheyou73v0_A05	5732600	5734650	BnaA05T0098400ZY	0	-	0	0	2050	0.0000000
zheyou73v0_A05	5736632	5737157	BnaA05T0098500ZY	0	+	0	0	525	0.0000000
zheyou73v0_A05	5737738	5738185	BnaA05T0098600ZY	0	-	0	0	447	0.0000000
zheyou73v0_A05	5741256	5742641	BnaA05T0098700ZY	0	-	0	0	1385	0.0000000
zheyou73v0_A05	5743273	5744473	BnaA05T0098800ZY	0	+	0	0	1200	0.0000000
zheyou73v0_A05	5745092	5745851	BnaA05T0098900ZY	0	-	0	0	759	0.0000000
zheyou73v0_A05	5746005	5748829	BnaA05T0099000ZY	0	-	0	0	2824	0.0000000
zheyou73v0_A05	5746005	5748829	BnaA05T0099000ZY.1	0	-	0	0	2824	0.0000000
zheyou73v0_A05	5752455	5753783	BnaA05T0099100ZY	0	+	0	0	1328	0.0000000
zheyou73v0_A05	5755532	5759397	BnaA05T0099200ZY	0	+	0	0	3865	0.0000000
zheyou73v0_A05	5767503	5768827	BnaA05T0099300ZY	0	+	0	0	1324	0.0000000
zheyou73v0_A05	5771816	5775929	BnaA05T0099400ZY	0	-	0	0	4113	0.0000000
zheyou73v0_A05	5779654	5785884	BnaA05T0099500ZY	0	-	0	0	6230	0.0000000
zheyou73v0_A05	5786136	5790390	BnaA05T0099600ZY	0	-	0	0	4254	0.0000000
zheyou73v0_A05	5799606	5800395	BnaA05T0099700ZY	0	+	0	0	789	0.0000000
zheyou73v0_A05	5803389	5804463	BnaA05T0099800ZY	0	+	0	0	1074	0.0000000
zheyou73v0_A05	5805646	5809137	BnaA05T0099900ZY	0	+	0	0	3491	0.0000000
zheyou73v0_A05	5809298	5811555	BnaA05T0100000ZY	0	-	0	0	2257	0.0000000
zheyou73v0_A05	5812090	5813263	BnaA05T0100100ZY	0	+	0	0	1173	0.0000000
zheyou73v0_A05	5813635	5815807	BnaA05T0100200ZY	0	-	0	0	2172	0.0000000
zheyou73v0_A05	5818231	5818468	BnaA05T0100300ZY	0	-	0	0	237	0.0000000
zheyou73v0_A05	5824788	5838868	BnaA05T0100400ZY	0	-	0	0	14080	0.0000000
zheyou73v0_A05	5839425	5840709	BnaA05T0100500ZY	0	-	0	0	1284	0.0000000
zheyou73v0_A05	5841508	5844299	BnaA05T0100600ZY	0	-	0	0	2791	0.0000000
zheyou73v0_A05	5841508	5844299	BnaA05T0100600ZY.1	0	-	0	0	2791	0.0000000
zheyou73v0_A05	5855145	5856606	BnaA05T0100700ZY	0	+	0	0	1461	0.0000000
zheyou73v0_A05	5862207	5863686	BnaA05T0100800ZY	0	+	0	0	1479	0.0000000
zheyou73v0_A05	5864283	5866023	BnaA05T0100900ZY	0	-	0	0	1740	0.0000000
zheyou73v0_A05	5866991	5868008	BnaA05T0101000ZY	0	-	0	0	1017	0.0000000
zheyou73v0_A05	5873245	5878521	BnaA05T0101100ZY	0	+	0	0	5276	0.0000000
zheyou73v0_A05	5878545	5880189	BnaA05T0101200ZY	0	-	0	0	1644	0.0000000
zheyou73v0_A05	5878545	5880189	BnaA05T0101200ZY.1	0	-	0	0	1644	0.0000000
zheyou73v0_A05	5883072	5885184	BnaA05T0101300ZY	0	+	0	0	2112	0.0000000
zheyou73v0_A05	5888801	5891457	BnaA05T0101400ZY	0	+	0	0	2656	0.0000000
zheyou73v0_A05	5894705	5895934	BnaA05T0101500ZY	0	+	0	0	1229	0.0000000
zheyou73v0_A05	5904142	5907305	BnaA05T0101600ZY	0	+	0	0	3163	0.0000000
zheyou73v0_A05	5915012	5917657	BnaA05T0101700ZY	0	+	0	0	2645	0.0000000
zheyou73v0_A05	5918357	5920311	BnaA05T0101800ZY	0	-	0	0	1954	0.0000000
zheyou73v0_A05	5922387	5923716	BnaA05T0101900ZY	0	+	0	0	1329	0.0000000
zheyou73v0_A05	5924014	5926381	BnaA05T0102000ZY	0	+	0	0	2367	0.0000000
zheyou73v0_A05	5927708	5929872	BnaA05T0102100ZY	0	-	0	0	2164	0.0000000
zheyou73v0_A05	5944682	5946650	BnaA05T0102200ZY	0	+	0	0	1968	0.0000000
zheyou73v0_A05	5944682	5946650	BnaA05T0102200ZY.1	0	+	0	0	1968	0.0000000
zheyou73v0_A05	5944682	5946650	BnaA05T0102200ZY.3	0	+	0	0	1968	0.0000000
zheyou73v0_A05	5945232	5946650	BnaA05T0102200ZY.2	0	+	0	0	1418	0.0000000
zheyou73v0_A05	5947844	5950095	BnaA05T0102300ZY	0	+	0	0	2251	0.0000000
zheyou73v0_A05	5968678	5970256	BnaA05T0102400ZY	0	+	0	0	1578	0.0000000
zheyou73v0_A05	5997740	6000852	BnaA05T0102500ZY	0	+	0	0	3112	0.0000000
zheyou73v0_A05	6001511	6001980	BnaA05T0102600ZY	0	+	0	0	469	0.0000000
zheyou73v0_A05	6002934	6004015	BnaA05T0102700ZY	0	-	0	0	1081	0.0000000
zheyou73v0_A05	6005453	6008552	BnaA05T0102800ZY	0	+	0	0	3099	0.0000000
zheyou73v0_A05	6010060	6010751	BnaA05T0102900ZY	0	+	0	0	691	0.0000000
zheyou73v0_A05	6013945	6014689	BnaA05T0103000ZY	0	-	0	0	744	0.0000000
zheyou73v0_A05	6026771	6027640	BnaA05T0103100ZY	0	-	0	0	869	0.0000000
zheyou73v0_A05	6045307	6046272	BnaA05T0103200ZY	0	-	0	0	965	0.0000000
zheyou73v0_A05	6076505	6076972	BnaA05T0103300ZY	0	-	0	0	467	0.0000000
zheyou73v0_A05	6229710	6231226	BnaA05T0103400ZY	0	-	0	0	1516	0.0000000
zheyou73v0_A05	6324765	6327206	BnaA05T0103500ZY	0	-	0	0	2441	0.0000000
zheyou73v0_A05	6513078	6513545	BnaA05T0103600ZY	0	+	0	0	467	0.0000000
zheyou73v0_A05	6514202	6514941	BnaA05T0103700ZY	0	-	0	0	739	0.0000000
zheyou73v0_A05	6524295	6524499	BnaA05T0103800ZY	0	-	0	0	204	0.0000000
zheyou73v0_A05	6862934	6863732	BnaA05T0103900ZY	0	+	0	0	798	0.0000000
zheyou73v0_A05	6869513	6870375	BnaA05T0104000ZY	0	-	0	0	862	0.0000000
zheyou73v0_A05	6883583	6884772	BnaA05T0104100ZY	0	+	0	0	1189	0.0000000
zheyou73v0_A05	6884830	6886302	BnaA05T0104200ZY	0	-	0	0	1472	0.0000000
zheyou73v0_A05	6886482	6887559	BnaA05T0104300ZY	0	+	0	0	1077	0.0000000
zheyou73v0_A05	6887837	6888404	BnaA05T0104400ZY	0	-	0	0	567	0.0000000
zheyou73v0_A05	6889042	6889492	BnaA05T0104500ZY	0	+	0	0	450	0.0000000
zheyou73v0_A05	6895796	6896291	BnaA05T0104600ZY	0	+	0	0	495	0.0000000
zheyou73v0_A05	6899073	6900377	BnaA05T0104700ZY	0	+	0	0	1304	0.0000000
zheyou73v0_A05	6901500	6903796	BnaA05T0104800ZY	0	-	0	0	2296	0.0000000
zheyou73v0_A05	6901500	6903796	BnaA05T0104800ZY.1	0	-	0	0	2296	0.0000000
zheyou73v0_A05	6901500	6903796	BnaA05T0104800ZY.2	0	-	0	0	2296	0.0000000
zheyou73v0_A05	6901500	6903796	BnaA05T0104800ZY.3	0	-	0	0	2296	0.0000000
zheyou73v0_A05	6905132	6908130	BnaA05T0104900ZY	0	-	0	0	2998	0.0000000
zheyou73v0_A05	6912371	6914259	BnaA05T0105000ZY	0	+	0	0	1888	0.0000000
zheyou73v0_A05	6914624	6916450	BnaA05T0105100ZY	0	-	0	0	1826	0.0000000
zheyou73v0_A05	6940552	6942532	BnaA05T0105200ZY	0	+	0	0	1980	0.0000000
zheyou73v0_A05	6943947	6945404	BnaA05T0105300ZY	0	+	0	0	1457	0.0000000
zheyou73v0_A05	6949317	6953881	BnaA05T0105400ZY	0	+	0	0	4564	0.0000000
zheyou73v0_A05	6957800	6960464	BnaA05T0105500ZY	0	+	0	0	2664	0.0000000
zheyou73v0_A05	6960932	6961689	BnaA05T0105600ZY	0	-	0	0	757	0.0000000
zheyou73v0_A05	6962284	6963443	BnaA05T0105700ZY	0	-	0	0	1159	0.0000000
zheyou73v0_A05	6973727	6973910	BnaA05T0105800ZY	0	-	0	0	183	0.0000000
zheyou73v0_A05	6974402	6974835	BnaA05T0105900ZY	0	+	0	0	433	0.0000000
zheyou73v0_A05	6977068	6981010	BnaA05T0106000ZY	0	-	0	0	3942	0.0000000
zheyou73v0_A05	6982150	6983373	BnaA05T0106100ZY	0	-	0	0	1223	0.0000000
zheyou73v0_A05	6982150	6983373	BnaA05T0106100ZY.1	0	-	0	0	1223	0.0000000
zheyou73v0_A05	6986217	6987706	BnaA05T0106200ZY	0	+	0	0	1489	0.0000000
zheyou73v0_A05	6988414	6989780	BnaA05T0106300ZY	0	+	0	0	1366	0.0000000
zheyou73v0_A05	6990292	6992102	BnaA05T0106400ZY	0	-	0	0	1810	0.0000000
zheyou73v0_A05	6993057	6994460	BnaA05T0106500ZY	0	-	0	0	1403	0.0000000
zheyou73v0_A05	6997251	6998412	BnaA05T0106600ZY	0	+	0	0	1161	0.0000000
zheyou73v0_A05	6998450	7000010	BnaA05T0106700ZY	0	-	0	0	1560	0.0000000
zheyou73v0_A05	6998450	6999639	BnaA05T0106700ZY.1	0	-	0	0	1189	0.0000000
zheyou73v0_A05	7002749	7005634	BnaA05T0106800ZY	0	+	0	0	2885	0.0000000
zheyou73v0_A05	7002749	7005634	BnaA05T0106800ZY.1	0	+	0	0	2885	0.0000000
zheyou73v0_A05	7002749	7005634	BnaA05T0106800ZY.2	0	+	0	0	2885	0.0000000
zheyou73v0_A05	7002749	7005634	BnaA05T0106800ZY.3	0	+	0	0	2885	0.0000000
zheyou73v0_A05	7007232	7008704	BnaA05T0106900ZY	0	+	0	0	1472	0.0000000
zheyou73v0_A05	7008388	7011590	BnaA05T0107000ZY	0	-	0	0	3202	0.0000000
zheyou73v0_A05	7018550	7020251	BnaA05T0107100ZY	0	-	0	0	1701	0.0000000
zheyou73v0_A05	7029314	7030017	BnaA05T0107200ZY	0	+	0	0	703	0.0000000
zheyou73v0_A05	7036784	7041918	BnaA05T0107300ZY	0	+	0	0	5134	0.0000000
zheyou73v0_A05	7042681	7045263	BnaA05T0107400ZY	0	+	0	0	2582	0.0000000
zheyou73v0_A05	7047932	7049618	BnaA05T0107500ZY	0	+	0	0	1686	0.0000000
zheyou73v0_A05	7050991	7051341	BnaA05T0107600ZY	0	-	0	0	350	0.0000000
zheyou73v0_A05	7058259	7059320	BnaA05T0107700ZY	0	+	0	0	1061	0.0000000
zheyou73v0_A05	7061283	7063197	BnaA05T0107800ZY	0	-	0	0	1914	0.0000000
zheyou73v0_A05	7071666	7073485	BnaA05T0107900ZY	0	-	0	0	1819	0.0000000
zheyou73v0_A05	7078977	7081099	BnaA05T0108000ZY	0	+	0	0	2122	0.0000000
zheyou73v0_A05	7078977	7080734	BnaA05T0108000ZY.1	0	+	0	0	1757	0.0000000
zheyou73v0_A05	7081632	7090944	BnaA05T0108100ZY	0	+	0	0	9312	0.0000000
zheyou73v0_A05	7086803	7090944	BnaA05T0108100ZY.1	0	+	0	0	4141	0.0000000
zheyou73v0_A05	7101159	7102856	BnaA05T0108200ZY	0	+	0	0	1697	0.0000000
zheyou73v0_A05	7105093	7108767	BnaA05T0108300ZY	0	+	0	0	3674	0.0000000
zheyou73v0_A05	7109815	7110934	BnaA05T0108400ZY	0	-	0	0	1119	0.0000000
zheyou73v0_A05	7113797	7119282	BnaA05T0108500ZY	0	-	0	0	5485	0.0000000
zheyou73v0_A05	7118391	7128851	BnaA05T0108600ZY	0	-	0	0	10460	0.0000000
zheyou73v0_A05	7132776	7148268	BnaA05T0108700ZY	0	-	0	0	15492	0.0000000
zheyou73v0_A05	7168824	7172209	BnaA05T0108800ZY	0	+	0	0	3385	0.0000000
zheyou73v0_A05	7174513	7177623	BnaA05T0108900ZY	0	+	0	0	3110	0.0000000
zheyou73v0_A05	7174513	7177623	BnaA05T0108900ZY.1	0	+	0	0	3110	0.0000000
zheyou73v0_A05	7174513	7177623	BnaA05T0108900ZY.2	0	+	0	0	3110	0.0000000
zheyou73v0_A05	7179002	7179748	BnaA05T0109000ZY	0	+	0	0	746	0.0000000
zheyou73v0_A05	7181015	7185299	BnaA05T0109100ZY	0	+	0	0	4284	0.0000000
zheyou73v0_A05	7191291	7193229	BnaA05T0109200ZY	0	-	0	0	1938	0.0000000
zheyou73v0_A05	7216755	7218418	BnaA05T0109300ZY	0	+	0	0	1663	0.0000000
zheyou73v0_A05	7218852	7219954	BnaA05T0109400ZY	0	-	0	0	1102	0.0000000
zheyou73v0_A05	7224990	7226562	BnaA05T0109500ZY	0	-	0	0	1572	0.0000000
zheyou73v0_A05	7238651	7240958	BnaA05T0109600ZY	0	-	0	0	2307	0.0000000
zheyou73v0_A05	7245657	7248452	BnaA05T0109700ZY	0	-	0	0	2795	0.0000000
zheyou73v0_A05	7248974	7252339	BnaA05T0109800ZY	0	-	0	0	3365	0.0000000
zheyou73v0_A05	7259115	7263326	BnaA05T0109900ZY	0	+	0	0	4211	0.0000000
zheyou73v0_A05	7262479	7265402	BnaA05T0110000ZY	0	-	0	0	2923	0.0000000
zheyou73v0_A05	7262479	7265402	BnaA05T0110000ZY.1	0	-	0	0	2923	0.0000000
zheyou73v0_A05	7267121	7267551	BnaA05T0110100ZY	0	+	0	0	430	0.0000000
zheyou73v0_A05	7278364	7281765	BnaA05T0110200ZY.1	0	-	0	0	3401	0.0000000
zheyou73v0_A05	7278377	7281765	BnaA05T0110200ZY	0	-	0	0	3388	0.0000000
zheyou73v0_A05	7313083	7316812	BnaA05T0110300ZY	0	-	0	0	3729	0.0000000
zheyou73v0_A05	7313083	7316812	BnaA05T0110300ZY.1	0	-	0	0	3729	0.0000000
zheyou73v0_A05	7317948	7318824	BnaA05T0110400ZY	0	+	0	0	876	0.0000000
zheyou73v0_A05	7326523	7328880	BnaA05T0110500ZY	0	+	0	0	2357	0.0000000
zheyou73v0_A05	7335903	7337580	BnaA05T0110600ZY	0	+	0	0	1677	0.0000000
zheyou73v0_A05	7335951	7336377	BnaA05T0110700ZY	0	-	0	0	426	0.0000000
zheyou73v0_A05	7343104	7346021	BnaA05T0110800ZY	0	+	0	0	2917	0.0000000
zheyou73v0_A05	7346414	7349963	BnaA05T0110900ZY	0	-	0	0	3549	0.0000000
zheyou73v0_A05	7351662	7352007	BnaA05T0111000ZY	0	-	0	0	345	0.0000000
zheyou73v0_A05	7352730	7353124	BnaA05T0111100ZY	0	+	0	0	394	0.0000000
zheyou73v0_A05	7353923	7363822	BnaA05T0111200ZY	0	-	0	0	9899	0.0000000
zheyou73v0_A05	7371471	7375051	BnaA05T0111300ZY	0	-	0	0	3580	0.0000000
zheyou73v0_A05	7377741	7381006	BnaA05T0111400ZY	0	+	0	0	3265	0.0000000
zheyou73v0_A05	7381603	7383501	BnaA05T0111500ZY	0	+	0	0	1898	0.0000000
zheyou73v0_A05	7385802	7387669	BnaA05T0111600ZY	0	-	0	0	1867	0.0000000
zheyou73v0_A05	7408939	7410566	BnaA05T0111700ZY	0	+	0	0	1627	0.0000000
zheyou73v0_A05	7411792	7413919	BnaA05T0111800ZY	0	-	0	0	2127	0.0000000
zheyou73v0_A05	7417357	7421898	BnaA05T0111900ZY	0	-	0	0	4541	0.0000000
zheyou73v0_A05	7417357	7421824	BnaA05T0111900ZY.1	0	-	0	0	4467	0.0000000
zheyou73v0_A05	7417357	7421751	BnaA05T0111900ZY.2	0	-	0	0	4394	0.0000000
zheyou73v0_A05	7430486	7431413	BnaA05T0112000ZY	0	-	0	0	927	0.0000000
zheyou73v0_A05	7439887	7440841	BnaA05T0112100ZY	0	-	0	0	954	0.0000000
zheyou73v0_A05	7447162	7451209	BnaA05T0112200ZY	0	-	0	0	4047	0.0000000
zheyou73v0_A05	7452746	7453481	BnaA05T0112300ZY	0	+	0	0	735	0.0000000
zheyou73v0_A05	7452746	7453481	BnaA05T0112300ZY.1	0	+	0	0	735	0.0000000
zheyou73v0_A05	7453550	7456320	BnaA05T0112400ZY	0	-	0	0	2770	0.0000000
zheyou73v0_A05	7453550	7456320	BnaA05T0112400ZY.1	0	-	0	0	2770	0.0000000
zheyou73v0_A05	7456626	7457866	BnaA05T0112500ZY	0	-	0	0	1240	0.0000000
zheyou73v0_A05	7458060	7465145	BnaA05T0112600ZY	0	-	0	0	7085	0.0000000
zheyou73v0_A05	7458060	7463861	BnaA05T0112600ZY.1	0	-	0	0	5801	0.0000000
zheyou73v0_A05	7466568	7469525	BnaA05T0112700ZY	0	-	0	0	2957	0.0000000
zheyou73v0_A05	7481920	7484602	BnaA05T0112800ZY	0	+	0	0	2682	0.0000000
zheyou73v0_A05	7494012	7496249	BnaA05T0112900ZY	0	+	0	0	2237	0.0000000
zheyou73v0_A05	7508169	7508588	BnaA05T0113000ZY	0	-	0	0	419	0.0000000
zheyou73v0_A05	7514723	7515549	BnaA05T0113100ZY	0	+	0	0	826	0.0000000
zheyou73v0_A05	7517060	7519560	BnaA05T0113200ZY	0	-	0	0	2500	0.0000000
zheyou73v0_A05	7520805	7521958	BnaA05T0113300ZY	0	-	0	0	1153	0.0000000
zheyou73v0_A05	7523438	7524185	BnaA05T0113400ZY	0	+	0	0	747	0.0000000
zheyou73v0_A05	7527318	7529031	BnaA05T0113500ZY	0	+	0	0	1713	0.0000000
zheyou73v0_A05	7530298	7531092	BnaA05T0113600ZY	0	+	0	0	794	0.0000000
zheyou73v0_A05	7537050	7537233	BnaA05T0113700ZY	0	-	0	0	183	0.0000000
zheyou73v0_A05	7550701	7554573	BnaA05T0113800ZY	0	+	0	0	3872	0.0000000
zheyou73v0_A05	7555020	7562939	BnaA05T0113900ZY	0	-	0	0	7919	0.0000000
zheyou73v0_A05	7566506	7569933	BnaA05T0114000ZY	0	+	0	0	3427	0.0000000
zheyou73v0_A05	7570104	7581744	BnaA05T0114100ZY	0	-	0	0	11640	0.0000000
zheyou73v0_A05	7591399	7591675	BnaA05T0114200ZY	0	+	0	0	276	0.0000000
zheyou73v0_A05	7595289	7597008	BnaA05T0114300ZY	0	+	0	0	1719	0.0000000
zheyou73v0_A05	7599551	7601734	BnaA05T0114400ZY	0	+	0	0	2183	0.0000000
zheyou73v0_A05	7605572	7607613	BnaA05T0114500ZY	0	-	0	0	2041	0.0000000
zheyou73v0_A05	7617078	7618829	BnaA05T0114600ZY	0	-	0	0	1751	0.0000000
zheyou73v0_A05	7620723	7622188	BnaA05T0114700ZY	0	-	0	0	1465	0.0000000
zheyou73v0_A05	7637609	7639127	BnaA05T0114800ZY	0	-	0	0	1518	0.0000000
zheyou73v0_A05	7643134	7646458	BnaA05T0114900ZY	0	+	0	0	3324	0.0000000
zheyou73v0_A05	7649195	7653240	BnaA05T0115000ZY	0	+	0	0	4045	0.0000000
zheyou73v0_A05	7653381	7654601	BnaA05T0115100ZY	0	+	0	0	1220	0.0000000
zheyou73v0_A05	7654865	7658466	BnaA05T0115200ZY	0	-	0	0	3601	0.0000000
zheyou73v0_A05	7658914	7660883	BnaA05T0115300ZY	0	-	0	0	1969	0.0000000
zheyou73v0_A05	7665045	7665949	BnaA05T0115400ZY	0	+	0	0	904	0.0000000
zheyou73v0_A05	7669226	7670708	BnaA05T0115500ZY	0	+	0	0	1482	0.0000000
zheyou73v0_A05	7670735	7671524	BnaA05T0115600ZY	0	+	0	0	789	0.0000000
zheyou73v0_A05	7674073	7675963	BnaA05T0115700ZY	0	-	0	0	1890	0.0000000
zheyou73v0_A05	7674073	7675963	BnaA05T0115700ZY.1	0	-	0	0	1890	0.0000000
zheyou73v0_A05	7674073	7675963	BnaA05T0115700ZY.2	0	-	0	0	1890	0.0000000
zheyou73v0_A05	7678747	7681343	BnaA05T0115800ZY	0	+	0	0	2596	0.0000000
zheyou73v0_A05	7694543	7695646	BnaA05T0115900ZY	0	-	0	0	1103	0.0000000
zheyou73v0_A05	7697567	7698729	BnaA05T0116000ZY	0	-	0	0	1162	0.0000000
zheyou73v0_A05	7697567	7698729	BnaA05T0116000ZY.1	0	-	0	0	1162	0.0000000
zheyou73v0_A05	7698115	7698729	BnaA05T0116000ZY.2	0	-	0	0	614	0.0000000
zheyou73v0_A05	7699109	7701362	BnaA05T0116100ZY	0	+	0	0	2253	0.0000000
zheyou73v0_A05	7702166	7703264	BnaA05T0116200ZY	0	+	0	0	1098	0.0000000
zheyou73v0_A05	7704066	7706969	BnaA05T0116300ZY	0	+	0	0	2903	0.0000000
zheyou73v0_A05	7709818	7710935	BnaA05T0116400ZY	0	+	0	0	1117	0.0000000
zheyou73v0_A05	7717602	7719937	BnaA05T0116500ZY	0	-	0	0	2335	0.0000000
zheyou73v0_A05	7728365	7729043	BnaA05T0116600ZY	0	+	0	0	678	0.0000000
zheyou73v0_A05	7738752	7739499	BnaA05T0116700ZY	0	+	0	0	747	0.0000000
zheyou73v0_A05	7751518	7757822	BnaA05T0116800ZY	0	+	0	0	6304	0.0000000
zheyou73v0_A05	7762283	7762796	BnaA05T0116900ZY	0	+	0	0	513	0.0000000
zheyou73v0_A05	7763276	7773238	BnaA05T0117000ZY	0	-	0	0	9962	0.0000000
zheyou73v0_A05	7781535	7782118	BnaA05T0117100ZY	0	-	0	0	583	0.0000000
zheyou73v0_A05	7784066	7784576	BnaA05T0117200ZY	0	-	0	0	510	0.0000000
zheyou73v0_A05	7796411	7796728	BnaA05T0117300ZY	0	-	0	0	317	0.0000000
zheyou73v0_A05	7797615	7798885	BnaA05T0117400ZY	0	+	0	0	1270	0.0000000
zheyou73v0_A05	7803065	7805926	BnaA05T0117500ZY	0	-	0	0	2861	0.0000000
zheyou73v0_A05	7811773	7812826	BnaA05T0117600ZY	0	+	0	0	1053	0.0000000
zheyou73v0_A05	7817270	7818673	BnaA05T0117700ZY	0	-	0	0	1403	0.0000000
zheyou73v0_A05	7821534	7821894	BnaA05T0117800ZY	0	-	0	0	360	0.0000000
zheyou73v0_A05	7822076	7824450	BnaA05T0117900ZY	0	-	0	0	2374	0.0000000
zheyou73v0_A05	7828228	7828902	BnaA05T0118000ZY	0	-	0	0	674	0.0000000
zheyou73v0_A05	7832497	7834603	BnaA05T0118100ZY	0	+	0	0	2106	0.0000000
zheyou73v0_A05	7839031	7839976	BnaA05T0118200ZY	0	-	0	0	945	0.0000000
zheyou73v0_A05	7846888	7855390	BnaA05T0118300ZY	0	+	0	0	8502	0.0000000
zheyou73v0_A05	7855769	7860324	BnaA05T0118400ZY	0	+	0	0	4555	0.0000000
zheyou73v0_A05	7860601	7863178	BnaA05T0118500ZY	0	-	0	0	2577	0.0000000
zheyou73v0_A05	7860601	7863188	BnaA05T0118500ZY.1	0	-	0	0	2587	0.0000000
zheyou73v0_A05	7867472	7871467	BnaA05T0118600ZY	0	-	0	0	3995	0.0000000
zheyou73v0_A05	7874100	7876608	BnaA05T0118700ZY	0	-	0	0	2508	0.0000000
zheyou73v0_A05	7879603	7881582	BnaA05T0118800ZY	0	-	0	0	1979	0.0000000
zheyou73v0_A05	7883099	7887051	BnaA05T0118900ZY	0	+	0	0	3952	0.0000000
zheyou73v0_A05	7898530	7900485	BnaA05T0119000ZY	0	+	0	0	1955	0.0000000
zheyou73v0_A05	7898530	7900485	BnaA05T0119000ZY.1	0	+	0	0	1955	0.0000000
zheyou73v0_A05	7898530	7900149	BnaA05T0119000ZY.2	0	+	0	0	1619	0.0000000
zheyou73v0_A05	7900720	7901799	BnaA05T0119100ZY	0	+	0	0	1079	0.0000000
zheyou73v0_A05	7916842	7917367	BnaA05T0119200ZY	0	+	0	0	525	0.0000000
zheyou73v0_A05	7919125	7920349	BnaA05T0119300ZY	0	+	0	0	1224	0.0000000
zheyou73v0_A05	7921121	7922770	BnaA05T0119400ZY	0	+	0	0	1649	0.0000000
zheyou73v0_A05	7933729	7934509	BnaA05T0119500ZY	0	+	0	0	780	0.0000000
zheyou73v0_A05	7934597	7937414	BnaA05T0119600ZY	0	+	0	0	2817	0.0000000
zheyou73v0_A05	7938165	7938713	BnaA05T0119700ZY	0	-	0	0	548	0.0000000
zheyou73v0_A05	7942565	7944311	BnaA05T0119800ZY	0	+	0	0	1746	0.0000000
zheyou73v0_A05	7944893	7951346	BnaA05T0119900ZY	0	-	0	0	6453	0.0000000
zheyou73v0_A05	7954504	7955368	BnaA05T0120000ZY	0	+	0	0	864	0.0000000
zheyou73v0_A05	7957073	7957907	BnaA05T0120100ZY	0	+	0	0	834	0.0000000
zheyou73v0_A05	7958616	7962449	BnaA05T0120200ZY	0	-	0	0	3833	0.0000000
zheyou73v0_A05	7993144	7993969	BnaA05T0120300ZY	0	-	0	0	825	0.0000000
zheyou73v0_A05	7996082	7996600	BnaA05T0120400ZY	0	-	0	0	518	0.0000000
zheyou73v0_A05	7998390	7998942	BnaA05T0120500ZY	0	-	0	0	552	0.0000000
zheyou73v0_A05	8000603	8001124	BnaA05T0120600ZY	0	-	0	0	521	0.0000000
zheyou73v0_A05	8001633	8001825	BnaA05T0120700ZY	0	-	0	0	192	0.0000000
zheyou73v0_A05	8006863	8007470	BnaA05T0120800ZY	0	-	0	0	607	0.0000000
zheyou73v0_A05	8009042	8009640	BnaA05T0120900ZY	0	-	0	0	598	0.0000000
zheyou73v0_A05	8011246	8011840	BnaA05T0121000ZY	0	-	0	0	594	0.0000000
zheyou73v0_A05	8013505	8014026	BnaA05T0121100ZY	0	-	0	0	521	0.0000000
zheyou73v0_A05	8014930	8015537	BnaA05T0121200ZY	0	-	0	0	607	0.0000000
zheyou73v0_A05	8017191	8017712	BnaA05T0121300ZY	0	-	0	0	521	0.0000000
zheyou73v0_A05	8018689	8019211	BnaA05T0121400ZY	0	-	0	0	522	0.0000000
zheyou73v0_A05	8020862	8022896	BnaA05T0121500ZY	0	-	0	0	2034	0.0000000
zheyou73v0_A05	8030494	8031181	BnaA05T0121600ZY	0	-	0	0	687	0.0000000
zheyou73v0_A05	8041831	8042955	BnaA05T0121700ZY	0	+	0	0	1124	0.0000000
zheyou73v0_A05	8043366	8045041	BnaA05T0121800ZY	0	+	0	0	1675	0.0000000
zheyou73v0_A05	8049671	8050712	BnaA05T0121900ZY	0	-	0	0	1041	0.0000000
zheyou73v0_A05	8053748	8054298	BnaA05T0122000ZY	0	+	0	0	550	0.0000000
zheyou73v0_A05	8056469	8058098	BnaA05T0122100ZY	0	+	0	0	1629	0.0000000
zheyou73v0_A05	8074544	8075669	BnaA05T0122200ZY	0	-	0	0	1125	0.0000000
zheyou73v0_A05	8076956	8078958	BnaA05T0122300ZY	0	+	0	0	2002	0.0000000
zheyou73v0_A05	8084622	8087068	BnaA05T0122400ZY	0	-	0	0	2446	0.0000000
zheyou73v0_A05	8087903	8088803	BnaA05T0122500ZY	0	-	0	0	900	0.0000000
zheyou73v0_A05	8093132	8097733	BnaA05T0122600ZY	0	+	0	0	4601	0.0000000
zheyou73v0_A05	8098280	8099664	BnaA05T0122700ZY	0	+	0	0	1384	0.0000000
zheyou73v0_A05	8100729	8101464	BnaA05T0122800ZY	0	-	0	0	735	0.0000000
zheyou73v0_A05	8109804	8111028	BnaA05T0122900ZY	0	+	0	0	1224	0.0000000
zheyou73v0_A05	8113416	8114007	BnaA05T0123000ZY	0	+	0	0	591	0.0000000
zheyou73v0_A05	8119590	8121799	BnaA05T0123100ZY	0	+	0	0	2209	0.0000000
zheyou73v0_A05	8124692	8126044	BnaA05T0123200ZY	0	+	0	0	1352	0.0000000
zheyou73v0_A05	8127260	8129861	BnaA05T0123300ZY	0	+	0	0	2601	0.0000000
zheyou73v0_A05	8130079	8131126	BnaA05T0123400ZY	0	-	0	0	1047	0.0000000
zheyou73v0_A05	8131732	8133798	BnaA05T0123500ZY	0	-	0	0	2066	0.0000000
zheyou73v0_A05	8136896	8138554	BnaA05T0123600ZY	0	+	0	0	1658	0.0000000
zheyou73v0_A05	8146315	8148200	BnaA05T0123700ZY	0	-	0	0	1885	0.0000000
zheyou73v0_A05	8162429	8166117	BnaA05T0123800ZY	0	-	0	0	3688	0.0000000
zheyou73v0_A05	8166962	8167184	BnaA05T0123900ZY	0	-	0	0	222	0.0000000
zheyou73v0_A05	8171822	8172512	BnaA05T0124000ZY	0	-	0	0	690	0.0000000
zheyou73v0_A05	8173606	8179097	BnaA05T0124100ZY	0	+	0	0	5491	0.0000000
zheyou73v0_A05	8179193	8179871	BnaA05T0124200ZY	0	-	0	0	678	0.0000000
zheyou73v0_A05	8191907	8193359	BnaA05T0124300ZY	0	+	0	0	1452	0.0000000
zheyou73v0_A05	8194008	8194977	BnaA05T0124400ZY	0	-	0	0	969	0.0000000
zheyou73v0_A05	8200669	8201563	BnaA05T0124500ZY	0	+	0	0	894	0.0000000
zheyou73v0_A05	8202176	8202659	BnaA05T0124600ZY	0	+	0	0	483	0.0000000
zheyou73v0_A05	8213384	8214064	BnaA05T0124700ZY	0	-	0	0	680	0.0000000
zheyou73v0_A05	8226084	8227536	BnaA05T0124800ZY	0	+	0	0	1452	0.0000000
zheyou73v0_A05	8228185	8229154	BnaA05T0124900ZY	0	-	0	0	969	0.0000000
zheyou73v0_A05	8234844	8235738	BnaA05T0125000ZY	0	+	0	0	894	0.0000000
zheyou73v0_A05	8236252	8237000	BnaA05T0125100ZY	0	+	0	0	748	0.0000000
zheyou73v0_A05	8244209	8246986	BnaA05T0125200ZY	0	-	0	0	2777	0.0000000
zheyou73v0_A05	8247910	8250276	BnaA05T0125300ZY	0	+	0	0	2366	0.0000000
zheyou73v0_A05	8253028	8254102	BnaA05T0125400ZY	0	-	0	0	1074	0.0000000
zheyou73v0_A05	8258143	8259598	BnaA05T0125500ZY	0	-	0	0	1455	0.0000000
zheyou73v0_A05	8263929	8265065	BnaA05T0125600ZY	0	+	0	0	1136	0.0000000
zheyou73v0_A05	8267206	8268648	BnaA05T0125700ZY	0	+	0	0	1442	0.0000000
zheyou73v0_A05	8272301	8273872	BnaA05T0125800ZY	0	+	0	0	1571	0.0000000
zheyou73v0_A05	8272301	8273872	BnaA05T0125800ZY.1	0	+	0	0	1571	0.0000000
zheyou73v0_A05	8276510	8277531	BnaA05T0125900ZY	0	-	0	0	1021	0.0000000
zheyou73v0_A05	8305001	8308510	BnaA05T0126000ZY	0	-	0	0	3509	0.0000000
zheyou73v0_A05	8326878	8329396	BnaA05T0126100ZY	0	+	0	0	2518	0.0000000
zheyou73v0_A05	8340029	8344990	BnaA05T0126200ZY	0	+	0	0	4961	0.0000000
zheyou73v0_A05	8340029	8344990	BnaA05T0126200ZY.1	0	+	0	0	4961	0.0000000
zheyou73v0_A05	8340029	8344990	BnaA05T0126200ZY.2	0	+	0	0	4961	0.0000000
zheyou73v0_A05	8345325	8346381	BnaA05T0126300ZY	0	+	0	0	1056	0.0000000
zheyou73v0_A05	8347657	8348623	BnaA05T0126400ZY	0	+	0	0	966	0.0000000
zheyou73v0_A05	8349841	8350822	BnaA05T0126500ZY	0	+	0	0	981	0.0000000
zheyou73v0_A05	8351589	8354221	BnaA05T0126600ZY	0	+	0	0	2632	0.0000000
zheyou73v0_A05	8351589	8354221	BnaA05T0126600ZY.1	0	+	0	0	2632	0.0000000
zheyou73v0_A05	8357267	8358753	BnaA05T0126700ZY	0	+	0	0	1486	0.0000000
zheyou73v0_A05	8360573	8361168	BnaA05T0126800ZY	0	-	0	0	595	0.0000000
zheyou73v0_A05	8386837	8388913	BnaA05T0126900ZY	0	+	0	0	2076	0.0000000
zheyou73v0_A05	8391990	8392629	BnaA05T0127000ZY	0	-	0	0	639	0.0000000
zheyou73v0_A05	8405740	8406345	BnaA05T0127100ZY	0	-	0	0	605	0.0000000
zheyou73v0_A05	8422463	8424083	BnaA05T0127200ZY	0	+	0	0	1620	0.0000000
zheyou73v0_A05	8424365	8428486	BnaA05T0127300ZY	0	+	0	0	4121	0.0000000
zheyou73v0_A05	8429694	8432198	BnaA05T0127400ZY	0	-	0	0	2504	0.0000000
zheyou73v0_A05	8429694	8432198	BnaA05T0127400ZY.1	0	-	0	0	2504	0.0000000
zheyou73v0_A05	8433738	8437678	BnaA05T0127500ZY	0	-	0	0	3940	0.0000000
zheyou73v0_A05	8433738	8437678	BnaA05T0127500ZY.1	0	-	0	0	3940	0.0000000
zheyou73v0_A05	8433738	8437678	BnaA05T0127500ZY.2	0	-	0	0	3940	0.0000000
zheyou73v0_A05	8440219	8442006	BnaA05T0127600ZY	0	-	0	0	1787	0.0000000
zheyou73v0_A05	8446466	8447485	BnaA05T0127700ZY	0	-	0	0	1019	0.0000000
zheyou73v0_A05	8466614	8468121	BnaA05T0127800ZY	0	-	0	0	1507	0.0000000
zheyou73v0_A05	8473760	8474674	BnaA05T0127900ZY	0	+	0	0	914	0.0000000
zheyou73v0_A05	8475155	8478008	BnaA05T0128000ZY	0	-	0	0	2853	0.0000000
zheyou73v0_A05	8492129	8505075	BnaA05T0128100ZY	0	+	0	0	12946	0.0000000
zheyou73v0_A05	8505177	8506479	BnaA05T0128200ZY	0	+	0	0	1302	0.0000000
zheyou73v0_A05	8507218	8510072	BnaA05T0128300ZY.1	0	-	0	0	2854	0.0000000
zheyou73v0_A05	8507553	8510072	BnaA05T0128300ZY	0	-	0	0	2519	0.0000000
zheyou73v0_A05	8512301	8515350	BnaA05T0128400ZY	0	-	0	0	3049	0.0000000
zheyou73v0_A05	8519093	8520589	BnaA05T0128500ZY	0	-	0	0	1496	0.0000000
zheyou73v0_A05	8536237	8538595	BnaA05T0128600ZY	0	+	0	0	2358	0.0000000
zheyou73v0_A05	8539532	8540374	BnaA05T0128700ZY	0	-	0	0	842	0.0000000
zheyou73v0_A05	8556407	8557754	BnaA05T0128800ZY	0	-	0	0	1347	0.0000000
zheyou73v0_A05	8570355	8574555	BnaA05T0128900ZY	0	-	0	0	4200	0.0000000
zheyou73v0_A05	8576933	8577628	BnaA05T0129000ZY	0	+	0	0	695	0.0000000
zheyou73v0_A05	8578659	8579014	BnaA05T0129100ZY	0	-	0	0	355	0.0000000
zheyou73v0_A05	8584049	8586152	BnaA05T0129200ZY	0	-	0	0	2103	0.0000000
zheyou73v0_A05	8589154	8592184	BnaA05T0129300ZY	0	+	0	0	3030	0.0000000
zheyou73v0_A05	8589154	8592184	BnaA05T0129300ZY.1	0	+	0	0	3030	0.0000000
zheyou73v0_A05	8592769	8593669	BnaA05T0129400ZY	0	+	0	0	900	0.0000000
zheyou73v0_A05	8595032	8595191	BnaA05T0129500ZY	0	+	0	0	159	0.0000000
zheyou73v0_A05	8614421	8616762	BnaA05T0129600ZY	0	+	0	0	2341	0.0000000
zheyou73v0_A05	8617203	8621844	BnaA05T0129700ZY	0	+	0	0	4641	0.0000000
zheyou73v0_A05	8617203	8621844	BnaA05T0129700ZY.1	0	+	0	0	4641	0.0000000
zheyou73v0_A05	8626540	8627306	BnaA05T0129800ZY	0	-	0	0	766	0.0000000
zheyou73v0_A05	8629655	8633334	BnaA05T0129900ZY	0	+	0	0	3679	0.0000000
zheyou73v0_A05	8634671	8636108	BnaA05T0130000ZY	0	+	0	0	1437	0.0000000
zheyou73v0_A05	8636556	8637209	BnaA05T0130100ZY	0	-	0	0	653	0.0000000
zheyou73v0_A05	8643912	8644931	BnaA05T0130200ZY	0	-	0	0	1019	0.0000000
zheyou73v0_A05	8652691	8653389	BnaA05T0130300ZY	0	+	0	0	698	0.0000000
zheyou73v0_A05	8653882	8655121	BnaA05T0130400ZY	0	-	0	0	1239	0.0000000
zheyou73v0_A05	8660467	8662052	BnaA05T0130500ZY	0	+	0	0	1585	0.0000000
zheyou73v0_A05	8679535	8681721	BnaA05T0130600ZY	0	+	0	0	2186	0.0000000
zheyou73v0_A05	8719144	8719700	BnaA05T0130700ZY	0	-	0	0	556	0.0000000
zheyou73v0_A05	8721372	8723341	BnaA05T0130800ZY	0	-	0	0	1969	0.0000000
zheyou73v0_A05	8727347	8729327	BnaA05T0130900ZY	0	+	0	0	1980	0.0000000
zheyou73v0_A05	8731040	8732482	BnaA05T0131000ZY	0	+	0	0	1442	0.0000000
zheyou73v0_A05	8732854	8734374	BnaA05T0131100ZY	0	+	0	0	1520	0.0000000
zheyou73v0_A05	8739981	8740697	BnaA05T0131200ZY	0	+	0	0	716	0.0000000
zheyou73v0_A05	8760972	8761952	BnaA05T0131300ZY	0	+	0	0	980	0.0000000
zheyou73v0_A05	8769857	8771904	BnaA05T0131400ZY	0	+	0	0	2047	0.0000000
zheyou73v0_A05	8772986	8775061	BnaA05T0131500ZY	0	+	0	0	2075	0.0000000
zheyou73v0_A05	8777649	8783803	BnaA05T0131600ZY	0	+	0	0	6154	0.0000000
zheyou73v0_A05	8785204	8787110	BnaA05T0131700ZY	0	+	0	0	1906	0.0000000
zheyou73v0_A05	8787105	8788823	BnaA05T0131800ZY	0	-	0	0	1718	0.0000000
zheyou73v0_A05	8791106	8792761	BnaA05T0131900ZY	0	-	0	0	1655	0.0000000
zheyou73v0_A05	8796037	8798882	BnaA05T0132000ZY	0	-	0	0	2845	0.0000000
zheyou73v0_A05	8804694	8805813	BnaA05T0132100ZY	0	-	0	0	1119	0.0000000
zheyou73v0_A05	8825982	8826710	BnaA05T0132200ZY	0	-	0	0	728	0.0000000
zheyou73v0_A05	8829598	8834216	BnaA05T0132300ZY	0	+	0	0	4618	0.0000000
zheyou73v0_A05	8842815	8844664	BnaA05T0132400ZY	0	+	0	0	1849	0.0000000
zheyou73v0_A05	8851054	8852850	BnaA05T0132500ZY	0	+	0	0	1796	0.0000000
zheyou73v0_A05	8853053	8856281	BnaA05T0132600ZY	0	-	0	0	3228	0.0000000
zheyou73v0_A05	8871325	8876404	BnaA05T0132700ZY	0	-	0	0	5079	0.0000000
zheyou73v0_A05	8891610	8893127	BnaA05T0132800ZY	0	-	0	0	1517	0.0000000
zheyou73v0_A05	8899913	8904340	BnaA05T0132900ZY	0	-	0	0	4427	0.0000000
zheyou73v0_A05	8936849	8941768	BnaA05T0133000ZY	0	+	0	0	4919	0.0000000
zheyou73v0_A05	8949217	8950011	BnaA05T0133100ZY	0	-	0	0	794	0.0000000
zheyou73v0_A05	8952204	8955694	BnaA05T0133200ZY	0	-	0	0	3490	0.0000000
zheyou73v0_A05	8959802	8962520	BnaA05T0133300ZY	0	-	0	0	2718	0.0000000
zheyou73v0_A05	8968522	8969960	BnaA05T0133400ZY	0	+	0	0	1438	0.0000000
zheyou73v0_A05	8972946	8974673	BnaA05T0133500ZY	0	+	0	0	1727	0.0000000
zheyou73v0_A05	8975512	8976923	BnaA05T0133600ZY	0	-	0	0	1411	0.0000000
zheyou73v0_A05	8988419	8990455	BnaA05T0133700ZY	0	+	0	0	2036	0.0000000
zheyou73v0_A05	8992095	8992461	BnaA05T0133800ZY	0	-	0	0	366	0.0000000
zheyou73v0_A05	8993420	8998246	BnaA05T0133900ZY	0	-	0	0	4826	0.0000000
zheyou73v0_A05	8999599	9001950	BnaA05T0134000ZY	0	-	0	0	2351	0.0000000
zheyou73v0_A05	9009191	9009365	BnaA05T0134100ZY	0	+	0	0	174	0.0000000
zheyou73v0_A05	9012552	9014234	BnaA05T0134200ZY	0	+	0	0	1682	0.0000000
zheyou73v0_A05	9013837	9015264	BnaA05T0134300ZY	0	-	0	0	1427	0.0000000
zheyou73v0_A05	9024998	9025711	BnaA05T0134400ZY	0	-	0	0	713	0.0000000
zheyou73v0_A05	9034871	9036198	BnaA05T0134500ZY	0	+	0	0	1327	0.0000000
zheyou73v0_A05	9036512	9037976	BnaA05T0134600ZY	0	-	0	0	1464	0.0000000
zheyou73v0_A05	9039404	9040805	BnaA05T0134700ZY	0	-	0	0	1401	0.0000000
zheyou73v0_A05	9041458	9042299	BnaA05T0134800ZY	0	-	0	0	841	0.0000000
zheyou73v0_A05	9042575	9065109	BnaA05T0134900ZY	0	-	0	0	22534	0.0000000
zheyou73v0_A05	9065287	9069113	BnaA05T0135000ZY	0	+	0	0	3826	0.0000000
zheyou73v0_A05	9069250	9071591	BnaA05T0135100ZY	0	-	0	0	2341	0.0000000
zheyou73v0_A05	9077912	9081160	BnaA05T0135200ZY	0	+	0	0	3248	0.0000000
zheyou73v0_A05	9077912	9081160	BnaA05T0135200ZY.1	0	+	0	0	3248	0.0000000
zheyou73v0_A05	9077912	9081160	BnaA05T0135200ZY.2	0	+	0	0	3248	0.0000000
zheyou73v0_A05	9080780	9082862	BnaA05T0135300ZY	0	-	0	0	2082	0.0000000
zheyou73v0_A05	9085861	9088003	BnaA05T0135400ZY	0	-	0	0	2142	0.0000000
zheyou73v0_A05	9088067	9090061	BnaA05T0135500ZY	0	-	0	0	1994	0.0000000
zheyou73v0_A05	9093658	9096995	BnaA05T0135600ZY	0	+	0	0	3337	0.0000000
zheyou73v0_A05	9098290	9099265	BnaA05T0135700ZY	0	+	0	0	975	0.0000000
zheyou73v0_A05	9099322	9099556	BnaA05T0135800ZY	0	-	0	0	234	0.0000000
zheyou73v0_A05	9105443	9106632	BnaA05T0135900ZY	0	+	0	0	1189	0.0000000
zheyou73v0_A05	9106991	9109782	BnaA05T0136000ZY	0	-	0	0	2791	0.0000000
zheyou73v0_A05	9110433	9112550	BnaA05T0136100ZY	0	+	0	0	2117	0.0000000
zheyou73v0_A05	9113009	9113960	BnaA05T0136200ZY	0	-	0	0	951	0.0000000
zheyou73v0_A05	9114253	9115492	BnaA05T0136300ZY	0	+	0	0	1239	0.0000000
zheyou73v0_A05	9118219	9120734	BnaA05T0136400ZY	0	-	0	0	2515	0.0000000
zheyou73v0_A05	9121701	9122624	BnaA05T0136500ZY	0	+	0	0	923	0.0000000
zheyou73v0_A05	9125689	9126329	BnaA05T0136600ZY	0	+	0	0	640	0.0000000
zheyou73v0_A05	9127776	9128756	BnaA05T0136700ZY	0	+	0	0	980	0.0000000
zheyou73v0_A05	9130957	9131922	BnaA05T0136800ZY	0	+	0	0	965	0.0000000
zheyou73v0_A05	9146677	9146946	BnaA05T0136900ZY	0	-	0	0	269	0.0000000
zheyou73v0_A05	9147723	9148584	BnaA05T0137000ZY	0	+	0	0	861	0.0000000
zheyou73v0_A05	9153158	9154494	BnaA05T0137100ZY	0	+	0	0	1336	0.0000000
zheyou73v0_A05	9160348	9163585	BnaA05T0137200ZY	0	-	0	0	3237	0.0000000
zheyou73v0_A05	9178158	9179613	BnaA05T0137300ZY	0	+	0	0	1455	0.0000000
zheyou73v0_A05	9180069	9180855	BnaA05T0137400ZY	0	+	0	0	786	0.0000000
zheyou73v0_A05	9185809	9190291	BnaA05T0137500ZY	0	-	0	0	4482	0.0000000
zheyou73v0_A05	9218833	9220404	BnaA05T0137600ZY	0	+	0	0	1571	0.0000000
zheyou73v0_A05	9221772	9223221	BnaA05T0137700ZY	0	+	0	0	1449	0.0000000
zheyou73v0_A05	9225004	9226680	BnaA05T0137800ZY	0	-	0	0	1676	0.0000000
zheyou73v0_A05	9231479	9242972	BnaA05T0137900ZY	0	-	0	0	11493	0.0000000
zheyou73v0_A05	9234139	9235313	BnaA05T0138000ZY	0	-	0	0	1174	0.0000000
zheyou73v0_A05	9244578	9246450	BnaA05T0138100ZY	0	+	0	0	1872	0.0000000
zheyou73v0_A05	9246602	9251220	BnaA05T0138200ZY	0	-	0	0	4618	0.0000000
zheyou73v0_A05	9246602	9251220	BnaA05T0138200ZY.1	0	-	0	0	4618	0.0000000
zheyou73v0_A05	9246602	9251220	BnaA05T0138200ZY.2	0	-	0	0	4618	0.0000000
zheyou73v0_A05	9258825	9261397	BnaA05T0138300ZY	0	+	0	0	2572	0.0000000
zheyou73v0_A05	9258825	9260947	BnaA05T0138300ZY.1	0	+	0	0	2122	0.0000000
zheyou73v0_A05	9296150	9300914	BnaA05T0138400ZY	0	+	0	0	4764	0.0000000
zheyou73v0_A05	9307389	9309081	BnaA05T0138500ZY	0	-	0	0	1692	0.0000000
zheyou73v0_A05	9309420	9311798	BnaA05T0138600ZY	0	-	0	0	2378	0.0000000
zheyou73v0_A05	9309420	9311798	BnaA05T0138600ZY.1	0	-	0	0	2378	0.0000000
zheyou73v0_A05	9309420	9311798	BnaA05T0138600ZY.2	0	-	0	0	2378	0.0000000
zheyou73v0_A05	9309420	9311798	BnaA05T0138600ZY.3	0	-	0	0	2378	0.0000000
zheyou73v0_A05	9317874	9318363	BnaA05T0138700ZY	0	-	0	0	489	0.0000000
zheyou73v0_A05	9318478	9323207	BnaA05T0138800ZY	0	-	0	0	4729	0.0000000
zheyou73v0_A05	9353027	9354746	BnaA05T0138900ZY	0	+	0	0	1719	0.0000000
zheyou73v0_A05	9359126	9359650	BnaA05T0139000ZY	0	+	0	0	524	0.0000000
zheyou73v0_A05	9361871	9366636	BnaA05T0139100ZY	0	-	0	0	4765	0.0000000
zheyou73v0_A05	9370424	9371292	BnaA05T0139200ZY	0	+	0	0	868	0.0000000
zheyou73v0_A05	9374546	9374933	BnaA05T0139300ZY	0	+	0	0	387	0.0000000
zheyou73v0_A05	9378480	9381254	BnaA05T0139400ZY	0	+	0	0	2774	0.0000000
zheyou73v0_A05	9390756	9391368	BnaA05T0139500ZY	0	+	0	0	612	0.0000000
zheyou73v0_A05	9398965	9400104	BnaA05T0139600ZY	0	+	0	0	1139	0.0000000
zheyou73v0_A05	9420809	9423859	BnaA05T0139700ZY.1	0	+	0	0	3050	0.0000000
zheyou73v0_A05	9420823	9423859	BnaA05T0139700ZY	0	+	0	0	3036	0.0000000
zheyou73v0_A05	9440676	9442330	BnaA05T0139800ZY	0	+	0	0	1654	0.0000000
zheyou73v0_A05	9445254	9447872	BnaA05T0139900ZY	0	+	0	0	2618	0.0000000
zheyou73v0_A05	9452326	9454979	BnaA05T0140000ZY	0	-	0	0	2653	0.0000000
zheyou73v0_A05	9459380	9461876	BnaA05T0140100ZY	0	+	0	0	2496	0.0000000
zheyou73v0_A05	9462360	9463129	BnaA05T0140200ZY	0	-	0	0	769	0.0000000
zheyou73v0_A05	9470088	9472095	BnaA05T0140300ZY	0	+	0	0	2007	0.0000000
zheyou73v0_A05	9479695	9481111	BnaA05T0140400ZY	0	+	0	0	1416	0.0000000
zheyou73v0_A05	9499728	9500841	BnaA05T0140500ZY	0	+	0	0	1113	0.0000000
zheyou73v0_A05	9511318	9517290	BnaA05T0140600ZY	0	+	0	0	5972	0.0000000
zheyou73v0_A05	9525597	9525822	BnaA05T0140700ZY	0	-	0	0	225	0.0000000
zheyou73v0_A05	9525949	9527212	BnaA05T0140800ZY	0	-	0	0	1263	0.0000000
zheyou73v0_A05	9529568	9531410	BnaA05T0140900ZY	0	+	0	0	1842	0.0000000
zheyou73v0_A05	9537275	9538220	BnaA05T0141000ZY	0	+	0	0	945	0.0000000
zheyou73v0_A05	9542974	9549914	BnaA05T0141100ZY	0	-	0	0	6940	0.0000000
zheyou73v0_A05	9542974	9549914	BnaA05T0141100ZY.1	0	-	0	0	6940	0.0000000
zheyou73v0_A05	9562104	9567386	BnaA05T0141200ZY	0	+	0	0	5282	0.0000000
zheyou73v0_A05	9576840	9580665	BnaA05T0141300ZY	0	-	0	0	3825	0.0000000
zheyou73v0_A05	9586624	9587912	BnaA05T0141400ZY	0	+	0	0	1288	0.0000000
zheyou73v0_A05	9591864	9592905	BnaA05T0141500ZY	0	+	0	0	1041	0.0000000
zheyou73v0_A05	9606875	9610086	BnaA05T0141600ZY	0	+	0	0	3211	0.0000000
zheyou73v0_A05	9620062	9620660	BnaA05T0141700ZY	0	+	0	0	598	0.0000000
zheyou73v0_A05	9622352	9624593	BnaA05T0141800ZY	0	-	0	0	2241	0.0000000
zheyou73v0_A05	9629981	9631269	BnaA05T0141900ZY	0	-	0	0	1288	0.0000000
zheyou73v0_A05	9652049	9653842	BnaA05T0142000ZY	0	+	0	0	1793	0.0000000
zheyou73v0_A05	9654492	9655524	BnaA05T0142100ZY	0	+	0	0	1032	0.0000000
zheyou73v0_A05	9686170	9688118	BnaA05T0142200ZY	0	+	0	0	1948	0.0000000
zheyou73v0_A05	9691378	9691591	BnaA05T0142300ZY	0	+	0	0	213	0.0000000
zheyou73v0_A05	9702403	9703993	BnaA05T0142400ZY	0	-	0	0	1590	0.0000000
zheyou73v0_A05	9708931	9710483	BnaA05T0142500ZY	0	+	0	0	1552	0.0000000
zheyou73v0_A05	9708931	9710483	BnaA05T0142500ZY.1	0	+	0	0	1552	0.0000000
zheyou73v0_A05	9715893	9717578	BnaA05T0142600ZY	0	+	0	0	1685	0.0000000
zheyou73v0_A05	9731947	9737475	BnaA05T0142700ZY	0	-	0	0	5528	0.0000000
zheyou73v0_A05	9755923	9756243	BnaA05T0142800ZY	0	-	0	0	320	0.0000000
zheyou73v0_A05	9763853	9766394	BnaA05T0142900ZY	0	-	0	0	2541	0.0000000
zheyou73v0_A05	9778312	9782111	BnaA05T0143000ZY	0	+	0	0	3799	0.0000000
zheyou73v0_A05	9786158	9789696	BnaA05T0143100ZY	0	-	0	0	3538	0.0000000
zheyou73v0_A05	9800509	9802102	BnaA05T0143200ZY	0	+	0	0	1593	0.0000000
zheyou73v0_A05	9807189	9808859	BnaA05T0143300ZY	0	+	0	0	1670	0.0000000
zheyou73v0_A05	9810401	9810823	BnaA05T0143400ZY	0	+	0	0	422	0.0000000
zheyou73v0_A05	9824455	9826667	BnaA05T0143500ZY	0	+	0	0	2212	0.0000000
zheyou73v0_A05	9829317	9831012	BnaA05T0143600ZY	0	+	0	0	1695	0.0000000
zheyou73v0_A05	9831046	9831831	BnaA05T0143700ZY	0	-	0	0	785	0.0000000
zheyou73v0_A05	9834273	9836302	BnaA05T0143800ZY	0	-	0	0	2029	0.0000000
zheyou73v0_A05	9836443	9838641	BnaA05T0143900ZY	0	+	0	0	2198	0.0000000
zheyou73v0_A05	9860677	9861024	BnaA05T0144000ZY	0	+	0	0	347	0.0000000
zheyou73v0_A05	9868148	9868933	BnaA05T0144100ZY	0	-	0	0	785	0.0000000
zheyou73v0_A05	9874747	9877860	BnaA05T0144200ZY	0	-	0	0	3113	0.0000000
zheyou73v0_A05	9888070	9889567	BnaA05T0144300ZY	0	+	0	0	1497	0.0000000
zheyou73v0_A05	9901377	9903399	BnaA05T0144400ZY	0	+	0	0	2022	0.0000000
zheyou73v0_A05	9915153	9917376	BnaA05T0144500ZY	0	+	0	0	2223	0.0000000
zheyou73v0_A05	9920889	9921484	BnaA05T0144600ZY	0	+	0	0	595	0.0000000
zheyou73v0_A05	9921850	9922383	BnaA05T0144700ZY	0	-	0	0	533	0.0000000
zheyou73v0_A05	9922585	9923460	BnaA05T0144800ZY	0	-	0	0	875	0.0000000
zheyou73v0_A05	9932496	9933267	BnaA05T0144900ZY	0	+	0	0	771	0.0000000
zheyou73v0_A05	9940985	9944609	BnaA05T0145000ZY	0	+	0	0	3624	0.0000000
zheyou73v0_A05	9940985	9944609	BnaA05T0145000ZY.1	0	+	0	0	3624	0.0000000
zheyou73v0_A05	9948499	9950682	BnaA05T0145100ZY	0	+	0	0	2183	0.0000000
zheyou73v0_A05	9953014	9954903	BnaA05T0145200ZY	0	+	0	0	1889	0.0000000
zheyou73v0_A05	9961343	9961913	BnaA05T0145300ZY	0	-	0	0	570	0.0000000
zheyou73v0_A05	9979524	9979946	BnaA05T0145400ZY	0	-	0	0	422	0.0000000
zheyou73v0_A05	9995992	9997045	BnaA05T0145500ZY	0	+	0	0	1053	0.0000000
zheyou73v0_A05	10000544	10011117	BnaA05T0145600ZY	0	+	0	0	10573	0.0000000
zheyou73v0_A05	10018300	10029313	BnaA05T0145700ZY	0	+	0	0	11013	0.0000000
zheyou73v0_A05	10018300	10028902	BnaA05T0145700ZY.1	0	+	0	0	10602	0.0000000
zheyou73v0_A05	10029366	10032426	BnaA05T0145800ZY	0	-	0	0	3060	0.0000000
zheyou73v0_A05	10055645	10061987	BnaA05T0145900ZY	0	+	0	0	6342	0.0000000
zheyou73v0_A05	10079186	10087149	BnaA05T0146000ZY	0	-	0	0	7963	0.0000000
zheyou73v0_A05	10087501	10088168	BnaA05T0146100ZY	0	-	0	0	667	0.0000000
zheyou73v0_A05	10092212	10094431	BnaA05T0146200ZY	0	+	0	0	2219	0.0000000
zheyou73v0_A05	10097406	10099293	BnaA05T0146300ZY	0	-	0	0	1887	0.0000000
zheyou73v0_A05	10104070	10106302	BnaA05T0146400ZY	0	-	0	0	2232	0.0000000
zheyou73v0_A05	10104070	10106302	BnaA05T0146400ZY.1	0	-	0	0	2232	0.0000000
zheyou73v0_A05	10111239	10113200	BnaA05T0146500ZY	0	+	0	0	1961	0.0000000
zheyou73v0_A05	10113424	10113625	BnaA05T0146600ZY	0	+	0	0	201	0.0000000
zheyou73v0_A05	10114136	10116013	BnaA05T0146700ZY	0	-	0	0	1877	0.0000000
zheyou73v0_A05	10119396	10120733	BnaA05T0146800ZY	0	+	0	0	1337	0.0000000
zheyou73v0_A05	10122627	10123990	BnaA05T0146900ZY	0	-	0	0	1363	0.0000000
zheyou73v0_A05	10128782	10130698	BnaA05T0147000ZY	0	-	0	0	1916	0.0000000
zheyou73v0_A05	10130896	10132215	BnaA05T0147100ZY	0	-	0	0	1319	0.0000000
zheyou73v0_A05	10133050	10136851	BnaA05T0147200ZY	0	+	0	0	3801	0.0000000
zheyou73v0_A05	10136521	10142319	BnaA05T0147300ZY	0	-	0	0	5798	0.0000000
zheyou73v0_A05	10148772	10149473	BnaA05T0147400ZY	0	-	0	0	701	0.0000000
zheyou73v0_A05	10158476	10158719	BnaA05T0147500ZY	0	-	0	0	243	0.0000000
zheyou73v0_A05	10166176	10168335	BnaA05T0147600ZY	0	+	0	0	2159	0.0000000
zheyou73v0_A05	10169233	10170084	BnaA05T0147700ZY	0	+	0	0	851	0.0000000
zheyou73v0_A05	10172683	10173214	BnaA05T0147800ZY	0	+	0	0	531	0.0000000
zheyou73v0_A05	10185894	10188610	BnaA05T0147900ZY	0	+	0	0	2716	0.0000000
zheyou73v0_A05	10188895	10189619	BnaA05T0148000ZY	0	+	0	0	724	0.0000000
zheyou73v0_A05	10204239	10205283	BnaA05T0148100ZY	0	-	0	0	1044	0.0000000
zheyou73v0_A05	10214554	10216444	BnaA05T0148200ZY	0	+	0	0	1890	0.0000000
zheyou73v0_A05	10218553	10220096	BnaA05T0148300ZY	0	+	0	0	1543	0.0000000
zheyou73v0_A05	10227048	10229027	BnaA05T0148400ZY	0	+	0	0	1979	0.0000000
zheyou73v0_A05	10227048	10229027	BnaA05T0148400ZY.1	0	+	0	0	1979	0.0000000
zheyou73v0_A05	10229161	10230622	BnaA05T0148500ZY	0	+	0	0	1461	0.0000000
zheyou73v0_A05	10229161	10230766	BnaA05T0148500ZY.1	0	+	0	0	1605	0.0000000
zheyou73v0_A05	10231061	10231350	BnaA05T0148600ZY	0	+	0	0	289	0.0000000
zheyou73v0_A05	10234576	10236965	BnaA05T0148700ZY	0	+	0	0	2389	0.0000000
zheyou73v0_A05	10241393	10243245	BnaA05T0148800ZY	0	-	0	0	1852	0.0000000
zheyou73v0_A05	10241393	10243245	BnaA05T0148800ZY.1	0	-	0	0	1852	0.0000000
zheyou73v0_A05	10243966	10245665	BnaA05T0148900ZY	0	-	0	0	1699	0.0000000
zheyou73v0_A05	10247042	10248168	BnaA05T0149000ZY	0	+	0	0	1126	0.0000000
zheyou73v0_A05	10262221	10263796	BnaA05T0149100ZY	0	+	0	0	1575	0.0000000
zheyou73v0_A05	10265988	10266376	BnaA05T0149200ZY	0	+	0	0	388	0.0000000
zheyou73v0_A05	10286221	10287632	BnaA05T0149300ZY	0	-	0	0	1411	0.0000000
zheyou73v0_A05	10286221	10287632	BnaA05T0149300ZY.1	0	-	0	0	1411	0.0000000
zheyou73v0_A05	10286221	10287632	BnaA05T0149300ZY.2	0	-	0	0	1411	0.0000000
zheyou73v0_A05	10286221	10287632	BnaA05T0149300ZY.3	0	-	0	0	1411	0.0000000
zheyou73v0_A05	10286221	10287632	BnaA05T0149300ZY.4	0	-	0	0	1411	0.0000000
zheyou73v0_A05	10292339	10292732	BnaA05T0149400ZY	0	+	0	0	393	0.0000000
zheyou73v0_A05	10298931	10299342	BnaA05T0149500ZY	0	+	0	0	411	0.0000000
zheyou73v0_A05	10300420	10309722	BnaA05T0149600ZY	0	-	0	0	9302	0.0000000
zheyou73v0_A05	10313077	10314484	BnaA05T0149700ZY	0	-	0	0	1407	0.0000000
zheyou73v0_A05	10314686	10316360	BnaA05T0149800ZY	0	-	0	0	1674	0.0000000
zheyou73v0_A05	10320401	10321964	BnaA05T0149900ZY	0	+	0	0	1563	0.0000000
zheyou73v0_A05	10327040	10328971	BnaA05T0150000ZY	0	+	0	0	1931	0.0000000
zheyou73v0_A05	10329230	10330045	BnaA05T0150100ZY	0	-	0	0	815	0.0000000
zheyou73v0_A05	10340236	10341381	BnaA05T0150200ZY	0	+	0	0	1145	0.0000000
zheyou73v0_A05	10342792	10343732	BnaA05T0150300ZY	0	-	0	0	940	0.0000000
zheyou73v0_A05	10352119	10353013	BnaA05T0150400ZY	0	+	0	0	894	0.0000000
zheyou73v0_A05	10354189	10355031	BnaA05T0150500ZY	0	-	0	0	842	0.0000000
zheyou73v0_A05	10357502	10359826	BnaA05T0150600ZY	0	-	0	0	2324	0.0000000
zheyou73v0_A05	10363380	10364396	BnaA05T0150700ZY	0	-	0	0	1016	0.0000000
zheyou73v0_A05	10366827	10367746	BnaA05T0150800ZY	0	+	0	0	919	0.0000000
zheyou73v0_A05	10368258	10369824	BnaA05T0150900ZY	0	+	0	0	1566	0.0000000
zheyou73v0_A05	10374226	10377503	BnaA05T0151000ZY	0	+	0	0	3277	0.0000000
zheyou73v0_A05	10382126	10383454	BnaA05T0151100ZY.1	0	+	0	0	1328	0.0000000
zheyou73v0_A05	10382135	10383454	BnaA05T0151100ZY	0	+	0	0	1319	0.0000000
zheyou73v0_A05	10386417	10389544	BnaA05T0151200ZY	0	+	0	0	3127	0.0000000
zheyou73v0_A05	10397365	10398514	BnaA05T0151300ZY	0	+	0	0	1149	0.0000000
zheyou73v0_A05	10401058	10401740	BnaA05T0151400ZY	0	-	0	0	682	0.0000000
zheyou73v0_A05	10402286	10403550	BnaA05T0151500ZY	0	-	0	0	1264	0.0000000
zheyou73v0_A05	10413108	10413291	BnaA05T0151600ZY	0	+	0	0	183	0.0000000
zheyou73v0_A05	10416443	10417833	BnaA05T0151700ZY	0	+	0	0	1390	0.0000000
zheyou73v0_A05	10418664	10424183	BnaA05T0151800ZY	0	-	0	0	5519	0.0000000
zheyou73v0_A05	10439278	10442110	BnaA05T0151900ZY	0	+	0	0	2832	0.0000000
zheyou73v0_A05	10440716	10441945	BnaA05T0151900ZY.1	0	+	0	0	1229	0.0000000
zheyou73v0_A05	10453524	10453999	BnaA05T0152000ZY	0	-	0	0	475	0.0000000
zheyou73v0_A05	10455241	10459519	BnaA05T0152100ZY	0	+	0	0	4278	0.0000000
zheyou73v0_A05	10460399	10471097	BnaA05T0152200ZY	0	-	0	0	10698	0.0000000
zheyou73v0_A05	10476362	10476947	BnaA05T0152300ZY	0	-	0	0	585	0.0000000
zheyou73v0_A05	10482520	10482855	BnaA05T0152400ZY	0	+	0	0	335	0.0000000
zheyou73v0_A05	10485057	10487061	BnaA05T0152500ZY	0	+	0	0	2004	0.0000000
zheyou73v0_A05	10495574	10497535	BnaA05T0152600ZY	0	+	0	0	1961	0.0000000
zheyou73v0_A05	10497690	10499826	BnaA05T0152700ZY	0	-	0	0	2136	0.0000000
zheyou73v0_A05	10501546	10503097	BnaA05T0152800ZY	0	-	0	0	1551	0.0000000
zheyou73v0_A05	10515369	10516317	BnaA05T0152900ZY	0	-	0	0	948	0.0000000
zheyou73v0_A05	10517402	10517720	BnaA05T0153000ZY	0	-	0	0	318	0.0000000
zheyou73v0_A05	10521928	10524630	BnaA05T0153100ZY	0	-	0	0	2702	0.0000000
zheyou73v0_A05	10527463	10529138	BnaA05T0153200ZY	0	+	0	0	1675	0.0000000
zheyou73v0_A05	10529214	10535776	BnaA05T0153300ZY	0	+	0	0	6562	0.0000000
zheyou73v0_A05	10536436	10538418	BnaA05T0153400ZY	0	-	0	0	1982	0.0000000
zheyou73v0_A05	10536436	10538418	BnaA05T0153400ZY.1	0	-	0	0	1982	0.0000000
zheyou73v0_A05	10536436	10538418	BnaA05T0153400ZY.2	0	-	0	0	1982	0.0000000
zheyou73v0_A05	10536436	10538418	BnaA05T0153400ZY.3	0	-	0	0	1982	0.0000000
zheyou73v0_A05	10536436	10538195	BnaA05T0153400ZY.4	0	-	0	0	1759	0.0000000
zheyou73v0_A05	10549230	10550748	BnaA05T0153500ZY	0	-	0	0	1518	0.0000000
zheyou73v0_A05	10562623	10563832	BnaA05T0153600ZY	0	-	0	0	1209	0.0000000
zheyou73v0_A05	10584075	10584786	BnaA05T0153700ZY	0	+	0	0	711	0.0000000
zheyou73v0_A05	10586840	10587608	BnaA05T0153800ZY	0	+	0	0	768	0.0000000
zheyou73v0_A05	10588378	10588642	BnaA05T0153900ZY	0	-	0	0	264	0.0000000
zheyou73v0_A05	10592461	10593224	BnaA05T0154000ZY	0	+	0	0	763	0.0000000
zheyou73v0_A05	10598856	10601310	BnaA05T0154100ZY	0	+	0	0	2454	0.0000000
zheyou73v0_A05	10601788	10602638	BnaA05T0154200ZY	0	+	0	0	850	0.0000000
zheyou73v0_A05	10611983	10613424	BnaA05T0154300ZY	0	+	0	0	1441	0.0000000
zheyou73v0_A05	10616868	10618540	BnaA05T0154400ZY	0	+	0	0	1672	0.0000000
zheyou73v0_A05	10622315	10622650	BnaA05T0154500ZY	0	+	0	0	335	0.0000000
zheyou73v0_A05	10624572	10624911	BnaA05T0154600ZY	0	+	0	0	339	0.0000000
zheyou73v0_A05	10633102	10633497	BnaA05T0154700ZY	0	+	0	0	395	0.0000000
zheyou73v0_A05	10635036	10636704	BnaA05T0154800ZY	0	-	0	0	1668	0.0000000
zheyou73v0_A05	10653471	10653711	BnaA05T0154900ZY	0	+	0	0	240	0.0000000
zheyou73v0_A05	10662039	10662963	BnaA05T0155000ZY	0	-	0	0	924	0.0000000
zheyou73v0_A05	10675774	10676080	BnaA05T0155100ZY	0	+	0	0	306	0.0000000
zheyou73v0_A05	10676917	10677136	BnaA05T0155200ZY	0	+	0	0	219	0.0000000
zheyou73v0_A05	10688285	10688651	BnaA05T0155300ZY	0	+	0	0	366	0.0000000
zheyou73v0_A05	10691093	10691850	BnaA05T0155400ZY	0	-	0	0	757	0.0000000
zheyou73v0_A05	10709287	10710140	BnaA05T0155500ZY	0	-	0	0	853	0.0000000
zheyou73v0_A05	10721075	10725249	BnaA05T0155600ZY	0	-	0	0	4174	0.0000000
zheyou73v0_A05	10748594	10751796	BnaA05T0155700ZY	0	+	0	0	3202	0.0000000
zheyou73v0_A05	10748594	10751441	BnaA05T0155700ZY.1	0	+	0	0	2847	0.0000000
zheyou73v0_A05	10748594	10751796	BnaA05T0155700ZY.2	0	+	0	0	3202	0.0000000
zheyou73v0_A05	10753112	10755200	BnaA05T0155800ZY	0	+	0	0	2088	0.0000000
zheyou73v0_A05	10755623	10760205	BnaA05T0155900ZY	0	-	0	0	4582	0.0000000
zheyou73v0_A05	10771753	10772618	BnaA05T0156000ZY	0	+	0	0	865	0.0000000
zheyou73v0_A05	10778872	10785428	BnaA05T0156100ZY	0	-	0	0	6556	0.0000000
zheyou73v0_A05	10800918	10803408	BnaA05T0156200ZY	0	-	0	0	2490	0.0000000
zheyou73v0_A05	10805244	10805850	BnaA05T0156300ZY	0	+	0	0	606	0.0000000
zheyou73v0_A05	10809282	10814312	BnaA05T0156400ZY	0	-	0	0	5030	0.0000000
zheyou73v0_A05	10818948	10820139	BnaA05T0156500ZY	0	+	0	0	1191	0.0000000
zheyou73v0_A05	10826940	10827830	BnaA05T0156600ZY	0	-	0	0	890	0.0000000
zheyou73v0_A05	10831062	10831805	BnaA05T0156700ZY	0	-	0	0	743	0.0000000
zheyou73v0_A05	10832678	10833468	BnaA05T0156800ZY	0	+	0	0	790	0.0000000
zheyou73v0_A05	10838937	10841976	BnaA05T0156900ZY	0	-	0	0	3039	0.0000000
zheyou73v0_A05	10845979	10848317	BnaA05T0157000ZY	0	+	0	0	2338	0.0000000
zheyou73v0_A05	10854663	10855032	BnaA05T0157100ZY	0	+	0	0	369	0.0000000
zheyou73v0_A05	10870598	10873465	BnaA05T0157200ZY	0	-	0	0	2867	0.0000000
zheyou73v0_A05	10877085	10879286	BnaA05T0157300ZY	0	-	0	0	2201	0.0000000
zheyou73v0_A05	10879293	10879521	BnaA05T0157400ZY	0	-	0	0	228	0.0000000
zheyou73v0_A05	10904669	10907270	BnaA05T0157500ZY	0	-	0	0	2601	0.0000000
zheyou73v0_A05	10912206	10914068	BnaA05T0157600ZY	0	+	0	0	1862	0.0000000
zheyou73v0_A05	10915906	10917899	BnaA05T0157700ZY	0	+	0	0	1993	0.0000000
zheyou73v0_A05	10922969	10925870	BnaA05T0157800ZY	0	-	0	0	2901	0.0000000
zheyou73v0_A05	10927025	10929928	BnaA05T0157900ZY	0	+	0	0	2903	0.0000000
zheyou73v0_A05	10938667	10942511	BnaA05T0158000ZY	0	-	0	0	3844	0.0000000
zheyou73v0_A05	10952982	10954248	BnaA05T0158100ZY	0	-	0	0	1266	0.0000000
zheyou73v0_A05	10962529	10963132	BnaA05T0158200ZY	0	+	0	0	603	0.0000000
zheyou73v0_A05	10967209	10976988	BnaA05T0158300ZY	0	-	0	0	9779	0.0000000
zheyou73v0_A05	10980033	10981145	BnaA05T0158400ZY	0	+	0	0	1112	0.0000000
zheyou73v0_A05	10999790	11000000	BnaA05T0158500ZY	0	+	0	0	210	0.0000000
zheyou73v0_A05	11009102	11010095	BnaA05T0158600ZY	0	-	0	0	993	0.0000000
zheyou73v0_A05	11014580	11015202	BnaA05T0158700ZY	0	-	0	0	622	0.0000000
zheyou73v0_A05	11031645	11034644	BnaA05T0158800ZY	0	-	0	0	2999	0.0000000
zheyou73v0_A05	11052941	11053394	BnaA05T0158900ZY	0	+	0	0	453	0.0000000
zheyou73v0_A05	11058233	11061635	BnaA05T0159000ZY	0	+	0	0	3402	0.0000000
zheyou73v0_A05	11083714	11085337	BnaA05T0159100ZY	0	+	0	0	1623	0.0000000
zheyou73v0_A05	11092395	11092830	BnaA05T0159200ZY	0	+	0	0	435	0.0000000
zheyou73v0_A05	11092933	11093776	BnaA05T0159300ZY	0	+	0	0	843	0.0000000
zheyou73v0_A05	11094248	11095562	BnaA05T0159400ZY	0	+	0	0	1314	0.0000000
zheyou73v0_A05	11105687	11107310	BnaA05T0159500ZY	0	+	0	0	1623	0.0000000
zheyou73v0_A05	11114390	11117559	BnaA05T0159600ZY	0	+	0	0	3169	0.0000000
zheyou73v0_A05	11122206	11123799	BnaA05T0159700ZY	0	+	0	0	1593	0.0000000
zheyou73v0_A05	11126291	11127866	BnaA05T0159800ZY	0	+	0	0	1575	0.0000000
zheyou73v0_A05	11126291	11127866	BnaA05T0159800ZY.1	0	+	0	0	1575	0.0000000
zheyou73v0_A05	11164204	11165198	BnaA05T0159900ZY	0	+	0	0	994	0.0000000
zheyou73v0_A05	11167646	11168158	BnaA05T0160000ZY	0	-	0	0	512	0.0000000
zheyou73v0_A05	11168972	11170707	BnaA05T0160100ZY	0	-	0	0	1735	0.0000000
zheyou73v0_A05	11175170	11176723	BnaA05T0160200ZY	0	-	0	0	1553	0.0000000
zheyou73v0_A05	11177046	11179097	BnaA05T0160300ZY	0	-	0	0	2051	0.0000000
zheyou73v0_A05	11180522	11181240	BnaA05T0160400ZY	0	-	0	0	718	0.0000000
zheyou73v0_A05	11208308	11210527	BnaA05T0160500ZY	0	+	0	0	2219	0.0000000
zheyou73v0_A05	11215385	11220701	BnaA05T0160600ZY	0	+	0	0	5316	0.0000000
zheyou73v0_A05	11224298	11225716	BnaA05T0160700ZY	0	-	0	0	1418	0.0000000
zheyou73v0_A05	11233125	11234751	BnaA05T0160800ZY	0	-	0	0	1626	0.0000000
zheyou73v0_A05	11235293	11239060	BnaA05T0160900ZY	0	+	0	0	3767	0.0000000
zheyou73v0_A05	11241895	11242353	BnaA05T0161000ZY	0	+	0	0	458	0.0000000
zheyou73v0_A05	11270412	11270916	BnaA05T0161100ZY	0	+	0	0	504	0.0000000
zheyou73v0_A05	11293951	11295703	BnaA05T0161200ZY	0	+	0	0	1752	0.0000000
zheyou73v0_A05	11295967	11298312	BnaA05T0161300ZY	0	-	0	0	2345	0.0000000
zheyou73v0_A05	11300311	11300975	BnaA05T0161400ZY	0	+	0	0	664	0.0000000
zheyou73v0_A05	11301355	11303386	BnaA05T0161500ZY	0	-	0	0	2031	0.0000000
zheyou73v0_A05	11304736	11309678	BnaA05T0161600ZY	0	+	0	0	4942	0.0000000
zheyou73v0_A05	11311572	11314718	BnaA05T0161700ZY	0	-	0	0	3146	0.0000000
zheyou73v0_A05	11316125	11320332	BnaA05T0161800ZY	0	-	0	0	4207	0.0000000
zheyou73v0_A05	11327009	11329875	BnaA05T0161900ZY	0	-	0	0	2866	0.0000000
zheyou73v0_A05	11350414	11352419	BnaA05T0162000ZY	0	-	0	0	2005	0.0000000
zheyou73v0_A05	11352682	11359322	BnaA05T0162100ZY	0	-	0	0	6640	0.0000000
zheyou73v0_A05	11379622	11380321	BnaA05T0162200ZY	0	+	0	0	699	0.0000000
zheyou73v0_A05	11381320	11382293	BnaA05T0162300ZY	0	-	0	0	973	0.0000000
zheyou73v0_A05	11382616	11386104	BnaA05T0162400ZY	0	-	0	0	3488	0.0000000
zheyou73v0_A05	11390297	11405673	BnaA05T0162500ZY	0	+	0	0	15376	0.0000000
zheyou73v0_A05	11410516	11411654	BnaA05T0162600ZY	0	+	0	0	1138	0.0000000
zheyou73v0_A05	11413937	11415642	BnaA05T0162700ZY	0	+	0	0	1705	0.0000000
zheyou73v0_A05	11416700	11417077	BnaA05T0162800ZY	0	+	0	0	377	0.0000000
zheyou73v0_A05	11427548	11429870	BnaA05T0162900ZY	0	+	0	0	2322	0.0000000
zheyou73v0_A05	11431202	11431820	BnaA05T0163000ZY	0	+	0	0	618	0.0000000
zheyou73v0_A05	11439217	11440661	BnaA05T0163100ZY	0	-	0	0	1444	0.0000000
zheyou73v0_A05	11442797	11443031	BnaA05T0163200ZY	0	-	0	0	234	0.0000000
zheyou73v0_A05	11451488	11454064	BnaA05T0163300ZY	0	-	0	0	2576	0.0000000
zheyou73v0_A05	11476504	11479927	BnaA05T0163400ZY	0	+	0	0	3423	0.0000000
zheyou73v0_A05	11481667	11483575	BnaA05T0163500ZY	0	-	0	0	1908	0.0000000
zheyou73v0_A05	11489053	11490143	BnaA05T0163600ZY	0	-	0	0	1090	0.0000000
zheyou73v0_A05	11506888	11508513	BnaA05T0163700ZY	0	+	0	0	1625	0.0000000
zheyou73v0_A05	11506888	11508513	BnaA05T0163700ZY.1	0	+	0	0	1625	0.0000000
zheyou73v0_A05	11520162	11523494	BnaA05T0163800ZY	0	+	0	0	3332	0.0000000
zheyou73v0_A05	11524018	11527131	BnaA05T0163900ZY	0	+	0	0	3113	0.0000000
zheyou73v0_A05	11524018	11526976	BnaA05T0163900ZY.1	0	+	0	0	2958	0.0000000
zheyou73v0_A05	11527109	11528329	BnaA05T0164000ZY	0	-	0	0	1220	0.0000000
zheyou73v0_A05	11531533	11531863	BnaA05T0164100ZY	0	+	0	0	330	0.0000000
zheyou73v0_A05	11532658	11532964	BnaA05T0164200ZY	0	-	0	0	306	0.0000000
zheyou73v0_A05	11534201	11534660	BnaA05T0164300ZY	0	-	0	0	459	0.0000000
zheyou73v0_A05	11553534	11557939	BnaA05T0164400ZY	0	+	0	0	4405	0.0000000
zheyou73v0_A05	11595287	11595832	BnaA05T0164500ZY	0	+	0	0	545	0.0000000
zheyou73v0_A05	11600062	11603411	BnaA05T0164600ZY	0	+	0	0	3349	0.0000000
zheyou73v0_A05	11611850	11617335	BnaA05T0164700ZY	0	+	0	0	5485	0.0000000
zheyou73v0_A05	11620559	11621249	BnaA05T0164800ZY	0	+	0	0	690	0.0000000
zheyou73v0_A05	11642149	11646182	BnaA05T0164900ZY	0	+	0	0	4033	0.0000000
zheyou73v0_A05	11655894	11659710	BnaA05T0165000ZY	0	+	0	0	3816	0.0000000
zheyou73v0_A05	11659999	11664349	BnaA05T0165100ZY	0	-	0	0	4350	0.0000000
zheyou73v0_A05	11678898	11688536	BnaA05T0165200ZY	0	+	0	0	9638	0.0000000
zheyou73v0_A05	11689763	11695612	BnaA05T0165300ZY	0	+	0	0	5849	0.0000000
zheyou73v0_A05	11695773	11697088	BnaA05T0165400ZY	0	-	0	0	1315	0.0000000
zheyou73v0_A05	11697816	11700574	BnaA05T0165500ZY	0	-	0	0	2758	0.0000000
zheyou73v0_A05	11708803	11710794	BnaA05T0165600ZY	0	-	0	0	1991	0.0000000
zheyou73v0_A05	11711948	11713763	BnaA05T0165700ZY	0	+	0	0	1815	0.0000000
zheyou73v0_A05	11720751	11721543	BnaA05T0165800ZY	0	-	0	0	792	0.0000000
zheyou73v0_A05	11727101	11730544	BnaA05T0165900ZY	0	-	0	0	3443	0.0000000
zheyou73v0_A05	11746320	11749494	BnaA05T0166000ZY	0	+	0	0	3174	0.0000000
zheyou73v0_A05	11746320	11749494	BnaA05T0166000ZY.1	0	+	0	0	3174	0.0000000
zheyou73v0_A05	11751986	11753197	BnaA05T0166100ZY	0	-	0	0	1211	0.0000000
zheyou73v0_A05	11761676	11761949	BnaA05T0166200ZY	0	-	0	0	273	0.0000000
zheyou73v0_A05	11775882	11777911	BnaA05T0166300ZY	0	+	0	0	2029	0.0000000
zheyou73v0_A05	11785044	11787306	BnaA05T0166400ZY	0	+	0	0	2262	0.0000000
zheyou73v0_A05	11788674	11791370	BnaA05T0166500ZY	0	-	0	0	2696	0.0000000
zheyou73v0_A05	11793490	11795732	BnaA05T0166600ZY	0	+	0	0	2242	0.0000000
zheyou73v0_A05	11804136	11805634	BnaA05T0166700ZY	0	+	0	0	1498	0.0000000
zheyou73v0_A05	11808761	11812183	BnaA05T0166800ZY	0	+	0	0	3422	0.0000000
zheyou73v0_A05	11872450	11875019	BnaA05T0166900ZY	0	+	0	0	2569	0.0000000
zheyou73v0_A05	11880171	11881715	BnaA05T0167000ZY	0	-	0	0	1544	0.0000000
zheyou73v0_A05	11885230	11887223	BnaA05T0167100ZY	0	+	0	0	1993	0.0000000
zheyou73v0_A05	11890675	11897533	BnaA05T0167200ZY	0	-	0	0	6858	0.0000000
zheyou73v0_A05	11899438	11899813	BnaA05T0167300ZY	0	-	0	0	375	0.0000000
zheyou73v0_A05	11926052	11931136	BnaA05T0167400ZY	0	+	0	0	5084	0.0000000
zheyou73v0_A05	11934504	11935199	BnaA05T0167500ZY	0	-	0	0	695	0.0000000
zheyou73v0_A05	11976700	11977095	BnaA05T0167600ZY	0	-	0	0	395	0.0000000
zheyou73v0_A05	12000496	12004140	BnaA05T0167700ZY	0	-	0	0	3644	0.0000000
zheyou73v0_A05	12037824	12042283	BnaA05T0167800ZY	0	+	0	0	4459	0.0000000
zheyou73v0_A05	12047000	12049477	BnaA05T0167900ZY	0	-	0	0	2477	0.0000000
zheyou73v0_A05	12071223	12075171	BnaA05T0168000ZY	0	-	0	0	3948	0.0000000
zheyou73v0_A05	12080282	12082116	BnaA05T0168100ZY	0	+	0	0	1834	0.0000000
zheyou73v0_A05	12098981	12102463	BnaA05T0168200ZY	0	-	0	0	3482	0.0000000
zheyou73v0_A05	12103896	12104214	BnaA05T0168300ZY	0	-	0	0	318	0.0000000
zheyou73v0_A05	12104955	12105853	BnaA05T0168400ZY	0	+	0	0	898	0.0000000
zheyou73v0_A05	12140997	12143036	BnaA05T0168500ZY	0	+	0	0	2039	0.0000000
zheyou73v0_A05	12143216	12144251	BnaA05T0168600ZY	0	-	0	0	1035	0.0000000
zheyou73v0_A05	12146701	12148243	BnaA05T0168700ZY	0	-	0	0	1542	0.0000000
zheyou73v0_A05	12148644	12149318	BnaA05T0168800ZY	0	-	0	0	674	0.0000000
zheyou73v0_A05	12155103	12162338	BnaA05T0168900ZY	0	-	0	0	7235	0.0000000
zheyou73v0_A05	12177922	12187438	BnaA05T0169000ZY	0	+	0	0	9516	0.0000000
zheyou73v0_A05	12189347	12191036	BnaA05T0169100ZY	0	+	0	0	1689	0.0000000
zheyou73v0_A05	12201458	12204370	BnaA05T0169200ZY	0	-	0	0	2912	0.0000000
zheyou73v0_A05	12209221	12209875	BnaA05T0169300ZY	0	-	0	0	654	0.0000000
zheyou73v0_A05	12216221	12217567	BnaA05T0169400ZY	0	+	0	0	1346	0.0000000
zheyou73v0_A05	12217874	12218479	BnaA05T0169500ZY	0	-	0	0	605	0.0000000
zheyou73v0_A05	12220857	12221145	BnaA05T0169600ZY	0	-	0	0	288	0.0000000
zheyou73v0_A05	12221760	12225474	BnaA05T0169700ZY	0	+	0	0	3714	0.0000000
zheyou73v0_A05	12227247	12227421	BnaA05T0169800ZY	0	+	0	0	174	0.0000000
zheyou73v0_A05	12229863	12234350	BnaA05T0169900ZY	0	+	0	0	4487	0.0000000
zheyou73v0_A05	12272946	12275686	BnaA05T0170000ZY	0	+	0	0	2740	0.0000000
zheyou73v0_A05	12276960	12277938	BnaA05T0170100ZY	0	+	0	0	978	0.0000000
zheyou73v0_A05	12304392	12309066	BnaA05T0170200ZY	0	+	0	0	4674	0.0000000
zheyou73v0_A05	12328503	12330407	BnaA05T0170300ZY	0	-	0	0	1904	0.0000000
zheyou73v0_A05	12330560	12331189	BnaA05T0170400ZY	0	-	0	0	629	0.0000000
zheyou73v0_A05	12354594	12357269	BnaA05T0170500ZY	0	-	0	0	2675	0.0000000
zheyou73v0_A05	12373628	12374400	BnaA05T0170600ZY	0	-	0	0	772	0.0000000
zheyou73v0_A05	12374817	12377428	BnaA05T0170700ZY	0	-	0	0	2611	0.0000000
zheyou73v0_A05	12374817	12377428	BnaA05T0170700ZY.1	0	-	0	0	2611	0.0000000
zheyou73v0_A05	12377978	12385565	BnaA05T0170800ZY	0	+	0	0	7587	0.0000000
zheyou73v0_A05	12442590	12443588	BnaA05T0170900ZY	0	+	0	0	998	0.0000000
zheyou73v0_A05	12443918	12446112	BnaA05T0171000ZY	0	-	0	0	2194	0.0000000
zheyou73v0_A05	12448450	12451820	BnaA05T0171100ZY	0	-	0	0	3370	0.0000000
zheyou73v0_A05	12459512	12460033	BnaA05T0171200ZY	0	-	0	0	521	0.0000000
zheyou73v0_A05	12478938	12479685	BnaA05T0171300ZY	0	+	0	0	747	0.0000000
zheyou73v0_A05	12512348	12514496	BnaA05T0171400ZY	0	-	0	0	2148	0.0000000
zheyou73v0_A05	12528225	12529974	BnaA05T0171500ZY	0	-	0	0	1749	0.0000000
zheyou73v0_A05	12528225	12529974	BnaA05T0171500ZY.1	0	-	0	0	1749	0.0000000
zheyou73v0_A05	12530651	12532668	BnaA05T0171600ZY	0	+	0	0	2017	0.0000000
zheyou73v0_A05	12565405	12566737	BnaA05T0171700ZY	0	+	0	0	1332	0.0000000
zheyou73v0_A05	12565405	12566737	BnaA05T0171700ZY.1	0	+	0	0	1332	0.0000000
zheyou73v0_A05	12573255	12573603	BnaA05T0171800ZY	0	-	0	0	348	0.0000000
zheyou73v0_A05	12579618	12580315	BnaA05T0171900ZY	0	+	0	0	697	0.0000000
zheyou73v0_A05	12581118	12581621	BnaA05T0172000ZY	0	-	0	0	503	0.0000000
zheyou73v0_A05	12584783	12590050	BnaA05T0172100ZY	0	-	0	0	5267	0.0000000
zheyou73v0_A05	12604908	12607330	BnaA05T0172200ZY	0	-	0	0	2422	0.0000000
zheyou73v0_A05	12609468	12612537	BnaA05T0172300ZY	0	-	0	0	3069	0.0000000
zheyou73v0_A05	12613140	12619528	BnaA05T0172400ZY	0	+	0	0	6388	0.0000000
zheyou73v0_A05	12633103	12636128	BnaA05T0172500ZY	0	-	0	0	3025	0.0000000
zheyou73v0_A05	12675218	12675578	BnaA05T0172600ZY	0	+	0	0	360	0.0000000
zheyou73v0_A05	12680753	12698445	BnaA05T0172700ZY	0	+	0	0	17692	0.0000000
zheyou73v0_A05	12701218	12703338	BnaA05T0172800ZY	0	-	0	0	2120	0.0000000
zheyou73v0_A05	12705653	12706202	BnaA05T0172900ZY	0	-	0	0	549	0.0000000
zheyou73v0_A05	12706278	12707228	BnaA05T0173000ZY	0	-	0	0	950	0.0000000
zheyou73v0_A05	12728161	12730419	BnaA05T0173100ZY	0	+	0	0	2258	0.0000000
zheyou73v0_A05	12732018	12732995	BnaA05T0173200ZY	0	-	0	0	977	0.0000000
zheyou73v0_A05	12734343	12735534	BnaA05T0173300ZY	0	+	0	0	1191	0.0000000
zheyou73v0_A05	12741632	12746360	BnaA05T0173400ZY	0	-	0	0	4728	0.0000000
zheyou73v0_A05	12747061	12749508	BnaA05T0173500ZY	0	-	0	0	2447	0.0000000
zheyou73v0_A05	12768698	12770589	BnaA05T0173600ZY	0	-	0	0	1891	0.0000000
zheyou73v0_A05	12781627	12782197	BnaA05T0173700ZY	0	-	0	0	570	0.0000000
zheyou73v0_A05	12794120	12795975	BnaA05T0173800ZY	0	+	0	0	1855	0.0000000
zheyou73v0_A05	12804204	12816325	BnaA05T0173900ZY	0	-	0	0	12121	0.0000000
zheyou73v0_A05	12817564	12819356	BnaA05T0174000ZY	0	-	0	0	1792	0.0000000
zheyou73v0_A05	12819705	12820909	BnaA05T0174100ZY	0	+	0	0	1204	0.0000000
zheyou73v0_A05	12821452	12823409	BnaA05T0174200ZY	0	-	0	0	1957	0.0000000
zheyou73v0_A05	12828050	12830552	BnaA05T0174300ZY	0	+	0	0	2502	0.0000000
zheyou73v0_A05	12832364	12833966	BnaA05T0174400ZY	0	-	0	0	1602	0.0000000
zheyou73v0_A05	12832364	12833966	BnaA05T0174400ZY.1	0	-	0	0	1602	0.0000000
zheyou73v0_A05	12861403	12863115	BnaA05T0174500ZY	0	+	0	0	1712	0.0000000
zheyou73v0_A05	12863234	12864712	BnaA05T0174600ZY	0	-	0	0	1478	0.0000000
zheyou73v0_A05	12863234	12864712	BnaA05T0174600ZY.1	0	-	0	0	1478	0.0000000
zheyou73v0_A05	12892375	12892546	BnaA05T0174700ZY	0	-	0	0	171	0.0000000
zheyou73v0_A05	12914610	12914970	BnaA05T0174800ZY	0	+	0	0	360	0.0000000
zheyou73v0_A05	12919459	12919833	BnaA05T0174900ZY	0	+	0	0	374	0.0000000
zheyou73v0_A05	12931259	12932894	BnaA05T0175000ZY	0	+	0	0	1635	0.0000000
zheyou73v0_A05	12951200	12955782	BnaA05T0175100ZY	0	-	0	0	4582	0.0000000
zheyou73v0_A05	12957263	12959105	BnaA05T0175200ZY	0	-	0	0	1842	0.0000000
zheyou73v0_A05	12959583	12960153	BnaA05T0175300ZY	0	-	0	0	570	0.0000000
zheyou73v0_A05	12961163	12972830	BnaA05T0175400ZY	0	-	0	0	11667	0.0000000
zheyou73v0_A05	12961163	12972661	BnaA05T0175400ZY.1	0	-	0	0	11498	0.0000000
zheyou73v0_A05	12977272	12988725	BnaA05T0175500ZY	0	-	0	0	11453	0.0000000
zheyou73v0_A05	12999988	13001101	BnaA05T0175600ZY	0	+	0	0	1113	0.0000000
zheyou73v0_A05	13024169	13024777	BnaA05T0175700ZY	0	+	0	0	608	0.0000000
zheyou73v0_A05	13043085	13044984	BnaA05T0175800ZY	0	-	0	0	1899	0.0000000
zheyou73v0_A05	13062427	13063432	BnaA05T0175900ZY	0	+	0	0	1005	0.0000000
zheyou73v0_A05	13062427	13063432	BnaA05T0175900ZY.1	0	+	0	0	1005	0.0000000
zheyou73v0_A05	13093343	13094848	BnaA05T0176000ZY	0	+	0	0	1505	0.0000000
zheyou73v0_A05	13093343	13094848	BnaA05T0176000ZY.1	0	+	0	0	1505	0.0000000
zheyou73v0_A05	13114601	13116958	BnaA05T0176100ZY	0	-	0	0	2357	0.0000000
zheyou73v0_A05	13128954	13130823	BnaA05T0176200ZY	0	+	0	0	1869	0.0000000
zheyou73v0_A05	13137483	13137702	BnaA05T0176300ZY	0	+	0	0	219	0.0000000
zheyou73v0_A05	13141601	13144154	BnaA05T0176400ZY	0	+	0	0	2553	0.0000000
zheyou73v0_A05	13144334	13147360	BnaA05T0176500ZY	0	-	0	0	3026	0.0000000
zheyou73v0_A05	13150659	13151637	BnaA05T0176600ZY	0	+	0	0	978	0.0000000
zheyou73v0_A05	13154892	13157783	BnaA05T0176700ZY	0	+	0	0	2891	0.0000000
zheyou73v0_A05	13161118	13161726	BnaA05T0176800ZY	0	-	0	0	608	0.0000000
zheyou73v0_A05	13176474	13177250	BnaA05T0176900ZY	0	+	0	0	776	0.0000000
zheyou73v0_A05	13182211	13182605	BnaA05T0177000ZY	0	+	0	0	394	0.0000000
zheyou73v0_A05	13183104	13184423	BnaA05T0177100ZY	0	+	0	0	1319	0.0000000
zheyou73v0_A05	13190566	13193216	BnaA05T0177200ZY	0	-	0	0	2650	0.0000000
zheyou73v0_A05	13201326	13207429	BnaA05T0177300ZY	0	+	0	0	6103	0.0000000
zheyou73v0_A05	13220036	13222169	BnaA05T0177400ZY	0	-	0	0	2133	0.0000000
zheyou73v0_A05	13222582	13223888	BnaA05T0177500ZY	0	+	0	0	1306	0.0000000
zheyou73v0_A05	13272734	13274370	BnaA05T0177600ZY	0	+	0	0	1636	0.0000000
zheyou73v0_A05	13281819	13287854	BnaA05T0177700ZY	0	+	0	0	6035	0.0000000
zheyou73v0_A05	13300862	13301473	BnaA05T0177800ZY	0	-	0	0	611	0.0000000
zheyou73v0_A05	13312846	13313151	BnaA05T0177900ZY	0	+	0	0	305	0.0000000
zheyou73v0_A05	13325788	13326543	BnaA05T0178000ZY	0	+	0	0	755	0.0000000
zheyou73v0_A05	13338973	13344373	BnaA05T0178100ZY	0	+	0	0	5400	0.0000000
zheyou73v0_A05	13352433	13357526	BnaA05T0178200ZY	0	+	0	0	5093	0.0000000
zheyou73v0_A05	13357826	13358669	BnaA05T0178300ZY	0	+	0	0	843	0.0000000
zheyou73v0_A05	13372692	13377214	BnaA05T0178400ZY	0	+	0	0	4522	0.0000000
zheyou73v0_A05	13380082	13384217	BnaA05T0178500ZY	0	-	0	0	4135	0.0000000
zheyou73v0_A05	13389811	13390935	BnaA05T0178600ZY	0	+	0	0	1124	0.0000000
zheyou73v0_A05	13396886	13397605	BnaA05T0178700ZY	0	+	0	0	719	0.0000000
zheyou73v0_A05	13400495	13401230	BnaA05T0178800ZY	0	+	0	0	735	0.0000000
zheyou73v0_A05	13421602	13422202	BnaA05T0178900ZY	0	-	0	0	600	0.0000000
zheyou73v0_A05	13425821	13427493	BnaA05T0179000ZY	0	+	0	0	1672	0.0000000
zheyou73v0_A05	13427607	13428599	BnaA05T0179100ZY	0	-	0	0	992	0.0000000
zheyou73v0_A05	13443685	13444727	BnaA05T0179200ZY	0	-	0	0	1042	0.0000000
zheyou73v0_A05	13446933	13447579	BnaA05T0179300ZY	0	+	0	0	646	0.0000000
zheyou73v0_A05	13460120	13462159	BnaA05T0179400ZY	0	-	0	0	2039	0.0000000
zheyou73v0_A05	13550932	13551668	BnaA05T0179500ZY	0	+	0	0	736	0.0000000
zheyou73v0_A05	13552020	13553426	BnaA05T0179600ZY	0	-	0	0	1406	0.0000000
zheyou73v0_A05	13630301	13633040	BnaA05T0179700ZY	0	-	0	0	2739	0.0000000
zheyou73v0_A05	13642516	13643941	BnaA05T0179800ZY	0	+	0	0	1425	0.0000000
zheyou73v0_A05	13655910	13656840	BnaA05T0179900ZY	0	+	0	0	930	0.0000000
zheyou73v0_A05	13657103	13658068	BnaA05T0180000ZY	0	-	0	0	965	0.0000000
zheyou73v0_A05	13660908	13669673	BnaA05T0180100ZY	0	-	0	0	8765	0.0000000
zheyou73v0_A05	13672626	13674160	BnaA05T0180200ZY	0	-	0	0	1534	0.0000000
zheyou73v0_A05	13678451	13679175	BnaA05T0180300ZY	0	+	0	0	724	0.0000000
zheyou73v0_A05	13685564	13685906	BnaA05T0180400ZY	0	+	0	0	342	0.0000000
zheyou73v0_A05	13690521	13695420	BnaA05T0180500ZY	0	-	0	0	4899	0.0000000
zheyou73v0_A05	13699448	13700893	BnaA05T0180600ZY	0	-	0	0	1445	0.0000000
zheyou73v0_A05	13702704	13703472	BnaA05T0180700ZY	0	-	0	0	768	0.0000000
zheyou73v0_A05	13705842	13707539	BnaA05T0180800ZY	0	+	0	0	1697	0.0000000
zheyou73v0_A05	13734572	13743581	BnaA05T0180900ZY	0	-	0	0	9009	0.0000000
zheyou73v0_A05	13746161	13754708	BnaA05T0181000ZY	0	+	0	0	8547	0.0000000
zheyou73v0_A05	13760793	13762705	BnaA05T0181100ZY	0	-	0	0	1912	0.0000000
zheyou73v0_A05	13763146	13763602	BnaA05T0181200ZY	0	+	0	0	456	0.0000000
zheyou73v0_A05	13765447	13768235	BnaA05T0181300ZY	0	+	0	0	2788	0.0000000
zheyou73v0_A05	13765447	13768235	BnaA05T0181300ZY.1	0	+	0	0	2788	0.0000000
zheyou73v0_A05	13834529	13834823	BnaA05T0181400ZY	0	-	0	0	294	0.0000000
zheyou73v0_A05	13847451	13850229	BnaA05T0181500ZY	0	-	0	0	2778	0.0000000
zheyou73v0_A05	13857424	13859423	BnaA05T0181600ZY	0	+	0	0	1999	0.0000000
zheyou73v0_A05	13892302	13893646	BnaA05T0181700ZY	0	+	0	0	1344	0.0000000
zheyou73v0_A05	13901915	13902276	BnaA05T0181800ZY	0	-	0	0	361	0.0000000
zheyou73v0_A05	13914014	13915817	BnaA05T0181900ZY	0	-	0	0	1803	0.0000000
zheyou73v0_A05	13927343	13927751	BnaA05T0182000ZY	0	+	0	0	408	0.0000000
zheyou73v0_A05	13949032	13951974	BnaA05T0182100ZY	0	+	0	0	2942	0.0000000
zheyou73v0_A05	13952214	13953594	BnaA05T0182200ZY	0	-	0	0	1380	0.0000000
zheyou73v0_A05	13958408	13965047	BnaA05T0182300ZY	0	-	0	0	6639	0.0000000
zheyou73v0_A05	13966823	13969444	BnaA05T0182400ZY	0	+	0	0	2621	0.0000000
zheyou73v0_A05	14023548	14026423	BnaA05T0182500ZY	0	+	0	0	2875	0.0000000
zheyou73v0_A05	14037313	14038866	BnaA05T0182600ZY	0	+	0	0	1553	0.0000000
zheyou73v0_A05	14043044	14044849	BnaA05T0182700ZY	0	-	0	0	1805	0.0000000
zheyou73v0_A05	14095569	14096507	BnaA05T0182800ZY	0	-	0	0	938	0.0000000
zheyou73v0_A05	14114681	14117374	BnaA05T0182900ZY	0	+	0	0	2693	0.0000000
zheyou73v0_A05	14118563	14118989	BnaA05T0183000ZY	0	-	0	0	426	0.0000000
zheyou73v0_A05	14120354	14120765	BnaA05T0183100ZY	0	-	0	0	411	0.0000000
zheyou73v0_A05	14133751	14135406	BnaA05T0183200ZY	0	+	0	0	1655	0.0000000
zheyou73v0_A05	14135465	14139530	BnaA05T0183300ZY	0	-	0	0	4065	0.0000000
zheyou73v0_A05	14148612	14150060	BnaA05T0183400ZY	0	+	0	0	1448	0.0000000
zheyou73v0_A05	14150448	14152279	BnaA05T0183500ZY	0	-	0	0	1831	0.0000000
zheyou73v0_A05	14234944	14235145	BnaA05T0183600ZY	0	-	0	0	201	0.0000000
zheyou73v0_A05	14237126	14238337	BnaA05T0183700ZY	0	+	0	0	1211	0.0000000
zheyou73v0_A05	14238491	14238958	BnaA05T0183800ZY	0	+	0	0	467	0.0000000
zheyou73v0_A05	14244434	14246027	BnaA05T0183900ZY	0	-	0	0	1593	0.0000000
zheyou73v0_A05	14246946	14247275	BnaA05T0184000ZY	0	-	0	0	329	0.0000000
zheyou73v0_A05	14252274	14253485	BnaA05T0184100ZY	0	+	0	0	1211	0.0000000
zheyou73v0_A05	14253639	14254106	BnaA05T0184200ZY	0	+	0	0	467	0.0000000
zheyou73v0_A05	14254656	14255326	BnaA05T0184300ZY	0	-	0	0	670	0.0000000
zheyou73v0_A05	14276421	14277908	BnaA05T0184400ZY	0	-	0	0	1487	0.0000000
zheyou73v0_A05	14285991	14286458	BnaA05T0184500ZY	0	-	0	0	467	0.0000000
zheyou73v0_A05	14286612	14287823	BnaA05T0184600ZY	0	-	0	0	1211	0.0000000
zheyou73v0_A05	14299956	14300124	BnaA05T0184700ZY	0	+	0	0	168	0.0000000
zheyou73v0_A05	14300830	14302898	BnaA05T0184800ZY	0	-	0	0	2068	0.0000000
zheyou73v0_A05	14315545	14315713	BnaA05T0184900ZY	0	+	0	0	168	0.0000000
zheyou73v0_A05	14316419	14337522	BnaA05T0185000ZY	0	-	0	0	21103	0.0000000
zheyou73v0_A05	14337676	14338887	BnaA05T0185100ZY	0	-	0	0	1211	0.0000000
zheyou73v0_A05	14346973	14347234	BnaA05T0185200ZY	0	-	0	0	261	0.0000000
zheyou73v0_A05	14348112	14349876	BnaA05T0185300ZY	0	-	0	0	1764	0.0000000
zheyou73v0_A05	14351273	14351657	BnaA05T0185400ZY	0	+	0	0	384	0.0000000
zheyou73v0_A05	14352574	14352742	BnaA05T0185500ZY	0	+	0	0	168	0.0000000
zheyou73v0_A05	14353410	14355740	BnaA05T0185600ZY	0	-	0	0	2330	0.0000000
zheyou73v0_A05	14359963	14361450	BnaA05T0185700ZY	0	+	0	0	1487	0.0000000
zheyou73v0_A05	14361501	14361877	BnaA05T0185800ZY	0	-	0	0	376	0.0000000
zheyou73v0_A05	14361999	14362466	BnaA05T0185900ZY	0	-	0	0	467	0.0000000
zheyou73v0_A05	14362778	14363831	BnaA05T0186000ZY	0	-	0	0	1053	0.0000000
zheyou73v0_A05	14368571	14370058	BnaA05T0186100ZY	0	+	0	0	1487	0.0000000
zheyou73v0_A05	14370109	14371430	BnaA05T0186200ZY	0	-	0	0	1321	0.0000000
zheyou73v0_A05	14377879	14378047	BnaA05T0186300ZY	0	+	0	0	168	0.0000000
zheyou73v0_A05	14382592	14382760	BnaA05T0186400ZY	0	-	0	0	168	0.0000000
zheyou73v0_A05	14623666	14623834	BnaA05T0186500ZY	0	-	0	0	168	0.0000000
zheyou73v0_A05	14627994	14630612	BnaA05T0186600ZY	0	-	0	0	2618	0.0000000
zheyou73v0_A05	14661243	14661952	BnaA05T0186700ZY	0	-	0	0	709	0.0000000
zheyou73v0_A05	14678954	14679185	BnaA05T0186800ZY	0	+	0	0	231	0.0000000
zheyou73v0_A05	14713365	14715433	BnaA05T0186900ZY	0	-	0	0	2068	0.0000000
zheyou73v0_A05	14737278	14738194	BnaA05T0187000ZY	0	-	0	0	916	0.0000000
zheyou73v0_A05	14738843	14739140	BnaA05T0187100ZY	0	+	0	0	297	0.0000000
zheyou73v0_A05	14901525	14901992	BnaA05T0187200ZY	0	-	0	0	467	0.0000000
zheyou73v0_A05	14902147	14903358	BnaA05T0187300ZY	0	-	0	0	1211	0.0000000
zheyou73v0_A05	14908852	14909020	BnaA05T0187400ZY	0	+	0	0	168	0.0000000
zheyou73v0_A05	14909726	14911007	BnaA05T0187500ZY	0	-	0	0	1281	0.0000000
zheyou73v0_A05	14917533	14917701	BnaA05T0187600ZY	0	+	0	0	168	0.0000000
zheyou73v0_A05	14925099	14926064	BnaA05T0187700ZY	0	-	0	0	965	0.0000000
zheyou73v0_A05	14926218	14927422	BnaA05T0187800ZY	0	-	0	0	1204	0.0000000
zheyou73v0_A05	14960149	14960317	BnaA05T0187900ZY	0	+	0	0	168	0.0000000
zheyou73v0_A05	14960783	14960972	BnaA05T0188000ZY	0	+	0	0	189	0.0000000
zheyou73v0_A05	14961521	14961988	BnaA05T0188100ZY	0	-	0	0	467	0.0000000
zheyou73v0_A05	14962141	14963352	BnaA05T0188200ZY	0	-	0	0	1211	0.0000000
zheyou73v0_A05	14974776	14975834	BnaA05T0188300ZY	0	+	0	0	1058	0.0000000
zheyou73v0_A05	14979329	14980988	BnaA05T0188400ZY	0	+	0	0	1659	0.0000000
zheyou73v0_A05	14983776	14985435	BnaA05T0188500ZY	0	+	0	0	1659	0.0000000
zheyou73v0_A05	14988393	14990052	BnaA05T0188600ZY	0	+	0	0	1659	0.0000000
zheyou73v0_A05	15004437	15005718	BnaA05T0188700ZY	0	+	0	0	1281	0.0000000
zheyou73v0_A05	15022135	15024465	BnaA05T0188800ZY	0	+	0	0	2330	0.0000000
zheyou73v0_A05	15024516	15026006	BnaA05T0188900ZY	0	-	0	0	1490	0.0000000
zheyou73v0_A05	15060140	15061322	BnaA05T0189000ZY	0	+	0	0	1182	0.0000000
zheyou73v0_A05	15063427	15063583	BnaA05T0189100ZY	0	+	0	0	156	0.0000000
zheyou73v0_A05	15065871	15067519	BnaA05T0189200ZY	0	+	0	0	1648	0.0000000
zheyou73v0_A05	15069295	15071363	BnaA05T0189300ZY	0	+	0	0	2068	0.0000000
zheyou73v0_A05	15072796	15073636	BnaA05T0189400ZY	0	-	0	0	840	0.0000000
zheyou73v0_A05	15101268	15101436	BnaA05T0189500ZY	0	+	0	0	168	0.0000000
zheyou73v0_A05	15102144	15103108	BnaA05T0189600ZY	0	-	0	0	964	0.0000000
zheyou73v0_A05	15103261	15104473	BnaA05T0189700ZY	0	-	0	0	1212	0.0000000
zheyou73v0_A05	15110344	15110557	BnaA05T0189800ZY	0	+	0	0	213	0.0000000
zheyou73v0_A05	15111219	15113286	BnaA05T0189900ZY	0	-	0	0	2067	0.0000000
zheyou73v0_A05	15118283	15119088	BnaA05T0190000ZY	0	-	0	0	805	0.0000000
zheyou73v0_A05	15119419	15121308	BnaA05T0190100ZY	0	+	0	0	1889	0.0000000
zheyou73v0_A05	15122709	15123514	BnaA05T0190200ZY	0	-	0	0	805	0.0000000
zheyou73v0_A05	15432910	15439918	BnaA05T0190300ZY	0	-	0	0	7008	0.0000000
zheyou73v0_A05	15442058	15447104	BnaA05T0190400ZY	0	-	0	0	5046	0.0000000
zheyou73v0_A05	15502107	15502275	BnaA05T0190500ZY	0	+	0	0	168	0.0000000
zheyou73v0_A05	15502293	15502822	BnaA05T0190600ZY	0	+	0	0	529	0.0000000
zheyou73v0_A05	15502938	15504224	BnaA05T0190700ZY	0	-	0	0	1286	0.0000000
zheyou73v0_A05	15654923	15655390	BnaA05T0190800ZY	0	-	0	0	467	0.0000000
zheyou73v0_A05	15655544	15656755	BnaA05T0190900ZY	0	-	0	0	1211	0.0000000
zheyou73v0_A05	15669103	15669345	BnaA05T0191000ZY	0	+	0	0	242	0.0000000
zheyou73v0_A05	15670262	15670430	BnaA05T0191100ZY	0	+	0	0	168	0.0000000
zheyou73v0_A05	15671136	15672101	BnaA05T0191200ZY	0	-	0	0	965	0.0000000
zheyou73v0_A05	15672255	15673448	BnaA05T0191300ZY	0	-	0	0	1193	0.0000000
zheyou73v0_A05	15686826	15687293	BnaA05T0191400ZY	0	-	0	0	467	0.0000000
zheyou73v0_A05	15687447	15688658	BnaA05T0191500ZY	0	-	0	0	1211	0.0000000
zheyou73v0_A05	15689306	15693401	BnaA05T0191600ZY	0	+	0	0	4095	0.0000000
zheyou73v0_A05	15710881	15711969	BnaA05T0191700ZY	0	+	0	0	1088	0.0000000
zheyou73v0_A05	15712020	15714088	BnaA05T0191800ZY	0	-	0	0	2068	0.0000000
zheyou73v0_A05	15724622	15725089	BnaA05T0191900ZY	0	+	0	0	467	0.0000000
zheyou73v0_A05	15749751	15750962	BnaA05T0192000ZY	0	+	0	0	1211	0.0000000
zheyou73v0_A05	15752158	15753210	BnaA05T0192100ZY	0	+	0	0	1052	0.0000000
zheyou73v0_A05	15770418	15775938	BnaA05T0192200ZY	0	+	0	0	5520	0.0000000
zheyou73v0_A05	15786497	15787984	BnaA05T0192300ZY	0	+	0	0	1487	0.0000000
zheyou73v0_A05	15788035	15789000	BnaA05T0192400ZY	0	-	0	0	965	0.0000000
zheyou73v0_A05	15789195	15790102	BnaA05T0192500ZY	0	-	0	0	907	0.0000000
zheyou73v0_A05	15803835	15805310	BnaA05T0192600ZY	0	+	0	0	1475	0.0000000
zheyou73v0_A05	15805859	15806287	BnaA05T0192700ZY	0	-	0	0	428	0.0000000
zheyou73v0_A05	15806441	15807652	BnaA05T0192800ZY	0	-	0	0	1211	0.0000000
zheyou73v0_A05	15813301	15813768	BnaA05T0192900ZY	0	-	0	0	467	0.0000000
zheyou73v0_A05	15829420	15829588	BnaA05T0193000ZY	0	+	0	0	168	0.0000000
zheyou73v0_A05	15830294	15832354	BnaA05T0193100ZY	0	-	0	0	2060	0.0000000
zheyou73v0_A05	15840672	15840876	BnaA05T0193200ZY	0	+	0	0	204	0.0000000
zheyou73v0_A05	15841793	15841961	BnaA05T0193300ZY	0	+	0	0	168	0.0000000
zheyou73v0_A05	15842667	15843632	BnaA05T0193400ZY	0	-	0	0	965	0.0000000
zheyou73v0_A05	15849630	15850480	BnaA05T0193500ZY	0	-	0	0	850	0.0000000
zheyou73v0_A05	15856445	15857656	BnaA05T0193600ZY	0	-	0	0	1211	0.0000000
zheyou73v0_A05	15863867	15864251	BnaA05T0193700ZY	0	-	0	0	384	0.0000000
zheyou73v0_A05	15867705	15868609	BnaA05T0193800ZY	0	-	0	0	904	0.0000000
zheyou73v0_A05	15872529	15872997	BnaA05T0193900ZY	0	-	0	0	468	0.0000000
zheyou73v0_A05	15887895	15891404	BnaA05T0194000ZY	0	-	0	0	3509	0.0000000
zheyou73v0_A05	15904807	15905844	BnaA05T0194100ZY	0	-	0	0	1037	0.0000000
zheyou73v0_A05	15906156	15907208	BnaA05T0194200ZY	0	-	0	0	1052	0.0000000
zheyou73v0_A05	15925791	15927072	BnaA05T0194300ZY	0	-	0	0	1281	0.0000000
zheyou73v0_A05	15933067	15933889	BnaA05T0194400ZY	0	+	0	0	822	0.0000000
zheyou73v0_A05	15934438	15934905	BnaA05T0194500ZY	0	-	0	0	467	0.0000000
zheyou73v0_A05	15935089	15936269	BnaA05T0194600ZY	0	-	0	0	1180	0.0000000
zheyou73v0_A05	15937993	15939204	BnaA05T0194700ZY	0	-	0	0	1211	0.0000000
zheyou73v0_A05	15954987	15955497	BnaA05T0194800ZY	0	+	0	0	510	0.0000000
zheyou73v0_A05	15955852	15956056	BnaA05T0194900ZY	0	+	0	0	204	0.0000000
zheyou73v0_A05	15963180	15963647	BnaA05T0195000ZY	0	-	0	0	467	0.0000000
zheyou73v0_A05	15966915	15967721	BnaA05T0195100ZY	0	-	0	0	806	0.0000000
zheyou73v0_A05	15971710	15971878	BnaA05T0195200ZY	0	+	0	0	168	0.0000000
zheyou73v0_A05	15972585	15985911	BnaA05T0195300ZY	0	-	0	0	13326	0.0000000
zheyou73v0_A05	15986065	15987277	BnaA05T0195400ZY	0	-	0	0	1212	0.0000000
zheyou73v0_A05	15996809	15997276	BnaA05T0195500ZY	0	-	0	0	467	0.0000000
zheyou73v0_A05	16004663	16005419	BnaA05T0195600ZY	0	+	0	0	756	0.0000000
zheyou73v0_A05	16008014	16008182	BnaA05T0195700ZY	0	+	0	0	168	0.0000000
zheyou73v0_A05	16008888	16009264	BnaA05T0195800ZY	0	-	0	0	376	0.0000000
zheyou73v0_A05	16009386	16009853	BnaA05T0195900ZY	0	-	0	0	467	0.0000000
zheyou73v0_A05	16010007	16011219	BnaA05T0196000ZY	0	-	0	0	1212	0.0000000
zheyou73v0_A05	16016683	16017506	BnaA05T0196100ZY	0	+	0	0	823	0.0000000
zheyou73v0_A05	16017557	16019625	BnaA05T0196200ZY	0	-	0	0	2068	0.0000000
zheyou73v0_A05	16022712	16023024	BnaA05T0196300ZY	0	+	0	0	312	0.0000000
zheyou73v0_A05	16031355	16033153	BnaA05T0196400ZY	0	-	0	0	1798	0.0000000
zheyou73v0_A05	16036318	16037178	BnaA05T0196500ZY	0	+	0	0	860	0.0000000
zheyou73v0_A05	16037229	16039296	BnaA05T0196600ZY	0	-	0	0	2067	0.0000000
zheyou73v0_A05	16045032	16045858	BnaA05T0196700ZY	0	+	0	0	826	0.0000000
zheyou73v0_A05	16046407	16046874	BnaA05T0196800ZY	0	-	0	0	467	0.0000000
zheyou73v0_A05	16050317	16050784	BnaA05T0196900ZY	0	-	0	0	467	0.0000000
zheyou73v0_A05	16054654	16056141	BnaA05T0197000ZY	0	+	0	0	1487	0.0000000
zheyou73v0_A05	16056690	16057157	BnaA05T0197100ZY	0	-	0	0	467	0.0000000
zheyou73v0_A05	16057312	16058510	BnaA05T0197200ZY	0	-	0	0	1198	0.0000000
zheyou73v0_A05	16068793	16070167	BnaA05T0197300ZY	0	+	0	0	1374	0.0000000
zheyou73v0_A05	16070326	16071291	BnaA05T0197400ZY	0	-	0	0	965	0.0000000
zheyou73v0_A05	16078114	16078975	BnaA05T0197500ZY	0	+	0	0	861	0.0000000
zheyou73v0_A05	16079524	16079991	BnaA05T0197600ZY	0	-	0	0	467	0.0000000
zheyou73v0_A05	16080145	16081356	BnaA05T0197700ZY	0	-	0	0	1211	0.0000000
zheyou73v0_A05	16084951	16087019	BnaA05T0197800ZY	0	+	0	0	2068	0.0000000
zheyou73v0_A05	16087723	16087891	BnaA05T0197900ZY	0	-	0	0	168	0.0000000
zheyou73v0_A05	16092952	16094162	BnaA05T0198000ZY	0	+	0	0	1210	0.0000000
zheyou73v0_A05	16109547	16111615	BnaA05T0198100ZY	0	+	0	0	2068	0.0000000
zheyou73v0_A05	16111666	16112489	BnaA05T0198200ZY	0	-	0	0	823	0.0000000
zheyou73v0_A05	16121597	16122649	BnaA05T0198300ZY	0	+	0	0	1052	0.0000000
zheyou73v0_A05	16122961	16123428	BnaA05T0198400ZY	0	+	0	0	467	0.0000000
zheyou73v0_A05	16123994	16125481	BnaA05T0198500ZY	0	-	0	0	1487	0.0000000
zheyou73v0_A05	16130310	16140623	BnaA05T0198600ZY	0	+	0	0	10313	0.0000000
zheyou73v0_A05	16140777	16141244	BnaA05T0198700ZY	0	+	0	0	467	0.0000000
zheyou73v0_A05	16144251	16145462	BnaA05T0198800ZY	0	+	0	0	1211	0.0000000
zheyou73v0_A05	16145616	16146083	BnaA05T0198900ZY	0	+	0	0	467	0.0000000
zheyou73v0_A05	16154833	16156901	BnaA05T0199000ZY	0	+	0	0	2068	0.0000000
zheyou73v0_A05	16162567	16171023	BnaA05T0199100ZY	0	+	0	0	8456	0.0000000
zheyou73v0_A05	16174895	16176106	BnaA05T0199200ZY	0	+	0	0	1211	0.0000000
zheyou73v0_A05	16176260	16177227	BnaA05T0199300ZY	0	+	0	0	967	0.0000000
zheyou73v0_A05	16177937	16178105	BnaA05T0199400ZY	0	-	0	0	168	0.0000000
zheyou73v0_A05	16206484	16207537	BnaA05T0199500ZY	0	-	0	0	1053	0.0000000
zheyou73v0_A05	16212962	16213714	BnaA05T0199600ZY	0	+	0	0	752	0.0000000
zheyou73v0_A05	16214992	16216181	BnaA05T0199700ZY	0	-	0	0	1189	0.0000000
zheyou73v0_A05	16218285	16219250	BnaA05T0199800ZY	0	-	0	0	965	0.0000000
zheyou73v0_A05	16219562	16220613	BnaA05T0199900ZY	0	-	0	0	1051	0.0000000
zheyou73v0_A05	16232919	16235075	BnaA05T0200000ZY	0	+	0	0	2156	0.0000000
zheyou73v0_A05	16235732	16236199	BnaA05T0200100ZY	0	-	0	0	467	0.0000000
zheyou73v0_A05	16236353	16237564	BnaA05T0200200ZY	0	-	0	0	1211	0.0000000
zheyou73v0_A05	16243050	16243218	BnaA05T0200300ZY	0	+	0	0	168	0.0000000
zheyou73v0_A05	16243924	16244300	BnaA05T0200400ZY	0	-	0	0	376	0.0000000
zheyou73v0_A05	16244422	16244889	BnaA05T0200500ZY	0	-	0	0	467	0.0000000
zheyou73v0_A05	16245043	16246253	BnaA05T0200600ZY	0	-	0	0	1210	0.0000000
zheyou73v0_A05	16306279	16307484	BnaA05T0200700ZY	0	+	0	0	1205	0.0000000
zheyou73v0_A05	16307638	16308105	BnaA05T0200800ZY	0	+	0	0	467	0.0000000
zheyou73v0_A05	16308341	16308602	BnaA05T0200900ZY	0	+	0	0	261	0.0000000
zheyou73v0_A05	16308628	16308970	BnaA05T0201000ZY	0	-	0	0	342	0.0000000
zheyou73v0_A05	16309283	16309451	BnaA05T0201100ZY	0	-	0	0	168	0.0000000
zheyou73v0_A05	16314835	16314991	BnaA05T0201200ZY	0	+	0	0	156	0.0000000
zheyou73v0_A05	16323755	16324966	BnaA05T0201300ZY	0	+	0	0	1211	0.0000000
zheyou73v0_A05	16325120	16325587	BnaA05T0201400ZY	0	+	0	0	467	0.0000000
zheyou73v0_A05	16326136	16327522	BnaA05T0201500ZY	0	-	0	0	1386	0.0000000
zheyou73v0_A05	16337663	16339378	BnaA05T0201600ZY	0	-	0	0	1715	0.0000000
zheyou73v0_A05	16345289	16346260	BnaA05T0201700ZY	0	+	0	0	971	0.0000000
zheyou73v0_A05	16347685	16348493	BnaA05T0201800ZY	0	-	0	0	808	0.0000000
zheyou73v0_A05	16351583	16351751	BnaA05T0201900ZY	0	+	0	0	168	0.0000000
zheyou73v0_A05	16352440	16353405	BnaA05T0202000ZY	0	-	0	0	965	0.0000000
zheyou73v0_A05	16353519	16354770	BnaA05T0202100ZY	0	-	0	0	1251	0.0000000
zheyou73v0_A05	16368238	16369585	BnaA05T0202200ZY	0	-	0	0	1347	0.0000000
zheyou73v0_A05	16384146	16384757	BnaA05T0202300ZY	0	+	0	0	611	0.0000000
zheyou73v0_A05	16384911	16385378	BnaA05T0202400ZY	0	+	0	0	467	0.0000000
zheyou73v0_A05	16385523	16386750	BnaA05T0202500ZY	0	-	0	0	1227	0.0000000
zheyou73v0_A05	16388011	16388816	BnaA05T0202600ZY	0	-	0	0	805	0.0000000
zheyou73v0_A05	16389431	16391037	BnaA05T0202700ZY	0	+	0	0	1606	0.0000000
zheyou73v0_A05	16392405	16393210	BnaA05T0202800ZY	0	-	0	0	805	0.0000000
zheyou73v0_A05	16393825	16395428	BnaA05T0202900ZY	0	+	0	0	1603	0.0000000
zheyou73v0_A05	16399978	16401036	BnaA05T0203000ZY	0	+	0	0	1058	0.0000000
zheyou73v0_A05	16411604	16412557	BnaA05T0203100ZY	0	+	0	0	953	0.0000000
zheyou73v0_A05	16412957	16413176	BnaA05T0203200ZY	0	+	0	0	219	0.0000000
zheyou73v0_A05	16423090	16423258	BnaA05T0203300ZY	0	-	0	0	168	0.0000000
zheyou73v0_A05	16424176	16424443	BnaA05T0203400ZY	0	-	0	0	267	0.0000000
zheyou73v0_A05	16428974	16431042	BnaA05T0203500ZY	0	+	0	0	2068	0.0000000
zheyou73v0_A05	16431749	16431917	BnaA05T0203600ZY	0	-	0	0	168	0.0000000
zheyou73v0_A05	16444356	16446424	BnaA05T0203700ZY	0	+	0	0	2068	0.0000000
zheyou73v0_A05	16446475	16447112	BnaA05T0203800ZY	0	-	0	0	637	0.0000000
zheyou73v0_A05	16447130	16447298	BnaA05T0203900ZY	0	-	0	0	168	0.0000000
zheyou73v0_A05	16452332	16453543	BnaA05T0204000ZY	0	+	0	0	1211	0.0000000
zheyou73v0_A05	16453697	16454164	BnaA05T0204100ZY	0	+	0	0	467	0.0000000
zheyou73v0_A05	16455337	16455505	BnaA05T0204200ZY	0	-	0	0	168	0.0000000
zheyou73v0_A05	16466329	16467610	BnaA05T0204300ZY	0	+	0	0	1281	0.0000000
zheyou73v0_A05	16468315	16468483	BnaA05T0204400ZY	0	-	0	0	168	0.0000000
zheyou73v0_A05	16474159	16478953	BnaA05T0204500ZY	0	+	0	0	4794	0.0000000
zheyou73v0_A05	16479659	16479827	BnaA05T0204600ZY	0	-	0	0	168	0.0000000
zheyou73v0_A05	16486013	16487832	BnaA05T0204700ZY	0	-	0	0	1819	0.0000000
zheyou73v0_A05	16496517	16498585	BnaA05T0204800ZY	0	+	0	0	2068	0.0000000
zheyou73v0_A05	16498636	16499459	BnaA05T0204900ZY	0	-	0	0	823	0.0000000
zheyou73v0_A05	16506738	16507949	BnaA05T0205000ZY	0	-	0	0	1211	0.0000000
zheyou73v0_A05	16528170	16528902	BnaA05T0205100ZY	0	+	0	0	732	0.0000000
zheyou73v0_A05	16528953	16531021	BnaA05T0205200ZY	0	-	0	0	2068	0.0000000
zheyou73v0_A05	16536932	16538614	BnaA05T0205300ZY	0	+	0	0	1682	0.0000000
zheyou73v0_A05	16543627	16544796	BnaA05T0205400ZY	0	+	0	0	1169	0.0000000
zheyou73v0_A05	16545238	16546831	BnaA05T0205500ZY	0	-	0	0	1593	0.0000000
zheyou73v0_A05	16578034	16579245	BnaA05T0205600ZY	0	+	0	0	1211	0.0000000
zheyou73v0_A05	16579399	16579866	BnaA05T0205700ZY	0	+	0	0	467	0.0000000
zheyou73v0_A05	16611461	16613529	BnaA05T0205800ZY	0	+	0	0	2068	0.0000000
zheyou73v0_A05	16613580	16614403	BnaA05T0205900ZY	0	-	0	0	823	0.0000000
zheyou73v0_A05	16644917	16646985	BnaA05T0206000ZY	0	+	0	0	2068	0.0000000
zheyou73v0_A05	16647036	16647859	BnaA05T0206100ZY	0	-	0	0	823	0.0000000
zheyou73v0_A05	16655199	16656410	BnaA05T0206200ZY	0	+	0	0	1211	0.0000000
zheyou73v0_A05	16657139	16657514	BnaA05T0206300ZY	0	+	0	0	375	0.0000000
zheyou73v0_A05	16661096	16661417	BnaA05T0206400ZY	0	+	0	0	321	0.0000000
zheyou73v0_A05	16663777	16663933	BnaA05T0206500ZY	0	+	0	0	156	0.0000000
zheyou73v0_A05	16666130	16667429	BnaA05T0206600ZY	0	+	0	0	1299	0.0000000
zheyou73v0_A05	16690789	16692000	BnaA05T0206700ZY	0	+	0	0	1211	0.0000000
zheyou73v0_A05	16692154	16692621	BnaA05T0206800ZY	0	+	0	0	467	0.0000000
zheyou73v0_A05	16693825	16693993	BnaA05T0206900ZY	0	-	0	0	168	0.0000000
zheyou73v0_A05	16710014	16712082	BnaA05T0207000ZY	0	+	0	0	2068	0.0000000
zheyou73v0_A05	16712772	16712940	BnaA05T0207100ZY	0	-	0	0	168	0.0000000
zheyou73v0_A05	16726552	16728282	BnaA05T0207200ZY	0	+	0	0	1730	0.0000000
zheyou73v0_A05	16729016	16754991	BnaA05T0207300ZY	0	+	0	0	25975	0.0000000
zheyou73v0_A05	16755391	16756984	BnaA05T0207400ZY	0	-	0	0	1593	0.0000000
zheyou73v0_A05	16757901	16758105	BnaA05T0207500ZY	0	-	0	0	204	0.0000000
zheyou73v0_A05	16822896	16824106	BnaA05T0207600ZY	0	+	0	0	1210	0.0000000
zheyou73v0_A05	16853705	16855298	BnaA05T0207700ZY	0	-	0	0	1593	0.0000000
zheyou73v0_A05	16872419	16873630	BnaA05T0207800ZY	0	+	0	0	1211	0.0000000
zheyou73v0_A05	16873784	16874251	BnaA05T0207900ZY	0	+	0	0	467	0.0000000
zheyou73v0_A05	16874373	16874748	BnaA05T0208000ZY	0	+	0	0	375	0.0000000
zheyou73v0_A05	16875410	16875623	BnaA05T0208100ZY	0	-	0	0	213	0.0000000
zheyou73v0_A05	16916623	16917904	BnaA05T0208200ZY	0	+	0	0	1281	0.0000000
zheyou73v0_A05	16918611	16918779	BnaA05T0208300ZY	0	-	0	0	168	0.0000000
zheyou73v0_A05	16925602	16927622	BnaA05T0208400ZY	0	+	0	0	2020	0.0000000
zheyou73v0_A05	16927721	16928063	BnaA05T0208500ZY	0	-	0	0	342	0.0000000
zheyou73v0_A05	16928376	16928544	BnaA05T0208600ZY	0	-	0	0	168	0.0000000
zheyou73v0_A05	16939144	16939348	BnaA05T0208700ZY	0	-	0	0	204	0.0000000
zheyou73v0_A05	16948055	16950123	BnaA05T0208800ZY	0	+	0	0	2068	0.0000000
zheyou73v0_A05	16950829	16950997	BnaA05T0208900ZY	0	-	0	0	168	0.0000000
zheyou73v0_A05	16957249	16958460	BnaA05T0209000ZY	0	+	0	0	1211	0.0000000
zheyou73v0_A05	16958614	16959081	BnaA05T0209100ZY	0	+	0	0	467	0.0000000
zheyou73v0_A05	16959630	16960453	BnaA05T0209200ZY	0	-	0	0	823	0.0000000
zheyou73v0_A05	16991746	16993814	BnaA05T0209300ZY	0	+	0	0	2068	0.0000000
zheyou73v0_A05	16993973	16996146	BnaA05T0209400ZY	0	-	0	0	2173	0.0000000
zheyou73v0_A05	16999735	17000945	BnaA05T0209500ZY	0	+	0	0	1210	0.0000000
zheyou73v0_A05	17001345	17002938	BnaA05T0209600ZY	0	-	0	0	1593	0.0000000
zheyou73v0_A05	17009388	17011455	BnaA05T0209700ZY	0	+	0	0	2067	0.0000000
zheyou73v0_A05	17011506	17012329	BnaA05T0209800ZY	0	-	0	0	823	0.0000000
zheyou73v0_A05	17025395	17027463	BnaA05T0209900ZY	0	+	0	0	2068	0.0000000
zheyou73v0_A05	17046560	17047525	BnaA05T0210000ZY	0	+	0	0	965	0.0000000
zheyou73v0_A05	17047925	17048392	BnaA05T0210100ZY	0	+	0	0	467	0.0000000
zheyou73v0_A05	17048723	17048915	BnaA05T0210200ZY	0	+	0	0	192	0.0000000
zheyou73v0_A05	17048941	17050428	BnaA05T0210300ZY	0	-	0	0	1487	0.0000000
zheyou73v0_A05	17056268	17057046	BnaA05T0210400ZY	0	+	0	0	778	0.0000000
zheyou73v0_A05	17057358	17058323	BnaA05T0210500ZY	0	+	0	0	965	0.0000000
zheyou73v0_A05	17058374	17058716	BnaA05T0210600ZY	0	-	0	0	342	0.0000000
zheyou73v0_A05	17059029	17059197	BnaA05T0210700ZY	0	-	0	0	168	0.0000000
zheyou73v0_A05	17068189	17068614	BnaA05T0210800ZY	0	+	0	0	425	0.0000000
zheyou73v0_A05	17090555	17092623	BnaA05T0210900ZY	0	+	0	0	2068	0.0000000
zheyou73v0_A05	17103791	17105859	BnaA05T0211000ZY	0	+	0	0	2068	0.0000000
zheyou73v0_A05	17106018	17106733	BnaA05T0211100ZY	0	-	0	0	715	0.0000000
zheyou73v0_A05	17112854	17115867	BnaA05T0211200ZY	0	+	0	0	3013	0.0000000
zheyou73v0_A05	17116805	17118017	BnaA05T0211300ZY	0	+	0	0	1212	0.0000000
zheyou73v0_A05	17118693	17118861	BnaA05T0211400ZY	0	-	0	0	168	0.0000000
zheyou73v0_A05	17148958	17149300	BnaA05T0211500ZY	0	-	0	0	342	0.0000000
zheyou73v0_A05	17149328	17149640	BnaA05T0211600ZY	0	+	0	0	312	0.0000000
zheyou73v0_A05	17153238	17155306	BnaA05T0211700ZY	0	+	0	0	2068	0.0000000
zheyou73v0_A05	17166083	17168413	BnaA05T0211800ZY	0	+	0	0	2330	0.0000000
zheyou73v0_A05	17169119	17169287	BnaA05T0211900ZY	0	-	0	0	168	0.0000000
zheyou73v0_A05	17175222	17177547	BnaA05T0212000ZY	0	+	0	0	2325	0.0000000
zheyou73v0_A05	17178253	17178421	BnaA05T0212100ZY	0	-	0	0	168	0.0000000
zheyou73v0_A05	17184654	17186736	BnaA05T0212200ZY	0	+	0	0	2082	0.0000000
zheyou73v0_A05	17196148	17197182	BnaA05T0212300ZY	0	+	0	0	1034	0.0000000
zheyou73v0_A05	17197759	17199352	BnaA05T0212400ZY	0	-	0	0	1593	0.0000000
zheyou73v0_A05	17205430	17206638	BnaA05T0212500ZY	0	+	0	0	1208	0.0000000
zheyou73v0_A05	17206792	17207259	BnaA05T0212600ZY	0	+	0	0	467	0.0000000
zheyou73v0_A05	17230133	17231071	BnaA05T0212700ZY	0	+	0	0	938	0.0000000
zheyou73v0_A05	17231230	17231606	BnaA05T0212800ZY	0	-	0	0	376	0.0000000
zheyou73v0_A05	17231728	17232194	BnaA05T0212900ZY	0	-	0	0	466	0.0000000
zheyou73v0_A05	17232348	17233559	BnaA05T0213000ZY	0	-	0	0	1211	0.0000000
zheyou73v0_A05	17274350	17275837	BnaA05T0213100ZY	0	+	0	0	1487	0.0000000
zheyou73v0_A05	17277007	17277941	BnaA05T0213200ZY	0	-	0	0	934	0.0000000
zheyou73v0_A05	17290549	17292617	BnaA05T0213300ZY	0	+	0	0	2068	0.0000000
zheyou73v0_A05	17292668	17293491	BnaA05T0213400ZY	0	-	0	0	823	0.0000000
zheyou73v0_A05	17299217	17301284	BnaA05T0213500ZY	0	+	0	0	2067	0.0000000
zheyou73v0_A05	17320676	17321592	BnaA05T0213600ZY	0	+	0	0	916	0.0000000
zheyou73v0_A05	17323104	17324315	BnaA05T0213700ZY	0	+	0	0	1211	0.0000000
zheyou73v0_A05	17339334	17341402	BnaA05T0213800ZY	0	+	0	0	2068	0.0000000
zheyou73v0_A05	17341453	17342275	BnaA05T0213900ZY	0	-	0	0	822	0.0000000
zheyou73v0_A05	17357495	17358584	BnaA05T0214000ZY	0	+	0	0	1089	0.0000000
zheyou73v0_A05	17359654	17360477	BnaA05T0214100ZY	0	-	0	0	823	0.0000000
zheyou73v0_A05	17366378	17367590	BnaA05T0214200ZY	0	+	0	0	1212	0.0000000
zheyou73v0_A05	17367747	17367978	BnaA05T0214300ZY	0	+	0	0	231	0.0000000
zheyou73v0_A05	17367994	17368942	BnaA05T0214400ZY	0	-	0	0	948	0.0000000
zheyou73v0_A05	17375279	17375447	BnaA05T0214500ZY	0	-	0	0	168	0.0000000
zheyou73v0_A05	17384704	17386524	BnaA05T0214600ZY	0	-	0	0	1820	0.0000000
zheyou73v0_A05	17393452	17395522	BnaA05T0214700ZY	0	+	0	0	2070	0.0000000
zheyou73v0_A05	17395573	17396396	BnaA05T0214800ZY	0	-	0	0	823	0.0000000
zheyou73v0_A05	17399913	17400204	BnaA05T0214900ZY	0	-	0	0	291	0.0000000
zheyou73v0_A05	17400539	17400854	BnaA05T0215000ZY	0	+	0	0	315	0.0000000
zheyou73v0_A05	17402745	17405535	BnaA05T0215100ZY	0	-	0	0	2790	0.0000000
zheyou73v0_A05	17431558	17432770	BnaA05T0215200ZY	0	+	0	0	1212	0.0000000
zheyou73v0_A05	17432924	17433391	BnaA05T0215300ZY	0	+	0	0	467	0.0000000
zheyou73v0_A05	17433940	17434577	BnaA05T0215400ZY	0	-	0	0	637	0.0000000
zheyou73v0_A05	17434595	17434763	BnaA05T0215500ZY	0	-	0	0	168	0.0000000
zheyou73v0_A05	17455753	17457821	BnaA05T0215600ZY	0	+	0	0	2068	0.0000000
zheyou73v0_A05	17457980	17460683	BnaA05T0215700ZY	0	-	0	0	2703	0.0000000
zheyou73v0_A05	17469767	17471836	BnaA05T0215800ZY	0	-	0	0	2069	0.0000000
zheyou73v0_A05	17478971	17479936	BnaA05T0215900ZY	0	-	0	0	965	0.0000000
zheyou73v0_A05	17480090	17481301	BnaA05T0216000ZY	0	-	0	0	1211	0.0000000
zheyou73v0_A05	17486704	17487505	BnaA05T0216100ZY	0	-	0	0	801	0.0000000
zheyou73v0_A05	17490360	17491183	BnaA05T0216200ZY	0	+	0	0	823	0.0000000
zheyou73v0_A05	17491234	17492199	BnaA05T0216300ZY	0	-	0	0	965	0.0000000
zheyou73v0_A05	17492353	17493731	BnaA05T0216400ZY	0	-	0	0	1378	0.0000000
zheyou73v0_A05	17496278	17497101	BnaA05T0216500ZY	0	+	0	0	823	0.0000000
zheyou73v0_A05	17497152	17499220	BnaA05T0216600ZY	0	-	0	0	2068	0.0000000
zheyou73v0_A05	17543403	17543571	BnaA05T0216700ZY	0	+	0	0	168	0.0000000
zheyou73v0_A05	17544775	17545243	BnaA05T0216800ZY	0	-	0	0	468	0.0000000
zheyou73v0_A05	17545397	17546606	BnaA05T0216900ZY	0	-	0	0	1209	0.0000000
zheyou73v0_A05	17567900	17568859	BnaA05T0217000ZY	0	+	0	0	959	0.0000000
zheyou73v0_A05	17569300	17569773	BnaA05T0217100ZY	0	-	0	0	473	0.0000000
zheyou73v0_A05	17575768	17575999	BnaA05T0217200ZY	0	+	0	0	231	0.0000000
zheyou73v0_A05	17586083	17589358	BnaA05T0217300ZY	0	+	0	0	3275	0.0000000
zheyou73v0_A05	17589708	17590107	BnaA05T0217400ZY	0	+	0	0	399	0.0000000
zheyou73v0_A05	17590180	17590594	BnaA05T0217500ZY	0	+	0	0	414	0.0000000
zheyou73v0_A05	17591391	17591858	BnaA05T0217600ZY	0	-	0	0	467	0.0000000
zheyou73v0_A05	17592012	17593223	BnaA05T0217700ZY	0	-	0	0	1211	0.0000000
zheyou73v0_A05	17633428	17634250	BnaA05T0217800ZY	0	+	0	0	822	0.0000000
zheyou73v0_A05	17634799	17635266	BnaA05T0217900ZY	0	-	0	0	467	0.0000000
zheyou73v0_A05	17635422	17641352	BnaA05T0218000ZY	0	-	0	0	5930	0.0000000
zheyou73v0_A05	17648605	17648773	BnaA05T0218100ZY	0	+	0	0	168	0.0000000
zheyou73v0_A05	17649479	17651547	BnaA05T0218200ZY	0	-	0	0	2068	0.0000000
zheyou73v0_A05	17657796	17658619	BnaA05T0218300ZY	0	+	0	0	823	0.0000000
zheyou73v0_A05	17658670	17700292	BnaA05T0218400ZY	0	-	0	0	41622	0.0000000
zheyou73v0_A05	17700447	17701658	BnaA05T0218500ZY	0	-	0	0	1211	0.0000000
zheyou73v0_A05	17714309	17715132	BnaA05T0218600ZY	0	+	0	0	823	0.0000000
zheyou73v0_A05	17715183	17715558	BnaA05T0218700ZY	0	-	0	0	375	0.0000000
zheyou73v0_A05	17715680	17716147	BnaA05T0218800ZY	0	-	0	0	467	0.0000000
zheyou73v0_A05	17716301	17717511	BnaA05T0218900ZY	0	-	0	0	1210	0.0000000
zheyou73v0_A05	17747102	17747435	BnaA05T0219000ZY	0	-	0	0	333	0.0000000
zheyou73v0_A05	17752146	17753810	BnaA05T0219100ZY	0	+	0	0	1664	0.0000000
zheyou73v0_A05	17753861	17754237	BnaA05T0219200ZY	0	-	0	0	376	0.0000000
zheyou73v0_A05	17754359	17754826	BnaA05T0219300ZY	0	-	0	0	467	0.0000000
zheyou73v0_A05	17754980	17756191	BnaA05T0219400ZY	0	-	0	0	1211	0.0000000
zheyou73v0_A05	17761607	17761775	BnaA05T0219500ZY	0	+	0	0	168	0.0000000
zheyou73v0_A05	17762481	17768194	BnaA05T0219600ZY	0	-	0	0	5713	0.0000000
zheyou73v0_A05	17768348	17769558	BnaA05T0219700ZY	0	-	0	0	1210	0.0000000
zheyou73v0_A05	17775437	17775605	BnaA05T0219800ZY	0	+	0	0	168	0.0000000
zheyou73v0_A05	17800665	17800833	BnaA05T0219900ZY	0	+	0	0	168	0.0000000
zheyou73v0_A05	17808599	17808975	BnaA05T0220000ZY	0	-	0	0	376	0.0000000
zheyou73v0_A05	17854401	17854605	BnaA05T0220100ZY	0	+	0	0	204	0.0000000
zheyou73v0_A05	17863310	17863652	BnaA05T0220200ZY	0	-	0	0	342	0.0000000
zheyou73v0_A05	17864727	17865378	BnaA05T0220300ZY	0	-	0	0	651	0.0000000
zheyou73v0_A05	17878786	17879253	BnaA05T0220400ZY	0	-	0	0	467	0.0000000
zheyou73v0_A05	17879407	17880618	BnaA05T0220500ZY	0	-	0	0	1211	0.0000000
zheyou73v0_A05	17903581	17903749	BnaA05T0220600ZY	0	+	0	0	168	0.0000000
zheyou73v0_A05	17904966	17905433	BnaA05T0220700ZY	0	-	0	0	467	0.0000000
zheyou73v0_A05	17905587	17906798	BnaA05T0220800ZY	0	-	0	0	1211	0.0000000
zheyou73v0_A05	17915906	17916729	BnaA05T0220900ZY	0	+	0	0	823	0.0000000
zheyou73v0_A05	17916780	17918847	BnaA05T0221000ZY	0	-	0	0	2067	0.0000000
zheyou73v0_A05	17925107	17925275	BnaA05T0221100ZY	0	+	0	0	168	0.0000000
zheyou73v0_A05	17929172	17929496	BnaA05T0221200ZY	0	-	0	0	324	0.0000000
zheyou73v0_A05	17931747	17932008	BnaA05T0221300ZY	0	-	0	0	261	0.0000000
zheyou73v0_A05	17932162	17933373	BnaA05T0221400ZY	0	-	0	0	1211	0.0000000
zheyou73v0_A05	17936953	17938158	BnaA05T0221500ZY	0	+	0	0	1205	0.0000000
zheyou73v0_A05	17941069	17941398	BnaA05T0221600ZY	0	-	0	0	329	0.0000000
zheyou73v0_A05	17954653	17955618	BnaA05T0221700ZY	0	+	0	0	965	0.0000000
zheyou73v0_A05	17955669	17956011	BnaA05T0221800ZY	0	-	0	0	342	0.0000000
zheyou73v0_A05	17956324	17956492	BnaA05T0221900ZY	0	-	0	0	168	0.0000000
zheyou73v0_A05	17962506	17970205	BnaA05T0222000ZY	0	+	0	0	7699	0.0000000
zheyou73v0_A05	17970605	17972198	BnaA05T0222100ZY	0	-	0	0	1593	0.0000000
zheyou73v0_A05	17978455	17980523	BnaA05T0222200ZY	0	+	0	0	2068	0.0000000
zheyou73v0_A05	17980566	17981398	BnaA05T0222300ZY	0	-	0	0	832	0.0000000
zheyou73v0_A05	17996745	17998813	BnaA05T0222400ZY	0	+	0	0	2068	0.0000000
zheyou73v0_A05	17999519	17999687	BnaA05T0222500ZY	0	-	0	0	168	0.0000000
zheyou73v0_A05	18000604	18000808	BnaA05T0222600ZY	0	-	0	0	204	0.0000000
zheyou73v0_A05	18013709	18013913	BnaA05T0222700ZY	0	+	0	0	204	0.0000000
zheyou73v0_A05	18014828	18016421	BnaA05T0222800ZY	0	+	0	0	1593	0.0000000
zheyou73v0_A05	18016821	18018038	BnaA05T0222900ZY	0	-	0	0	1217	0.0000000
zheyou73v0_A05	18023602	18025473	BnaA05T0223000ZY	0	-	0	0	1871	0.0000000
zheyou73v0_A05	18032256	18032424	BnaA05T0223100ZY	0	+	0	0	168	0.0000000
zheyou73v0_A05	18033627	18034094	BnaA05T0223200ZY	0	-	0	0	467	0.0000000
zheyou73v0_A05	18034238	18035442	BnaA05T0223300ZY	0	-	0	0	1204	0.0000000
zheyou73v0_A05	18098649	18099785	BnaA05T0223400ZY	0	+	0	0	1136	0.0000000
zheyou73v0_A05	18128053	18128876	BnaA05T0223500ZY	0	+	0	0	823	0.0000000
zheyou73v0_A05	18128927	18130995	BnaA05T0223600ZY	0	-	0	0	2068	0.0000000
zheyou73v0_A05	18140826	18140994	BnaA05T0223700ZY	0	+	0	0	168	0.0000000
zheyou73v0_A05	18161652	18162863	BnaA05T0223800ZY	0	-	0	0	1211	0.0000000
zheyou73v0_A05	18167971	18168139	BnaA05T0223900ZY	0	+	0	0	168	0.0000000
zheyou73v0_A05	18169343	18169810	BnaA05T0224000ZY	0	-	0	0	467	0.0000000
zheyou73v0_A05	18169964	18171175	BnaA05T0224100ZY	0	-	0	0	1211	0.0000000
zheyou73v0_A05	18203489	18204445	BnaA05T0224200ZY	0	+	0	0	956	0.0000000
zheyou73v0_A05	18204994	18205461	BnaA05T0224300ZY	0	-	0	0	467	0.0000000
zheyou73v0_A05	18205773	18206826	BnaA05T0224400ZY	0	-	0	0	1053	0.0000000
zheyou73v0_A05	18249018	18250184	BnaA05T0224500ZY	0	+	0	0	1166	0.0000000
zheyou73v0_A05	18250338	18250805	BnaA05T0224600ZY	0	+	0	0	467	0.0000000
zheyou73v0_A05	18252011	18252179	BnaA05T0224700ZY	0	-	0	0	168	0.0000000
zheyou73v0_A05	18257938	18260006	BnaA05T0224800ZY	0	+	0	0	2068	0.0000000
zheyou73v0_A05	18328886	18335899	BnaA05T0224900ZY	0	+	0	0	7013	0.0000000
zheyou73v0_A05	18336053	18345326	BnaA05T0225000ZY	0	+	0	0	9273	0.0000000
zheyou73v0_A05	18348573	18350050	BnaA05T0225100ZY	0	+	0	0	1477	0.0000000
zheyou73v0_A05	18350599	18351066	BnaA05T0225200ZY	0	-	0	0	467	0.0000000
zheyou73v0_A05	18351180	18352277	BnaA05T0225300ZY	0	-	0	0	1097	0.0000000
zheyou73v0_A05	18361718	18362185	BnaA05T0225400ZY	0	-	0	0	467	0.0000000
zheyou73v0_A05	18362299	18363396	BnaA05T0225500ZY	0	-	0	0	1097	0.0000000
zheyou73v0_A05	18373475	18383146	BnaA05T0225600ZY	0	+	0	0	9671	0.0000000
zheyou73v0_A05	18383545	18384494	BnaA05T0225700ZY	0	-	0	0	949	0.0000000
zheyou73v0_A05	18390516	18391460	BnaA05T0225800ZY	0	+	0	0	944	0.0000000
zheyou73v0_A05	18391511	18393578	BnaA05T0225900ZY	0	-	0	0	2067	0.0000000
zheyou73v0_A05	18401238	18402061	BnaA05T0226000ZY	0	+	0	0	823	0.0000000
zheyou73v0_A05	18402112	18404180	BnaA05T0226100ZY	0	-	0	0	2068	0.0000000
zheyou73v0_A05	18410436	18411259	BnaA05T0226200ZY	0	+	0	0	823	0.0000000
zheyou73v0_A05	18411310	18413378	BnaA05T0226300ZY	0	-	0	0	2068	0.0000000
zheyou73v0_A05	18417647	18440059	BnaA05T0226400ZY	0	+	0	0	22412	0.0000000
zheyou73v0_A05	18454959	18457027	BnaA05T0226500ZY	0	+	0	0	2068	0.0000000
zheyou73v0_A05	18457078	18457900	BnaA05T0226600ZY	0	-	0	0	822	0.0000000
zheyou73v0_A05	18494377	18496445	BnaA05T0226700ZY	0	+	0	0	2068	0.0000000
zheyou73v0_A05	18497147	18497315	BnaA05T0226800ZY	0	-	0	0	168	0.0000000
zheyou73v0_A05	18503223	18504277	BnaA05T0226900ZY	0	+	0	0	1054	0.0000000
zheyou73v0_A05	18504589	18505056	BnaA05T0227000ZY	0	+	0	0	467	0.0000000
zheyou73v0_A05	18505737	18506739	BnaA05T0227100ZY	0	-	0	0	1002	0.0000000
zheyou73v0_A05	18507840	18508008	BnaA05T0227200ZY	0	-	0	0	168	0.0000000
zheyou73v0_A05	18512046	18512851	BnaA05T0227300ZY	0	+	0	0	805	0.0000000
zheyou73v0_A05	18518838	18521167	BnaA05T0227400ZY	0	+	0	0	2329	0.0000000
zheyou73v0_A05	18521218	18522022	BnaA05T0227500ZY	0	-	0	0	804	0.0000000
zheyou73v0_A05	18527379	18529417	BnaA05T0227600ZY	0	+	0	0	2038	0.0000000
zheyou73v0_A05	18529576	18538686	BnaA05T0227700ZY	0	-	0	0	9110	0.0000000
zheyou73v0_A05	18543811	18545879	BnaA05T0227800ZY	0	+	0	0	2068	0.0000000
zheyou73v0_A05	18567616	18568686	BnaA05T0227900ZY	0	+	0	0	1070	0.0000000
zheyou73v0_A05	18570593	18570806	BnaA05T0228000ZY	0	-	0	0	213	0.0000000
zheyou73v0_A05	18571718	18571991	BnaA05T0228100ZY	0	-	0	0	273	0.0000000
zheyou73v0_A05	18578548	18580616	BnaA05T0228200ZY	0	+	0	0	2068	0.0000000
zheyou73v0_A05	18584295	18585096	BnaA05T0228300ZY	0	+	0	0	801	0.0000000
zheyou73v0_A05	18603186	18605253	BnaA05T0228400ZY	0	+	0	0	2067	0.0000000
zheyou73v0_A05	18605304	18605646	BnaA05T0228500ZY	0	-	0	0	342	0.0000000
zheyou73v0_A05	18605959	18606127	BnaA05T0228600ZY	0	-	0	0	168	0.0000000
zheyou73v0_A05	18628113	18630181	BnaA05T0228700ZY	0	+	0	0	2068	0.0000000
zheyou73v0_A05	18651816	18652639	BnaA05T0228800ZY	0	+	0	0	823	0.0000000
zheyou73v0_A05	18652690	18654758	BnaA05T0228900ZY	0	-	0	0	2068	0.0000000
zheyou73v0_A05	18660698	18661521	BnaA05T0229000ZY	0	+	0	0	823	0.0000000
zheyou73v0_A05	18661572	18663640	BnaA05T0229100ZY	0	-	0	0	2068	0.0000000
zheyou73v0_A05	18669607	18670430	BnaA05T0229200ZY	0	+	0	0	823	0.0000000
zheyou73v0_A05	18670481	18672549	BnaA05T0229300ZY	0	-	0	0	2068	0.0000000
zheyou73v0_A05	18676761	18677602	BnaA05T0229400ZY	0	+	0	0	841	0.0000000
zheyou73v0_A05	18678186	18678562	BnaA05T0229500ZY	0	-	0	0	376	0.0000000
zheyou73v0_A05	18678684	18679151	BnaA05T0229600ZY	0	-	0	0	467	0.0000000
zheyou73v0_A05	18679305	18680294	BnaA05T0229700ZY	0	-	0	0	989	0.0000000
zheyou73v0_A05	18680739	18680919	BnaA05T0229800ZY	0	+	0	0	180	0.0000000
zheyou73v0_A05	18687489	18689079	BnaA05T0229900ZY	0	+	0	0	1590	0.0000000
zheyou73v0_A05	18689479	18690428	BnaA05T0230000ZY	0	-	0	0	949	0.0000000
zheyou73v0_A05	18697436	18699505	BnaA05T0230100ZY	0	-	0	0	2069	0.0000000
zheyou73v0_A05	18705474	18705705	BnaA05T0230200ZY	0	+	0	0	231	0.0000000
zheyou73v0_A05	18706348	18707314	BnaA05T0230300ZY	0	-	0	0	966	0.0000000
zheyou73v0_A05	18707468	18708680	BnaA05T0230400ZY	0	-	0	0	1212	0.0000000
zheyou73v0_A05	18719592	18719760	BnaA05T0230500ZY	0	+	0	0	168	0.0000000
zheyou73v0_A05	18720226	18720415	BnaA05T0230600ZY	0	+	0	0	189	0.0000000
zheyou73v0_A05	18720466	18722534	BnaA05T0230700ZY	0	-	0	0	2068	0.0000000
zheyou73v0_A05	18734362	18734530	BnaA05T0230800ZY	0	+	0	0	168	0.0000000
zheyou73v0_A05	18735734	18736201	BnaA05T0230900ZY	0	-	0	0	467	0.0000000
zheyou73v0_A05	18736355	18737566	BnaA05T0231000ZY	0	-	0	0	1211	0.0000000
zheyou73v0_A05	18743150	18744356	BnaA05T0231100ZY	0	+	0	0	1206	0.0000000
zheyou73v0_A05	18744434	18759784	BnaA05T0231200ZY	0	-	0	0	15350	0.0000000
zheyou73v0_A05	18764090	18765577	BnaA05T0231300ZY	0	+	0	0	1487	0.0000000
zheyou73v0_A05	18765628	18767696	BnaA05T0231400ZY	0	-	0	0	2068	0.0000000
zheyou73v0_A05	18782880	18783360	BnaA05T0231500ZY	0	+	0	0	480	0.0000000
zheyou73v0_A05	18784253	18785100	BnaA05T0231600ZY	0	+	0	0	847	0.0000000
zheyou73v0_A05	18785151	18787219	BnaA05T0231700ZY	0	-	0	0	2068	0.0000000
zheyou73v0_A05	18814400	18814763	BnaA05T0231800ZY	0	+	0	0	363	0.0000000
zheyou73v0_A05	18817787	18818770	BnaA05T0231900ZY	0	+	0	0	983	0.0000000
zheyou73v0_A05	18819427	18819894	BnaA05T0232000ZY	0	-	0	0	467	0.0000000
zheyou73v0_A05	18820048	18821259	BnaA05T0232100ZY	0	-	0	0	1211	0.0000000
zheyou73v0_A05	18827235	18828065	BnaA05T0232200ZY	0	+	0	0	830	0.0000000
zheyou73v0_A05	18831116	18831939	BnaA05T0232300ZY	0	+	0	0	823	0.0000000
zheyou73v0_A05	18831990	18834058	BnaA05T0232400ZY	0	-	0	0	2068	0.0000000
zheyou73v0_A05	18840215	18840383	BnaA05T0232500ZY	0	+	0	0	168	0.0000000
zheyou73v0_A05	18840696	18841038	BnaA05T0232600ZY	0	+	0	0	342	0.0000000
zheyou73v0_A05	18842208	18849974	BnaA05T0232700ZY	0	-	0	0	7766	0.0000000
zheyou73v0_A05	18860283	18860451	BnaA05T0232800ZY	0	+	0	0	168	0.0000000
zheyou73v0_A05	18861157	18863212	BnaA05T0232900ZY	0	-	0	0	2055	0.0000000
zheyou73v0_A05	18869602	18870425	BnaA05T0233000ZY	0	+	0	0	823	0.0000000
zheyou73v0_A05	18870476	18881120	BnaA05T0233100ZY	0	-	0	0	10644	0.0000000
zheyou73v0_A05	18883980	18884229	BnaA05T0233200ZY	0	+	0	0	249	0.0000000
zheyou73v0_A05	18886614	18886770	BnaA05T0233300ZY	0	+	0	0	156	0.0000000
zheyou73v0_A05	18887580	18888385	BnaA05T0233400ZY	0	-	0	0	805	0.0000000
zheyou73v0_A05	18888848	18890628	BnaA05T0233500ZY	0	+	0	0	1780	0.0000000
zheyou73v0_A05	18895286	18895454	BnaA05T0233600ZY	0	+	0	0	168	0.0000000
zheyou73v0_A05	18896135	18896536	BnaA05T0233700ZY	0	-	0	0	401	0.0000000
zheyou73v0_A05	18896658	18897125	BnaA05T0233800ZY	0	-	0	0	467	0.0000000
zheyou73v0_A05	18897279	18898490	BnaA05T0233900ZY	0	-	0	0	1211	0.0000000
zheyou73v0_A05	18902821	18903025	BnaA05T0234000ZY	0	+	0	0	204	0.0000000
zheyou73v0_A05	18903942	18904110	BnaA05T0234100ZY	0	+	0	0	168	0.0000000
zheyou73v0_A05	18905256	18905723	BnaA05T0234200ZY	0	-	0	0	467	0.0000000
zheyou73v0_A05	18905877	18907088	BnaA05T0234300ZY	0	-	0	0	1211	0.0000000
zheyou73v0_A05	18916187	18917976	BnaA05T0234400ZY	0	-	0	0	1789	0.0000000
zheyou73v0_A05	18920760	18921475	BnaA05T0234500ZY	0	+	0	0	715	0.0000000
zheyou73v0_A05	18922753	18923964	BnaA05T0234600ZY	0	-	0	0	1211	0.0000000
zheyou73v0_A05	18932167	18933066	BnaA05T0234700ZY	0	+	0	0	899	0.0000000
zheyou73v0_A05	18933615	18934082	BnaA05T0234800ZY	0	-	0	0	467	0.0000000
zheyou73v0_A05	18934235	18935446	BnaA05T0234900ZY	0	-	0	0	1211	0.0000000
zheyou73v0_A05	18939492	18952404	BnaA05T0235000ZY	0	+	0	0	12912	0.0000000
zheyou73v0_A05	18952804	18954016	BnaA05T0235100ZY	0	-	0	0	1212	0.0000000
zheyou73v0_A05	18959494	18959662	BnaA05T0235200ZY	0	+	0	0	168	0.0000000
zheyou73v0_A05	18961285	18963029	BnaA05T0235300ZY	0	+	0	0	1744	0.0000000
zheyou73v0_A05	18963329	18964540	BnaA05T0235400ZY	0	-	0	0	1211	0.0000000
zheyou73v0_A05	18969874	18970042	BnaA05T0235500ZY	0	+	0	0	168	0.0000000
zheyou73v0_A05	18970748	18980412	BnaA05T0235600ZY	0	-	0	0	9664	0.0000000
zheyou73v0_A05	18980566	18981777	BnaA05T0235700ZY	0	-	0	0	1211	0.0000000
zheyou73v0_A05	19008644	19008812	BnaA05T0235800ZY	0	+	0	0	168	0.0000000
zheyou73v0_A05	19038410	19039359	BnaA05T0235900ZY	0	-	0	0	949	0.0000000
zheyou73v0_A05	19041216	19044949	BnaA05T0236000ZY	0	-	0	0	3733	0.0000000
zheyou73v0_A05	19050309	19051913	BnaA05T0236100ZY	0	-	0	0	1604	0.0000000
zheyou73v0_A05	19054709	19074114	BnaA05T0236200ZY	0	+	0	0	19405	0.0000000
zheyou73v0_A05	19074514	19075463	BnaA05T0236300ZY	0	-	0	0	949	0.0000000
zheyou73v0_A05	19081819	19081987	BnaA05T0236400ZY	0	+	0	0	168	0.0000000
zheyou73v0_A05	19082453	19082642	BnaA05T0236500ZY	0	+	0	0	189	0.0000000
zheyou73v0_A05	19082668	19083657	BnaA05T0236600ZY	0	-	0	0	989	0.0000000
zheyou73v0_A05	19083811	19084258	BnaA05T0236700ZY	0	-	0	0	447	0.0000000
zheyou73v0_A05	19096112	19096268	BnaA05T0236800ZY	0	+	0	0	156	0.0000000
zheyou73v0_A05	19101993	19102816	BnaA05T0236900ZY	0	+	0	0	823	0.0000000
zheyou73v0_A05	19102867	19104934	BnaA05T0237000ZY	0	-	0	0	2067	0.0000000
zheyou73v0_A05	19111346	19111514	BnaA05T0237100ZY	0	+	0	0	168	0.0000000
zheyou73v0_A05	19136989	19137954	BnaA05T0237200ZY	0	+	0	0	965	0.0000000
zheyou73v0_A05	19138005	19138654	BnaA05T0237300ZY	0	-	0	0	649	0.0000000
zheyou73v0_A05	19138660	19138828	BnaA05T0237400ZY	0	-	0	0	168	0.0000000
zheyou73v0_A05	19142490	19142823	BnaA05T0237500ZY	0	+	0	0	333	0.0000000
zheyou73v0_A05	19149051	19150073	BnaA05T0237600ZY	0	+	0	0	1022	0.0000000
zheyou73v0_A05	19156946	19157769	BnaA05T0237700ZY	0	+	0	0	823	0.0000000
zheyou73v0_A05	19157820	19159101	BnaA05T0237800ZY	0	-	0	0	1281	0.0000000
zheyou73v0_A05	19220468	19222649	BnaA05T0237900ZY	0	+	0	0	2181	0.0000000
zheyou73v0_A05	19235205	19236416	BnaA05T0238000ZY	0	-	0	0	1211	0.0000000
zheyou73v0_A05	19248356	19249071	BnaA05T0238100ZY	0	+	0	0	715	0.0000000
zheyou73v0_A05	19249230	19251297	BnaA05T0238200ZY	0	-	0	0	2067	0.0000000
zheyou73v0_A05	19293143	19293347	BnaA05T0238300ZY	0	+	0	0	204	0.0000000
zheyou73v0_A05	19294265	19294433	BnaA05T0238400ZY	0	+	0	0	168	0.0000000
zheyou73v0_A05	19295139	19304563	BnaA05T0238500ZY	0	-	0	0	9424	0.0000000
zheyou73v0_A05	19311159	19312096	BnaA05T0238600ZY	0	+	0	0	937	0.0000000
zheyou73v0_A05	19312645	19313109	BnaA05T0238700ZY	0	-	0	0	464	0.0000000
zheyou73v0_A05	19313263	19314473	BnaA05T0238800ZY	0	-	0	0	1210	0.0000000
zheyou73v0_A05	19326741	19326909	BnaA05T0238900ZY	0	+	0	0	168	0.0000000
zheyou73v0_A05	19327615	19329682	BnaA05T0239000ZY	0	-	0	0	2067	0.0000000
zheyou73v0_A05	19343971	19344920	BnaA05T0239100ZY	0	-	0	0	949	0.0000000
zheyou73v0_A05	19350715	19350883	BnaA05T0239200ZY	0	+	0	0	168	0.0000000
zheyou73v0_A05	19351588	19352553	BnaA05T0239300ZY	0	-	0	0	965	0.0000000
zheyou73v0_A05	19542293	19542584	BnaA05T0239400ZY	0	+	0	0	291	0.0000000
zheyou73v0_A05	19844964	19845548	BnaA05T0239500ZY	0	+	0	0	584	0.0000000
zheyou73v0_A05	19852140	19852836	BnaA05T0239600ZY	0	+	0	0	696	0.0000000
zheyou73v0_A05	20012138	20014206	BnaA05T0239700ZY	0	+	0	0	2068	0.0000000
zheyou73v0_A05	20014912	20015080	BnaA05T0239800ZY	0	-	0	0	168	0.0000000
zheyou73v0_A05	20015997	20016201	BnaA05T0239900ZY	0	-	0	0	204	0.0000000
zheyou73v0_A05	20200476	20201687	BnaA05T0240000ZY	0	-	0	0	1211	0.0000000
zheyou73v0_A05	20253168	20255235	BnaA05T0240100ZY	0	+	0	0	2067	0.0000000
zheyou73v0_A05	20255286	20256109	BnaA05T0240200ZY	0	-	0	0	823	0.0000000
zheyou73v0_A05	20262466	20264253	BnaA05T0240300ZY	0	+	0	0	1787	0.0000000
zheyou73v0_A05	20281130	20283209	BnaA05T0240400ZY	0	+	0	0	2079	0.0000000
zheyou73v0_A05	20283260	20284747	BnaA05T0240500ZY	0	-	0	0	1487	0.0000000
zheyou73v0_A05	20329076	20330192	BnaA05T0240600ZY	0	-	0	0	1116	0.0000000
zheyou73v0_A05	20335097	20337593	BnaA05T0240700ZY	0	+	0	0	2496	0.0000000
zheyou73v0_A05	20338024	20342160	BnaA05T0240800ZY	0	+	0	0	4136	0.0000000
zheyou73v0_A05	20349658	20350216	BnaA05T0240900ZY	0	+	0	0	558	0.0000000
zheyou73v0_A05	20350267	20351232	BnaA05T0241000ZY	0	-	0	0	965	0.0000000
zheyou73v0_A05	20351386	20352598	BnaA05T0241100ZY	0	-	0	0	1212	0.0000000
zheyou73v0_A05	20363907	20364075	BnaA05T0241200ZY	0	+	0	0	168	0.0000000
zheyou73v0_A05	20364781	20366849	BnaA05T0241300ZY	0	-	0	0	2068	0.0000000
zheyou73v0_A05	20373108	20373276	BnaA05T0241400ZY	0	+	0	0	168	0.0000000
zheyou73v0_A05	20374480	20374947	BnaA05T0241500ZY	0	-	0	0	467	0.0000000
zheyou73v0_A05	20375152	20376312	BnaA05T0241600ZY	0	-	0	0	1160	0.0000000
zheyou73v0_A05	20378982	20380780	BnaA05T0241700ZY	0	+	0	0	1798	0.0000000
zheyou73v0_A05	20381136	20381340	BnaA05T0241800ZY	0	+	0	0	204	0.0000000
zheyou73v0_A05	20394967	20396454	BnaA05T0241900ZY	0	+	0	0	1487	0.0000000
zheyou73v0_A05	20396505	20396881	BnaA05T0242000ZY	0	-	0	0	376	0.0000000
zheyou73v0_A05	20397003	20397470	BnaA05T0242100ZY	0	-	0	0	467	0.0000000
zheyou73v0_A05	20417608	20417776	BnaA05T0242200ZY	0	+	0	0	168	0.0000000
zheyou73v0_A05	20418482	20418858	BnaA05T0242300ZY	0	-	0	0	376	0.0000000
zheyou73v0_A05	20418980	20419447	BnaA05T0242400ZY	0	-	0	0	467	0.0000000
zheyou73v0_A05	20419601	20420812	BnaA05T0242500ZY	0	-	0	0	1211	0.0000000
zheyou73v0_A05	20448805	20450017	BnaA05T0242600ZY	0	+	0	0	1212	0.0000000
zheyou73v0_A05	20450171	20451136	BnaA05T0242700ZY	0	+	0	0	965	0.0000000
zheyou73v0_A05	20451187	20452010	BnaA05T0242800ZY	0	-	0	0	823	0.0000000
zheyou73v0_A05	20464530	20466598	BnaA05T0242900ZY	0	+	0	0	2068	0.0000000
zheyou73v0_A05	20466649	20467472	BnaA05T0243000ZY	0	-	0	0	823	0.0000000
zheyou73v0_A05	20472687	20474755	BnaA05T0243100ZY	0	+	0	0	2068	0.0000000
zheyou73v0_A05	20474806	20475629	BnaA05T0243200ZY	0	-	0	0	823	0.0000000
zheyou73v0_A05	20481783	20483851	BnaA05T0243300ZY	0	+	0	0	2068	0.0000000
zheyou73v0_A05	20483902	20484725	BnaA05T0243400ZY	0	-	0	0	823	0.0000000
zheyou73v0_A05	20497011	20499079	BnaA05T0243500ZY	0	+	0	0	2068	0.0000000
zheyou73v0_A05	20499130	20499953	BnaA05T0243600ZY	0	-	0	0	823	0.0000000
zheyou73v0_A05	20520885	20521278	BnaA05T0243700ZY	0	+	0	0	393	0.0000000
zheyou73v0_A05	20526695	20527024	BnaA05T0243800ZY	0	+	0	0	329	0.0000000
zheyou73v0_A05	20527941	20529533	BnaA05T0243900ZY	0	+	0	0	1592	0.0000000
zheyou73v0_A05	20529933	20531144	BnaA05T0244000ZY	0	-	0	0	1211	0.0000000
zheyou73v0_A05	20540460	20540789	BnaA05T0244100ZY	0	+	0	0	329	0.0000000
zheyou73v0_A05	20541706	20542529	BnaA05T0244200ZY	0	+	0	0	823	0.0000000
zheyou73v0_A05	20542580	20543545	BnaA05T0244300ZY	0	-	0	0	965	0.0000000
zheyou73v0_A05	20543857	20544909	BnaA05T0244400ZY	0	-	0	0	1052	0.0000000
zheyou73v0_A05	20667435	20667594	BnaA05T0244500ZY	0	-	0	0	159	0.0000000
zheyou73v0_A05	20812588	20813505	BnaA05T0244600ZY	0	-	0	0	917	0.0000000
zheyou73v0_A05	20815188	20815356	BnaA05T0244700ZY	0	+	0	0	168	0.0000000
zheyou73v0_A05	20816062	20817027	BnaA05T0244800ZY	0	-	0	0	965	0.0000000
zheyou73v0_A05	20817222	20818120	BnaA05T0244900ZY	0	-	0	0	898	0.0000000
zheyou73v0_A05	20828064	20828393	BnaA05T0245000ZY	0	+	0	0	329	0.0000000
zheyou73v0_A05	20829310	20830085	BnaA05T0245100ZY	0	+	0	0	775	0.0000000
zheyou73v0_A05	20830184	20832251	BnaA05T0245200ZY	0	-	0	0	2067	0.0000000
zheyou73v0_A05	20855741	20855909	BnaA05T0245300ZY	0	+	0	0	168	0.0000000
zheyou73v0_A05	21015648	21015852	BnaA05T0245400ZY	0	+	0	0	204	0.0000000
zheyou73v0_A05	21016769	21016937	BnaA05T0245500ZY	0	+	0	0	168	0.0000000
zheyou73v0_A05	21017697	21018614	BnaA05T0245600ZY	0	-	0	0	917	0.0000000
zheyou73v0_A05	21020297	21020465	BnaA05T0245700ZY	0	+	0	0	168	0.0000000
zheyou73v0_A05	21021669	21022136	BnaA05T0245800ZY	0	-	0	0	467	0.0000000
zheyou73v0_A05	21023819	21023987	BnaA05T0245900ZY	0	+	0	0	168	0.0000000
zheyou73v0_A05	21024693	21038642	BnaA05T0246000ZY	0	-	0	0	13949	0.0000000
zheyou73v0_A05	21038796	21040007	BnaA05T0246100ZY	0	-	0	0	1211	0.0000000
zheyou73v0_A05	21045909	21046077	BnaA05T0246200ZY	0	+	0	0	168	0.0000000
zheyou73v0_A05	21053774	21055842	BnaA05T0246300ZY	0	-	0	0	2068	0.0000000
zheyou73v0_A05	21060932	21061136	BnaA05T0246400ZY	0	+	0	0	204	0.0000000
zheyou73v0_A05	21062053	21062221	BnaA05T0246500ZY	0	+	0	0	168	0.0000000
zheyou73v0_A05	21070449	21071730	BnaA05T0246600ZY	0	-	0	0	1281	0.0000000
zheyou73v0_A05	21078773	21079596	BnaA05T0246700ZY	0	+	0	0	823	0.0000000
zheyou73v0_A05	21079647	21080612	BnaA05T0246800ZY	0	-	0	0	965	0.0000000
zheyou73v0_A05	21080865	21081978	BnaA05T0246900ZY	0	-	0	0	1113	0.0000000
zheyou73v0_A05	21086244	21087941	BnaA05T0247000ZY	0	-	0	0	1697	0.0000000
zheyou73v0_A05	21093970	21094138	BnaA05T0247100ZY	0	+	0	0	168	0.0000000
zheyou73v0_A05	21094844	21097174	BnaA05T0247200ZY	0	-	0	0	2330	0.0000000
zheyou73v0_A05	21103707	21103875	BnaA05T0247300ZY	0	+	0	0	168	0.0000000
zheyou73v0_A05	21104581	21106911	BnaA05T0247400ZY	0	-	0	0	2330	0.0000000
zheyou73v0_A05	21112925	21113093	BnaA05T0247500ZY	0	+	0	0	168	0.0000000
zheyou73v0_A05	21113799	21123137	BnaA05T0247600ZY	0	-	0	0	9338	0.0000000
zheyou73v0_A05	21123449	21124502	BnaA05T0247700ZY	0	-	0	0	1053	0.0000000
zheyou73v0_A05	21152613	21154681	BnaA05T0247800ZY	0	+	0	0	2068	0.0000000
zheyou73v0_A05	21154732	21155555	BnaA05T0247900ZY	0	-	0	0	823	0.0000000
zheyou73v0_A05	21177092	21179160	BnaA05T0248000ZY	0	+	0	0	2068	0.0000000
zheyou73v0_A05	21179211	21180034	BnaA05T0248100ZY	0	-	0	0	823	0.0000000
zheyou73v0_A05	21192276	21194606	BnaA05T0248200ZY	0	+	0	0	2330	0.0000000
zheyou73v0_A05	21194657	21195480	BnaA05T0248300ZY	0	-	0	0	823	0.0000000
zheyou73v0_A05	21204547	21205758	BnaA05T0248400ZY	0	+	0	0	1211	0.0000000
zheyou73v0_A05	21205912	21206381	BnaA05T0248500ZY	0	+	0	0	469	0.0000000
zheyou73v0_A05	21207585	21207753	BnaA05T0248600ZY	0	-	0	0	168	0.0000000
zheyou73v0_A05	21214044	21216112	BnaA05T0248700ZY	0	+	0	0	2068	0.0000000
zheyou73v0_A05	21216163	21216985	BnaA05T0248800ZY	0	-	0	0	822	0.0000000
zheyou73v0_A05	21237552	21239620	BnaA05T0248900ZY	0	-	0	0	2068	0.0000000
zheyou73v0_A05	21247993	21249204	BnaA05T0249000ZY	0	-	0	0	1211	0.0000000
zheyou73v0_A05	21255388	21256981	BnaA05T0249100ZY	0	+	0	0	1593	0.0000000
zheyou73v0_A05	21257381	21258593	BnaA05T0249200ZY	0	-	0	0	1212	0.0000000
zheyou73v0_A05	21266551	21266719	BnaA05T0249300ZY	0	+	0	0	168	0.0000000
zheyou73v0_A05	21267425	21269493	BnaA05T0249400ZY	0	-	0	0	2068	0.0000000
zheyou73v0_A05	21275759	21276582	BnaA05T0249500ZY	0	+	0	0	823	0.0000000
zheyou73v0_A05	21276633	21278701	BnaA05T0249600ZY	0	-	0	0	2068	0.0000000
zheyou73v0_A05	21292416	21294009	BnaA05T0249700ZY	0	+	0	0	1593	0.0000000
zheyou73v0_A05	21294409	21295620	BnaA05T0249800ZY	0	-	0	0	1211	0.0000000
zheyou73v0_A05	21301176	21309698	BnaA05T0249900ZY	0	+	0	0	8522	0.0000000
zheyou73v0_A05	21309749	21310572	BnaA05T0250000ZY	0	-	0	0	823	0.0000000
zheyou73v0_A05	21311490	21311819	BnaA05T0250100ZY	0	-	0	0	329	0.0000000
zheyou73v0_A05	21316918	21318986	BnaA05T0250200ZY	0	+	0	0	2068	0.0000000
zheyou73v0_A05	21319037	21319860	BnaA05T0250300ZY	0	-	0	0	823	0.0000000
zheyou73v0_A05	21323830	21324653	BnaA05T0250400ZY	0	+	0	0	823	0.0000000
zheyou73v0_A05	21324704	21326772	BnaA05T0250500ZY	0	-	0	0	2068	0.0000000
zheyou73v0_A05	21333908	21334284	BnaA05T0250600ZY	0	-	0	0	376	0.0000000
zheyou73v0_A05	21351682	21352011	BnaA05T0250700ZY	0	+	0	0	329	0.0000000
zheyou73v0_A05	21352928	21354521	BnaA05T0250800ZY	0	+	0	0	1593	0.0000000
zheyou73v0_A05	21354921	21356132	BnaA05T0250900ZY	0	-	0	0	1211	0.0000000
zheyou73v0_A05	21359125	21368745	BnaA05T0251000ZY	0	-	0	0	9620	0.0000000
zheyou73v0_A05	21392937	21393266	BnaA05T0251100ZY	0	+	0	0	329	0.0000000
zheyou73v0_A05	21394183	21395775	BnaA05T0251200ZY	0	+	0	0	1592	0.0000000
zheyou73v0_A05	21396175	21397386	BnaA05T0251300ZY	0	-	0	0	1211	0.0000000
zheyou73v0_A05	21398829	21398997	BnaA05T0251400ZY	0	-	0	0	168	0.0000000
zheyou73v0_A05	21413352	21413681	BnaA05T0251500ZY	0	+	0	0	329	0.0000000
zheyou73v0_A05	21414598	21414766	BnaA05T0251600ZY	0	+	0	0	168	0.0000000
zheyou73v0_A05	21415472	21417802	BnaA05T0251700ZY	0	-	0	0	2330	0.0000000
zheyou73v0_A05	21422581	21422910	BnaA05T0251800ZY	0	+	0	0	329	0.0000000
zheyou73v0_A05	21423827	21423995	BnaA05T0251900ZY	0	+	0	0	168	0.0000000
zheyou73v0_A05	21424701	21427031	BnaA05T0252000ZY	0	-	0	0	2330	0.0000000
zheyou73v0_A05	21450170	21458898	BnaA05T0252100ZY	0	+	0	0	8728	0.0000000
zheyou73v0_A05	21459052	21459519	BnaA05T0252200ZY	0	+	0	0	467	0.0000000
zheyou73v0_A05	21487766	21487973	BnaA05T0252300ZY	0	-	0	0	207	0.0000000
zheyou73v0_A05	21516910	21526484	BnaA05T0252400ZY	0	+	0	0	9574	0.0000000
zheyou73v0_A05	21533383	21535713	BnaA05T0252500ZY	0	+	0	0	2330	0.0000000
zheyou73v0_A05	21549067	21550278	BnaA05T0252600ZY	0	+	0	0	1211	0.0000000
zheyou73v0_A05	21550678	21561406	BnaA05T0252700ZY	0	-	0	0	10728	0.0000000
zheyou73v0_A05	21576942	21578153	BnaA05T0252800ZY	0	+	0	0	1211	0.0000000
zheyou73v0_A05	21578307	21578774	BnaA05T0252900ZY	0	+	0	0	467	0.0000000
zheyou73v0_A05	21578896	21579271	BnaA05T0253000ZY	0	+	0	0	375	0.0000000
zheyou73v0_A05	21579322	21580145	BnaA05T0253100ZY	0	-	0	0	823	0.0000000
zheyou73v0_A05	21614941	21615133	BnaA05T0253200ZY	0	-	0	0	192	0.0000000
zheyou73v0_A05	21616051	21616255	BnaA05T0253300ZY	0	-	0	0	204	0.0000000
zheyou73v0_A05	21624887	21626480	BnaA05T0253400ZY	0	-	0	0	1593	0.0000000
zheyou73v0_A05	21633416	21635485	BnaA05T0253500ZY	0	+	0	0	2069	0.0000000
zheyou73v0_A05	21636190	21636358	BnaA05T0253600ZY	0	-	0	0	168	0.0000000
zheyou73v0_A05	21678867	21679035	BnaA05T0253700ZY	0	+	0	0	168	0.0000000
zheyou73v0_A05	21679741	21681771	BnaA05T0253800ZY	0	-	0	0	2030	0.0000000
zheyou73v0_A05	21689632	21689800	BnaA05T0253900ZY	0	+	0	0	168	0.0000000
zheyou73v0_A05	21690507	21692537	BnaA05T0254000ZY	0	-	0	0	2030	0.0000000
zheyou73v0_A05	21698564	21706394	BnaA05T0254100ZY	0	+	0	0	7830	0.0000000
zheyou73v0_A05	21707310	21707478	BnaA05T0254200ZY	0	+	0	0	168	0.0000000
zheyou73v0_A05	21708170	21716088	BnaA05T0254300ZY	0	-	0	0	7918	0.0000000
zheyou73v0_A05	21725133	21727201	BnaA05T0254400ZY	0	-	0	0	2068	0.0000000
zheyou73v0_A05	21732833	21733656	BnaA05T0254500ZY	0	+	0	0	823	0.0000000
zheyou73v0_A05	21733707	21735775	BnaA05T0254600ZY	0	-	0	0	2068	0.0000000
zheyou73v0_A05	21741592	21742366	BnaA05T0254700ZY	0	+	0	0	774	0.0000000
zheyou73v0_A05	21742417	21744485	BnaA05T0254800ZY	0	-	0	0	2068	0.0000000
zheyou73v0_A05	21750367	21750535	BnaA05T0254900ZY	0	+	0	0	168	0.0000000
zheyou73v0_A05	21751241	21751809	BnaA05T0255000ZY	0	-	0	0	568	0.0000000
zheyou73v0_A05	21760954	21762165	BnaA05T0255100ZY	0	-	0	0	1211	0.0000000
zheyou73v0_A05	21762291	21776457	BnaA05T0255200ZY	0	-	0	0	14166	0.0000000
zheyou73v0_A05	21788327	21788531	BnaA05T0255300ZY	0	+	0	0	204	0.0000000
zheyou73v0_A05	21788784	21790271	BnaA05T0255400ZY	0	+	0	0	1487	0.0000000
zheyou73v0_A05	21790817	21791284	BnaA05T0255500ZY	0	-	0	0	467	0.0000000
zheyou73v0_A05	21857057	21858650	BnaA05T0255600ZY	0	+	0	0	1593	0.0000000
zheyou73v0_A05	21859050	21860255	BnaA05T0255700ZY	0	-	0	0	1205	0.0000000
zheyou73v0_A05	21865807	21865975	BnaA05T0255800ZY	0	+	0	0	168	0.0000000
zheyou73v0_A05	21887165	21888114	BnaA05T0255900ZY	0	-	0	0	949	0.0000000
zheyou73v0_A05	21917774	21917942	BnaA05T0256000ZY	0	+	0	0	168	0.0000000
zheyou73v0_A05	21919138	21919605	BnaA05T0256100ZY	0	-	0	0	467	0.0000000
zheyou73v0_A05	21968299	21969122	BnaA05T0256200ZY	0	+	0	0	823	0.0000000
zheyou73v0_A05	21969173	21971501	BnaA05T0256300ZY	0	-	0	0	2328	0.0000000
zheyou73v0_A05	22005392	22005560	BnaA05T0256400ZY	0	+	0	0	168	0.0000000
zheyou73v0_A05	22006266	22006642	BnaA05T0256500ZY	0	-	0	0	376	0.0000000
zheyou73v0_A05	22006764	22007231	BnaA05T0256600ZY	0	-	0	0	467	0.0000000
zheyou73v0_A05	22007385	22008596	BnaA05T0256700ZY	0	-	0	0	1211	0.0000000
zheyou73v0_A05	22074611	22083982	BnaA05T0256800ZY	0	-	0	0	9371	0.0000000
zheyou73v0_A05	22139414	22140237	BnaA05T0256900ZY	0	+	0	0	823	0.0000000
zheyou73v0_A05	22140288	22142356	BnaA05T0257000ZY	0	-	0	0	2068	0.0000000
zheyou73v0_A05	22149345	22150169	BnaA05T0257100ZY	0	+	0	0	824	0.0000000
zheyou73v0_A05	22150220	22152288	BnaA05T0257200ZY	0	-	0	0	2068	0.0000000
zheyou73v0_A05	22167250	22168097	BnaA05T0257300ZY	0	+	0	0	847	0.0000000
zheyou73v0_A05	22168148	22170217	BnaA05T0257400ZY	0	-	0	0	2069	0.0000000
zheyou73v0_A05	22204654	22206940	BnaA05T0257500ZY	0	+	0	0	2286	0.0000000
zheyou73v0_A05	22207645	22207813	BnaA05T0257600ZY	0	-	0	0	168	0.0000000
zheyou73v0_A05	22216690	22217892	BnaA05T0257700ZY	0	+	0	0	1202	0.0000000
zheyou73v0_A05	22218055	22219540	BnaA05T0257800ZY	0	+	0	0	1485	0.0000000
zheyou73v0_A05	22219726	22219894	BnaA05T0257900ZY	0	-	0	0	168	0.0000000
zheyou73v0_A05	22227693	22229286	BnaA05T0258000ZY	0	+	0	0	1593	0.0000000
zheyou73v0_A05	22229686	22230896	BnaA05T0258100ZY	0	-	0	0	1210	0.0000000
zheyou73v0_A05	22236342	22236510	BnaA05T0258200ZY	0	+	0	0	168	0.0000000
zheyou73v0_A05	22237216	22239546	BnaA05T0258300ZY	0	-	0	0	2330	0.0000000
zheyou73v0_A05	22244559	22246152	BnaA05T0258400ZY	0	+	0	0	1593	0.0000000
zheyou73v0_A05	22248486	22248953	BnaA05T0258500ZY	0	+	0	0	467	0.0000000
zheyou73v0_A05	22250153	22250321	BnaA05T0258600ZY	0	-	0	0	168	0.0000000
zheyou73v0_A05	22273317	22274911	BnaA05T0258700ZY	0	-	0	0	1594	0.0000000
zheyou73v0_A05	22278329	22279539	BnaA05T0258800ZY	0	+	0	0	1210	0.0000000
zheyou73v0_A05	22280715	22280946	BnaA05T0258900ZY	0	-	0	0	231	0.0000000
zheyou73v0_A05	22288128	22289339	BnaA05T0259000ZY	0	+	0	0	1211	0.0000000
zheyou73v0_A05	22289493	22289960	BnaA05T0259100ZY	0	+	0	0	467	0.0000000
zheyou73v0_A05	22291164	22291332	BnaA05T0259200ZY	0	-	0	0	168	0.0000000
zheyou73v0_A05	22307251	22309319	BnaA05T0259300ZY	0	+	0	0	2068	0.0000000
zheyou73v0_A05	22309370	22310193	BnaA05T0259400ZY	0	-	0	0	823	0.0000000
zheyou73v0_A05	22311144	22312667	BnaA05T0259500ZY	0	-	0	0	1523	0.0000000
zheyou73v0_A05	22313045	22313321	BnaA05T0259600ZY	0	+	0	0	276	0.0000000
zheyou73v0_A05	22316219	22317157	BnaA05T0259700ZY	0	-	0	0	938	0.0000000
zheyou73v0_A05	22317615	22318420	BnaA05T0259800ZY	0	+	0	0	805	0.0000000
zheyou73v0_A05	22329414	22329675	BnaA05T0259900ZY	0	-	0	0	261	0.0000000
zheyou73v0_A05	22330003	22331009	BnaA05T0260000ZY	0	-	0	0	1006	0.0000000
zheyou73v0_A05	22350099	22351301	BnaA05T0260100ZY	0	+	0	0	1202	0.0000000
zheyou73v0_A05	22351464	22352949	BnaA05T0260200ZY	0	+	0	0	1485	0.0000000
zheyou73v0_A05	22353135	22353303	BnaA05T0260300ZY	0	-	0	0	168	0.0000000
zheyou73v0_A05	22372559	22374336	BnaA05T0260400ZY	0	+	0	0	1777	0.0000000
zheyou73v0_A05	22407591	22408802	BnaA05T0260500ZY	0	+	0	0	1211	0.0000000
zheyou73v0_A05	22408956	22409921	BnaA05T0260600ZY	0	+	0	0	965	0.0000000
zheyou73v0_A05	22410080	22410621	BnaA05T0260700ZY	0	-	0	0	541	0.0000000
zheyou73v0_A05	22410627	22410795	BnaA05T0260800ZY	0	-	0	0	168	0.0000000
zheyou73v0_A05	22433670	22434881	BnaA05T0260900ZY	0	+	0	0	1211	0.0000000
zheyou73v0_A05	22435281	22463048	BnaA05T0261000ZY	0	-	0	0	27767	0.0000000
zheyou73v0_A05	22464189	22466256	BnaA05T0261100ZY	0	+	0	0	2067	0.0000000
zheyou73v0_A05	22466990	22474177	BnaA05T0261200ZY	0	+	0	0	7187	0.0000000
zheyou73v0_A05	22474883	22475051	BnaA05T0261300ZY	0	-	0	0	168	0.0000000
zheyou73v0_A05	22481304	22482515	BnaA05T0261400ZY	0	+	0	0	1211	0.0000000
zheyou73v0_A05	22482669	22483586	BnaA05T0261500ZY	0	+	0	0	917	0.0000000
zheyou73v0_A05	22484340	22484508	BnaA05T0261600ZY	0	-	0	0	168	0.0000000
zheyou73v0_A05	22526318	22526755	BnaA05T0261700ZY	0	+	0	0	437	0.0000000
zheyou73v0_A05	22533834	22534440	BnaA05T0261800ZY	0	+	0	0	606	0.0000000
zheyou73v0_A05	22539141	22539309	BnaA05T0261900ZY	0	-	0	0	168	0.0000000
zheyou73v0_A05	22559839	22560070	BnaA05T0262000ZY	0	-	0	0	231	0.0000000
zheyou73v0_A05	22565657	22566606	BnaA05T0262100ZY	0	+	0	0	949	0.0000000
zheyou73v0_A05	22567006	22602041	BnaA05T0262200ZY	0	-	0	0	35035	0.0000000
zheyou73v0_A05	22633102	22633303	BnaA05T0262300ZY	0	+	0	0	201	0.0000000
zheyou73v0_A05	22653872	22654082	BnaA05T0262400ZY	0	-	0	0	210	0.0000000
zheyou73v0_A05	22684583	22685499	BnaA05T0262500ZY	0	-	0	0	916	0.0000000
zheyou73v0_A05	22842553	22843913	BnaA05T0262600ZY	0	-	0	0	1360	0.0000000
zheyou73v0_A05	23192200	23193782	BnaA05T0262700ZY	0	+	0	0	1582	0.0000000
zheyou73v0_A05	23196867	23198625	BnaA05T0262800ZY	0	+	0	0	1758	0.0000000
zheyou73v0_A05	23260485	23260653	BnaA05T0262900ZY	0	+	0	0	168	0.0000000
zheyou73v0_A05	23262099	23262325	BnaA05T0263000ZY	0	-	0	0	226	0.0000000
zheyou73v0_A05	23439181	23439379	BnaA05T0263100ZY	0	+	0	0	198	0.0000000
zheyou73v0_A05	23575151	23576200	BnaA05T0263200ZY	0	-	0	0	1049	0.0000000
zheyou73v0_A05	23726263	23726467	BnaA05T0263300ZY	0	+	0	0	204	0.0000000
zheyou73v0_A05	23726720	23728207	BnaA05T0263400ZY	0	+	0	0	1487	0.0000000
zheyou73v0_A05	23728258	23730589	BnaA05T0263500ZY	0	-	0	0	2331	0.0000000
zheyou73v0_A05	23813818	23814285	BnaA05T0263600ZY	0	-	0	0	467	0.0000000
zheyou73v0_A05	23848684	23849874	BnaA05T0263700ZY	0	-	0	0	1190	0.0000000
zheyou73v0_A05	23938961	23939906	BnaA05T0263800ZY	0	+	0	0	945	0.0000000
zheyou73v0_A05	23940550	23940718	BnaA05T0263900ZY	0	-	0	0	168	0.0000000
zheyou73v0_A05	23941636	23945517	BnaA05T0264000ZY	0	-	0	0	3881	0.0000000
zheyou73v0_A05	24291876	24292062	BnaA05T0264100ZY	0	+	0	0	186	0.0000000
zheyou73v0_A05	24302710	24304542	BnaA05T0264200ZY	0	-	0	0	1832	0.0000000
zheyou73v0_A05	24326925	24339659	BnaA05T0264300ZY	0	+	0	0	12734	0.0000000
zheyou73v0_A05	24628667	24633181	BnaA05T0264400ZY	0	+	0	0	4514	0.0000000
zheyou73v0_A05	24633936	24634104	BnaA05T0264500ZY	0	-	0	0	168	0.0000000
zheyou73v0_A05	25112003	25112507	BnaA05T0264600ZY	0	-	0	0	504	0.0000000
zheyou73v0_A05	25233002	25233506	BnaA05T0264700ZY	0	-	0	0	504	0.0000000
zheyou73v0_A05	26158469	26158761	BnaA05T0264800ZY	0	-	0	0	292	0.0000000
zheyou73v0_A05	26311373	26312860	BnaA05T0264900ZY	0	+	0	0	1487	0.0000000
zheyou73v0_A05	26312911	26322272	BnaA05T0265000ZY	0	-	0	0	9361	0.0000000
zheyou73v0_A05	26332451	26333130	BnaA05T0265100ZY	0	+	0	0	679	0.0000000
zheyou73v0_A05	26354925	26355392	BnaA05T0265200ZY	0	-	0	0	467	0.0000000
zheyou73v0_A05	26355546	26356757	BnaA05T0265300ZY	0	-	0	0	1211	0.0000000
zheyou73v0_A05	26370913	26372506	BnaA05T0265400ZY	0	+	0	0	1593	0.0000000
zheyou73v0_A05	26372906	26374116	BnaA05T0265500ZY	0	-	0	0	1210	0.0000000
zheyou73v0_A05	26470743	26471210	BnaA05T0265600ZY	0	-	0	0	467	0.0000000
zheyou73v0_A05	26471377	26472576	BnaA05T0265700ZY	0	-	0	0	1199	0.0000000
zheyou73v0_A05	26478572	26478740	BnaA05T0265800ZY	0	+	0	0	168	0.0000000
zheyou73v0_A05	26482417	26482780	BnaA05T0265900ZY	0	-	0	0	363	0.0000000
zheyou73v0_A05	26485265	26486224	BnaA05T0266000ZY	0	+	0	0	959	0.0000000
zheyou73v0_A05	26486624	26487836	BnaA05T0266100ZY	0	-	0	0	1212	0.0000000
zheyou73v0_A05	26493795	26494642	BnaA05T0266200ZY	0	+	0	0	847	0.0000000
zheyou73v0_A05	26519586	26521179	BnaA05T0266300ZY	0	+	0	0	1593	0.0000000
zheyou73v0_A05	26529297	26529626	BnaA05T0266400ZY	0	-	0	0	329	0.0000000
zheyou73v0_A05	26534383	26535501	BnaA05T0266500ZY	0	+	0	0	1118	0.0000000
zheyou73v0_A05	26536852	26538063	BnaA05T0266600ZY	0	+	0	0	1211	0.0000000
zheyou73v0_A05	26538217	26539023	BnaA05T0266700ZY	0	+	0	0	806	0.0000000
zheyou73v0_A05	26540385	26542453	BnaA05T0266800ZY	0	+	0	0	2068	0.0000000
zheyou73v0_A05	26542504	26543327	BnaA05T0266900ZY	0	-	0	0	823	0.0000000
zheyou73v0_A05	26544244	26544573	BnaA05T0267000ZY	0	-	0	0	329	0.0000000
zheyou73v0_A05	26549143	26550354	BnaA05T0267100ZY	0	+	0	0	1211	0.0000000
zheyou73v0_A05	26556630	26558698	BnaA05T0267200ZY	0	-	0	0	2068	0.0000000
zheyou73v0_A05	26563731	26564060	BnaA05T0267300ZY	0	+	0	0	329	0.0000000
zheyou73v0_A05	26564977	26565800	BnaA05T0267400ZY	0	+	0	0	823	0.0000000
zheyou73v0_A05	26565851	26567919	BnaA05T0267500ZY	0	-	0	0	2068	0.0000000
zheyou73v0_A05	26574919	26576987	BnaA05T0267600ZY	0	-	0	0	2068	0.0000000
zheyou73v0_A05	26581964	26582293	BnaA05T0267700ZY	0	+	0	0	329	0.0000000
zheyou73v0_A05	26583210	26584033	BnaA05T0267800ZY	0	+	0	0	823	0.0000000
zheyou73v0_A05	26584084	26586153	BnaA05T0267900ZY	0	-	0	0	2069	0.0000000
zheyou73v0_A05	26597549	26597878	BnaA05T0268000ZY	0	+	0	0	329	0.0000000
zheyou73v0_A05	26598795	26599614	BnaA05T0268100ZY	0	+	0	0	819	0.0000000
zheyou73v0_A05	26599665	26601733	BnaA05T0268200ZY	0	-	0	0	2068	0.0000000
zheyou73v0_A05	26606525	26606854	BnaA05T0268300ZY	0	+	0	0	329	0.0000000
zheyou73v0_A05	26607771	26608594	BnaA05T0268400ZY	0	+	0	0	823	0.0000000
zheyou73v0_A05	26608645	26609957	BnaA05T0268500ZY	0	-	0	0	1312	0.0000000
zheyou73v0_A05	26610417	26610976	BnaA05T0268600ZY	0	-	0	0	559	0.0000000
zheyou73v0_A05	27040240	27041727	BnaA05T0268700ZY	0	+	0	0	1487	0.0000000
zheyou73v0_A05	27042276	27042743	BnaA05T0268800ZY	0	-	0	0	467	0.0000000
zheyou73v0_A05	27042897	27044108	BnaA05T0268900ZY	0	-	0	0	1211	0.0000000
zheyou73v0_A05	27051936	27052104	BnaA05T0269000ZY	0	+	0	0	168	0.0000000
zheyou73v0_A05	27052811	27054880	BnaA05T0269100ZY	0	-	0	0	2069	0.0000000
zheyou73v0_A05	27055268	27065390	BnaA05T0269200ZY	0	-	0	0	10122	0.0000000
zheyou73v0_A05	27069795	27069963	BnaA05T0269300ZY	0	+	0	0	168	0.0000000
zheyou73v0_A05	27070669	27071045	BnaA05T0269400ZY	0	-	0	0	376	0.0000000
zheyou73v0_A05	27071167	27071634	BnaA05T0269500ZY	0	-	0	0	467	0.0000000
zheyou73v0_A05	27071788	27072999	BnaA05T0269600ZY	0	-	0	0	1211	0.0000000
zheyou73v0_A05	27494403	27494910	BnaA05T0269700ZY	0	-	0	0	507	0.0000000
zheyou73v0_A05	27641403	27643438	BnaA05T0269800ZY	0	+	0	0	2035	0.0000000
zheyou73v0_A05	27644144	27644312	BnaA05T0269900ZY	0	-	0	0	168	0.0000000
zheyou73v0_A05	27649805	27652135	BnaA05T0270000ZY	0	+	0	0	2330	0.0000000
zheyou73v0_A05	27653925	27654129	BnaA05T0270100ZY	0	-	0	0	204	0.0000000
zheyou73v0_A05	27750145	27750652	BnaA05T0270200ZY	0	-	0	0	507	0.0000000
zheyou73v0_A05	28531274	28532018	BnaA05T0270300ZY	0	-	0	0	744	0.0000000
zheyou73v0_A05	28714778	28715282	BnaA05T0270400ZY	0	+	0	0	504	0.0000000
zheyou73v0_A05	29430347	29431896	BnaA05T0270500ZY	0	-	0	0	1549	0.0000000
zheyou73v0_A05	29577419	29577644	BnaA05T0270600ZY	0	+	0	0	225	0.0000000
zheyou73v0_A05	29587771	29588920	BnaA05T0270700ZY	0	-	0	0	1149	0.0000000
zheyou73v0_A05	29615001	29620122	BnaA05T0270800ZY	0	-	0	0	5121	0.0000000
zheyou73v0_A05	29620086	29623322	BnaA05T0270900ZY	0	+	0	0	3236	0.0000000
zheyou73v0_A05	29620086	29623322	BnaA05T0270900ZY.1	0	+	0	0	3236	0.0000000
zheyou73v0_A05	29625933	29627354	BnaA05T0271000ZY	0	-	0	0	1421	0.0000000
zheyou73v0_A05	29626399	29627354	BnaA05T0271000ZY.1	0	-	0	0	955	0.0000000
zheyou73v0_A05	29656391	29656562	BnaA05T0271100ZY	0	+	0	0	171	0.0000000
zheyou73v0_A05	29657665	29659443	BnaA05T0271200ZY	0	-	0	0	1778	0.0000000
zheyou73v0_A05	29664083	29684535	BnaA05T0271300ZY	0	+	0	0	20452	0.0000000
zheyou73v0_A05	29713590	29715213	BnaA05T0271400ZY	0	+	0	0	1623	0.0000000
zheyou73v0_A05	29757799	29759826	BnaA05T0271500ZY	0	+	0	0	2027	0.0000000
zheyou73v0_A05	29909493	29909675	BnaA05T0271600ZY	0	+	0	0	182	0.0000000
zheyou73v0_A05	29910506	29910828	BnaA05T0271700ZY	0	+	0	0	322	0.0000000
zheyou73v0_A05	29911834	29912482	BnaA05T0271800ZY	0	-	0	0	648	0.0000000
zheyou73v0_A05	29920205	29921171	BnaA05T0271900ZY	0	-	0	0	966	0.0000000
zheyou73v0_A05	30188569	30189140	BnaA05T0272000ZY	0	-	0	0	571	0.0000000
zheyou73v0_A05	30189557	30192336	BnaA05T0272100ZY	0	-	0	0	2779	0.0000000
zheyou73v0_A05	30216667	30217219	BnaA05T0272200ZY	0	+	0	0	552	0.0000000
zheyou73v0_A05	30451302	30453385	BnaA05T0272300ZY	0	+	0	0	2083	0.0000000
zheyou73v0_A05	30476225	30476375	BnaA05T0272400ZY	0	-	0	0	150	0.0000000
zheyou73v0_A05	30490454	30491429	BnaA05T0272500ZY	0	-	0	0	975	0.0000000
zheyou73v0_A05	30496392	30497836	BnaA05T0272600ZY	0	+	0	0	1444	0.0000000
zheyou73v0_A05	30661213	30662937	BnaA05T0272700ZY	0	+	0	0	1724	0.0000000
zheyou73v0_A05	30665585	30666404	BnaA05T0272800ZY	0	-	0	0	819	0.0000000
zheyou73v0_A05	30670206	30672257	BnaA05T0272900ZY	0	-	0	0	2051	0.0000000
zheyou73v0_A05	30670206	30672257	BnaA05T0272900ZY.1	0	-	0	0	2051	0.0000000
zheyou73v0_A05	30678654	30678945	BnaA05T0273000ZY	0	+	0	0	291	0.0000000
zheyou73v0_A05	30681218	30684759	BnaA05T0273100ZY	0	-	0	0	3541	0.0000000
zheyou73v0_A05	30691279	30709426	BnaA05T0273200ZY	0	-	0	0	18147	0.0000000
zheyou73v0_A05	30716704	30723651	BnaA05T0273300ZY	0	-	0	0	6947	0.0000000
zheyou73v0_A05	30726042	30737113	BnaA05T0273400ZY	0	+	0	0	11071	0.0000000
zheyou73v0_A05	30747764	30749988	BnaA05T0273500ZY	0	-	0	0	2224	0.0000000
zheyou73v0_A05	30748370	30750065	BnaA05T0273500ZY.1	0	-	0	0	1695	0.0000000
zheyou73v0_A05	30761619	30763875	BnaA05T0273600ZY	0	-	0	0	2256	0.0000000
zheyou73v0_A05	30805952	30806917	BnaA05T0273700ZY	0	-	0	0	965	0.0000000
zheyou73v0_A05	30807026	30807320	BnaA05T0273800ZY	0	-	0	0	294	0.0000000
zheyou73v0_A05	30831956	30833951	BnaA05T0273900ZY	0	+	0	0	1995	0.0000000
zheyou73v0_A05	30848735	30849264	BnaA05T0274000ZY	0	+	0	0	529	0.0000000
zheyou73v0_A05	30849455	30850282	BnaA05T0274100ZY	0	+	0	0	827	0.0000000
zheyou73v0_A05	30856045	30862720	BnaA05T0274200ZY	0	+	0	0	6675	0.0000000
zheyou73v0_A05	30868786	30869187	BnaA05T0274300ZY	0	-	0	0	401	0.0000000
zheyou73v0_A05	30883407	30888070	BnaA05T0274400ZY	0	+	0	0	4663	0.0000000
zheyou73v0_A05	30895658	30902924	BnaA05T0274500ZY	0	+	0	0	7266	0.0000000
zheyou73v0_A05	30895658	30902924	BnaA05T0274500ZY.1	0	+	0	0	7266	0.0000000
zheyou73v0_A05	30895658	30902924	BnaA05T0274500ZY.2	0	+	0	0	7266	0.0000000
zheyou73v0_A05	30911068	30912030	BnaA05T0274600ZY	0	+	0	0	962	0.0000000
zheyou73v0_A05	30925816	30938733	BnaA05T0274700ZY	0	+	0	0	12917	0.0000000
zheyou73v0_A05	30942494	30944430	BnaA05T0274800ZY	0	-	0	0	1936	0.0000000
zheyou73v0_A05	30945258	30948145	BnaA05T0274900ZY	0	+	0	0	2887	0.0000000
zheyou73v0_A05	30949188	30950725	BnaA05T0275000ZY	0	-	0	0	1537	0.0000000
zheyou73v0_A05	30956973	30957738	BnaA05T0275100ZY	0	-	0	0	765	0.0000000
zheyou73v0_A05	30959490	30960329	BnaA05T0275200ZY	0	-	0	0	839	0.0000000
zheyou73v0_A05	30982955	30983568	BnaA05T0275300ZY	0	+	0	0	613	0.0000000
zheyou73v0_A05	31008022	31010084	BnaA05T0275400ZY	0	-	0	0	2062	0.0000000
zheyou73v0_A05	31018423	31022694	BnaA05T0275500ZY	0	-	0	0	4271	0.0000000
zheyou73v0_A05	31078142	31079356	BnaA05T0275600ZY	0	+	0	0	1214	0.0000000
zheyou73v0_A05	31113645	31115164	BnaA05T0275700ZY	0	+	0	0	1519	0.0000000
zheyou73v0_A05	31123035	31124345	BnaA05T0275800ZY	0	-	0	0	1310	0.0000000
zheyou73v0_A05	31128294	31129519	BnaA05T0275900ZY	0	+	0	0	1225	0.0000000
zheyou73v0_A05	31134006	31136009	BnaA05T0276000ZY	0	-	0	0	2003	0.0000000
zheyou73v0_A05	31134006	31136009	BnaA05T0276000ZY.1	0	-	0	0	2003	0.0000000
zheyou73v0_A05	31134006	31136009	BnaA05T0276000ZY.2	0	-	0	0	2003	0.0000000
zheyou73v0_A05	31155932	31157063	BnaA05T0276100ZY	0	+	0	0	1131	0.0000000
zheyou73v0_A05	31175796	31178170	BnaA05T0276200ZY	0	-	0	0	2374	0.0000000
zheyou73v0_A05	31197383	31197539	BnaA05T0276300ZY	0	+	0	0	156	0.0000000
zheyou73v0_A05	31198927	31201251	BnaA05T0276400ZY	0	-	0	0	2324	0.0000000
zheyou73v0_A05	31201175	31205721	BnaA05T0276500ZY	0	+	0	0	4546	0.0000000
zheyou73v0_A05	31213563	31216508	BnaA05T0276600ZY	0	-	0	0	2945	0.0000000
zheyou73v0_A05	31220827	31221509	BnaA05T0276700ZY	0	+	0	0	682	0.0000000
zheyou73v0_A05	31238913	31239831	BnaA05T0276800ZY	0	-	0	0	918	0.0000000
zheyou73v0_A05	31239887	31247791	BnaA05T0276900ZY	0	-	0	0	7904	0.0000000
zheyou73v0_A05	31264596	31269654	BnaA05T0277000ZY	0	+	0	0	5058	0.0000000
zheyou73v0_A05	31277683	31280326	BnaA05T0277100ZY	0	-	0	0	2643	0.0000000
zheyou73v0_A05	31289852	31290931	BnaA05T0277200ZY	0	-	0	0	1079	0.0000000
zheyou73v0_A05	31308845	31312297	BnaA05T0277300ZY	0	+	0	0	3452	0.0000000
zheyou73v0_A05	31314371	31319563	BnaA05T0277400ZY	0	+	0	0	5192	0.0000000
zheyou73v0_A05	31319611	31321733	BnaA05T0277500ZY	0	-	0	0	2122	0.0000000
zheyou73v0_A05	31334388	31335259	BnaA05T0277600ZY	0	+	0	0	871	0.0000000
zheyou73v0_A05	31335949	31347422	BnaA05T0277700ZY	0	+	0	0	11473	0.0000000
zheyou73v0_A05	31350650	31351590	BnaA05T0277800ZY	0	-	0	0	940	0.0000000
zheyou73v0_A05	31350650	31351728	BnaA05T0277800ZY.1	0	-	0	0	1078	0.0000000
zheyou73v0_A05	31363588	31363836	BnaA05T0277900ZY	0	-	0	0	248	0.0000000
zheyou73v0_A05	31367312	31369825	BnaA05T0278000ZY	0	+	0	0	2513	0.0000000
zheyou73v0_A05	31378490	31378968	BnaA05T0278100ZY	0	+	0	0	478	0.0000000
zheyou73v0_A05	31430057	31430222	BnaA05T0278200ZY	0	+	0	0	165	0.0000000
zheyou73v0_A05	31433650	31434016	BnaA05T0278300ZY	0	-	0	0	366	0.0000000
zheyou73v0_A05	31437136	31437969	BnaA05T0278400ZY	0	-	0	0	833	0.0000000
zheyou73v0_A05	31447190	31449389	BnaA05T0278500ZY	0	-	0	0	2199	0.0000000
zheyou73v0_A05	31457227	31457753	BnaA05T0278600ZY	0	-	0	0	526	0.0000000
zheyou73v0_A05	31471978	31473891	BnaA05T0278700ZY	0	+	0	0	1913	0.0000000
zheyou73v0_A05	31471978	31473891	BnaA05T0278700ZY.1	0	+	0	0	1913	0.0000000
zheyou73v0_A05	31471978	31473891	BnaA05T0278700ZY.2	0	+	0	0	1913	0.0000000
zheyou73v0_A05	31474376	31476095	BnaA05T0278800ZY	0	-	0	0	1719	0.0000000
zheyou73v0_A05	31482491	31483654	BnaA05T0278900ZY	0	-	0	0	1163	0.0000000
zheyou73v0_A05	31518216	31518913	BnaA05T0279000ZY	0	+	0	0	697	0.0000000
zheyou73v0_A05	31519408	31521762	BnaA05T0279100ZY	0	-	0	0	2354	0.0000000
zheyou73v0_A05	31528721	31530594	BnaA05T0279200ZY	0	+	0	0	1873	0.0000000
zheyou73v0_A05	31531770	31532067	BnaA05T0279300ZY	0	-	0	0	297	0.0000000
zheyou73v0_A05	31549848	31550714	BnaA05T0279400ZY	0	+	0	0	866	0.0000000
zheyou73v0_A05	31555224	31555782	BnaA05T0279500ZY	0	-	0	0	558	0.0000000
zheyou73v0_A05	31558624	31559227	BnaA05T0279600ZY	0	-	0	0	603	0.0000000
zheyou73v0_A05	31610808	31612774	BnaA05T0279700ZY	0	-	0	0	1966	0.0000000
zheyou73v0_A05	31627826	31629584	BnaA05T0279800ZY	0	+	0	0	1758	0.0000000
zheyou73v0_A05	31634411	31636156	BnaA05T0279900ZY	0	-	0	0	1745	0.0000000
zheyou73v0_A05	31639433	31641635	BnaA05T0280000ZY	0	+	0	0	2202	0.0000000
zheyou73v0_A05	31641726	31643939	BnaA05T0280100ZY	0	-	0	0	2213	0.0000000
zheyou73v0_A05	31652635	31653586	BnaA05T0280200ZY	0	-	0	0	951	0.0000000
zheyou73v0_A05	31676943	31679298	BnaA05T0280300ZY	0	+	0	0	2355	0.0000000
zheyou73v0_A05	31680609	31683338	BnaA05T0280400ZY	0	-	0	0	2729	0.0000000
zheyou73v0_A05	31680609	31683338	BnaA05T0280400ZY.1	0	-	0	0	2729	0.0000000
zheyou73v0_A05	31733182	31734769	BnaA05T0280500ZY	0	+	0	0	1587	0.0000000
zheyou73v0_A05	31741393	31741663	BnaA05T0280600ZY	0	+	0	0	270	0.0000000
zheyou73v0_A05	31758404	31764729	BnaA05T0280700ZY	0	+	0	0	6325	0.0000000
zheyou73v0_A05	31769829	31770734	BnaA05T0280800ZY	0	+	0	0	905	0.0000000
zheyou73v0_A05	31770866	31775077	BnaA05T0280900ZY	0	+	0	0	4211	0.0000000
zheyou73v0_A05	31786097	31786754	BnaA05T0281000ZY	0	-	0	0	657	0.0000000
zheyou73v0_A05	31792661	31793270	BnaA05T0281100ZY	0	-	0	0	609	0.0000000
zheyou73v0_A05	31805628	31808285	BnaA05T0281200ZY	0	+	0	0	2657	0.0000000
zheyou73v0_A05	31815309	31815540	BnaA05T0281300ZY	0	-	0	0	231	0.0000000
zheyou73v0_A05	31816549	31816753	BnaA05T0281400ZY	0	+	0	0	204	0.0000000
zheyou73v0_A05	31831077	31831275	BnaA05T0281500ZY	0	+	0	0	198	0.0000000
zheyou73v0_A05	31831532	31831869	BnaA05T0281600ZY	0	-	0	0	337	0.0000000
zheyou73v0_A05	31835224	31836544	BnaA05T0281700ZY	0	+	0	0	1320	0.0000000
zheyou73v0_A05	31851792	31853112	BnaA05T0281800ZY	0	+	0	0	1320	0.0000000
zheyou73v0_A05	31868372	31874944	BnaA05T0281900ZY	0	+	0	0	6572	0.0000000
zheyou73v0_A05	31882279	31883641	BnaA05T0282000ZY	0	+	0	0	1362	0.0000000
zheyou73v0_A05	31895919	31899819	BnaA05T0282100ZY	0	+	0	0	3900	0.0000000
zheyou73v0_A05	31902871	31903207	BnaA05T0282200ZY	0	+	0	0	336	0.0000000
zheyou73v0_A05	31903853	31907258	BnaA05T0282300ZY	0	-	0	0	3405	0.0000000
zheyou73v0_A05	31920294	31922585	BnaA05T0282400ZY	0	+	0	0	2291	0.0000000
zheyou73v0_A05	31949584	31952817	BnaA05T0282500ZY	0	+	0	0	3233	0.0000000
zheyou73v0_A05	31972861	31974271	BnaA05T0282600ZY	0	+	0	0	1410	0.0000000
zheyou73v0_A05	31983809	31985798	BnaA05T0282700ZY	0	+	0	0	1989	0.0000000
zheyou73v0_A05	31990742	31992063	BnaA05T0282800ZY	0	+	0	0	1321	0.0000000
zheyou73v0_A05	31999366	32001331	BnaA05T0282900ZY	0	-	0	0	1965	0.0000000
zheyou73v0_A05	31999366	32000984	BnaA05T0282900ZY.1	0	-	0	0	1618	0.0000000
zheyou73v0_A05	32009664	32010306	BnaA05T0283000ZY	0	+	0	0	642	0.0000000
zheyou73v0_A05	32082077	32082410	BnaA05T0283100ZY	0	+	0	0	333	0.0000000
zheyou73v0_A05	32096807	32098974	BnaA05T0283200ZY	0	+	0	0	2167	0.0000000
zheyou73v0_A05	32100998	32101972	BnaA05T0283300ZY	0	-	0	0	974	0.0000000
zheyou73v0_A05	32102515	32103865	BnaA05T0283400ZY	0	+	0	0	1350	0.0000000
zheyou73v0_A05	32107064	32108464	BnaA05T0283500ZY	0	-	0	0	1400	0.0000000
zheyou73v0_A05	32109287	32110871	BnaA05T0283600ZY	0	+	0	0	1584	0.0000000
zheyou73v0_A05	32111332	32113625	BnaA05T0283700ZY	0	-	0	0	2293	0.0000000
zheyou73v0_A05	32117940	32163756	BnaA05T0283800ZY	0	-	0	0	45816	0.0000000
zheyou73v0_A05	32117940	32162414	BnaA05T0283800ZY.1	0	-	0	0	44474	0.0000000
zheyou73v0_A05	32181004	32181208	BnaA05T0283900ZY	0	+	0	0	204	0.0000000
zheyou73v0_A05	32187720	32188962	BnaA05T0284000ZY	0	+	0	0	1242	0.0000000
zheyou73v0_A05	32189865	32190801	BnaA05T0284100ZY	0	-	0	0	936	0.0000000
zheyou73v0_A05	32191593	32193724	BnaA05T0284200ZY	0	+	0	0	2131	0.0000000
zheyou73v0_A05	32194099	32200838	BnaA05T0284300ZY	0	+	0	0	6739	0.0000000
zheyou73v0_A05	32205287	32206118	BnaA05T0284400ZY	0	+	0	0	831	0.0000000
zheyou73v0_A05	32206371	32206671	BnaA05T0284500ZY	0	-	0	0	300	0.0000000
zheyou73v0_A05	32293072	32297815	BnaA05T0284600ZY	0	+	0	0	4743	0.0000000
zheyou73v0_A05	32296093	32297815	BnaA05T0284600ZY.1	0	+	0	0	1722	0.0000000
zheyou73v0_A05	32298060	32300629	BnaA05T0284700ZY	0	-	0	0	2569	0.0000000
zheyou73v0_A05	32312876	32313346	BnaA05T0284800ZY	0	+	0	0	470	0.0000000
zheyou73v0_A05	32325908	32333199	BnaA05T0284900ZY	0	-	0	0	7291	0.0000000
zheyou73v0_A05	32334449	32336619	BnaA05T0285000ZY	0	+	0	0	2170	0.0000000
zheyou73v0_A05	32345889	32348042	BnaA05T0285100ZY	0	-	0	0	2153	0.0000000
zheyou73v0_A05	32353134	32354106	BnaA05T0285200ZY	0	+	0	0	972	0.0000000
zheyou73v0_A05	32354428	32355820	BnaA05T0285300ZY	0	-	0	0	1392	0.0000000
zheyou73v0_A05	32366365	32368229	BnaA05T0285400ZY	0	+	0	0	1864	0.0000000
zheyou73v0_A05	32385376	32388079	BnaA05T0285500ZY	0	+	0	0	2703	0.0000000
zheyou73v0_A05	32385376	32388079	BnaA05T0285500ZY.1	0	+	0	0	2703	0.0000000
zheyou73v0_A05	32385376	32388079	BnaA05T0285500ZY.2	0	+	0	0	2703	0.0000000
zheyou73v0_A05	32488191	32488442	BnaA05T0285600ZY	0	+	0	0	251	0.0000000
zheyou73v0_A05	32489177	32489474	BnaA05T0285700ZY	0	+	0	0	297	0.0000000
zheyou73v0_A05	32501113	32502125	BnaA05T0285800ZY	0	-	0	0	1012	0.0000000
zheyou73v0_A05	32511282	32512313	BnaA05T0285900ZY	0	-	0	0	1031	0.0000000
zheyou73v0_A05	32599665	32604715	BnaA05T0286000ZY	0	+	0	0	5050	0.0000000
zheyou73v0_A05	32668197	32669435	BnaA05T0286100ZY	0	+	0	0	1238	0.0000000
zheyou73v0_A05	32670459	32672987	BnaA05T0286200ZY	0	+	0	0	2528	0.0000000
zheyou73v0_A05	32697965	32700277	BnaA05T0286300ZY	0	+	0	0	2312	0.0000000
zheyou73v0_A05	32707147	32707950	BnaA05T0286400ZY	0	+	0	0	803	0.0000000
zheyou73v0_A05	32713969	32717408	BnaA05T0286500ZY	0	+	0	0	3439	0.0000000
zheyou73v0_A05	32735033	32738102	BnaA05T0286600ZY	0	-	0	0	3069	0.0000000
zheyou73v0_A05	32758025	32759600	BnaA05T0286700ZY	0	-	0	0	1575	0.0000000
zheyou73v0_A05	32765976	32768155	BnaA05T0286800ZY	0	+	0	0	2179	0.0000000
zheyou73v0_A05	32768934	32775836	BnaA05T0286900ZY	0	+	0	0	6902	0.0000000
zheyou73v0_A05	32777208	32778062	BnaA05T0287000ZY	0	-	0	0	854	0.0000000
zheyou73v0_A05	32794867	32798738	BnaA05T0287100ZY	0	+	0	0	3871	0.0000000
zheyou73v0_A05	32809597	32810774	BnaA05T0287200ZY	0	-	0	0	1177	0.0000000
zheyou73v0_A05	32825935	32827514	BnaA05T0287300ZY	0	+	0	0	1579	0.0000000
zheyou73v0_A05	32825935	32827179	BnaA05T0287300ZY.1	0	+	0	0	1244	0.0000000
zheyou73v0_A05	32855979	32856162	BnaA05T0287400ZY	0	+	0	0	183	0.0000000
zheyou73v0_A05	32870856	32875080	BnaA05T0287500ZY	0	+	0	0	4224	0.0000000
zheyou73v0_A05	32882967	32885255	BnaA05T0287600ZY	0	+	0	0	2288	0.0000000
zheyou73v0_A05	32885512	32886789	BnaA05T0287700ZY	0	+	0	0	1277	0.0000000
zheyou73v0_A05	32887024	32889079	BnaA05T0287800ZY	0	-	0	0	2055	0.0000000
zheyou73v0_A05	32890790	32893074	BnaA05T0287900ZY	0	-	0	0	2284	0.0000000
zheyou73v0_A05	32897302	32899329	BnaA05T0288000ZY	0	+	0	0	2027	0.0000000
zheyou73v0_A05	32899000	32899252	BnaA05T0288100ZY	0	-	0	0	252	0.0000000
zheyou73v0_A05	32900795	32904862	BnaA05T0288200ZY	0	-	0	0	4067	0.0000000
zheyou73v0_A05	32900795	32904862	BnaA05T0288200ZY.1	0	-	0	0	4067	0.0000000
zheyou73v0_A05	32900795	32904862	BnaA05T0288200ZY.2	0	-	0	0	4067	0.0000000
zheyou73v0_A05	32908429	32914720	BnaA05T0288300ZY	0	+	0	0	6291	0.0000000
zheyou73v0_A05	32914899	32916844	BnaA05T0288400ZY	0	-	0	0	1945	0.0000000
zheyou73v0_A05	32950564	32952201	BnaA05T0288500ZY	0	-	0	0	1637	0.0000000
zheyou73v0_A05	32954150	32954541	BnaA05T0288600ZY	0	+	0	0	391	0.0000000
zheyou73v0_A05	32960099	32961004	BnaA05T0288700ZY	0	-	0	0	905	0.0000000
zheyou73v0_A05	32961008	32964289	BnaA05T0288800ZY	0	-	0	0	3281	0.0000000
zheyou73v0_A05	32971895	32976253	BnaA05T0288900ZY	0	-	0	0	4358	0.0000000
zheyou73v0_A05	32983133	32986072	BnaA05T0289000ZY	0	-	0	0	2939	0.0000000
zheyou73v0_A05	32986226	32988225	BnaA05T0289100ZY	0	+	0	0	1999	0.0000000
zheyou73v0_A05	32986226	32988225	BnaA05T0289100ZY.1	0	+	0	0	1999	0.0000000
zheyou73v0_A05	32992744	32996548	BnaA05T0289200ZY	0	-	0	0	3804	0.0000000
zheyou73v0_A05	33004227	33005070	BnaA05T0289300ZY	0	+	0	0	843	0.0000000
zheyou73v0_A05	33013820	33016378	BnaA05T0289400ZY	0	+	0	0	2558	0.0000000
zheyou73v0_A05	33018914	33020255	BnaA05T0289500ZY	0	+	0	0	1341	0.0000000
zheyou73v0_A05	33020387	33021724	BnaA05T0289600ZY	0	+	0	0	1337	0.0000000
zheyou73v0_A05	33028824	33030277	BnaA05T0289700ZY	0	+	0	0	1453	0.0000000
zheyou73v0_A05	33031380	33032000	BnaA05T0289800ZY	0	+	0	0	620	0.0000000
zheyou73v0_A05	33069410	33070252	BnaA05T0289900ZY	0	-	0	0	842	0.0000000
zheyou73v0_A05	33073552	33076321	BnaA05T0290000ZY	0	+	0	0	2769	0.0000000
zheyou73v0_A05	33079982	33081313	BnaA05T0290100ZY	0	+	0	0	1331	0.0000000
zheyou73v0_A05	33097633	33100162	BnaA05T0290200ZY	0	+	0	0	2529	0.0000000
zheyou73v0_A05	33097633	33100162	BnaA05T0290200ZY.1	0	+	0	0	2529	0.0000000
zheyou73v0_A05	33102712	33104867	BnaA05T0290300ZY	0	+	0	0	2155	0.0000000
zheyou73v0_A05	33104274	33108343	BnaA05T0290400ZY	0	-	0	0	4069	0.0000000
zheyou73v0_A05	33104274	33108343	BnaA05T0290400ZY.1	0	-	0	0	4069	0.0000000
zheyou73v0_A05	33104274	33108343	BnaA05T0290400ZY.2	0	-	0	0	4069	0.0000000
zheyou73v0_A05	33119352	33119640	BnaA05T0290500ZY	0	-	0	0	288	0.0000000
zheyou73v0_A05	33129377	33137353	BnaA05T0290600ZY	0	-	0	0	7976	0.0000000
zheyou73v0_A05	33162767	33164460	BnaA05T0290700ZY	0	-	0	0	1693	0.0000000
zheyou73v0_A05	33178124	33179080	BnaA05T0290800ZY	0	+	0	0	956	0.0000000
zheyou73v0_A05	33180120	33180766	BnaA05T0290900ZY	0	-	0	0	646	0.0000000
zheyou73v0_A05	33197658	33200371	BnaA05T0291000ZY	0	+	0	0	2713	0.0000000
zheyou73v0_A05	33200372	33201856	BnaA05T0291100ZY	0	-	0	0	1484	0.0000000
zheyou73v0_A05	33235854	33238049	BnaA05T0291200ZY	0	-	0	0	2195	0.0000000
zheyou73v0_A05	33238208	33241881	BnaA05T0291300ZY	0	+	0	0	3673	0.0000000
zheyou73v0_A05	33273091	33275020	BnaA05T0291400ZY	0	-	0	0	1929	0.0000000
zheyou73v0_A05	33284527	33284916	BnaA05T0291500ZY	0	+	0	0	389	0.0000000
zheyou73v0_A05	33302272	33303277	BnaA05T0291600ZY	0	-	0	0	1005	0.0000000
zheyou73v0_A05	33307970	33310552	BnaA05T0291700ZY	0	+	0	0	2582	0.0000000
zheyou73v0_A05	33338623	33341671	BnaA05T0291800ZY	0	+	0	0	3048	0.0000000
zheyou73v0_A05	33342424	33344910	BnaA05T0291900ZY	0	-	0	0	2486	0.0000000
zheyou73v0_A05	33377753	33378625	BnaA05T0292000ZY	0	-	0	0	872	0.0000000
zheyou73v0_A05	33380060	33382183	BnaA05T0292100ZY	0	-	0	0	2123	0.0000000
zheyou73v0_A05	33390820	33393154	BnaA05T0292200ZY	0	-	0	0	2334	0.0000000
zheyou73v0_A05	33395754	33398427	BnaA05T0292300ZY	0	-	0	0	2673	0.0000000
zheyou73v0_A05	33445661	33446822	BnaA05T0292400ZY	0	+	0	0	1161	0.0000000
zheyou73v0_A05	33447151	33448656	BnaA05T0292500ZY	0	-	0	0	1505	0.0000000
zheyou73v0_A05	33468615	33470520	BnaA05T0292600ZY	0	+	0	0	1905	0.0000000
zheyou73v0_A05	33477209	33477425	BnaA05T0292700ZY	0	-	0	0	216	0.0000000
zheyou73v0_A05	33483725	33484871	BnaA05T0292800ZY	0	+	0	0	1146	0.0000000
zheyou73v0_A05	33489575	33491493	BnaA05T0292900ZY	0	-	0	0	1918	0.0000000
zheyou73v0_A05	33505772	33507056	BnaA05T0293000ZY	0	+	0	0	1284	0.0000000
zheyou73v0_A05	33516264	33518368	BnaA05T0293100ZY	0	-	0	0	2104	0.0000000
zheyou73v0_A05	33529823	33536368	BnaA05T0293200ZY	0	+	0	0	6545	0.0000000
zheyou73v0_A05	33551705	33554727	BnaA05T0293300ZY	0	-	0	0	3022	0.0000000
zheyou73v0_A05	33560562	33563170	BnaA05T0293400ZY	0	-	0	0	2608	0.0000000
zheyou73v0_A05	33586306	33592478	BnaA05T0293500ZY	0	+	0	0	6172	0.0000000
zheyou73v0_A05	33602569	33605101	BnaA05T0293600ZY	0	+	0	0	2532	0.0000000
zheyou73v0_A05	33604144	33605856	BnaA05T0293700ZY	0	-	0	0	1712	0.0000000
zheyou73v0_A05	33606004	33607548	BnaA05T0293800ZY	0	+	0	0	1544	0.0000000
zheyou73v0_A05	33607994	33609560	BnaA05T0293900ZY	0	+	0	0	1566	0.0000000
zheyou73v0_A05	33609633	33610441	BnaA05T0294000ZY	0	-	0	0	808	0.0000000
zheyou73v0_A05	33617333	33618221	BnaA05T0294100ZY	0	+	0	0	888	0.0000000
zheyou73v0_A05	33618901	33620328	BnaA05T0294200ZY	0	-	0	0	1427	0.0000000
zheyou73v0_A05	33621165	33621763	BnaA05T0294300ZY	0	+	0	0	598	0.0000000
zheyou73v0_A05	33640849	33641979	BnaA05T0294400ZY	0	+	0	0	1130	0.0000000
zheyou73v0_A05	33685406	33685868	BnaA05T0294500ZY	0	+	0	0	462	0.0000000
zheyou73v0_A05	33694951	33695952	BnaA05T0294600ZY	0	-	0	0	1001	0.0000000
zheyou73v0_A05	33703270	33704279	BnaA05T0294700ZY	0	+	0	0	1009	0.0000000
zheyou73v0_A05	33705599	33707965	BnaA05T0294800ZY	0	-	0	0	2366	0.0000000
zheyou73v0_A05	33709917	33710773	BnaA05T0294900ZY	0	-	0	0	856	0.0000000
zheyou73v0_A05	33711240	33712113	BnaA05T0295000ZY	0	+	0	0	873	0.0000000
zheyou73v0_A05	33711763	33713094	BnaA05T0295100ZY	0	-	0	0	1331	0.0000000
zheyou73v0_A05	33722780	33727135	BnaA05T0295200ZY	0	-	0	0	4355	0.0000000
zheyou73v0_A05	33730230	33732266	BnaA05T0295300ZY	0	-	0	0	2036	0.0000000
zheyou73v0_A05	33735653	33738407	BnaA05T0295400ZY	0	-	0	0	2754	0.0000000
zheyou73v0_A05	33740871	33741422	BnaA05T0295500ZY	0	-	0	0	551	0.0000000
zheyou73v0_A05	33758602	33759197	BnaA05T0295600ZY	0	+	0	0	595	0.0000000
zheyou73v0_A05	33763242	33764035	BnaA05T0295700ZY	0	-	0	0	793	0.0000000
zheyou73v0_A05	33778765	33781816	BnaA05T0295800ZY	0	+	0	0	3051	0.0000000
zheyou73v0_A05	33783932	33789149	BnaA05T0295900ZY	0	-	0	0	5217	0.0000000
zheyou73v0_A05	33836629	33843172	BnaA05T0296000ZY	0	-	0	0	6543	0.0000000
zheyou73v0_A05	33861212	33864000	BnaA05T0296100ZY	0	-	0	0	2788	0.0000000
zheyou73v0_A05	33866129	33867058	BnaA05T0296200ZY	0	+	0	0	929	0.0000000
zheyou73v0_A05	33867359	33869988	BnaA05T0296300ZY	0	-	0	0	2629	0.0000000
zheyou73v0_A05	33870612	33871687	BnaA05T0296400ZY	0	-	0	0	1075	0.0000000
zheyou73v0_A05	33872394	33875152	BnaA05T0296500ZY	0	-	0	0	2758	0.0000000
zheyou73v0_A05	33883741	33884567	BnaA05T0296600ZY	0	+	0	0	826	0.0000000
zheyou73v0_A05	33884786	33888618	BnaA05T0296700ZY	0	-	0	0	3832	0.0000000
zheyou73v0_A05	33890335	33891305	BnaA05T0296800ZY	0	-	0	0	970	0.0000000
zheyou73v0_A05	33892649	33895348	BnaA05T0296900ZY	0	-	0	0	2699	0.0000000
zheyou73v0_A05	33892649	33895348	BnaA05T0296900ZY.1	0	-	0	0	2699	0.0000000
zheyou73v0_A05	33892649	33895348	BnaA05T0296900ZY.2	0	-	0	0	2699	0.0000000
zheyou73v0_A05	33901502	33901828	BnaA05T0297000ZY	0	-	0	0	326	0.0000000
zheyou73v0_A05	33909526	33912654	BnaA05T0297100ZY	0	-	0	0	3128	0.0000000
zheyou73v0_A05	33918659	33919342	BnaA05T0297200ZY	0	+	0	0	683	0.0000000
zheyou73v0_A05	33927385	33931036	BnaA05T0297300ZY	0	+	0	0	3651	0.0000000
zheyou73v0_A05	33931521	33932345	BnaA05T0297400ZY	0	+	0	0	824	0.0000000
zheyou73v0_A05	33932421	33946383	BnaA05T0297500ZY	0	-	0	0	13962	0.0000000
zheyou73v0_A05	33957229	33958827	BnaA05T0297600ZY	0	-	0	0	1598	0.0000000
zheyou73v0_A05	33962451	33964492	BnaA05T0297700ZY.1	0	+	0	0	2041	0.0000000
zheyou73v0_A05	33962588	33964492	BnaA05T0297700ZY	0	+	0	0	1904	0.0000000
zheyou73v0_A05	33979220	33982926	BnaA05T0297800ZY	0	-	0	0	3706	0.0000000
zheyou73v0_A05	33991550	33993513	BnaA05T0297900ZY	0	+	0	0	1963	0.0000000
zheyou73v0_A05	33995620	33999042	BnaA05T0298000ZY	0	+	0	0	3422	0.0000000
zheyou73v0_A05	33995620	33999042	BnaA05T0298000ZY.1	0	+	0	0	3422	0.0000000
zheyou73v0_A05	34012244	34013118	BnaA05T0298100ZY	0	+	0	0	874	0.0000000
zheyou73v0_A05	34021654	34024525	BnaA05T0298200ZY	0	-	0	0	2871	0.0000000
zheyou73v0_A05	34037254	34038406	BnaA05T0298300ZY	0	+	0	0	1152	0.0000000
zheyou73v0_A05	34041733	34043101	BnaA05T0298400ZY	0	-	0	0	1368	0.0000000
zheyou73v0_A05	34069592	34070874	BnaA05T0298500ZY	0	-	0	0	1282	0.0000000
zheyou73v0_A05	34069592	34070874	BnaA05T0298500ZY.1	0	-	0	0	1282	0.0000000
zheyou73v0_A05	34069592	34070874	BnaA05T0298500ZY.2	0	-	0	0	1282	0.0000000
zheyou73v0_A05	34069592	34070874	BnaA05T0298500ZY.3	0	-	0	0	1282	0.0000000
zheyou73v0_A05	34078654	34079040	BnaA05T0298600ZY	0	+	0	0	386	0.0000000
zheyou73v0_A05	34081872	34084723	BnaA05T0298700ZY	0	-	0	0	2851	0.0000000
zheyou73v0_A05	34081872	34083784	BnaA05T0298700ZY.1	0	-	0	0	1912	0.0000000
zheyou73v0_A05	34088169	34090047	BnaA05T0298800ZY	0	+	0	0	1878	0.0000000
zheyou73v0_A05	34089319	34089780	BnaA05T0298900ZY	0	-	0	0	461	0.0000000
zheyou73v0_A05	34090202	34091488	BnaA05T0299000ZY	0	-	0	0	1286	0.0000000
zheyou73v0_A05	34106087	34107746	BnaA05T0299100ZY	0	-	0	0	1659	0.0000000
zheyou73v0_A05	34114377	34115514	BnaA05T0299200ZY	0	-	0	0	1137	0.0000000
zheyou73v0_A05	34115719	34116745	BnaA05T0299300ZY	0	+	0	0	1026	0.0000000
zheyou73v0_A05	34137292	34139659	BnaA05T0299400ZY	0	+	0	0	2367	0.0000000
zheyou73v0_A05	34139705	34139936	BnaA05T0299500ZY	0	+	0	0	231	0.0000000
zheyou73v0_A05	34141055	34142259	BnaA05T0299600ZY	0	-	0	0	1204	0.0000000
zheyou73v0_A05	34158056	34159076	BnaA05T0299700ZY	0	+	0	0	1020	0.0000000
zheyou73v0_A05	34163634	34164698	BnaA05T0299800ZY	0	-	0	0	1064	0.0000000
zheyou73v0_A05	34173199	34174258	BnaA05T0299900ZY	0	-	0	0	1059	0.0000000
zheyou73v0_A05	34193182	34194195	BnaA05T0300000ZY	0	-	0	0	1013	0.0000000
zheyou73v0_A05	34206782	34207644	BnaA05T0300100ZY	0	+	0	0	862	0.0000000
zheyou73v0_A05	34208172	34210687	BnaA05T0300200ZY	0	+	0	0	2515	0.0000000
zheyou73v0_A05	34208172	34210687	BnaA05T0300200ZY.1	0	+	0	0	2515	0.0000000
zheyou73v0_A05	34208172	34210687	BnaA05T0300200ZY.2	0	+	0	0	2515	0.0000000
zheyou73v0_A05	34210866	34213486	BnaA05T0300300ZY	0	+	0	0	2620	0.0000000
zheyou73v0_A05	34219459	34220049	BnaA05T0300400ZY	0	-	0	0	590	0.0000000
zheyou73v0_A05	34238135	34249754	BnaA05T0300500ZY	0	+	0	0	11619	0.0000000
zheyou73v0_A05	34250153	34251564	BnaA05T0300600ZY	0	-	0	0	1411	0.0000000
zheyou73v0_A05	34253466	34255198	BnaA05T0300700ZY	0	-	0	0	1732	0.0000000
zheyou73v0_A05	34253466	34255198	BnaA05T0300700ZY.1	0	-	0	0	1732	0.0000000
zheyou73v0_A05	34266098	34267944	BnaA05T0300800ZY	0	-	0	0	1846	0.0000000
zheyou73v0_A05	34279978	34281618	BnaA05T0300900ZY	0	-	0	0	1640	0.0000000
zheyou73v0_A05	34284201	34285774	BnaA05T0301000ZY	0	+	0	0	1573	0.0000000
zheyou73v0_A05	34285996	34287436	BnaA05T0301100ZY	0	-	0	0	1440	0.0000000
zheyou73v0_A05	34292190	34293648	BnaA05T0301200ZY	0	-	0	0	1458	0.0000000
zheyou73v0_A05	34309128	34312565	BnaA05T0301300ZY	0	+	0	0	3437	0.0000000
zheyou73v0_A05	34318350	34321210	BnaA05T0301400ZY	0	-	0	0	2860	0.0000000
zheyou73v0_A05	34323365	34325555	BnaA05T0301500ZY	0	-	0	0	2190	0.0000000
zheyou73v0_A05	34339943	34344670	BnaA05T0301600ZY	0	-	0	0	4727	0.0000000
zheyou73v0_A05	34347216	34352604	BnaA05T0301700ZY	0	-	0	0	5388	0.0000000
zheyou73v0_A05	34372484	34373301	BnaA05T0301800ZY	0	+	0	0	817	0.0000000
zheyou73v0_A05	34373368	34373931	BnaA05T0301900ZY	0	+	0	0	563	0.0000000
zheyou73v0_A05	34375070	34375361	BnaA05T0302000ZY	0	+	0	0	291	0.0000000
zheyou73v0_A05	34376465	34376849	BnaA05T0302100ZY	0	+	0	0	384	0.0000000
zheyou73v0_A05	34387727	34390037	BnaA05T0302200ZY	0	+	0	0	2310	0.0000000
zheyou73v0_A05	34399165	34401630	BnaA05T0302300ZY	0	+	0	0	2465	0.0000000
zheyou73v0_A05	34402491	34405478	BnaA05T0302400ZY	0	+	0	0	2987	0.0000000
zheyou73v0_A05	34406500	34408295	BnaA05T0302500ZY	0	+	0	0	1795	0.0000000
zheyou73v0_A05	34409575	34411706	BnaA05T0302600ZY	0	+	0	0	2131	0.0000000
zheyou73v0_A05	34438798	34440475	BnaA05T0302700ZY	0	-	0	0	1677	0.0000000
zheyou73v0_A05	34452350	34453177	BnaA05T0302800ZY	0	+	0	0	827	0.0000000
zheyou73v0_A05	34460012	34463792	BnaA05T0302900ZY	0	+	0	0	3780	0.0000000
zheyou73v0_A05	34468729	34469556	BnaA05T0303000ZY	0	-	0	0	827	0.0000000
zheyou73v0_A05	34478166	34482480	BnaA05T0303100ZY	0	-	0	0	4314	0.0000000
zheyou73v0_A05	34482807	34484894	BnaA05T0303200ZY	0	-	0	0	2087	0.0000000
zheyou73v0_A05	34489001	34490940	BnaA05T0303300ZY	0	+	0	0	1939	0.0000000
zheyou73v0_A05	34491013	34493608	BnaA05T0303400ZY	0	-	0	0	2595	0.0000000
zheyou73v0_A05	34495487	34503013	BnaA05T0303500ZY	0	+	0	0	7526	0.0000000
zheyou73v0_A05	34505313	34507376	BnaA05T0303600ZY	0	-	0	0	2063	0.0000000
zheyou73v0_A05	34505313	34507376	BnaA05T0303600ZY.1	0	-	0	0	2063	0.0000000
zheyou73v0_A05	34516422	34517203	BnaA05T0303700ZY	0	-	0	0	781	0.0000000
zheyou73v0_A05	34537330	34539237	BnaA05T0303800ZY	0	+	0	0	1907	0.0000000
zheyou73v0_A05	34537330	34539987	BnaA05T0303900ZY	0	-	0	0	2657	0.0000000
zheyou73v0_A05	34549262	34549857	BnaA05T0304000ZY	0	-	0	0	595	0.0000000
zheyou73v0_A05	34549895	34551613	BnaA05T0304100ZY	0	-	0	0	1718	0.0000000
zheyou73v0_A05	34554624	34558774	BnaA05T0304200ZY	0	+	0	0	4150	0.0000000
zheyou73v0_A05	34570723	34571722	BnaA05T0304300ZY	0	-	0	0	999	0.0000000
zheyou73v0_A05	34584395	34586678	BnaA05T0304400ZY	0	+	0	0	2283	0.0000000
zheyou73v0_A05	34586942	34588177	BnaA05T0304500ZY	0	-	0	0	1235	0.0000000
zheyou73v0_A05	34592091	34594707	BnaA05T0304600ZY	0	+	0	0	2616	0.0000000
zheyou73v0_A05	34594994	34595425	BnaA05T0304700ZY	0	-	0	0	431	0.0000000
zheyou73v0_A05	34595639	34598638	BnaA05T0304800ZY	0	-	0	0	2999	0.0000000
zheyou73v0_A05	34601230	34601872	BnaA05T0304900ZY	0	+	0	0	642	0.0000000
zheyou73v0_A05	34604665	34610515	BnaA05T0305000ZY	0	-	0	0	5850	0.0000000
zheyou73v0_A05	34611315	34612169	BnaA05T0305100ZY	0	+	0	0	854	0.0000000
zheyou73v0_A05	34619873	34620695	BnaA05T0305200ZY	0	-	0	0	822	0.0000000
zheyou73v0_A05	34664645	34666580	BnaA05T0305300ZY	0	+	0	0	1935	0.0000000
zheyou73v0_A05	34664645	34666580	BnaA05T0305300ZY.1	0	+	0	0	1935	0.0000000
zheyou73v0_A05	34674091	34680175	BnaA05T0305400ZY	0	+	0	0	6084	0.0000000
zheyou73v0_A05	34674518	34680175	BnaA05T0305400ZY.1	0	+	0	0	5657	0.0000000
zheyou73v0_A05	34679909	34684057	BnaA05T0305500ZY	0	-	0	0	4148	0.0000000
zheyou73v0_A05	34684247	34687708	BnaA05T0305600ZY	0	+	0	0	3461	0.0000000
zheyou73v0_A05	34707895	34715105	BnaA05T0305700ZY	0	+	0	0	7210	0.0000000
zheyou73v0_A05	34716634	34719259	BnaA05T0305800ZY	0	+	0	0	2625	0.0000000
zheyou73v0_A05	34729134	34729587	BnaA05T0305900ZY	0	-	0	0	453	0.0000000
zheyou73v0_A05	34736980	34746671	BnaA05T0306000ZY	0	+	0	0	9691	0.0000000
zheyou73v0_A05	34769476	34770319	BnaA05T0306100ZY	0	+	0	0	843	0.0000000
zheyou73v0_A05	34770822	34772637	BnaA05T0306200ZY	0	-	0	0	1815	0.0000000
zheyou73v0_A05	34774504	34776743	BnaA05T0306300ZY	0	+	0	0	2239	0.0000000
zheyou73v0_A05	34776914	34786103	BnaA05T0306400ZY	0	-	0	0	9189	0.0000000
zheyou73v0_A05	34776914	34785397	BnaA05T0306400ZY.1	0	-	0	0	8483	0.0000000
zheyou73v0_A05	34793651	34799304	BnaA05T0306500ZY	0	+	0	0	5653	0.0000000
zheyou73v0_A05	34800605	34801467	BnaA05T0306600ZY	0	+	0	0	862	0.0000000
zheyou73v0_A05	34805029	34807815	BnaA05T0306700ZY	0	+	0	0	2786	0.0000000
zheyou73v0_A05	34810504	34811532	BnaA05T0306800ZY	0	-	0	0	1028	0.0000000
zheyou73v0_A05	34818107	34819259	BnaA05T0306900ZY	0	-	0	0	1152	0.0000000
zheyou73v0_A05	34825319	34825745	BnaA05T0307000ZY	0	-	0	0	426	0.0000000
zheyou73v0_A05	34828527	34831139	BnaA05T0307100ZY	0	-	0	0	2612	0.0000000
zheyou73v0_A05	34842102	34845915	BnaA05T0307200ZY	0	+	0	0	3813	0.0000000
zheyou73v0_A05	34860682	34863690	BnaA05T0307300ZY	0	+	0	0	3008	0.0000000
zheyou73v0_A05	34866222	34866777	BnaA05T0307400ZY	0	+	0	0	555	0.0000000
zheyou73v0_A05	34902460	34904036	BnaA05T0307500ZY	0	-	0	0	1576	0.0000000
zheyou73v0_A05	34904262	34906250	BnaA05T0307600ZY	0	-	0	0	1988	0.0000000
zheyou73v0_A05	34906902	34908611	BnaA05T0307700ZY	0	+	0	0	1709	0.0000000
zheyou73v0_A05	34908572	34910795	BnaA05T0307800ZY.1	0	-	0	0	2223	0.0000000
zheyou73v0_A05	34908927	34910795	BnaA05T0307800ZY	0	-	0	0	1868	0.0000000
zheyou73v0_A05	34913130	34913913	BnaA05T0307900ZY	0	-	0	0	783	0.0000000
zheyou73v0_A05	34919322	34920454	BnaA05T0308000ZY	0	-	0	0	1132	0.0000000
zheyou73v0_A05	34922826	34924453	BnaA05T0308100ZY	0	-	0	0	1627	0.0000000
zheyou73v0_A05	34934614	34936689	BnaA05T0308200ZY	0	+	0	0	2075	0.0000000
zheyou73v0_A05	34937437	34937874	BnaA05T0308300ZY	0	+	0	0	437	0.0000000
zheyou73v0_A05	34944677	34947351	BnaA05T0308400ZY	0	+	0	0	2674	0.0000000
zheyou73v0_A05	34947807	34948002	BnaA05T0308500ZY	0	+	0	0	195	0.0000000
zheyou73v0_A05	34947871	34950690	BnaA05T0308600ZY	0	-	0	0	2819	0.0000000
zheyou73v0_A05	34947871	34949984	BnaA05T0308600ZY.1	0	-	0	0	2113	0.0000000
zheyou73v0_A05	34957322	34957565	BnaA05T0308700ZY	0	-	0	0	243	0.0000000
zheyou73v0_A05	34958460	34961390	BnaA05T0308800ZY	0	-	0	0	2930	0.0000000
zheyou73v0_A05	34994223	34998034	BnaA05T0308900ZY	0	+	0	0	3811	0.0000000
zheyou73v0_A05	35001251	35002958	BnaA05T0309000ZY	0	-	0	0	1707	0.0000000
zheyou73v0_A05	35030863	35032418	BnaA05T0309100ZY	0	+	0	0	1555	0.0000000
zheyou73v0_A05	35036754	35038076	BnaA05T0309200ZY	0	-	0	0	1322	0.0000000
zheyou73v0_A05	35041602	35043794	BnaA05T0309300ZY	0	-	0	0	2192	0.0000000
zheyou73v0_A05	35041602	35043868	BnaA05T0309300ZY.1	0	-	0	0	2266	0.0000000
zheyou73v0_A05	35041602	35043794	BnaA05T0309300ZY.2	0	-	0	0	2192	0.0000000
zheyou73v0_A05	35060442	35062797	BnaA05T0309400ZY	0	+	0	0	2355	0.0000000
zheyou73v0_A05	35060442	35062508	BnaA05T0309400ZY.1	0	+	0	0	2066	0.0000000
zheyou73v0_A05	35067356	35070160	BnaA05T0309500ZY	0	-	0	0	2804	0.0000000
zheyou73v0_A05	35067356	35070160	BnaA05T0309500ZY.1	0	-	0	0	2804	0.0000000
zheyou73v0_A05	35070356	35074765	BnaA05T0309600ZY	0	+	0	0	4409	0.0000000
zheyou73v0_A05	35080453	35085015	BnaA05T0309700ZY	0	+	0	0	4562	0.0000000
zheyou73v0_A05	35121357	35124198	BnaA05T0309800ZY	0	-	0	0	2841	0.0000000
zheyou73v0_A05	35126518	35128122	BnaA05T0309900ZY	0	+	0	0	1604	0.0000000
zheyou73v0_A05	35128242	35131121	BnaA05T0310000ZY	0	+	0	0	2879	0.0000000
zheyou73v0_A05	35148477	35151849	BnaA05T0310100ZY	0	-	0	0	3372	0.0000000
zheyou73v0_A05	35153316	35154423	BnaA05T0310200ZY	0	+	0	0	1107	0.0000000
zheyou73v0_A05	35154778	35155536	BnaA05T0310300ZY	0	-	0	0	758	0.0000000
zheyou73v0_A05	35156471	35165808	BnaA05T0310400ZY	0	+	0	0	9337	0.0000000
zheyou73v0_A05	35183951	35188603	BnaA05T0310500ZY	0	-	0	0	4652	0.0000000
zheyou73v0_A05	35199555	35202162	BnaA05T0310600ZY	0	+	0	0	2607	0.0000000
zheyou73v0_A05	35220528	35224360	BnaA05T0310700ZY	0	+	0	0	3832	0.0000000
zheyou73v0_A05	35228517	35233608	BnaA05T0310800ZY	0	+	0	0	5091	0.0000000
zheyou73v0_A05	35262414	35263609	BnaA05T0310900ZY	0	+	0	0	1195	0.0000000
zheyou73v0_A05	35269320	35273768	BnaA05T0311000ZY	0	-	0	0	4448	0.0000000
zheyou73v0_A05	35279699	35281679	BnaA05T0311100ZY	0	+	0	0	1980	0.0000000
zheyou73v0_A05	35282158	35282848	BnaA05T0311200ZY	0	+	0	0	690	0.0000000
zheyou73v0_A05	35283124	35287104	BnaA05T0311300ZY	0	-	0	0	3980	0.0000000
zheyou73v0_A05	35288463	35289140	BnaA05T0311400ZY	0	-	0	0	677	0.0000000
zheyou73v0_A05	35290891	35291292	BnaA05T0311500ZY	0	+	0	0	401	0.0000000
zheyou73v0_A05	35291175	35292112	BnaA05T0311600ZY	0	-	0	0	937	0.0000000
zheyou73v0_A05	35293756	35298208	BnaA05T0311700ZY	0	-	0	0	4452	0.0000000
zheyou73v0_A05	35302469	35309226	BnaA05T0311800ZY	0	-	0	0	6757	0.0000000
zheyou73v0_A05	35312993	35323323	BnaA05T0311900ZY	0	-	0	0	10330	0.0000000
zheyou73v0_A05	35351518	35352347	BnaA05T0312000ZY	0	+	0	0	829	0.0000000
zheyou73v0_A05	35356807	35357092	BnaA05T0312100ZY	0	+	0	0	285	0.0000000
zheyou73v0_A05	35370953	35375450	BnaA05T0312200ZY	0	-	0	0	4497	0.0000000
zheyou73v0_A05	35379395	35380226	BnaA05T0312300ZY	0	-	0	0	831	0.0000000
zheyou73v0_A05	35388062	35393109	BnaA05T0312400ZY	0	-	0	0	5047	0.0000000
zheyou73v0_A05	35394882	35398656	BnaA05T0312500ZY	0	+	0	0	3774	0.0000000
zheyou73v0_A05	35400707	35405493	BnaA05T0312600ZY	0	+	0	0	4786	0.0000000
zheyou73v0_A05	35406674	35408661	BnaA05T0312700ZY	0	-	0	0	1987	0.0000000
zheyou73v0_A05	35406674	35408661	BnaA05T0312700ZY.1	0	-	0	0	1987	0.0000000
zheyou73v0_A05	35416510	35418123	BnaA05T0312800ZY	0	+	0	0	1613	0.0000000
zheyou73v0_A05	35419526	35419715	BnaA05T0312900ZY	0	+	0	0	189	0.0000000
zheyou73v0_A05	35423110	35425134	BnaA05T0313000ZY	0	+	0	0	2024	0.0000000
zheyou73v0_A05	35425485	35427397	BnaA05T0313100ZY	0	+	0	0	1912	0.0000000
zheyou73v0_A05	35425485	35427397	BnaA05T0313100ZY.1	0	+	0	0	1912	0.0000000
zheyou73v0_A05	35436532	35444990	BnaA05T0313200ZY	0	-	0	0	8458	0.0000000
zheyou73v0_A05	35451803	35453720	BnaA05T0313300ZY	0	-	0	0	1917	0.0000000
zheyou73v0_A05	35455007	35458046	BnaA05T0313400ZY	0	-	0	0	3039	0.0000000
zheyou73v0_A05	35455007	35457391	BnaA05T0313400ZY.1	0	-	0	0	2384	0.0000000
zheyou73v0_A05	35459766	35461755	BnaA05T0313500ZY	0	+	0	0	1989	0.0000000
zheyou73v0_A05	35463939	35464377	BnaA05T0313600ZY	0	+	0	0	438	0.0000000
zheyou73v0_A05	35465022	35470779	BnaA05T0313700ZY	0	+	0	0	5757	0.0000000
zheyou73v0_A05	35471048	35471354	BnaA05T0313800ZY	0	-	0	0	306	0.0000000
zheyou73v0_A05	35474459	35476074	BnaA05T0313900ZY	0	+	0	0	1615	0.0000000
zheyou73v0_A05	35481700	35485048	BnaA05T0314000ZY	0	+	0	0	3348	0.0000000
zheyou73v0_A05	35485464	35488384	BnaA05T0314100ZY	0	-	0	0	2920	0.0000000
zheyou73v0_A05	35489327	35491430	BnaA05T0314200ZY	0	-	0	0	2103	0.0000000
zheyou73v0_A05	35491490	35493180	BnaA05T0314300ZY	0	-	0	0	1690	0.0000000
zheyou73v0_A05	35494872	35497149	BnaA05T0314400ZY	0	+	0	0	2277	0.0000000
zheyou73v0_A05	35503312	35503930	BnaA05T0314500ZY	0	-	0	0	618	0.0000000
zheyou73v0_A05	35505697	35507171	BnaA05T0314600ZY	0	+	0	0	1474	0.0000000
zheyou73v0_A05	35508334	35509129	BnaA05T0314700ZY	0	-	0	0	795	0.0000000
zheyou73v0_A05	35521024	35521554	BnaA05T0314800ZY	0	-	0	0	530	0.0000000
zheyou73v0_A05	35535181	35535562	BnaA05T0314900ZY	0	-	0	0	381	0.0000000
zheyou73v0_A05	35537384	35540766	BnaA05T0315000ZY	0	+	0	0	3382	0.0000000
zheyou73v0_A05	35541265	35542623	BnaA05T0315100ZY	0	-	0	0	1358	0.0000000
zheyou73v0_A05	35544246	35544600	BnaA05T0315200ZY	0	-	0	0	354	0.0000000
zheyou73v0_A05	35548096	35551773	BnaA05T0315300ZY	0	-	0	0	3677	0.0000000
zheyou73v0_A05	35553067	35553592	BnaA05T0315400ZY	0	+	0	0	525	0.0000000
zheyou73v0_A05	35553660	35555160	BnaA05T0315500ZY	0	-	0	0	1500	0.0000000
zheyou73v0_A05	35560905	35562016	BnaA05T0315600ZY	0	-	0	0	1111	0.0000000
zheyou73v0_A05	35562873	35573530	BnaA05T0315700ZY	0	-	0	0	10657	0.0000000
zheyou73v0_A05	35574918	35576536	BnaA05T0315800ZY	0	-	0	0	1618	0.0000000
zheyou73v0_A05	35580712	35594845	BnaA05T0315900ZY	0	-	0	0	14133	0.0000000
zheyou73v0_A05	35595343	35597996	BnaA05T0316000ZY	0	-	0	0	2653	0.0000000
zheyou73v0_A05	35598919	35602844	BnaA05T0316100ZY	0	-	0	0	3925	0.0000000
zheyou73v0_A05	35614394	35616050	BnaA05T0316200ZY	0	-	0	0	1656	0.0000000
zheyou73v0_A05	35623438	35624662	BnaA05T0316300ZY	0	-	0	0	1224	0.0000000
zheyou73v0_A05	35627072	35628125	BnaA05T0316400ZY	0	-	0	0	1053	0.0000000
zheyou73v0_A05	35628707	35636040	BnaA05T0316500ZY	0	-	0	0	7333	0.0000000
zheyou73v0_A05	35658624	35660248	BnaA05T0316600ZY	0	-	0	0	1624	0.0000000
zheyou73v0_A05	35671098	35673159	BnaA05T0316700ZY	0	+	0	0	2061	0.0000000
zheyou73v0_A05	35671098	35673159	BnaA05T0316700ZY.1	0	+	0	0	2061	0.0000000
zheyou73v0_A05	35671098	35673159	BnaA05T0316700ZY.2	0	+	0	0	2061	0.0000000
zheyou73v0_A05	35671098	35673159	BnaA05T0316700ZY.3	0	+	0	0	2061	0.0000000
zheyou73v0_A05	35671098	35673159	BnaA05T0316700ZY.4	0	+	0	0	2061	0.0000000
zheyou73v0_A05	35671098	35673159	BnaA05T0316700ZY.5	0	+	0	0	2061	0.0000000
zheyou73v0_A05	35671098	35673159	BnaA05T0316700ZY.6	0	+	0	0	2061	0.0000000
zheyou73v0_A05	35671098	35673159	BnaA05T0316700ZY.7	0	+	0	0	2061	0.0000000
zheyou73v0_A05	35673844	35675476	BnaA05T0316800ZY	0	-	0	0	1632	0.0000000
zheyou73v0_A05	35675941	35679026	BnaA05T0316900ZY	0	-	0	0	3085	0.0000000
zheyou73v0_A05	35685874	35689405	BnaA05T0317000ZY	0	-	0	0	3531	0.0000000
zheyou73v0_A05	35689493	35693014	BnaA05T0317100ZY	0	+	0	0	3521	0.0000000
zheyou73v0_A05	35695347	35697286	BnaA05T0317200ZY	0	+	0	0	1939	0.0000000
zheyou73v0_A05	35697369	35699165	BnaA05T0317300ZY	0	-	0	0	1796	0.0000000
zheyou73v0_A05	35721911	35723544	BnaA05T0317400ZY	0	+	0	0	1633	0.0000000
zheyou73v0_A05	35723861	35727227	BnaA05T0317500ZY	0	+	0	0	3366	0.0000000
zheyou73v0_A05	35727442	35730425	BnaA05T0317600ZY	0	-	0	0	2983	0.0000000
zheyou73v0_A05	35727442	35730425	BnaA05T0317600ZY.1	0	-	0	0	2983	0.0000000
zheyou73v0_A05	35742399	35746209	BnaA05T0317700ZY	0	+	0	0	3810	0.0000000
zheyou73v0_A05	35755249	35756893	BnaA05T0317800ZY	0	+	0	0	1644	0.0000000
zheyou73v0_A05	35758413	35763342	BnaA05T0317900ZY	0	-	0	0	4929	0.0000000
zheyou73v0_A05	35764758	35765336	BnaA05T0318000ZY	0	-	0	0	578	0.0000000
zheyou73v0_A05	35765770	35768620	BnaA05T0318100ZY	0	-	0	0	2850	0.0000000
zheyou73v0_A05	35768833	35771351	BnaA05T0318200ZY	0	-	0	0	2518	0.0000000
zheyou73v0_A05	35773253	35775906	BnaA05T0318300ZY	0	-	0	0	2653	0.0000000
zheyou73v0_A05	35776524	35801640	BnaA05T0318400ZY	0	-	0	0	25116	0.0000000
zheyou73v0_A05	35814728	35821195	BnaA05T0318500ZY	0	-	0	0	6467	0.0000000
zheyou73v0_A05	35826533	35827551	BnaA05T0318600ZY	0	-	0	0	1018	0.0000000
zheyou73v0_A05	35831123	35833479	BnaA05T0318700ZY	0	-	0	0	2356	0.0000000
zheyou73v0_A05	35838059	35840402	BnaA05T0318800ZY	0	+	0	0	2343	0.0000000
zheyou73v0_A05	35840851	35843530	BnaA05T0318900ZY	0	-	0	0	2679	0.0000000
zheyou73v0_A05	35845160	35850423	BnaA05T0319000ZY	0	+	0	0	5263	0.0000000
zheyou73v0_A05	35852703	35852871	BnaA05T0319100ZY	0	+	0	0	168	0.0000000
zheyou73v0_A05	35860020	35862904	BnaA05T0319200ZY	0	-	0	0	2884	0.0000000
zheyou73v0_A05	35864879	35866750	BnaA05T0319300ZY	0	-	0	0	1871	0.0000000
zheyou73v0_A05	35867076	35872895	BnaA05T0319400ZY	0	-	0	0	5819	0.0000000
zheyou73v0_A05	35867076	35872895	BnaA05T0319400ZY.1	0	-	0	0	5819	0.0000000
zheyou73v0_A05	35867076	35872895	BnaA05T0319400ZY.2	0	-	0	0	5819	0.0000000
zheyou73v0_A05	35874327	35878926	BnaA05T0319500ZY	0	+	0	0	4599	0.0000000
zheyou73v0_A05	35888381	35890017	BnaA05T0319600ZY	0	+	0	0	1636	0.0000000
zheyou73v0_A05	35890398	35891387	BnaA05T0319700ZY	0	-	0	0	989	0.0000000
zheyou73v0_A05	35893984	35901486	BnaA05T0319800ZY	0	+	0	0	7502	0.0000000
zheyou73v0_A05	35903254	35904432	BnaA05T0319900ZY	0	-	0	0	1178	0.0000000
zheyou73v0_A05	35934829	35935578	BnaA05T0320000ZY	0	-	0	0	749	0.0000000
zheyou73v0_A05	35938740	35939069	BnaA05T0320100ZY	0	-	0	0	329	0.0000000
zheyou73v0_A05	35977830	35988122	BnaA05T0320200ZY	0	-	0	0	10292	0.0000000
zheyou73v0_A05	35990457	35990967	BnaA05T0320300ZY	0	-	0	0	510	0.0000000
zheyou73v0_A05	36012446	36012687	BnaA05T0320400ZY	0	-	0	0	241	0.0000000
zheyou73v0_A05	36039427	36040264	BnaA05T0320500ZY	0	+	0	0	837	0.0000000
zheyou73v0_A05	36048554	36049837	BnaA05T0320600ZY	0	-	0	0	1283	0.0000000
zheyou73v0_A05	36080402	36084992	BnaA05T0320700ZY	0	-	0	0	4590	0.0000000
zheyou73v0_A05	36113249	36126606	BnaA05T0320800ZY	0	+	0	0	13357	0.0000000
zheyou73v0_A05	36156041	36156551	BnaA05T0320900ZY	0	+	0	0	510	0.0000000
zheyou73v0_A05	36158877	36161820	BnaA05T0321000ZY	0	+	0	0	2943	0.0000000
zheyou73v0_A05	36183269	36183855	BnaA05T0321100ZY	0	-	0	0	586	0.0000000
zheyou73v0_A05	36218211	36218540	BnaA05T0321200ZY	0	+	0	0	329	0.0000000
zheyou73v0_A05	36222125	36222874	BnaA05T0321300ZY	0	+	0	0	749	0.0000000
zheyou73v0_A05	36335191	36348423	BnaA05T0321400ZY	0	+	0	0	13232	0.0000000
zheyou73v0_A05	36381960	36382470	BnaA05T0321500ZY	0	+	0	0	510	0.0000000
zheyou73v0_A05	36384796	36385384	BnaA05T0321600ZY	0	+	0	0	588	0.0000000
zheyou73v0_A05	36392458	36393255	BnaA05T0321700ZY	0	+	0	0	797	0.0000000
zheyou73v0_A05	36555506	36556957	BnaA05T0321800ZY	0	-	0	0	1451	0.0000000
zheyou73v0_A05	36556998	36557388	BnaA05T0321900ZY	0	-	0	0	390	0.0000000
zheyou73v0_A05	36557988	36558378	BnaA05T0322000ZY	0	+	0	0	390	0.0000000
zheyou73v0_A05	36558419	36559950	BnaA05T0322100ZY	0	+	0	0	1531	0.0000000
zheyou73v0_A05	36628965	36634309	BnaA05T0322200ZY	0	-	0	0	5344	0.0000000
zheyou73v0_A05	36628965	36634309	BnaA05T0322200ZY.1	0	-	0	0	5344	0.0000000
zheyou73v0_A05	36628965	36634309	BnaA05T0322200ZY.2	0	-	0	0	5344	0.0000000
zheyou73v0_A05	36628965	36633035	BnaA05T0322200ZY.3	0	-	0	0	4070	0.0000000
zheyou73v0_A05	36637483	36638629	BnaA05T0322300ZY	0	+	0	0	1146	0.0000000
zheyou73v0_A05	36651364	36654284	BnaA05T0322400ZY	0	+	0	0	2920	0.0000000
zheyou73v0_A05	36665241	36667520	BnaA05T0322500ZY	0	-	0	0	2279	0.0000000
zheyou73v0_A05	36667634	36670345	BnaA05T0322600ZY	0	-	0	0	2711	0.0000000
zheyou73v0_A05	36673034	36675744	BnaA05T0322700ZY	0	+	0	0	2710	0.0000000
zheyou73v0_A05	36673034	36675744	BnaA05T0322700ZY.1	0	+	0	0	2710	0.0000000
zheyou73v0_A05	36673034	36675744	BnaA05T0322700ZY.2	0	+	0	0	2710	0.0000000
zheyou73v0_A05	36677497	36679212	BnaA05T0322800ZY	0	-	0	0	1715	0.0000000
zheyou73v0_A05	36693948	36694517	BnaA05T0322900ZY	0	-	0	0	569	0.0000000
zheyou73v0_A05	36698404	36706238	BnaA05T0323000ZY	0	+	0	0	7834	0.0000000
zheyou73v0_A05	36698404	36706238	BnaA05T0323000ZY.1	0	+	0	0	7834	0.0000000
zheyou73v0_A05	36698404	36706238	BnaA05T0323000ZY.2	0	+	0	0	7834	0.0000000
zheyou73v0_A05	36709483	36710623	BnaA05T0323100ZY	0	-	0	0	1140	0.0000000
zheyou73v0_A05	36715595	36716735	BnaA05T0323200ZY	0	-	0	0	1140	0.0000000
zheyou73v0_A05	36719495	36720053	BnaA05T0323300ZY	0	+	0	0	558	0.0000000
zheyou73v0_A05	36720129	36721831	BnaA05T0323400ZY	0	-	0	0	1702	0.0000000
zheyou73v0_A05	36722152	36724447	BnaA05T0323500ZY	0	-	0	0	2295	0.0000000
zheyou73v0_A05	36727602	36728373	BnaA05T0323600ZY	0	+	0	0	771	0.0000000
zheyou73v0_A05	36729120	36730582	BnaA05T0323700ZY	0	+	0	0	1462	0.0000000
zheyou73v0_A05	36732260	36734468	BnaA05T0323800ZY	0	-	0	0	2208	0.0000000
zheyou73v0_A05	36755048	36760844	BnaA05T0323900ZY	0	+	0	0	5796	0.0000000
zheyou73v0_A05	36762327	36763416	BnaA05T0324000ZY	0	-	0	0	1089	0.0000000
zheyou73v0_A05	36771404	36771888	BnaA05T0324100ZY	0	+	0	0	484	0.0000000
zheyou73v0_A05	36774493	36775584	BnaA05T0324200ZY	0	+	0	0	1091	0.0000000
zheyou73v0_A05	36784978	36786147	BnaA05T0324300ZY	0	+	0	0	1169	0.0000000
zheyou73v0_A05	36794067	36795248	BnaA05T0324400ZY	0	-	0	0	1181	0.0000000
zheyou73v0_A05	36795784	36796301	BnaA05T0324500ZY	0	+	0	0	517	0.0000000
zheyou73v0_A05	36801676	36802815	BnaA05T0324600ZY	0	-	0	0	1139	0.0000000
zheyou73v0_A05	36827872	36829198	BnaA05T0324700ZY	0	+	0	0	1326	0.0000000
zheyou73v0_A05	36830458	36832814	BnaA05T0324800ZY	0	+	0	0	2356	0.0000000
zheyou73v0_A05	36835119	36836610	BnaA05T0324900ZY	0	+	0	0	1491	0.0000000
zheyou73v0_A05	36848070	36850054	BnaA05T0325000ZY	0	-	0	0	1984	0.0000000
zheyou73v0_A05	36848070	36850054	BnaA05T0325000ZY.1	0	-	0	0	1984	0.0000000
zheyou73v0_A05	36860071	36863200	BnaA05T0325100ZY	0	+	0	0	3129	0.0000000
zheyou73v0_A05	36863361	36863693	BnaA05T0325200ZY	0	+	0	0	332	0.0000000
zheyou73v0_A05	36866656	36868619	BnaA05T0325300ZY	0	+	0	0	1963	0.0000000
zheyou73v0_A05	36869421	36872241	BnaA05T0325400ZY	0	+	0	0	2820	0.0000000
zheyou73v0_A05	36872266	36874132	BnaA05T0325500ZY	0	-	0	0	1866	0.0000000
zheyou73v0_A05	36877709	36879893	BnaA05T0325600ZY	0	-	0	0	2184	0.0000000
zheyou73v0_A05	36882225	36884649	BnaA05T0325700ZY	0	-	0	0	2424	0.0000000
zheyou73v0_A05	36893540	36895379	BnaA05T0325800ZY	0	+	0	0	1839	0.0000000
zheyou73v0_A05	36903587	36907462	BnaA05T0325900ZY	0	-	0	0	3875	0.0000000
zheyou73v0_A05	36908603	36909814	BnaA05T0326000ZY	0	-	0	0	1211	0.0000000
zheyou73v0_A05	36911510	36913289	BnaA05T0326100ZY	0	-	0	0	1779	0.0000000
zheyou73v0_A05	36924555	36926109	BnaA05T0326200ZY	0	+	0	0	1554	0.0000000
zheyou73v0_A05	36926868	36929416	BnaA05T0326300ZY	0	-	0	0	2548	0.0000000
zheyou73v0_A05	36938027	36939718	BnaA05T0326400ZY	0	-	0	0	1691	0.0000000
zheyou73v0_A05	36947149	36947383	BnaA05T0326500ZY	0	-	0	0	234	0.0000000
zheyou73v0_A05	36948387	36950264	BnaA05T0326600ZY	0	+	0	0	1877	0.0000000
zheyou73v0_A05	36950249	36952652	BnaA05T0326700ZY	0	-	0	0	2403	0.0000000
zheyou73v0_A05	36957802	36960462	BnaA05T0326800ZY	0	+	0	0	2660	0.0000000
zheyou73v0_A05	36960714	36962345	BnaA05T0326900ZY	0	-	0	0	1631	0.0000000
zheyou73v0_A05	36966319	36969451	BnaA05T0327000ZY	0	+	0	0	3132	0.0000000
zheyou73v0_A05	36976985	36979829	BnaA05T0327100ZY	0	+	0	0	2844	0.0000000
zheyou73v0_A05	36986607	36988731	BnaA05T0327200ZY	0	+	0	0	2124	0.0000000
zheyou73v0_A05	36986607	36988731	BnaA05T0327200ZY.1	0	+	0	0	2124	0.0000000
zheyou73v0_A05	36989380	36991300	BnaA05T0327300ZY	0	-	0	0	1920	0.0000000
zheyou73v0_A05	37019886	37020390	BnaA05T0327400ZY	0	+	0	0	504	0.0000000
zheyou73v0_A05	37032472	37034837	BnaA05T0327500ZY	0	-	0	0	2365	0.0000000
zheyou73v0_A05	37038194	37040558	BnaA05T0327600ZY	0	+	0	0	2364	0.0000000
zheyou73v0_A05	37041111	37042415	BnaA05T0327700ZY	0	-	0	0	1304	0.0000000
zheyou73v0_A05	37042819	37049293	BnaA05T0327800ZY	0	+	0	0	6474	0.0000000
zheyou73v0_A05	37054598	37055802	BnaA05T0327900ZY	0	-	0	0	1204	0.0000000
zheyou73v0_A05	37056118	37056852	BnaA05T0328000ZY	0	+	0	0	734	0.0000000
zheyou73v0_A05	37059250	37066856	BnaA05T0328100ZY	0	-	0	0	7606	0.0000000
zheyou73v0_A05	37067442	37072100	BnaA05T0328200ZY	0	-	0	0	4658	0.0000000
zheyou73v0_A05	37075387	37076538	BnaA05T0328300ZY	0	+	0	0	1151	0.0000000
zheyou73v0_A05	37075387	37076149	BnaA05T0328300ZY.1	0	+	0	0	762	0.0000000
zheyou73v0_A05	37081766	37084513	BnaA05T0328400ZY	0	+	0	0	2747	0.0000000
zheyou73v0_A05	37081766	37083682	BnaA05T0328400ZY.1	0	+	0	0	1916	0.0000000
zheyou73v0_A05	37085102	37088350	BnaA05T0328500ZY	0	-	0	0	3248	0.0000000
zheyou73v0_A05	37096176	37098961	BnaA05T0328600ZY	0	-	0	0	2785	0.0000000
zheyou73v0_A05	37101145	37103711	BnaA05T0328700ZY	0	-	0	0	2566	0.0000000
zheyou73v0_A05	37107136	37107901	BnaA05T0328800ZY	0	-	0	0	765	0.0000000
zheyou73v0_A05	37115048	37117418	BnaA05T0328900ZY	0	-	0	0	2370	0.0000000
zheyou73v0_A05	37120793	37132380	BnaA05T0329000ZY	0	-	0	0	11587	0.0000000
zheyou73v0_A05	37139054	37139433	BnaA05T0329100ZY	0	+	0	0	379	0.0000000
zheyou73v0_A05	37140013	37141277	BnaA05T0329200ZY	0	-	0	0	1264	0.0000000
zheyou73v0_A05	37140013	37141277	BnaA05T0329200ZY.1	0	-	0	0	1264	0.0000000
zheyou73v0_A05	37146775	37148618	BnaA05T0329300ZY	0	+	0	0	1843	0.0000000
zheyou73v0_A05	37146775	37148618	BnaA05T0329300ZY.1	0	+	0	0	1843	0.0000000
zheyou73v0_A05	37159499	37160660	BnaA05T0329400ZY	0	+	0	0	1161	0.0000000
zheyou73v0_A05	37165135	37167552	BnaA05T0329500ZY	0	+	0	0	2417	0.0000000
zheyou73v0_A05	37168331	37169750	BnaA05T0329600ZY	0	+	0	0	1419	0.0000000
zheyou73v0_A05	37169746	37170789	BnaA05T0329700ZY	0	-	0	0	1043	0.0000000
zheyou73v0_A05	37172589	37174314	BnaA05T0329800ZY	0	-	0	0	1725	0.0000000
zheyou73v0_A05	37172589	37173907	BnaA05T0329800ZY.1	0	-	0	0	1318	0.0000000
zheyou73v0_A05	37176597	37177974	BnaA05T0329900ZY	0	-	0	0	1377	0.0000000
zheyou73v0_A05	37189722	37195183	BnaA05T0330000ZY	0	+	0	0	5461	0.0000000
zheyou73v0_A05	37196650	37198355	BnaA05T0330100ZY	0	+	0	0	1705	0.0000000
zheyou73v0_A05	37200388	37202118	BnaA05T0330200ZY	0	+	0	0	1730	0.0000000
zheyou73v0_A05	37202772	37206009	BnaA05T0330300ZY	0	-	0	0	3237	0.0000000
zheyou73v0_A05	37207018	37207830	BnaA05T0330400ZY	0	-	0	0	812	0.0000000
zheyou73v0_A05	37208029	37208952	BnaA05T0330500ZY	0	+	0	0	923	0.0000000
zheyou73v0_A05	37209140	37214182	BnaA05T0330600ZY	0	-	0	0	5042	0.0000000
zheyou73v0_A05	37228974	37231288	BnaA05T0330700ZY	0	+	0	0	2314	0.0000000
zheyou73v0_A05	37229233	37231288	BnaA05T0330700ZY.1	0	+	0	0	2055	0.0000000
zheyou73v0_A05	37231971	37232277	BnaA05T0330800ZY	0	+	0	0	306	0.0000000
zheyou73v0_A05	37232927	37234955	BnaA05T0330900ZY	0	-	0	0	2028	0.0000000
zheyou73v0_A05	37241722	37242958	BnaA05T0331000ZY	0	+	0	0	1236	0.0000000
zheyou73v0_A05	37243702	37245556	BnaA05T0331100ZY	0	+	0	0	1854	0.0000000
zheyou73v0_A05	37245983	37248343	BnaA05T0331200ZY	0	-	0	0	2360	0.0000000
zheyou73v0_A05	37251298	37254244	BnaA05T0331300ZY	0	+	0	0	2946	0.0000000
zheyou73v0_A05	37254506	37255403	BnaA05T0331400ZY	0	-	0	0	897	0.0000000
zheyou73v0_A05	37255634	37257293	BnaA05T0331500ZY	0	-	0	0	1659	0.0000000
zheyou73v0_A05	37262980	37265212	BnaA05T0331600ZY	0	-	0	0	2232	0.0000000
zheyou73v0_A05	37275444	37276249	BnaA05T0331700ZY	0	-	0	0	805	0.0000000
zheyou73v0_A05	37283190	37284184	BnaA05T0331800ZY	0	-	0	0	994	0.0000000
zheyou73v0_A05	37292267	37294445	BnaA05T0331900ZY	0	+	0	0	2178	0.0000000
zheyou73v0_A05	37295068	37296288	BnaA05T0332000ZY	0	+	0	0	1220	0.0000000
zheyou73v0_A05	37297115	37297742	BnaA05T0332100ZY	0	-	0	0	627	0.0000000
zheyou73v0_A05	37298015	37304935	BnaA05T0332200ZY	0	+	0	0	6920	0.0000000
zheyou73v0_A05	37298015	37303885	BnaA05T0332200ZY.1	0	+	0	0	5870	0.0000000
zheyou73v0_A05	37305722	37306004	BnaA05T0332300ZY	0	-	0	0	282	0.0000000
zheyou73v0_A05	37316944	37317450	BnaA05T0332400ZY	0	+	0	0	506	0.0000000
zheyou73v0_A05	37322143	37323424	BnaA05T0332500ZY	0	+	0	0	1281	0.0000000
zheyou73v0_A05	37326060	37328905	BnaA05T0332600ZY	0	-	0	0	2845	0.0000000
zheyou73v0_A05	37326060	37328617	BnaA05T0332600ZY.1	0	-	0	0	2557	0.0000000
zheyou73v0_A05	37326131	37326779	BnaA05T0332700ZY	0	+	0	0	648	0.0000000
zheyou73v0_A05	37330318	37332965	BnaA05T0332800ZY	0	+	0	0	2647	0.0000000
zheyou73v0_A05	37349491	37353008	BnaA05T0332900ZY	0	+	0	0	3517	0.0000000
zheyou73v0_A05	37353987	37355100	BnaA05T0333000ZY	0	+	0	0	1113	0.0000000
zheyou73v0_A05	37356228	37357758	BnaA05T0333100ZY	0	+	0	0	1530	0.0000000
zheyou73v0_A05	37358034	37360941	BnaA05T0333200ZY	0	-	0	0	2907	0.0000000
zheyou73v0_A05	37361299	37362938	BnaA05T0333300ZY	0	+	0	0	1639	0.0000000
zheyou73v0_A05	37374625	37378612	BnaA05T0333400ZY	0	+	0	0	3987	0.0000000
zheyou73v0_A05	37382062	37385364	BnaA05T0333500ZY	0	+	0	0	3302	0.0000000
zheyou73v0_A05	37387020	37387680	BnaA05T0333600ZY	0	-	0	0	660	0.0000000
zheyou73v0_A05	37391323	37392419	BnaA05T0333700ZY	0	+	0	0	1096	0.0000000
zheyou73v0_A05	37392587	37393085	BnaA05T0333800ZY	0	+	0	0	498	0.0000000
zheyou73v0_A05	37395400	37395799	BnaA05T0333900ZY	0	-	0	0	399	0.0000000
zheyou73v0_A05	37399762	37402223	BnaA05T0334000ZY	0	+	0	0	2461	0.0000000
zheyou73v0_A05	37416792	37418481	BnaA05T0334100ZY	0	+	0	0	1689	0.0000000
zheyou73v0_A05	37425687	37427530	BnaA05T0334200ZY	0	+	0	0	1843	0.0000000
zheyou73v0_A05	37431343	37434966	BnaA05T0334300ZY	0	-	0	0	3623	0.0000000
zheyou73v0_A05	37443751	37444788	BnaA05T0334400ZY	0	-	0	0	1037	0.0000000
zheyou73v0_A05	37446902	37447190	BnaA05T0334500ZY	0	-	0	0	288	0.0000000
zheyou73v0_A05	37447588	37450339	BnaA05T0334600ZY	0	-	0	0	2751	0.0000000
zheyou73v0_A05	37451529	37452395	BnaA05T0334700ZY	0	+	0	0	866	0.0000000
zheyou73v0_A05	37452604	37453132	BnaA05T0334800ZY	0	+	0	0	528	0.0000000
zheyou73v0_A05	37454709	37456645	BnaA05T0334900ZY	0	+	0	0	1936	0.0000000
zheyou73v0_A05	37476292	37480746	BnaA05T0335000ZY	0	-	0	0	4454	0.0000000
zheyou73v0_A05	37481916	37482726	BnaA05T0335100ZY	0	+	0	0	810	0.0000000
zheyou73v0_A05	37484946	37485931	BnaA05T0335200ZY	0	+	0	0	985	0.0000000
zheyou73v0_A05	37486415	37487541	BnaA05T0335300ZY	0	+	0	0	1126	0.0000000
zheyou73v0_A05	37491852	37492149	BnaA05T0335400ZY	0	-	0	0	297	0.0000000
zheyou73v0_A05	37498385	37501160	BnaA05T0335500ZY	0	+	0	0	2775	0.0000000
zheyou73v0_A05	37519661	37522403	BnaA05T0335600ZY	0	-	0	0	2742	0.0000000
zheyou73v0_A05	37522673	37525071	BnaA05T0335700ZY	0	+	0	0	2398	0.0000000
zheyou73v0_A05	37522873	37525071	BnaA05T0335700ZY.2	0	+	0	0	2198	0.0000000
zheyou73v0_A05	37522893	37525071	BnaA05T0335700ZY.1	0	+	0	0	2178	0.0000000
zheyou73v0_A05	37532084	37536406	BnaA05T0335800ZY	0	-	0	0	4322	0.0000000
zheyou73v0_A05	37532084	37536406	BnaA05T0335800ZY.1	0	-	0	0	4322	0.0000000
zheyou73v0_A05	37538902	37548503	BnaA05T0335900ZY	0	+	0	0	9601	0.0000000
zheyou73v0_A05	37560449	37563122	BnaA05T0336000ZY	0	+	0	0	2673	0.0000000
zheyou73v0_A05	37563461	37564220	BnaA05T0336100ZY	0	-	0	0	759	0.0000000
zheyou73v0_A05	37565209	37566211	BnaA05T0336200ZY	0	-	0	0	1002	0.0000000
zheyou73v0_A05	37567691	37573330	BnaA05T0336300ZY	0	-	0	0	5639	0.0000000
zheyou73v0_A05	37586431	37589002	BnaA05T0336400ZY	0	+	0	0	2571	0.0000000
zheyou73v0_A05	37589333	37589624	BnaA05T0336500ZY	0	-	0	0	291	0.0000000
zheyou73v0_A05	37592602	37594625	BnaA05T0336600ZY	0	-	0	0	2023	0.0000000
zheyou73v0_A05	37603917	37605476	BnaA05T0336700ZY	0	+	0	0	1559	0.0000000
zheyou73v0_A05	37608340	37608565	BnaA05T0336800ZY	0	+	0	0	225	0.0000000
zheyou73v0_A05	37612500	37612986	BnaA05T0336900ZY	0	+	0	0	486	0.0000000
zheyou73v0_A05	37612999	37613799	BnaA05T0337000ZY	0	+	0	0	800	0.0000000
zheyou73v0_A05	37620450	37622452	BnaA05T0337100ZY	0	+	0	0	2002	0.0000000
zheyou73v0_A05	37622562	37624841	BnaA05T0337200ZY	0	-	0	0	2279	0.0000000
zheyou73v0_A05	37637698	37639911	BnaA05T0337300ZY	0	-	0	0	2213	0.0000000
zheyou73v0_A05	37641598	37642235	BnaA05T0337400ZY	0	+	0	0	637	0.0000000
zheyou73v0_A05	37646181	37647932	BnaA05T0337500ZY	0	-	0	0	1751	0.0000000
zheyou73v0_A05	37649503	37650593	BnaA05T0337600ZY	0	-	0	0	1090	0.0000000
zheyou73v0_A05	37658808	37661028	BnaA05T0337700ZY.1	0	+	0	0	2220	0.0000000
zheyou73v0_A05	37658815	37661028	BnaA05T0337700ZY	0	+	0	0	2213	0.0000000
zheyou73v0_A05	37662278	37664227	BnaA05T0337800ZY	0	-	0	0	1949	0.0000000
zheyou73v0_A05	37664726	37665363	BnaA05T0337900ZY	0	+	0	0	637	0.0000000
zheyou73v0_A05	37671328	37673423	BnaA05T0338000ZY	0	-	0	0	2095	0.0000000
zheyou73v0_A05	37678506	37680646	BnaA05T0338100ZY	0	-	0	0	2140	0.0000000
zheyou73v0_A05	37678506	37680095	BnaA05T0338100ZY.1	0	-	0	0	1589	0.0000000
zheyou73v0_A05	37678506	37680095	BnaA05T0338100ZY.2	0	-	0	0	1589	0.0000000
zheyou73v0_A05	37688939	37690717	BnaA05T0338200ZY	0	-	0	0	1778	0.0000000
zheyou73v0_A05	37697799	37698260	BnaA05T0338300ZY	0	-	0	0	461	0.0000000
zheyou73v0_A05	37701226	37702994	BnaA05T0338400ZY	0	-	0	0	1768	0.0000000
zheyou73v0_A05	37704765	37704987	BnaA05T0338500ZY	0	-	0	0	222	0.0000000
zheyou73v0_A05	37705079	37706701	BnaA05T0338600ZY	0	+	0	0	1622	0.0000000
zheyou73v0_A05	37707072	37709194	BnaA05T0338700ZY	0	-	0	0	2122	0.0000000
zheyou73v0_A05	37710423	37712439	BnaA05T0338800ZY	0	-	0	0	2016	0.0000000
zheyou73v0_A05	37714080	37717606	BnaA05T0338900ZY	0	-	0	0	3526	0.0000000
zheyou73v0_A05	37724712	37725828	BnaA05T0339000ZY	0	-	0	0	1116	0.0000000
zheyou73v0_A05	37733840	37735844	BnaA05T0339100ZY	0	+	0	0	2004	0.0000000
zheyou73v0_A05	37736051	37737495	BnaA05T0339200ZY	0	+	0	0	1444	0.0000000
zheyou73v0_A05	37737732	37742478	BnaA05T0339300ZY	0	+	0	0	4746	0.0000000
zheyou73v0_A05	37742788	37746230	BnaA05T0339400ZY	0	-	0	0	3442	0.0000000
zheyou73v0_A05	37746984	37752558	BnaA05T0339500ZY	0	-	0	0	5574	0.0000000
zheyou73v0_A05	37753125	37756728	BnaA05T0339600ZY	0	-	0	0	3603	0.0000000
zheyou73v0_A05	37762237	37764370	BnaA05T0339700ZY	0	-	0	0	2133	0.0000000
zheyou73v0_A05	37766350	37770067	BnaA05T0339800ZY	0	-	0	0	3717	0.0000000
zheyou73v0_A05	37788567	37789951	BnaA05T0339900ZY	0	+	0	0	1384	0.0000000
zheyou73v0_A05	37795925	37796622	BnaA05T0340000ZY	0	+	0	0	697	0.0000000
zheyou73v0_A05	37809446	37810088	BnaA05T0340100ZY	0	-	0	0	642	0.0000000
zheyou73v0_A05	37811737	37812246	BnaA05T0340200ZY	0	+	0	0	509	0.0000000
zheyou73v0_A05	37813959	37816174	BnaA05T0340300ZY	0	-	0	0	2215	0.0000000
zheyou73v0_A05	37820898	37823093	BnaA05T0340400ZY	0	-	0	0	2195	0.0000000
zheyou73v0_A05	37827209	37829140	BnaA05T0340500ZY	0	+	0	0	1931	0.0000000
zheyou73v0_A05	37837385	37840669	BnaA05T0340600ZY	0	-	0	0	3284	0.0000000
zheyou73v0_A05	37843031	37848170	BnaA05T0340700ZY	0	-	0	0	5139	0.0000000
zheyou73v0_A05	37848413	37850135	BnaA05T0340800ZY	0	+	0	0	1722	0.0000000
zheyou73v0_A05	37851673	37853426	BnaA05T0340900ZY	0	+	0	0	1753	0.0000000
zheyou73v0_A05	37854139	37855076	BnaA05T0341000ZY	0	+	0	0	937	0.0000000
zheyou73v0_A05	37855426	37860785	BnaA05T0341100ZY	0	-	0	0	5359	0.0000000
zheyou73v0_A05	37863444	37865783	BnaA05T0341200ZY	0	-	0	0	2339	0.0000000
zheyou73v0_A05	37868026	37869485	BnaA05T0341300ZY	0	+	0	0	1459	0.0000000
zheyou73v0_A05	37878619	37879196	BnaA05T0341400ZY	0	-	0	0	577	0.0000000
zheyou73v0_A05	37879666	37882191	BnaA05T0341500ZY	0	-	0	0	2525	0.0000000
zheyou73v0_A05	37882766	37885925	BnaA05T0341600ZY	0	-	0	0	3159	0.0000000
zheyou73v0_A05	37890693	37891402	BnaA05T0341700ZY	0	-	0	0	709	0.0000000
zheyou73v0_A05	37897502	37898149	BnaA05T0341800ZY	0	+	0	0	647	0.0000000
zheyou73v0_A05	37898944	37905497	BnaA05T0341900ZY	0	+	0	0	6553	0.0000000
zheyou73v0_A05	37905944	37908335	BnaA05T0342000ZY	0	-	0	0	2391	0.0000000
zheyou73v0_A05	37909102	37911840	BnaA05T0342100ZY	0	-	0	0	2738	0.0000000
zheyou73v0_A05	37915228	37917401	BnaA05T0342200ZY	0	-	0	0	2173	0.0000000
zheyou73v0_A05	37915228	37917401	BnaA05T0342200ZY.1	0	-	0	0	2173	0.0000000
zheyou73v0_A05	37923908	37924720	BnaA05T0342300ZY	0	+	0	0	812	0.0000000
zheyou73v0_A05	37925213	37927345	BnaA05T0342400ZY	0	-	0	0	2132	0.0000000
zheyou73v0_A05	37928535	37930312	BnaA05T0342500ZY	0	+	0	0	1777	0.0000000
zheyou73v0_A05	37933411	37934871	BnaA05T0342600ZY	0	-	0	0	1460	0.0000000
zheyou73v0_A05	37943605	37944974	BnaA05T0342700ZY	0	-	0	0	1369	0.0000000
zheyou73v0_A05	37946154	37950537	BnaA05T0342800ZY	0	+	0	0	4383	0.0000000
zheyou73v0_A05	37951092	37953261	BnaA05T0342900ZY	0	+	0	0	2169	0.0000000
zheyou73v0_A05	37953481	37957798	BnaA05T0343000ZY	0	-	0	0	4317	0.0000000
zheyou73v0_A05	37965416	37977569	BnaA05T0343100ZY	0	+	0	0	12153	0.0000000
zheyou73v0_A05	37982869	37984169	BnaA05T0343200ZY	0	-	0	0	1300	0.0000000
zheyou73v0_A05	38004183	38005559	BnaA05T0343300ZY	0	+	0	0	1376	0.0000000
zheyou73v0_A05	38005848	38006357	BnaA05T0343400ZY	0	+	0	0	509	0.0000000
zheyou73v0_A05	38006354	38007753	BnaA05T0343500ZY	0	-	0	0	1399	0.0000000
zheyou73v0_A05	38008555	38010217	BnaA05T0343600ZY	0	-	0	0	1662	0.0000000
zheyou73v0_A05	38010952	38012496	BnaA05T0343700ZY	0	-	0	0	1544	0.0000000
zheyou73v0_A05	38013427	38014649	BnaA05T0343800ZY	0	-	0	0	1222	0.0000000
zheyou73v0_A05	38015265	38016427	BnaA05T0343900ZY	0	-	0	0	1162	0.0000000
zheyou73v0_A05	38017755	38018634	BnaA05T0344000ZY	0	-	0	0	879	0.0000000
zheyou73v0_A05	38021971	38022998	BnaA05T0344100ZY	0	-	0	0	1027	0.0000000
zheyou73v0_A05	38026102	38026889	BnaA05T0344200ZY	0	+	0	0	787	0.0000000
zheyou73v0_A05	38027376	38029642	BnaA05T0344300ZY	0	+	0	0	2266	0.0000000
zheyou73v0_A05	38030928	38031828	BnaA05T0344400ZY	0	-	0	0	900	0.0000000
zheyou73v0_A05	38044984	38045227	BnaA05T0344500ZY	0	-	0	0	243	0.0000000
zheyou73v0_A05	38050519	38051624	BnaA05T0344600ZY	0	+	0	0	1105	0.0000000
zheyou73v0_A05	38061404	38064838	BnaA05T0344700ZY	0	+	0	0	3434	0.0000000
zheyou73v0_A05	38066063	38067230	BnaA05T0344800ZY	0	-	0	0	1167	0.0000000
zheyou73v0_A05	38073714	38075377	BnaA05T0344900ZY	0	+	0	0	1663	0.0000000
zheyou73v0_A05	38073714	38075377	BnaA05T0344900ZY.1	0	+	0	0	1663	0.0000000
zheyou73v0_A05	38076411	38078683	BnaA05T0345000ZY	0	+	0	0	2272	0.0000000
zheyou73v0_A05	38079103	38080817	BnaA05T0345100ZY	0	-	0	0	1714	0.0000000
zheyou73v0_A05	38090092	38093002	BnaA05T0345200ZY	0	-	0	0	2910	0.0000000
zheyou73v0_A05	38110035	38111411	BnaA05T0345300ZY	0	-	0	0	1376	0.0000000
zheyou73v0_A05	38115164	38116428	BnaA05T0345400ZY	0	-	0	0	1264	0.0000000
zheyou73v0_A05	38123953	38130423	BnaA05T0345500ZY	0	+	0	0	6470	0.0000000
zheyou73v0_A05	38140856	38149057	BnaA05T0345600ZY	0	+	0	0	8201	0.0000000
zheyou73v0_A05	38149531	38150011	BnaA05T0345700ZY	0	+	0	0	480	0.0000000
zheyou73v0_A05	38152030	38153274	BnaA05T0345800ZY	0	+	0	0	1244	0.0000000
zheyou73v0_A05	38157956	38160605	BnaA05T0345900ZY	0	+	0	0	2649	0.0000000
zheyou73v0_A05	38163956	38165722	BnaA05T0346000ZY	0	+	0	0	1766	0.0000000
zheyou73v0_A05	38166207	38169005	BnaA05T0346100ZY	0	+	0	0	2798	0.0000000
zheyou73v0_A05	38169641	38170214	BnaA05T0346200ZY	0	+	0	0	573	0.0000000
zheyou73v0_A05	38174070	38175238	BnaA05T0346300ZY	0	+	0	0	1168	0.0000000
zheyou73v0_A05	38179546	38180207	BnaA05T0346400ZY	0	-	0	0	661	0.0000000
zheyou73v0_A05	38186322	38186883	BnaA05T0346500ZY	0	+	0	0	561	0.0000000
zheyou73v0_A05	38191608	38192270	BnaA05T0346600ZY	0	-	0	0	662	0.0000000
zheyou73v0_A05	38197521	38198082	BnaA05T0346700ZY	0	+	0	0	561	0.0000000
zheyou73v0_A05	38199732	38206786	BnaA05T0346800ZY	0	-	0	0	7054	0.0000000
zheyou73v0_A05	38214155	38214918	BnaA05T0346900ZY	0	-	0	0	763	0.0000000
zheyou73v0_A05	38219285	38219803	BnaA05T0347000ZY	0	+	0	0	518	0.0000000
zheyou73v0_A05	38220946	38221498	BnaA05T0347100ZY	0	+	0	0	552	0.0000000
zheyou73v0_A05	38222338	38223190	BnaA05T0347200ZY	0	-	0	0	852	0.0000000
zheyou73v0_A05	38226426	38227269	BnaA05T0347300ZY	0	-	0	0	843	0.0000000
zheyou73v0_A05	38242826	38244214	BnaA05T0347400ZY	0	-	0	0	1388	0.0000000
zheyou73v0_A05	38242826	38244214	BnaA05T0347400ZY.1	0	-	0	0	1388	0.0000000
zheyou73v0_A05	38242826	38244214	BnaA05T0347400ZY.2	0	-	0	0	1388	0.0000000
zheyou73v0_A05	38246300	38248192	BnaA05T0347500ZY	0	-	0	0	1892	0.0000000
zheyou73v0_A05	38258112	38259592	BnaA05T0347600ZY	0	+	0	0	1480	0.0000000
zheyou73v0_A05	38260070	38261261	BnaA05T0347700ZY	0	-	0	0	1191	0.0000000
zheyou73v0_A05	38262200	38264094	BnaA05T0347800ZY	0	-	0	0	1894	0.0000000
zheyou73v0_A05	38262200	38264094	BnaA05T0347800ZY.1	0	-	0	0	1894	0.0000000
zheyou73v0_A05	38262200	38264094	BnaA05T0347800ZY.2	0	-	0	0	1894	0.0000000
zheyou73v0_A05	38264754	38269315	BnaA05T0347900ZY	0	-	0	0	4561	0.0000000
zheyou73v0_A05	38264754	38269315	BnaA05T0347900ZY.1	0	-	0	0	4561	0.0000000
zheyou73v0_A05	38271295	38274243	BnaA05T0348000ZY	0	+	0	0	2948	0.0000000
zheyou73v0_A05	38276327	38277412	BnaA05T0348100ZY	0	-	0	0	1085	0.0000000
zheyou73v0_A05	38279621	38280756	BnaA05T0348200ZY	0	+	0	0	1135	0.0000000
zheyou73v0_A05	38284417	38290452	BnaA05T0348300ZY	0	-	0	0	6035	0.0000000
zheyou73v0_A05	38293345	38295127	BnaA05T0348400ZY	0	+	0	0	1782	0.0000000
zheyou73v0_A05	38299630	38301982	BnaA05T0348500ZY	0	+	0	0	2352	0.0000000
zheyou73v0_A05	38302776	38303874	BnaA05T0348600ZY	0	+	0	0	1098	0.0000000
zheyou73v0_A05	38304166	38304924	BnaA05T0348700ZY	0	+	0	0	758	0.0000000
zheyou73v0_A05	38304957	38308899	BnaA05T0348800ZY	0	-	0	0	3942	0.0000000
zheyou73v0_A05	38304957	38308899	BnaA05T0348800ZY.1	0	-	0	0	3942	0.0000000
zheyou73v0_A05	38312946	38315726	BnaA05T0348900ZY	0	-	0	0	2780	0.0000000
zheyou73v0_A05	38327547	38333084	BnaA05T0349000ZY	0	-	0	0	5537	0.0000000
zheyou73v0_A05	38346875	38350413	BnaA05T0349100ZY	0	+	0	0	3538	0.0000000
zheyou73v0_A05	38351414	38352615	BnaA05T0349200ZY	0	-	0	0	1201	0.0000000
zheyou73v0_A05	38358587	38360848	BnaA05T0349300ZY	0	-	0	0	2261	0.0000000
zheyou73v0_A05	38363635	38370995	BnaA05T0349400ZY	0	-	0	0	7360	0.0000000
zheyou73v0_A05	38373474	38381985	BnaA05T0349500ZY	0	-	0	0	8511	0.0000000
zheyou73v0_A05	38389086	38390236	BnaA05T0349600ZY	0	-	0	0	1150	0.0000000
zheyou73v0_A05	38391793	38395529	BnaA05T0349700ZY	0	+	0	0	3736	0.0000000
zheyou73v0_A05	38401852	38403039	BnaA05T0349800ZY	0	-	0	0	1187	0.0000000
zheyou73v0_A05	38403437	38404511	BnaA05T0349900ZY	0	+	0	0	1074	0.0000000
zheyou73v0_A05	38409692	38410750	BnaA05T0350000ZY	0	+	0	0	1058	0.0000000
zheyou73v0_A05	38412565	38417201	BnaA05T0350100ZY	0	+	0	0	4636	0.0000000
zheyou73v0_A05	38412565	38417201	BnaA05T0350100ZY.1	0	+	0	0	4636	0.0000000
zheyou73v0_A05	38420954	38430730	BnaA05T0350200ZY	0	+	0	0	9776	0.0000000
zheyou73v0_A05	38436294	38437461	BnaA05T0350300ZY	0	+	0	0	1167	0.0000000
zheyou73v0_A05	38441736	38442380	BnaA05T0350400ZY	0	-	0	0	644	0.0000000
zheyou73v0_A05	38444030	38445949	BnaA05T0350500ZY	0	+	0	0	1919	0.0000000
zheyou73v0_A05	38449411	38452334	BnaA05T0350600ZY	0	+	0	0	2923	0.0000000
zheyou73v0_A05	38453649	38456083	BnaA05T0350700ZY	0	+	0	0	2434	0.0000000
zheyou73v0_A05	38458344	38460366	BnaA05T0350800ZY	0	+	0	0	2022	0.0000000
zheyou73v0_A05	38458344	38460366	BnaA05T0350800ZY.1	0	+	0	0	2022	0.0000000
zheyou73v0_A05	38472055	38473500	BnaA05T0350900ZY	0	+	0	0	1445	0.0000000
zheyou73v0_A05	38475208	38478607	BnaA05T0351000ZY	0	-	0	0	3399	0.0000000
zheyou73v0_A05	38483415	38485590	BnaA05T0351100ZY	0	+	0	0	2175	0.0000000
zheyou73v0_A05	38483415	38485590	BnaA05T0351100ZY.1	0	+	0	0	2175	0.0000000
zheyou73v0_A05	38486655	38489121	BnaA05T0351200ZY	0	-	0	0	2466	0.0000000
zheyou73v0_A05	38499411	38506574	BnaA05T0351300ZY	0	-	0	0	7163	0.0000000
zheyou73v0_A05	38529412	38529760	BnaA05T0351400ZY	0	+	0	0	348	0.0000000
zheyou73v0_A05	38534715	38537271	BnaA05T0351500ZY	0	-	0	0	2556	0.0000000
zheyou73v0_A05	38556233	38562466	BnaA05T0351600ZY	0	-	0	0	6233	0.0000000
zheyou73v0_A05	38569909	38572367	BnaA05T0351700ZY	0	+	0	0	2458	0.0000000
zheyou73v0_A05	38572503	38573913	BnaA05T0351800ZY	0	-	0	0	1410	0.0000000
zheyou73v0_A05	38583620	38584045	BnaA05T0351900ZY	0	-	0	0	425	0.0000000
zheyou73v0_A05	38591103	38591915	BnaA05T0352000ZY	0	-	0	0	812	0.0000000
zheyou73v0_A05	38592503	38597118	BnaA05T0352100ZY	0	-	0	0	4615	0.0000000
zheyou73v0_A05	38597791	38599537	BnaA05T0352200ZY	0	+	0	0	1746	0.0000000
zheyou73v0_A05	38599942	38600692	BnaA05T0352300ZY	0	+	0	0	750	0.0000000
zheyou73v0_A05	38601952	38606052	BnaA05T0352400ZY	0	+	0	0	4100	0.0000000
zheyou73v0_A05	38607694	38608681	BnaA05T0352500ZY	0	-	0	0	987	0.0000000
zheyou73v0_A05	38609988	38613835	BnaA05T0352600ZY	0	-	0	0	3847	0.0000000
zheyou73v0_A05	38615037	38619414	BnaA05T0352700ZY	0	-	0	0	4377	0.0000000
zheyou73v0_A05	38620975	38622211	BnaA05T0352800ZY	0	+	0	0	1236	0.0000000
zheyou73v0_A05	38622485	38623989	BnaA05T0352900ZY	0	-	0	0	1504	0.0000000
zheyou73v0_A05	38634761	38635592	BnaA05T0353000ZY	0	+	0	0	831	0.0000000
zheyou73v0_A05	38635699	38635855	BnaA05T0353100ZY	0	+	0	0	156	0.0000000
zheyou73v0_A05	38638239	38640388	BnaA05T0353200ZY	0	+	0	0	2149	0.0000000
zheyou73v0_A05	38640769	38641998	BnaA05T0353300ZY	0	+	0	0	1229	0.0000000
zheyou73v0_A05	38646624	38650834	BnaA05T0353400ZY	0	+	0	0	4210	0.0000000
zheyou73v0_A05	38646624	38650834	BnaA05T0353400ZY.1	0	+	0	0	4210	0.0000000
zheyou73v0_A05	38651266	38655077	BnaA05T0353500ZY	0	-	0	0	3811	0.0000000
zheyou73v0_A05	38657870	38659364	BnaA05T0353600ZY	0	-	0	0	1494	0.0000000
zheyou73v0_A05	38673824	38674741	BnaA05T0353700ZY	0	+	0	0	917	0.0000000
zheyou73v0_A05	38674903	38677030	BnaA05T0353800ZY	0	-	0	0	2127	0.0000000
zheyou73v0_A05	38677742	38678115	BnaA05T0353900ZY	0	-	0	0	373	0.0000000
zheyou73v0_A05	38680757	38684010	BnaA05T0354000ZY	0	+	0	0	3253	0.0000000
zheyou73v0_A05	38684499	38685555	BnaA05T0354100ZY	0	-	0	0	1056	0.0000000
zheyou73v0_A05	38686825	38687477	BnaA05T0354200ZY	0	+	0	0	652	0.0000000
zheyou73v0_A05	38687587	38691569	BnaA05T0354300ZY	0	-	0	0	3982	0.0000000
zheyou73v0_A05	38692091	38696555	BnaA05T0354400ZY	0	-	0	0	4464	0.0000000
zheyou73v0_A05	38697617	38700203	BnaA05T0354500ZY	0	+	0	0	2586	0.0000000
zheyou73v0_A05	38700173	38704772	BnaA05T0354600ZY	0	-	0	0	4599	0.0000000
zheyou73v0_A05	38727226	38727733	BnaA05T0354700ZY	0	+	0	0	507	0.0000000
zheyou73v0_A05	38732715	38737549	BnaA05T0354800ZY	0	+	0	0	4834	0.0000000
zheyou73v0_A05	38739759	38740495	BnaA05T0354900ZY	0	+	0	0	736	0.0000000
zheyou73v0_A05	38742935	38745398	BnaA05T0355000ZY	0	+	0	0	2463	0.0000000
zheyou73v0_A05	38746085	38747544	BnaA05T0355100ZY	0	-	0	0	1459	0.0000000
zheyou73v0_A05	38750191	38750727	BnaA05T0355200ZY	0	+	0	0	536	0.0000000
zheyou73v0_A05	38759943	38764236	BnaA05T0355300ZY	0	-	0	0	4293	0.0000000
zheyou73v0_A05	38765246	38767426	BnaA05T0355400ZY	0	-	0	0	2180	0.0000000
zheyou73v0_A05	38765246	38767426	BnaA05T0355400ZY.1	0	-	0	0	2180	0.0000000
zheyou73v0_A05	38767810	38769545	BnaA05T0355500ZY	0	+	0	0	1735	0.0000000
zheyou73v0_A05	38767810	38769397	BnaA05T0355500ZY.1	0	+	0	0	1587	0.0000000
zheyou73v0_A05	38770061	38772252	BnaA05T0355600ZY	0	-	0	0	2191	0.0000000
zheyou73v0_A05	38776261	38777732	BnaA05T0355700ZY	0	+	0	0	1471	0.0000000
zheyou73v0_A05	38778194	38783800	BnaA05T0355800ZY	0	-	0	0	5606	0.0000000
zheyou73v0_A05	38784339	38785053	BnaA05T0355900ZY	0	-	0	0	714	0.0000000
zheyou73v0_A05	38788835	38792116	BnaA05T0356000ZY	0	-	0	0	3281	0.0000000
zheyou73v0_A05	38797337	38799640	BnaA05T0356100ZY	0	+	0	0	2303	0.0000000
zheyou73v0_A05	38803429	38806113	BnaA05T0356200ZY	0	+	0	0	2684	0.0000000
zheyou73v0_A05	38806238	38807656	BnaA05T0356300ZY	0	-	0	0	1418	0.0000000
zheyou73v0_A05	38819687	38820950	BnaA05T0356400ZY	0	-	0	0	1263	0.0000000
zheyou73v0_A05	38821734	38823530	BnaA05T0356500ZY	0	-	0	0	1796	0.0000000
zheyou73v0_A05	38835093	38837165	BnaA05T0356600ZY	0	-	0	0	2072	0.0000000
zheyou73v0_A05	38837629	38839460	BnaA05T0356700ZY	0	-	0	0	1831	0.0000000
zheyou73v0_A05	38842661	38845200	BnaA05T0356800ZY	0	-	0	0	2539	0.0000000
zheyou73v0_A05	38842723	38842924	BnaA05T0356900ZY	0	+	0	0	201	0.0000000
zheyou73v0_A05	38849421	38850507	BnaA05T0357000ZY	0	+	0	0	1086	0.0000000
zheyou73v0_A05	38852515	38852790	BnaA05T0357100ZY	0	-	0	0	275	0.0000000
zheyou73v0_A05	38853882	38855273	BnaA05T0357200ZY	0	+	0	0	1391	0.0000000
zheyou73v0_A05	38853882	38855273	BnaA05T0357200ZY.1	0	+	0	0	1391	0.0000000
zheyou73v0_A05	38853882	38855273	BnaA05T0357200ZY.2	0	+	0	0	1391	0.0000000
zheyou73v0_A05	38855483	38857014	BnaA05T0357300ZY	0	-	0	0	1531	0.0000000
zheyou73v0_A05	38867035	38868651	BnaA05T0357400ZY	0	-	0	0	1616	0.0000000
zheyou73v0_A05	38869654	38874023	BnaA05T0357500ZY	0	-	0	0	4369	0.0000000
zheyou73v0_A05	38876723	38880747	BnaA05T0357600ZY	0	-	0	0	4024	0.0000000
zheyou73v0_A05	38881453	38883354	BnaA05T0357700ZY	0	+	0	0	1901	0.0000000
zheyou73v0_A05	38883870	38884918	BnaA05T0357800ZY	0	+	0	0	1048	0.0000000
zheyou73v0_A05	38886685	38888557	BnaA05T0357900ZY	0	+	0	0	1872	0.0000000
zheyou73v0_A05	38889360	38892179	BnaA05T0358000ZY	0	-	0	0	2819	0.0000000
zheyou73v0_A05	38894488	38906235	BnaA05T0358100ZY	0	+	0	0	11747	0.0000000
zheyou73v0_A05	38909407	38948536	BnaA05T0358200ZY	0	+	0	0	39129	0.0000000
zheyou73v0_A05	38948583	38950203	BnaA05T0358300ZY	0	+	0	0	1620	0.0000000
zheyou73v0_A05	38950492	38954052	BnaA05T0358400ZY	0	+	0	0	3560	0.0000000
zheyou73v0_A05	38950492	38954052	BnaA05T0358400ZY.1	0	+	0	0	3560	0.0000000
zheyou73v0_A05	38953690	38954011	BnaA05T0358500ZY	0	-	0	0	321	0.0000000
zheyou73v0_A05	38962059	38963978	BnaA05T0358600ZY	0	-	0	0	1919	0.0000000
zheyou73v0_A05	38971432	38973177	BnaA05T0358700ZY	0	+	0	0	1745	0.0000000
zheyou73v0_A05	38981047	38982244	BnaA05T0358800ZY	0	-	0	0	1197	0.0000000
zheyou73v0_A05	39005360	39006462	BnaA05T0358900ZY	0	-	0	0	1102	0.0000000
zheyou73v0_A05	39007640	39008589	BnaA05T0359000ZY	0	+	0	0	949	0.0000000
zheyou73v0_A05	39016221	39021631	BnaA05T0359100ZY	0	+	0	0	5410	0.0000000
zheyou73v0_A05	39022054	39023152	BnaA05T0359200ZY	0	-	0	0	1098	0.0000000
zheyou73v0_A05	39025588	39028170	BnaA05T0359300ZY	0	-	0	0	2582	0.0000000
zheyou73v0_A05	39025588	39028170	BnaA05T0359300ZY.1	0	-	0	0	2582	0.0000000
zheyou73v0_A05	39025588	39027238	BnaA05T0359300ZY.2	0	-	0	0	1650	0.0000000
zheyou73v0_A05	39028346	39032465	BnaA05T0359400ZY	0	-	0	0	4119	0.0000000
zheyou73v0_A05	39028346	39032465	BnaA05T0359400ZY.1	0	-	0	0	4119	0.0000000
zheyou73v0_A05	39037056	39039961	BnaA05T0359500ZY	0	+	0	0	2905	0.0000000
zheyou73v0_A05	39040191	39043324	BnaA05T0359600ZY	0	-	0	0	3133	0.0000000
zheyou73v0_A05	39040191	39043324	BnaA05T0359600ZY.1	0	-	0	0	3133	0.0000000
zheyou73v0_A05	39045393	39046464	BnaA05T0359700ZY	0	-	0	0	1071	0.0000000
zheyou73v0_A05	39047579	39049042	BnaA05T0359800ZY	0	-	0	0	1463	0.0000000
zheyou73v0_A05	39049626	39050164	BnaA05T0359900ZY	0	-	0	0	538	0.0000000
zheyou73v0_A05	39051719	39054440	BnaA05T0360000ZY	0	-	0	0	2721	0.0000000
zheyou73v0_A05	39051719	39054161	BnaA05T0360000ZY.1	0	-	0	0	2442	0.0000000
zheyou73v0_A05	39060124	39060946	BnaA05T0360100ZY	0	+	0	0	822	0.0000000
zheyou73v0_A05	39061097	39061700	BnaA05T0360200ZY	0	+	0	0	603	0.0000000
zheyou73v0_A05	39061751	39062559	BnaA05T0360300ZY	0	-	0	0	808	0.0000000
zheyou73v0_A05	39064131	39065166	BnaA05T0360400ZY	0	+	0	0	1035	0.0000000
zheyou73v0_A05	39068587	39071506	BnaA05T0360500ZY	0	+	0	0	2919	0.0000000
zheyou73v0_A05	39071883	39073367	BnaA05T0360600ZY	0	-	0	0	1484	0.0000000
zheyou73v0_A05	39093736	39096640	BnaA05T0360700ZY	0	+	0	0	2904	0.0000000
zheyou73v0_A05	39103740	39104627	BnaA05T0360800ZY	0	+	0	0	887	0.0000000
zheyou73v0_A05	39105252	39106695	BnaA05T0360900ZY	0	-	0	0	1443	0.0000000
zheyou73v0_A05	39106990	39107816	BnaA05T0361000ZY	0	+	0	0	826	0.0000000
zheyou73v0_A05	39108889	39112685	BnaA05T0361100ZY	0	-	0	0	3796	0.0000000
zheyou73v0_A05	39110142	39111146	BnaA05T0361200ZY	0	+	0	0	1004	0.0000000
zheyou73v0_A05	39113665	39114385	BnaA05T0361300ZY	0	+	0	0	720	0.0000000
zheyou73v0_A05	39114877	39117241	BnaA05T0361400ZY	0	-	0	0	2364	0.0000000
zheyou73v0_A05	39119913	39125586	BnaA05T0361500ZY	0	+	0	0	5673	0.0000000
zheyou73v0_A05	39121100	39125586	BnaA05T0361500ZY.1	0	+	0	0	4486	0.0000000
zheyou73v0_A05	39135348	39136454	BnaA05T0361600ZY	0	-	0	0	1106	0.0000000
zheyou73v0_A05	39141953	39143540	BnaA05T0361700ZY	0	+	0	0	1587	0.0000000
zheyou73v0_A05	39142962	39144733	BnaA05T0361800ZY	0	-	0	0	1771	0.0000000
zheyou73v0_A05	39145156	39148636	BnaA05T0361900ZY	0	-	0	0	3480	0.0000000
zheyou73v0_A05	39153485	39155018	BnaA05T0362000ZY	0	+	0	0	1533	0.0000000
zheyou73v0_A05	39153485	39155212	BnaA05T0362000ZY.1	0	+	0	0	1727	0.0000000
zheyou73v0_A05	39155320	39157171	BnaA05T0362100ZY	0	+	0	0	1851	0.0000000
zheyou73v0_A05	39158413	39159660	BnaA05T0362200ZY	0	+	0	0	1247	0.0000000
zheyou73v0_A05	39160057	39161248	BnaA05T0362300ZY	0	+	0	0	1191	0.0000000
zheyou73v0_A05	39161898	39163851	BnaA05T0362400ZY	0	-	0	0	1953	0.0000000
zheyou73v0_A05	39167490	39172094	BnaA05T0362500ZY	0	-	0	0	4604	0.0000000
zheyou73v0_A05	39176580	39178305	BnaA05T0362600ZY	0	+	0	0	1725	0.0000000
zheyou73v0_A05	39180880	39182003	BnaA05T0362700ZY	0	+	0	0	1123	0.0000000
zheyou73v0_A05	39183930	39185289	BnaA05T0362800ZY	0	-	0	0	1359	0.0000000
zheyou73v0_A05	39207981	39209207	BnaA05T0362900ZY	0	-	0	0	1226	0.0000000
zheyou73v0_A05	39220952	39225010	BnaA05T0363000ZY	0	+	0	0	4058	0.0000000
zheyou73v0_A05	39225404	39227774	BnaA05T0363100ZY	0	+	0	0	2370	0.0000000
zheyou73v0_A05	39232588	39235473	BnaA05T0363200ZY	0	+	0	0	2885	0.0000000
zheyou73v0_A05	39246834	39248973	BnaA05T0363300ZY	0	-	0	0	2139	0.0000000
zheyou73v0_A05	39249338	39251153	BnaA05T0363400ZY	0	+	0	0	1815	0.0000000
zheyou73v0_A05	39250613	39255614	BnaA05T0363500ZY	0	-	0	0	5001	0.0000000
zheyou73v0_A05	39257175	39259325	BnaA05T0363600ZY	0	-	0	0	2150	0.0000000
zheyou73v0_A05	39260087	39261688	BnaA05T0363700ZY	0	-	0	0	1601	0.0000000
zheyou73v0_A05	39266318	39266560	BnaA05T0363800ZY	0	+	0	0	242	0.0000000
zheyou73v0_A05	39267735	39268446	BnaA05T0363900ZY	0	-	0	0	711	0.0000000
zheyou73v0_A05	39302139	39306357	BnaA05T0364000ZY	0	-	0	0	4218	0.0000000
zheyou73v0_A05	39306542	39310544	BnaA05T0364100ZY	0	-	0	0	4002	0.0000000
zheyou73v0_A05	39315333	39315993	BnaA05T0364200ZY	0	+	0	0	660	0.0000000
zheyou73v0_A05	39339563	39341702	BnaA05T0364300ZY	0	-	0	0	2139	0.0000000
zheyou73v0_A05	39343065	39344287	BnaA05T0364400ZY	0	+	0	0	1222	0.0000000
zheyou73v0_A05	39344381	39347122	BnaA05T0364500ZY	0	-	0	0	2741	0.0000000
zheyou73v0_A05	39344381	39347122	BnaA05T0364500ZY.1	0	-	0	0	2741	0.0000000
zheyou73v0_A05	39354883	39356430	BnaA05T0364600ZY	0	+	0	0	1547	0.0000000
zheyou73v0_A05	39358771	39360662	BnaA05T0364700ZY	0	+	0	0	1891	0.0000000
zheyou73v0_A05	39360978	39362351	BnaA05T0364800ZY	0	+	0	0	1373	0.0000000
zheyou73v0_A05	39360978	39362351	BnaA05T0364800ZY.1	0	+	0	0	1373	0.0000000
zheyou73v0_A05	39365670	39368298	BnaA05T0364900ZY	0	-	0	0	2628	0.0000000
zheyou73v0_A05	39371552	39371939	BnaA05T0365000ZY	0	-	0	0	387	0.0000000
zheyou73v0_A05	39396546	39400154	BnaA05T0365100ZY	0	-	0	0	3608	0.0000000
zheyou73v0_A05	39402445	39405457	BnaA05T0365200ZY	0	+	0	0	3012	0.0000000
zheyou73v0_A05	39405832	39407050	BnaA05T0365300ZY	0	-	0	0	1218	0.0000000
zheyou73v0_A05	39411011	39421499	BnaA05T0365400ZY	0	-	0	0	10488	0.0000000
zheyou73v0_A05	39423636	39424279	BnaA05T0365500ZY	0	-	0	0	643	0.0000000
zheyou73v0_A05	39429359	39432833	BnaA05T0365600ZY	0	+	0	0	3474	0.0000000
zheyou73v0_A05	39436283	39436694	BnaA05T0365700ZY	0	-	0	0	411	0.0000000
zheyou73v0_A05	39436972	39441986	BnaA05T0365800ZY	0	-	0	0	5014	0.0000000
zheyou73v0_A05	39436972	39440837	BnaA05T0365800ZY.1	0	-	0	0	3865	0.0000000
zheyou73v0_A05	39441828	39446084	BnaA05T0365900ZY	0	+	0	0	4256	0.0000000
zheyou73v0_A05	39446170	39448428	BnaA05T0366000ZY	0	-	0	0	2258	0.0000000
zheyou73v0_A05	39446806	39448428	BnaA05T0366000ZY.1	0	-	0	0	1622	0.0000000
zheyou73v0_A05	39446806	39448428	BnaA05T0366000ZY.2	0	-	0	0	1622	0.0000000
zheyou73v0_A05	39452658	39452973	BnaA05T0366100ZY	0	-	0	0	315	0.0000000
zheyou73v0_A05	39453189	39464805	BnaA05T0366200ZY	0	-	0	0	11616	0.0000000
zheyou73v0_A05	39474062	39475859	BnaA05T0366300ZY	0	+	0	0	1797	0.0000000
zheyou73v0_A05	39483212	39483538	BnaA05T0366400ZY	0	+	0	0	326	0.0000000
zheyou73v0_A05	39494069	39496426	BnaA05T0366500ZY	0	+	0	0	2357	0.0000000
zheyou73v0_A05	39494069	39496426	BnaA05T0366500ZY.1	0	+	0	0	2357	0.0000000
zheyou73v0_A05	39496582	39500191	BnaA05T0366600ZY	0	+	0	0	3609	0.0000000
zheyou73v0_A05	39500210	39500792	BnaA05T0366700ZY	0	-	0	0	582	0.0000000
zheyou73v0_A05	39505905	39507357	BnaA05T0366800ZY	0	+	0	0	1452	0.0000000
zheyou73v0_A05	39512923	39514452	BnaA05T0366900ZY	0	+	0	0	1529	0.0000000
zheyou73v0_A05	39517510	39519388	BnaA05T0367000ZY	0	-	0	0	1878	0.0000000
zheyou73v0_A05	39524198	39528683	BnaA05T0367100ZY	0	+	0	0	4485	0.0000000
zheyou73v0_A05	39528990	39529384	BnaA05T0367200ZY	0	+	0	0	394	0.0000000
zheyou73v0_A05	39529963	39530461	BnaA05T0367300ZY	0	+	0	0	498	0.0000000
zheyou73v0_A05	39536020	39539354	BnaA05T0367400ZY	0	+	0	0	3334	0.0000000
zheyou73v0_A05	39541411	39542054	BnaA05T0367500ZY	0	+	0	0	643	0.0000000
zheyou73v0_A05	39547368	39550193	BnaA05T0367600ZY	0	+	0	0	2825	0.0000000
zheyou73v0_A05	39564673	39566862	BnaA05T0367700ZY	0	+	0	0	2189	0.0000000
zheyou73v0_A05	39564673	39566862	BnaA05T0367700ZY.1	0	+	0	0	2189	0.0000000
zheyou73v0_A05	39568510	39570404	BnaA05T0367800ZY	0	+	0	0	1894	0.0000000
zheyou73v0_A05	39571663	39573192	BnaA05T0367900ZY	0	+	0	0	1529	0.0000000
zheyou73v0_A05	39573826	39575855	BnaA05T0368000ZY	0	-	0	0	2029	0.0000000
zheyou73v0_A05	39589657	39591420	BnaA05T0368100ZY	0	-	0	0	1763	0.0000000
zheyou73v0_A05	39593529	39594572	BnaA05T0368200ZY	0	-	0	0	1043	0.0000000
zheyou73v0_A05	39621788	39622203	BnaA05T0368300ZY	0	+	0	0	415	0.0000000
zheyou73v0_A05	39624776	39625337	BnaA05T0368400ZY	0	-	0	0	561	0.0000000
zheyou73v0_A05	39634719	39639737	BnaA05T0368500ZY	0	+	0	0	5018	0.0000000
zheyou73v0_A05	39634719	39639280	BnaA05T0368500ZY.1	0	+	0	0	4561	0.0000000
zheyou73v0_A05	39640352	39642261	BnaA05T0368600ZY	0	+	0	0	1909	0.0000000
zheyou73v0_A05	39643122	39644430	BnaA05T0368700ZY	0	+	0	0	1308	0.0000000
zheyou73v0_A05	39644636	39644831	BnaA05T0368800ZY	0	-	0	0	195	0.0000000
zheyou73v0_A05	39645610	39646034	BnaA05T0368900ZY	0	+	0	0	424	0.0000000
zheyou73v0_A05	39647837	39654186	BnaA05T0369000ZY	0	+	0	0	6349	0.0000000
zheyou73v0_A05	39654536	39656429	BnaA05T0369100ZY	0	+	0	0	1893	0.0000000
zheyou73v0_A05	39656668	39658344	BnaA05T0369200ZY	0	-	0	0	1676	0.0000000
zheyou73v0_A05	39659394	39663970	BnaA05T0369300ZY	0	+	0	0	4576	0.0000000
zheyou73v0_A05	39664197	39671862	BnaA05T0369400ZY	0	-	0	0	7665	0.0000000
zheyou73v0_A05	39672158	39673828	BnaA05T0369500ZY	0	+	0	0	1670	0.0000000
zheyou73v0_A05	39675132	39677367	BnaA05T0369600ZY	0	+	0	0	2235	0.0000000
zheyou73v0_A05	39677477	39679190	BnaA05T0369700ZY	0	-	0	0	1713	0.0000000
zheyou73v0_A05	39677477	39678394	BnaA05T0369700ZY.1	0	-	0	0	917	0.0000000
zheyou73v0_A05	39683822	39685842	BnaA05T0369800ZY	0	+	0	0	2020	0.0000000
zheyou73v0_A05	39686052	39688734	BnaA05T0369900ZY	0	+	0	0	2682	0.0000000
zheyou73v0_A05	39706719	39709201	BnaA05T0370000ZY	0	+	0	0	2482	0.0000000
zheyou73v0_A05	39710359	39712124	BnaA05T0370100ZY	0	-	0	0	1765	0.0000000
zheyou73v0_A05	39717191	39719749	BnaA05T0370200ZY	0	+	0	0	2558	0.0000000
zheyou73v0_A05	39722547	39727241	BnaA05T0370300ZY	0	+	0	0	4694	0.0000000
zheyou73v0_A05	39722547	39727241	BnaA05T0370300ZY.1	0	+	0	0	4694	0.0000000
zheyou73v0_A05	39722547	39727241	BnaA05T0370300ZY.2	0	+	0	0	4694	0.0000000
zheyou73v0_A05	39722547	39727241	BnaA05T0370300ZY.3	0	+	0	0	4694	0.0000000
zheyou73v0_A05	39722547	39727241	BnaA05T0370300ZY.4	0	+	0	0	4694	0.0000000
zheyou73v0_A05	39733126	39734248	BnaA05T0370400ZY	0	+	0	0	1122	0.0000000
zheyou73v0_A05	39740022	39741705	BnaA05T0370500ZY	0	+	0	0	1683	0.0000000
zheyou73v0_A05	39742368	39743273	BnaA05T0370600ZY	0	+	0	0	905	0.0000000
zheyou73v0_A05	39744786	39746520	BnaA05T0370700ZY	0	-	0	0	1734	0.0000000
zheyou73v0_A05	39752925	39753996	BnaA05T0370800ZY	0	-	0	0	1071	0.0000000
zheyou73v0_A05	39756214	39759657	BnaA05T0370900ZY	0	-	0	0	3443	0.0000000
zheyou73v0_A05	39779068	39780438	BnaA05T0371000ZY	0	+	0	0	1370	0.0000000
zheyou73v0_A05	39791967	39792974	BnaA05T0371100ZY	0	-	0	0	1007	0.0000000
zheyou73v0_A05	39795179	39795389	BnaA05T0371200ZY	0	+	0	0	210	0.0000000
zheyou73v0_A05	39798193	39799340	BnaA05T0371300ZY	0	-	0	0	1147	0.0000000
zheyou73v0_A05	39806072	39808042	BnaA05T0371400ZY	0	-	0	0	1970	0.0000000
zheyou73v0_A05	39815205	39819405	BnaA05T0371500ZY	0	+	0	0	4200	0.0000000
zheyou73v0_A05	39815205	39817694	BnaA05T0371500ZY.1	0	+	0	0	2489	0.0000000
zheyou73v0_A05	39820664	39822873	BnaA05T0371600ZY	0	+	0	0	2209	0.0000000
zheyou73v0_A05	39820664	39822873	BnaA05T0371600ZY.1	0	+	0	0	2209	0.0000000
zheyou73v0_A05	39822916	39824773	BnaA05T0371700ZY	0	-	0	0	1857	0.0000000
zheyou73v0_A05	39825039	39826398	BnaA05T0371800ZY	0	-	0	0	1359	0.0000000
zheyou73v0_A05	39827370	39831421	BnaA05T0371900ZY	0	+	0	0	4051	0.0000000
zheyou73v0_A05	39831518	39832270	BnaA05T0372000ZY	0	-	0	0	752	0.0000000
zheyou73v0_A05	39832909	39835908	BnaA05T0372100ZY	0	-	0	0	2999	0.0000000
zheyou73v0_A05	39848620	39850488	BnaA05T0372200ZY	0	-	0	0	1868	0.0000000
zheyou73v0_A05	39853701	39856894	BnaA05T0372300ZY	0	+	0	0	3193	0.0000000
zheyou73v0_A05	39858239	39859191	BnaA05T0372400ZY	0	+	0	0	952	0.0000000
zheyou73v0_A05	39859992	39861557	BnaA05T0372500ZY	0	+	0	0	1565	0.0000000
zheyou73v0_A05	39862543	39863248	BnaA05T0372600ZY	0	-	0	0	705	0.0000000
zheyou73v0_A05	39863331	39870493	BnaA05T0372700ZY	0	-	0	0	7162	0.0000000
zheyou73v0_A05	39877775	39881476	BnaA05T0372800ZY	0	-	0	0	3701	0.0000000
zheyou73v0_A05	39883025	39884499	BnaA05T0372900ZY	0	-	0	0	1474	0.0000000
zheyou73v0_A05	39887596	39887984	BnaA05T0373000ZY	0	+	0	0	388	0.0000000
zheyou73v0_A05	39889217	39891004	BnaA05T0373100ZY	0	+	0	0	1787	0.0000000
zheyou73v0_A05	39891123	39892645	BnaA05T0373200ZY	0	-	0	0	1522	0.0000000
zheyou73v0_A05	39894194	39895611	BnaA05T0373300ZY	0	-	0	0	1417	0.0000000
zheyou73v0_A05	39897984	39900153	BnaA05T0373400ZY	0	-	0	0	2169	0.0000000
zheyou73v0_A05	39915149	39916699	BnaA05T0373500ZY	0	+	0	0	1550	0.0000000
zheyou73v0_A05	39920452	39921925	BnaA05T0373600ZY	0	+	0	0	1473	0.0000000
zheyou73v0_A05	39926068	39927538	BnaA05T0373700ZY	0	+	0	0	1470	0.0000000
zheyou73v0_A05	39929309	39930518	BnaA05T0373800ZY	0	+	0	0	1209	0.0000000
zheyou73v0_A05	39933255	39934713	BnaA05T0373900ZY	0	+	0	0	1458	0.0000000
zheyou73v0_A05	39939282	39941009	BnaA05T0374000ZY	0	+	0	0	1727	0.0000000
zheyou73v0_A05	39941899	39943289	BnaA05T0374100ZY	0	+	0	0	1390	0.0000000
zheyou73v0_A05	39946820	39948107	BnaA05T0374200ZY	0	-	0	0	1287	0.0000000
zheyou73v0_A05	39949492	39949951	BnaA05T0374300ZY	0	+	0	0	459	0.0000000
zheyou73v0_A05	39953290	39953918	BnaA05T0374400ZY	0	+	0	0	628	0.0000000
zheyou73v0_A05	39958836	39959022	BnaA05T0374500ZY	0	-	0	0	186	0.0000000
zheyou73v0_A05	39963142	39965150	BnaA05T0374600ZY	0	-	0	0	2008	0.0000000
zheyou73v0_A05	39967052	39967559	BnaA05T0374700ZY	0	-	0	0	507	0.0000000
zheyou73v0_A05	39989324	39992447	BnaA05T0374800ZY	0	+	0	0	3123	0.0000000
zheyou73v0_A05	39993994	39995100	BnaA05T0374900ZY	0	+	0	0	1106	0.0000000
zheyou73v0_A05	39995228	39998069	BnaA05T0375000ZY	0	-	0	0	2841	0.0000000
zheyou73v0_A05	39999250	40002322	BnaA05T0375100ZY	0	+	0	0	3072	0.0000000
zheyou73v0_A05	39999250	40002322	BnaA05T0375100ZY.1	0	+	0	0	3072	0.0000000
zheyou73v0_A05	40009245	40012786	BnaA05T0375200ZY	0	-	0	0	3541	0.0000000
zheyou73v0_A05	40013194	40014810	BnaA05T0375300ZY	0	-	0	0	1616	0.0000000
zheyou73v0_A05	40015758	40017361	BnaA05T0375400ZY	0	-	0	0	1603	0.0000000
zheyou73v0_A05	40017824	40019731	BnaA05T0375500ZY	0	+	0	0	1907	0.0000000
zheyou73v0_A05	40036198	40038840	BnaA05T0375600ZY	0	-	0	0	2642	0.0000000
zheyou73v0_A05	40046021	40048029	BnaA05T0375700ZY	0	+	0	0	2008	0.0000000
zheyou73v0_A05	40048348	40051615	BnaA05T0375800ZY	0	-	0	0	3267	0.0000000
zheyou73v0_A05	40059530	40061563	BnaA05T0375900ZY	0	+	0	0	2033	0.0000000
zheyou73v0_A05	40075460	40084742	BnaA05T0376000ZY	0	+	0	0	9282	0.0000000
zheyou73v0_A05	40126825	40129658	BnaA05T0376100ZY	0	-	0	0	2833	0.0000000
zheyou73v0_A05	40130508	40133520	BnaA05T0376200ZY	0	-	0	0	3012	0.0000000
zheyou73v0_A05	40130508	40133520	BnaA05T0376200ZY.1	0	-	0	0	3012	0.0000000
zheyou73v0_A05	40136911	40137719	BnaA05T0376300ZY	0	+	0	0	808	0.0000000
zheyou73v0_A05	40137811	40143801	BnaA05T0376400ZY	0	-	0	0	5990	0.0000000
zheyou73v0_A05	40146315	40152089	BnaA05T0376500ZY	0	-	0	0	5774	0.0000000
zheyou73v0_A05	40146315	40152089	BnaA05T0376500ZY.1	0	-	0	0	5774	0.0000000
zheyou73v0_A05	40154787	40155398	BnaA05T0376600ZY	0	+	0	0	611	0.0000000
zheyou73v0_A05	40156231	40156948	BnaA05T0376700ZY	0	+	0	0	717	0.0000000
zheyou73v0_A05	40157412	40158449	BnaA05T0376800ZY	0	-	0	0	1037	0.0000000
zheyou73v0_A05	40176854	40178660	BnaA05T0376900ZY	0	-	0	0	1806	0.0000000
zheyou73v0_A05	40179090	40180137	BnaA05T0377000ZY	0	-	0	0	1047	0.0000000
zheyou73v0_A05	40181747	40182368	BnaA05T0377100ZY	0	+	0	0	621	0.0000000
zheyou73v0_A05	40182884	40183845	BnaA05T0377200ZY	0	-	0	0	961	0.0000000
zheyou73v0_A05	40185926	40186644	BnaA05T0377300ZY	0	+	0	0	718	0.0000000
zheyou73v0_A05	40190139	40190954	BnaA05T0377400ZY	0	-	0	0	815	0.0000000
zheyou73v0_A05	40192397	40193824	BnaA05T0377500ZY	0	+	0	0	1427	0.0000000
zheyou73v0_A05	40192397	40193073	BnaA05T0377500ZY.1	0	+	0	0	676	0.0000000
zheyou73v0_A05	40196648	40204610	BnaA05T0377600ZY	0	+	0	0	7962	0.0000000
zheyou73v0_A05	40206480	40208436	BnaA05T0377700ZY	0	+	0	0	1956	0.0000000
zheyou73v0_A05	40209799	40214117	BnaA05T0377800ZY	0	+	0	0	4318	0.0000000
zheyou73v0_A05	40214405	40218096	BnaA05T0377900ZY	0	-	0	0	3691	0.0000000
zheyou73v0_A05	40219040	40222389	BnaA05T0378000ZY	0	-	0	0	3349	0.0000000
zheyou73v0_A05	40219040	40222236	BnaA05T0378000ZY.1	0	-	0	0	3196	0.0000000
zheyou73v0_A05	40233641	40236145	BnaA05T0378100ZY	0	+	0	0	2504	0.0000000
zheyou73v0_A05	40236493	40237264	BnaA05T0378200ZY	0	-	0	0	771	0.0000000
zheyou73v0_A05	40238796	40242139	BnaA05T0378300ZY	0	-	0	0	3343	0.0000000
zheyou73v0_A05	40243733	40245101	BnaA05T0378400ZY	0	+	0	0	1368	0.0000000
zheyou73v0_A05	40249951	40251858	BnaA05T0378500ZY	0	+	0	0	1907	0.0000000
zheyou73v0_A05	40252483	40253696	BnaA05T0378600ZY	0	-	0	0	1213	0.0000000
zheyou73v0_A05	40254802	40255901	BnaA05T0378700ZY	0	-	0	0	1099	0.0000000
zheyou73v0_A05	40268285	40269549	BnaA05T0378800ZY	0	+	0	0	1264	0.0000000
zheyou73v0_A05	40275975	40277508	BnaA05T0378900ZY	0	-	0	0	1533	0.0000000
zheyou73v0_A05	40292672	40294281	BnaA05T0379000ZY	0	-	0	0	1609	0.0000000
zheyou73v0_A05	40300401	40301634	BnaA05T0379100ZY	0	-	0	0	1233	0.0000000
zheyou73v0_A05	40308550	40309096	BnaA05T0379200ZY	0	-	0	0	546	0.0000000
zheyou73v0_A05	40309652	40310435	BnaA05T0379300ZY	0	+	0	0	783	0.0000000
zheyou73v0_A05	40311118	40313792	BnaA05T0379400ZY	0	-	0	0	2674	0.0000000
zheyou73v0_A05	40324441	40325309	BnaA05T0379500ZY	0	+	0	0	868	0.0000000
zheyou73v0_A05	40328142	40336528	BnaA05T0379600ZY	0	-	0	0	8386	0.0000000
zheyou73v0_A05	40338087	40342999	BnaA05T0379700ZY	0	+	0	0	4912	0.0000000
zheyou73v0_A05	40343388	40344540	BnaA05T0379800ZY	0	-	0	0	1152	0.0000000
zheyou73v0_A05	40345261	40347440	BnaA05T0379900ZY	0	+	0	0	2179	0.0000000
zheyou73v0_A05	40345830	40349435	BnaA05T0380000ZY	0	-	0	0	3605	0.0000000
zheyou73v0_A05	40352297	40353430	BnaA05T0380100ZY	0	+	0	0	1133	0.0000000
zheyou73v0_A05	40353780	40355576	BnaA05T0380200ZY	0	-	0	0	1796	0.0000000
zheyou73v0_A05	40356934	40358149	BnaA05T0380300ZY	0	+	0	0	1215	0.0000000
zheyou73v0_A05	40361119	40362176	BnaA05T0380400ZY	0	+	0	0	1057	0.0000000
zheyou73v0_A05	40363854	40365513	BnaA05T0380500ZY	0	+	0	0	1659	0.0000000
zheyou73v0_A05	40366253	40368611	BnaA05T0380600ZY	0	-	0	0	2358	0.0000000
zheyou73v0_A05	40370046	40372027	BnaA05T0380700ZY	0	-	0	0	1981	0.0000000
zheyou73v0_A05	40378679	40381040	BnaA05T0380800ZY	0	+	0	0	2361	0.0000000
zheyou73v0_A05	40381812	40385706	BnaA05T0380900ZY	0	+	0	0	3894	0.0000000
zheyou73v0_A05	40381812	40385706	BnaA05T0380900ZY.1	0	+	0	0	3894	0.0000000
zheyou73v0_A05	40386621	40390211	BnaA05T0381000ZY	0	+	0	0	3590	0.0000000
zheyou73v0_A05	40390831	40392009	BnaA05T0381100ZY	0	-	0	0	1178	0.0000000
zheyou73v0_A05	40393046	40393754	BnaA05T0381200ZY	0	+	0	0	708	0.0000000
zheyou73v0_A05	40397520	40398626	BnaA05T0381300ZY	0	-	0	0	1106	0.0000000
zheyou73v0_A05	40401834	40404097	BnaA05T0381400ZY	0	+	0	0	2263	0.0000000
zheyou73v0_A05	40401834	40404097	BnaA05T0381400ZY.1	0	+	0	0	2263	0.0000000
zheyou73v0_A05	40404913	40406275	BnaA05T0381500ZY	0	-	0	0	1362	0.0000000
zheyou73v0_A05	40410985	40414350	BnaA05T0381600ZY	0	+	0	0	3365	0.0000000
zheyou73v0_A05	40414271	40417775	BnaA05T0381700ZY	0	-	0	0	3504	0.0000000
zheyou73v0_A05	40419357	40420065	BnaA05T0381800ZY	0	+	0	0	708	0.0000000
zheyou73v0_A05	40420188	40422399	BnaA05T0381900ZY	0	-	0	0	2211	0.0000000
zheyou73v0_A05	40422461	40423299	BnaA05T0382000ZY	0	-	0	0	838	0.0000000
zheyou73v0_A05	40424874	40427309	BnaA05T0382100ZY	0	+	0	0	2435	0.0000000
zheyou73v0_A05	40436352	40437601	BnaA05T0382200ZY	0	-	0	0	1249	0.0000000
zheyou73v0_A05	40441419	40442738	BnaA05T0382300ZY	0	-	0	0	1319	0.0000000
zheyou73v0_A05	40442980	40446454	BnaA05T0382400ZY	0	+	0	0	3474	0.0000000
zheyou73v0_A05	40442980	40446454	BnaA05T0382400ZY.1	0	+	0	0	3474	0.0000000
zheyou73v0_A05	40446774	40447575	BnaA05T0382500ZY	0	+	0	0	801	0.0000000
zheyou73v0_A05	40448801	40452277	BnaA05T0382600ZY	0	-	0	0	3476	0.0000000
zheyou73v0_A05	40452825	40453656	BnaA05T0382700ZY	0	+	0	0	831	0.0000000
zheyou73v0_A05	40454556	40456069	BnaA05T0382800ZY	0	-	0	0	1513	0.0000000
zheyou73v0_A05	40457133	40459034	BnaA05T0382900ZY	0	-	0	0	1901	0.0000000
zheyou73v0_A05	40460329	40465196	BnaA05T0383000ZY	0	+	0	0	4867	0.0000000
zheyou73v0_A05	40460329	40465196	BnaA05T0383000ZY.1	0	+	0	0	4867	0.0000000
zheyou73v0_A05	40465321	40468604	BnaA05T0383100ZY	0	-	0	0	3283	0.0000000
zheyou73v0_A05	40468393	40469692	BnaA05T0383200ZY	0	+	0	0	1299	0.0000000
zheyou73v0_A05	40470192	40472086	BnaA05T0383300ZY	0	-	0	0	1894	0.0000000
zheyou73v0_A05	40473653	40475032	BnaA05T0383400ZY	0	-	0	0	1379	0.0000000
zheyou73v0_A05	40476480	40477597	BnaA05T0383500ZY	0	-	0	0	1117	0.0000000
zheyou73v0_A05	40477834	40479889	BnaA05T0383600ZY	0	-	0	0	2055	0.0000000
zheyou73v0_A05	40477834	40479889	BnaA05T0383600ZY.1	0	-	0	0	2055	0.0000000
zheyou73v0_A05	40483634	40485965	BnaA05T0383700ZY	0	+	0	0	2331	0.0000000
zheyou73v0_A05	40492074	40492778	BnaA05T0383800ZY	0	+	0	0	704	0.0000000
zheyou73v0_A05	40494544	40496790	BnaA05T0383900ZY	0	+	0	0	2246	0.0000000
zheyou73v0_A05	40497122	40499817	BnaA05T0384000ZY	0	+	0	0	2695	0.0000000
zheyou73v0_A05	40505659	40507504	BnaA05T0384100ZY	0	+	0	0	1845	0.0000000
zheyou73v0_A05	40508135	40509488	BnaA05T0384200ZY	0	+	0	0	1353	0.0000000
zheyou73v0_A05	40522758	40525069	BnaA05T0384300ZY	0	+	0	0	2311	0.0000000
zheyou73v0_A05	40525944	40528703	BnaA05T0384400ZY	0	+	0	0	2759	0.0000000
zheyou73v0_A05	40529157	40531053	BnaA05T0384500ZY	0	-	0	0	1896	0.0000000
zheyou73v0_A05	40539779	40542760	BnaA05T0384600ZY	0	+	0	0	2981	0.0000000
zheyou73v0_A05	40544401	40545689	BnaA05T0384700ZY	0	+	0	0	1288	0.0000000
zheyou73v0_A05	40545963	40549481	BnaA05T0384800ZY	0	-	0	0	3518	0.0000000
zheyou73v0_A05	40550553	40555517	BnaA05T0384900ZY	0	-	0	0	4964	0.0000000
zheyou73v0_A05	40557207	40559315	BnaA05T0385000ZY	0	-	0	0	2108	0.0000000
zheyou73v0_A05	40560263	40561010	BnaA05T0385100ZY	0	+	0	0	747	0.0000000
zheyou73v0_A05	40562201	40568744	BnaA05T0385200ZY	0	-	0	0	6543	0.0000000
zheyou73v0_A05	40585123	40587684	BnaA05T0385300ZY	0	-	0	0	2561	0.0000000
zheyou73v0_A05	40588480	40589896	BnaA05T0385400ZY	0	-	0	0	1416	0.0000000
zheyou73v0_A05	40590817	40603093	BnaA05T0385500ZY	0	+	0	0	12276	0.0000000
zheyou73v0_A05	40603120	40605319	BnaA05T0385600ZY	0	-	0	0	2199	0.0000000
zheyou73v0_A05	40607180	40608509	BnaA05T0385700ZY	0	-	0	0	1329	0.0000000
zheyou73v0_A05	40608666	40615716	BnaA05T0385800ZY	0	-	0	0	7050	0.0000000
zheyou73v0_A05	40616550	40621474	BnaA05T0385900ZY	0	+	0	0	4924	0.0000000
zheyou73v0_A05	40622120	40623940	BnaA05T0386000ZY	0	+	0	0	1820	0.0000000
zheyou73v0_A05	40623827	40628245	BnaA05T0386100ZY	0	-	0	0	4418	0.0000000
zheyou73v0_A05	40623827	40628245	BnaA05T0386100ZY.1	0	-	0	0	4418	0.0000000
zheyou73v0_A05	40633594	40642765	BnaA05T0386200ZY	0	+	0	0	9171	0.0000000
zheyou73v0_A05	40654224	40656546	BnaA05T0386300ZY	0	-	0	0	2322	0.0000000
zheyou73v0_A05	40657707	40658133	BnaA05T0386400ZY	0	-	0	0	426	0.0000000
zheyou73v0_A05	40661651	40664099	BnaA05T0386500ZY	0	+	0	0	2448	0.0000000
zheyou73v0_A05	40666357	40668195	BnaA05T0386600ZY	0	+	0	0	1838	0.0000000
zheyou73v0_A05	40667995	40671734	BnaA05T0386700ZY	0	-	0	0	3739	0.0000000
zheyou73v0_A05	40675303	40676985	BnaA05T0386800ZY	0	+	0	0	1682	0.0000000
zheyou73v0_A05	40679037	40680093	BnaA05T0386900ZY	0	+	0	0	1056	0.0000000
zheyou73v0_A05	40684430	40686014	BnaA05T0387000ZY	0	-	0	0	1584	0.0000000
zheyou73v0_A05	40686634	40687980	BnaA05T0387100ZY	0	+	0	0	1346	0.0000000
zheyou73v0_A05	40688839	40689659	BnaA05T0387200ZY	0	+	0	0	820	0.0000000
zheyou73v0_A05	40691826	40693092	BnaA05T0387300ZY	0	+	0	0	1266	0.0000000
zheyou73v0_A05	40696249	40697436	BnaA05T0387400ZY	0	+	0	0	1187	0.0000000
zheyou73v0_A05	40699468	40702257	BnaA05T0387500ZY	0	+	0	0	2789	0.0000000
zheyou73v0_A05	40702544	40703214	BnaA05T0387600ZY	0	+	0	0	670	0.0000000
zheyou73v0_A05	40702544	40703214	BnaA05T0387600ZY.1	0	+	0	0	670	0.0000000
zheyou73v0_A05	40703570	40703971	BnaA05T0387700ZY	0	+	0	0	401	0.0000000
zheyou73v0_A05	40705051	40707421	BnaA05T0387800ZY	0	-	0	0	2370	0.0000000
zheyou73v0_A05	40709840	40711329	BnaA05T0387900ZY	0	-	0	0	1489	0.0000000
zheyou73v0_A05	40723137	40723576	BnaA05T0388000ZY	0	+	0	0	439	0.0000000
zheyou73v0_A05	40727644	40729671	BnaA05T0388100ZY	0	+	0	0	2027	0.0000000
zheyou73v0_A05	40733190	40736893	BnaA05T0388200ZY	0	-	0	0	3703	0.0000000
zheyou73v0_A05	40747212	40748201	BnaA05T0388300ZY	0	+	0	0	989	0.0000000
zheyou73v0_A05	40752657	40753116	BnaA05T0388400ZY	0	+	0	0	459	0.0000000
zheyou73v0_A05	40756318	40757239	BnaA05T0388500ZY	0	+	0	0	921	0.0000000
zheyou73v0_A05	40757480	40758901	BnaA05T0388600ZY	0	-	0	0	1421	0.0000000
zheyou73v0_A05	40759199	40761745	BnaA05T0388700ZY	0	+	0	0	2546	0.0000000
zheyou73v0_A05	40763483	40764107	BnaA05T0388800ZY	0	-	0	0	624	0.0000000
zheyou73v0_A05	40767007	40770447	BnaA05T0388900ZY	0	-	0	0	3440	0.0000000
zheyou73v0_A05	40784465	40786836	BnaA05T0389000ZY	0	+	0	0	2371	0.0000000
zheyou73v0_A05	40789294	40790916	BnaA05T0389100ZY	0	+	0	0	1622	0.0000000
zheyou73v0_A05	40790937	40796918	BnaA05T0389200ZY	0	-	0	0	5981	0.0000000
zheyou73v0_A05	40797202	40798222	BnaA05T0389300ZY	0	-	0	0	1020	0.0000000
zheyou73v0_A05	40798476	40803150	BnaA05T0389400ZY	0	-	0	0	4674	0.0000000
zheyou73v0_A05	40805549	40807087	BnaA05T0389500ZY	0	+	0	0	1538	0.0000000
zheyou73v0_A05	40809464	40810595	BnaA05T0389600ZY	0	+	0	0	1131	0.0000000
zheyou73v0_A05	40811027	40812011	BnaA05T0389700ZY	0	+	0	0	984	0.0000000
zheyou73v0_A05	40813737	40815687	BnaA05T0389800ZY	0	+	0	0	1950	0.0000000
zheyou73v0_A05	40816679	40818957	BnaA05T0389900ZY	0	-	0	0	2278	0.0000000
zheyou73v0_A05	40825066	40826772	BnaA05T0390000ZY	0	+	0	0	1706	0.0000000
zheyou73v0_A05	40825066	40826772	BnaA05T0390000ZY.1	0	+	0	0	1706	0.0000000
zheyou73v0_A05	40826767	40828624	BnaA05T0390100ZY	0	-	0	0	1857	0.0000000
zheyou73v0_A05	40829654	40831753	BnaA05T0390200ZY	0	+	0	0	2099	0.0000000
zheyou73v0_A05	40831961	40834305	BnaA05T0390300ZY	0	-	0	0	2344	0.0000000
zheyou73v0_A05	40835254	40835696	BnaA05T0390400ZY	0	+	0	0	442	0.0000000
zheyou73v0_A05	40836924	40838081	BnaA05T0390500ZY	0	+	0	0	1157	0.0000000
zheyou73v0_A05	40839483	40839855	BnaA05T0390600ZY	0	+	0	0	372	0.0000000
zheyou73v0_A05	40840636	40842937	BnaA05T0390700ZY	0	-	0	0	2301	0.0000000
zheyou73v0_A05	40840636	40842937	BnaA05T0390700ZY.1	0	-	0	0	2301	0.0000000
zheyou73v0_A05	40844255	40847463	BnaA05T0390800ZY	0	-	0	0	3208	0.0000000
zheyou73v0_A05	40856181	40857474	BnaA05T0390900ZY	0	+	0	0	1293	0.0000000
zheyou73v0_A05	40861747	40863590	BnaA05T0391000ZY	0	-	0	0	1843	0.0000000
zheyou73v0_A05	40864214	40865613	BnaA05T0391100ZY	0	-	0	0	1399	0.0000000
zheyou73v0_A05	40866109	40869831	BnaA05T0391200ZY	0	-	0	0	3722	0.0000000
zheyou73v0_A05	40871152	40873058	BnaA05T0391300ZY	0	-	0	0	1906	0.0000000
zheyou73v0_A05	40875236	40878399	BnaA05T0391400ZY	0	+	0	0	3163	0.0000000
zheyou73v0_A05	40883000	40885864	BnaA05T0391500ZY	0	+	0	0	2864	0.0000000
zheyou73v0_A05	40886919	40888408	BnaA05T0391600ZY	0	+	0	0	1489	0.0000000
zheyou73v0_A05	40887203	40888408	BnaA05T0391600ZY.1	0	+	0	0	1205	0.0000000
zheyou73v0_A05	40900669	40901405	BnaA05T0391700ZY	0	-	0	0	736	0.0000000
zheyou73v0_A05	40905692	40908323	BnaA05T0391800ZY	0	+	0	0	2631	0.0000000
zheyou73v0_A05	40905692	40908323	BnaA05T0391800ZY.1	0	+	0	0	2631	0.0000000
zheyou73v0_A05	40908368	40909888	BnaA05T0391900ZY	0	-	0	0	1520	0.0000000
zheyou73v0_A05	40911468	40913635	BnaA05T0392000ZY	0	+	0	0	2167	0.0000000
zheyou73v0_A05	40914641	40916977	BnaA05T0392100ZY	0	+	0	0	2336	0.0000000
zheyou73v0_A05	40917816	40920217	BnaA05T0392200ZY	0	+	0	0	2401	0.0000000
zheyou73v0_A05	40923691	40926393	BnaA05T0392300ZY	0	-	0	0	2702	0.0000000
zheyou73v0_A05	40930240	40931778	BnaA05T0392400ZY	0	-	0	0	1538	0.0000000
zheyou73v0_A05	40936575	40939140	BnaA05T0392500ZY	0	-	0	0	2565	0.0000000
zheyou73v0_A05	40942032	40950660	BnaA05T0392600ZY	0	+	0	0	8628	0.0000000
zheyou73v0_A05	40950988	40951727	BnaA05T0392700ZY	0	-	0	0	739	0.0000000
zheyou73v0_A05	40954116	40955823	BnaA05T0392800ZY	0	+	0	0	1707	0.0000000
zheyou73v0_A05	40956259	40957041	BnaA05T0392900ZY	0	-	0	0	782	0.0000000
zheyou73v0_A05	40957887	40960158	BnaA05T0393000ZY	0	-	0	0	2271	0.0000000
zheyou73v0_A05	40965932	40967414	BnaA05T0393100ZY	0	-	0	0	1482	0.0000000
zheyou73v0_A05	40968557	40970404	BnaA05T0393200ZY	0	+	0	0	1847	0.0000000
zheyou73v0_A05	40970930	40972481	BnaA05T0393300ZY	0	-	0	0	1551	0.0000000
zheyou73v0_A05	40973899	40975598	BnaA05T0393400ZY	0	-	0	0	1699	0.0000000
zheyou73v0_A05	40978995	40980116	BnaA05T0393500ZY	0	-	0	0	1121	0.0000000
zheyou73v0_A05	40980915	40983145	BnaA05T0393600ZY	0	-	0	0	2230	0.0000000
zheyou73v0_A05	40987903	40991047	BnaA05T0393700ZY	0	+	0	0	3144	0.0000000
zheyou73v0_A05	41006453	41008558	BnaA05T0393800ZY	0	+	0	0	2105	0.0000000
zheyou73v0_A05	41009287	41010841	BnaA05T0393900ZY	0	+	0	0	1554	0.0000000
zheyou73v0_A05	41012045	41012636	BnaA05T0394000ZY	0	+	0	0	591	0.0000000
zheyou73v0_A05	41013180	41014721	BnaA05T0394100ZY	0	-	0	0	1541	0.0000000
zheyou73v0_A05	41015061	41016467	BnaA05T0394200ZY	0	+	0	0	1406	0.0000000
zheyou73v0_A05	41018536	41022500	BnaA05T0394300ZY	0	+	0	0	3964	0.0000000
zheyou73v0_A05	41025107	41026125	BnaA05T0394400ZY	0	-	0	0	1018	0.0000000
zheyou73v0_A05	41030422	41031708	BnaA05T0394500ZY	0	+	0	0	1286	0.0000000
zheyou73v0_A05	41032044	41036841	BnaA05T0394600ZY	0	+	0	0	4797	0.0000000
zheyou73v0_A05	41037135	41037606	BnaA05T0394700ZY	0	-	0	0	471	0.0000000
zheyou73v0_A05	41037809	41039227	BnaA05T0394800ZY	0	+	0	0	1418	0.0000000
zheyou73v0_A05	41039815	41041590	BnaA05T0394900ZY	0	+	0	0	1775	0.0000000
zheyou73v0_A05	41043000	41043985	BnaA05T0395000ZY	0	-	0	0	985	0.0000000
zheyou73v0_A05	41046810	41047409	BnaA05T0395100ZY	0	+	0	0	599	0.0000000
zheyou73v0_A05	41048179	41048943	BnaA05T0395200ZY	0	+	0	0	764	0.0000000
zheyou73v0_A05	41055514	41057179	BnaA05T0395300ZY	0	+	0	0	1665	0.0000000
zheyou73v0_A05	41058533	41059899	BnaA05T0395400ZY	0	-	0	0	1366	0.0000000
zheyou73v0_A05	41072792	41079186	BnaA05T0395500ZY	0	+	0	0	6394	0.0000000
zheyou73v0_A05	41081120	41082801	BnaA05T0395600ZY	0	-	0	0	1681	0.0000000
zheyou73v0_A05	41083284	41088961	BnaA05T0395700ZY	0	+	0	0	5677	0.0000000
zheyou73v0_A05	41089353	41090732	BnaA05T0395800ZY	0	-	0	0	1379	0.0000000
zheyou73v0_A05	41093503	41095404	BnaA05T0395900ZY	0	-	0	0	1901	0.0000000
zheyou73v0_A05	41096826	41097283	BnaA05T0396000ZY	0	+	0	0	457	0.0000000
zheyou73v0_A05	41098337	41099186	BnaA05T0396100ZY	0	-	0	0	849	0.0000000
zheyou73v0_A05	41101178	41101957	BnaA05T0396200ZY	0	+	0	0	779	0.0000000
zheyou73v0_A05	41101882	41104131	BnaA05T0396300ZY	0	-	0	0	2249	0.0000000
zheyou73v0_A05	41101882	41104131	BnaA05T0396300ZY.1	0	-	0	0	2249	0.0000000
zheyou73v0_A05	41106482	41108101	BnaA05T0396400ZY	0	-	0	0	1619	0.0000000
zheyou73v0_A05	41108644	41110545	BnaA05T0396500ZY	0	-	0	0	1901	0.0000000
zheyou73v0_A05	41111649	41112867	BnaA05T0396600ZY	0	-	0	0	1218	0.0000000
zheyou73v0_A05	41113729	41114857	BnaA05T0396700ZY	0	-	0	0	1128	0.0000000
zheyou73v0_A05	41119667	41122124	BnaA05T0396800ZY	0	-	0	0	2457	0.0000000
zheyou73v0_A05	41122353	41126087	BnaA05T0396900ZY	0	-	0	0	3734	0.0000000
zheyou73v0_A05	41129360	41129750	BnaA05T0397000ZY	0	+	0	0	390	0.0000000
zheyou73v0_A05	41131852	41135710	BnaA05T0397100ZY	0	+	0	0	3858	0.0000000
zheyou73v0_A05	41131852	41135710	BnaA05T0397100ZY.1	0	+	0	0	3858	0.0000000
zheyou73v0_A05	41136071	41139380	BnaA05T0397200ZY	0	-	0	0	3309	0.0000000
zheyou73v0_A05	41140743	41143702	BnaA05T0397300ZY	0	+	0	0	2959	0.0000000
zheyou73v0_A05	41140743	41143702	BnaA05T0397300ZY.1	0	+	0	0	2959	0.0000000
zheyou73v0_A05	41144037	41146617	BnaA05T0397400ZY	0	-	0	0	2580	0.0000000
zheyou73v0_A05	41148570	41149820	BnaA05T0397500ZY	0	-	0	0	1250	0.0000000
zheyou73v0_A05	41157693	41160402	BnaA05T0397600ZY	0	-	0	0	2709	0.0000000
zheyou73v0_A05	41157693	41160402	BnaA05T0397600ZY.1	0	-	0	0	2709	0.0000000
zheyou73v0_A05	41157693	41160402	BnaA05T0397600ZY.2	0	-	0	0	2709	0.0000000
zheyou73v0_A05	41158571	41160402	BnaA05T0397600ZY.3	0	-	0	0	1831	0.0000000
zheyou73v0_A05	41169254	41170084	BnaA05T0397700ZY	0	+	0	0	830	0.0000000
zheyou73v0_A05	41173238	41176451	BnaA05T0397800ZY	0	-	0	0	3213	0.0000000
zheyou73v0_A05	41173238	41176451	BnaA05T0397800ZY.1	0	-	0	0	3213	0.0000000
zheyou73v0_A05	41177348	41180195	BnaA05T0397900ZY	0	+	0	0	2847	0.0000000
zheyou73v0_A05	41180559	41181665	BnaA05T0398000ZY	0	-	0	0	1106	0.0000000
zheyou73v0_A05	41182232	41190934	BnaA05T0398100ZY	0	+	0	0	8702	0.0000000
zheyou73v0_A05	41191250	41194337	BnaA05T0398200ZY	0	-	0	0	3087	0.0000000
zheyou73v0_A05	41195431	41197689	BnaA05T0398300ZY	0	-	0	0	2258	0.0000000
zheyou73v0_A05	41198589	41202388	BnaA05T0398400ZY	0	-	0	0	3799	0.0000000
zheyou73v0_A05	41208337	41210174	BnaA05T0398500ZY	0	+	0	0	1837	0.0000000
zheyou73v0_A05	41210503	41211172	BnaA05T0398600ZY	0	-	0	0	669	0.0000000
zheyou73v0_A05	41211180	41215282	BnaA05T0398700ZY	0	-	0	0	4102	0.0000000
zheyou73v0_A05	41221990	41223468	BnaA05T0398800ZY	0	-	0	0	1478	0.0000000
zheyou73v0_A05	41224395	41235616	BnaA05T0398900ZY	0	-	0	0	11221	0.0000000
zheyou73v0_A05	41247704	41249151	BnaA05T0399000ZY	0	+	0	0	1447	0.0000000
zheyou73v0_A05	41249633	41255837	BnaA05T0399100ZY	0	+	0	0	6204	0.0000000
zheyou73v0_A05	41256673	41258334	BnaA05T0399200ZY	0	+	0	0	1661	0.0000000
zheyou73v0_A05	41256673	41258603	BnaA05T0399200ZY.1	0	+	0	0	1930	0.0000000
zheyou73v0_A05	41256673	41258603	BnaA05T0399200ZY.2	0	+	0	0	1930	0.0000000
zheyou73v0_A05	41258690	41261596	BnaA05T0399300ZY	0	+	0	0	2906	0.0000000
zheyou73v0_A05	41262229	41264073	BnaA05T0399400ZY	0	+	0	0	1844	0.0000000
zheyou73v0_A05	41264048	41265927	BnaA05T0399500ZY	0	-	0	0	1879	0.0000000
zheyou73v0_A05	41266292	41267325	BnaA05T0399600ZY	0	+	0	0	1033	0.0000000
zheyou73v0_A05	41267669	41270120	BnaA05T0399700ZY	0	-	0	0	2451	0.0000000
zheyou73v0_A05	41307499	41308004	BnaA05T0399800ZY	0	-	0	0	505	0.0000000
zheyou73v0_A05	41315438	41316275	BnaA05T0399900ZY	0	-	0	0	837	0.0000000
zheyou73v0_A05	41317277	41317958	BnaA05T0400000ZY	0	-	0	0	681	0.0000000
zheyou73v0_A05	41323072	41324719	BnaA05T0400100ZY	0	+	0	0	1647	0.0000000
zheyou73v0_A05	41325717	41328447	BnaA05T0400200ZY.1	0	+	0	0	2730	0.0000000
zheyou73v0_A05	41325767	41328447	BnaA05T0400200ZY	0	+	0	0	2680	0.0000000
zheyou73v0_A05	41327893	41328391	BnaA05T0400300ZY	0	-	0	0	498	0.0000000
zheyou73v0_A05	41331440	41334183	BnaA05T0400400ZY	0	+	0	0	2743	0.0000000
zheyou73v0_A05	41334598	41336083	BnaA05T0400500ZY	0	-	0	0	1485	0.0000000
zheyou73v0_A05	41336358	41339566	BnaA05T0400600ZY	0	+	0	0	3208	0.0000000
zheyou73v0_A05	41340180	41341452	BnaA05T0400700ZY	0	+	0	0	1272	0.0000000
zheyou73v0_A05	41348862	41351567	BnaA05T0400800ZY	0	+	0	0	2705	0.0000000
zheyou73v0_A05	41351860	41352754	BnaA05T0400900ZY	0	+	0	0	894	0.0000000
zheyou73v0_A05	41371193	41373551	BnaA05T0401000ZY	0	-	0	0	2358	0.0000000
zheyou73v0_A05	41374298	41375744	BnaA05T0401100ZY	0	-	0	0	1446	0.0000000
zheyou73v0_A05	41394184	41394895	BnaA05T0401200ZY	0	+	0	0	711	0.0000000
zheyou73v0_A05	41417176	41420796	BnaA05T0401300ZY	0	+	0	0	3620	0.0000000
zheyou73v0_A05	41421138	41422798	BnaA05T0401400ZY	0	+	0	0	1660	0.0000000
zheyou73v0_A05	41423221	41424379	BnaA05T0401500ZY	0	-	0	0	1158	0.0000000
zheyou73v0_A05	41425465	41426522	BnaA05T0401600ZY	0	-	0	0	1057	0.0000000
zheyou73v0_A05	41428092	41430239	BnaA05T0401700ZY	0	+	0	0	2147	0.0000000
zheyou73v0_A05	41437084	41437891	BnaA05T0401800ZY	0	-	0	0	807	0.0000000
zheyou73v0_A05	41438365	41440567	BnaA05T0401900ZY	0	+	0	0	2202	0.0000000
zheyou73v0_A05	41440863	41444144	BnaA05T0402000ZY	0	-	0	0	3281	0.0000000
zheyou73v0_A05	41445006	41447720	BnaA05T0402100ZY	0	-	0	0	2714	0.0000000
zheyou73v0_A05	41462173	41463665	BnaA05T0402200ZY	0	+	0	0	1492	0.0000000
zheyou73v0_A05	41477363	41479320	BnaA05T0402300ZY	0	+	0	0	1957	0.0000000
zheyou73v0_A05	41479505	41480793	BnaA05T0402400ZY	0	-	0	0	1288	0.0000000
zheyou73v0_A05	41481006	41482553	BnaA05T0402500ZY	0	+	0	0	1547	0.0000000
zheyou73v0_A05	41482625	41485577	BnaA05T0402600ZY	0	-	0	0	2952	0.0000000
zheyou73v0_A05	41505012	41507191	BnaA05T0402700ZY	0	+	0	0	2179	0.0000000
zheyou73v0_A05	41506616	41508465	BnaA05T0402800ZY	0	-	0	0	1849	0.0000000
zheyou73v0_A05	41508649	41510225	BnaA05T0402900ZY	0	+	0	0	1576	0.0000000
zheyou73v0_A05	41510297	41513255	BnaA05T0403000ZY	0	-	0	0	2958	0.0000000
zheyou73v0_A05	41523100	41525329	BnaA05T0403100ZY	0	-	0	0	2229	0.0000000
zheyou73v0_A05	41526331	41527821	BnaA05T0403200ZY	0	+	0	0	1490	0.0000000
zheyou73v0_A05	41528451	41530753	BnaA05T0403300ZY	0	+	0	0	2302	0.0000000
zheyou73v0_A05	41533341	41534913	BnaA05T0403400ZY	0	+	0	0	1572	0.0000000
zheyou73v0_A05	41537016	41539533	BnaA05T0403500ZY	0	+	0	0	2517	0.0000000
zheyou73v0_A05	41542717	41544912	BnaA05T0403600ZY	0	+	0	0	2195	0.0000000
zheyou73v0_A05	41546374	41548377	BnaA05T0403700ZY	0	-	0	0	2003	0.0000000
zheyou73v0_A05	41549371	41549810	BnaA05T0403800ZY	0	+	0	0	439	0.0000000
zheyou73v0_A05	41551016	41555867	BnaA05T0403900ZY	0	-	0	0	4851	0.0000000
zheyou73v0_A05	41556103	41563631	BnaA05T0404000ZY	0	+	0	0	7528	0.0000000
zheyou73v0_A05	41561244	41563584	BnaA05T0404100ZY	0	-	0	0	2340	0.0000000
zheyou73v0_A05	41563993	41565762	BnaA05T0404200ZY	0	-	0	0	1769	0.0000000
zheyou73v0_A05	41566095	41568758	BnaA05T0404300ZY	0	+	0	0	2663	0.0000000
zheyou73v0_A05	41568835	41571608	BnaA05T0404400ZY	0	-	0	0	2773	0.0000000
zheyou73v0_A05	41568835	41571608	BnaA05T0404400ZY.1	0	-	0	0	2773	0.0000000
zheyou73v0_A05	41568835	41571608	BnaA05T0404400ZY.2	0	-	0	0	2773	0.0000000
zheyou73v0_A05	41572554	41573222	BnaA05T0404500ZY	0	-	0	0	668	0.0000000
zheyou73v0_A05	41573986	41576315	BnaA05T0404600ZY	0	-	0	0	2329	0.0000000
zheyou73v0_A05	41573986	41576315	BnaA05T0404600ZY.1	0	-	0	0	2329	0.0000000
zheyou73v0_A05	41573986	41576315	BnaA05T0404600ZY.2	0	-	0	0	2329	0.0000000
zheyou73v0_A05	41576417	41578129	BnaA05T0404700ZY	0	+	0	0	1712	0.0000000
zheyou73v0_A05	41582090	41585707	BnaA05T0404800ZY	0	+	0	0	3617	0.0000000
zheyou73v0_A05	41582090	41585707	BnaA05T0404800ZY.1	0	+	0	0	3617	0.0000000
zheyou73v0_A05	41586017	41588423	BnaA05T0404900ZY	0	+	0	0	2406	0.0000000
zheyou73v0_A05	41586017	41588423	BnaA05T0404900ZY.1	0	+	0	0	2406	0.0000000
zheyou73v0_A05	41586017	41588423	BnaA05T0404900ZY.2	0	+	0	0	2406	0.0000000
zheyou73v0_A05	41589187	41591184	BnaA05T0405000ZY	0	-	0	0	1997	0.0000000
zheyou73v0_A05	41593624	41594628	BnaA05T0405100ZY	0	-	0	0	1004	0.0000000
zheyou73v0_A05	41595064	41597755	BnaA05T0405200ZY	0	+	0	0	2691	0.0000000
zheyou73v0_A05	41597917	41600821	BnaA05T0405300ZY	0	-	0	0	2904	0.0000000
zheyou73v0_A05	41601922	41604018	BnaA05T0405400ZY	0	-	0	0	2096	0.0000000
zheyou73v0_A05	41604236	41607321	BnaA05T0405500ZY	0	+	0	0	3085	0.0000000
zheyou73v0_A05	41614192	41616549	BnaA05T0405600ZY	0	+	0	0	2357	0.0000000
zheyou73v0_A05	41618121	41618768	BnaA05T0405700ZY	0	+	0	0	647	0.0000000
zheyou73v0_A05	41619021	41619869	BnaA05T0405800ZY	0	+	0	0	848	0.0000000
zheyou73v0_A05	41619950	41620724	BnaA05T0405900ZY	0	+	0	0	774	0.0000000
zheyou73v0_A05	41621059	41622815	BnaA05T0406000ZY	0	-	0	0	1756	0.0000000
zheyou73v0_A05	41623503	41626038	BnaA05T0406100ZY	0	-	0	0	2535	0.0000000
zheyou73v0_A05	41628278	41630487	BnaA05T0406200ZY	0	-	0	0	2209	0.0000000
zheyou73v0_A05	41637913	41639892	BnaA05T0406300ZY	0	+	0	0	1979	0.0000000
zheyou73v0_A05	41641583	41643585	BnaA05T0406400ZY	0	+	0	0	2002	0.0000000
zheyou73v0_A05	41643698	41644237	BnaA05T0406500ZY	0	-	0	0	539	0.0000000
zheyou73v0_A05	41644610	41645280	BnaA05T0406600ZY	0	+	0	0	670	0.0000000
zheyou73v0_A05	41645903	41646231	BnaA05T0406700ZY	0	-	0	0	328	0.0000000
zheyou73v0_A05	41646870	41647677	BnaA05T0406800ZY	0	-	0	0	807	0.0000000
zheyou73v0_A05	41655534	41660731	BnaA05T0406900ZY	0	-	0	0	5197	0.0000000
zheyou73v0_A05	41671927	41674897	BnaA05T0407000ZY	0	+	0	0	2970	0.0000000
zheyou73v0_A05	41677040	41680215	BnaA05T0407100ZY	0	+	0	0	3175	0.0000000
zheyou73v0_A05	41681682	41684660	BnaA05T0407200ZY	0	+	0	0	2978	0.0000000
zheyou73v0_A05	41685276	41686211	BnaA05T0407300ZY	0	-	0	0	935	0.0000000
zheyou73v0_A05	41689869	41696840	BnaA05T0407400ZY	0	+	0	0	6971	0.0000000
zheyou73v0_A05	41697544	41699230	BnaA05T0407500ZY	0	+	0	0	1686	0.0000000
zheyou73v0_A05	41699614	41700715	BnaA05T0407600ZY	0	+	0	0	1101	0.0000000
zheyou73v0_A05	41701145	41703013	BnaA05T0407700ZY	0	-	0	0	1868	0.0000000
zheyou73v0_A05	41703185	41705292	BnaA05T0407800ZY	0	+	0	0	2107	0.0000000
zheyou73v0_A05	41707735	41710901	BnaA05T0407900ZY	0	+	0	0	3166	0.0000000
zheyou73v0_A05	41712496	41714000	BnaA05T0408000ZY	0	+	0	0	1504	0.0000000
zheyou73v0_A05	41714737	41720439	BnaA05T0408100ZY	0	+	0	0	5702	0.0000000
zheyou73v0_A05	41720627	41725951	BnaA05T0408200ZY	0	+	0	0	5324	0.0000000
zheyou73v0_A05	41720946	41725951	BnaA05T0408200ZY.1	0	+	0	0	5005	0.0000000
zheyou73v0_A05	41725221	41726146	BnaA05T0408300ZY	0	-	0	0	925	0.0000000
zheyou73v0_A05	41730000	41734318	BnaA05T0408400ZY	0	+	0	0	4318	0.0000000
zheyou73v0_A05	41733102	41734152	BnaA05T0408500ZY	0	-	0	0	1050	0.0000000
zheyou73v0_A05	41734707	41735112	BnaA05T0408600ZY	0	+	0	0	405	0.0000000
zheyou73v0_A05	41736522	41738686	BnaA05T0408700ZY	0	-	0	0	2164	0.0000000
zheyou73v0_A05	41739330	41740673	BnaA05T0408800ZY	0	-	0	0	1343	0.0000000
zheyou73v0_A05	41743912	41746425	BnaA05T0408900ZY	0	-	0	0	2513	0.0000000
zheyou73v0_A05	41747202	41750439	BnaA05T0409000ZY	0	-	0	0	3237	0.0000000
zheyou73v0_A05	41751379	41753725	BnaA05T0409100ZY	0	-	0	0	2346	0.0000000
zheyou73v0_A05	41754397	41760782	BnaA05T0409200ZY	0	+	0	0	6385	0.0000000
zheyou73v0_A05	41761494	41763660	BnaA05T0409300ZY	0	-	0	0	2166	0.0000000
zheyou73v0_A05	41764240	41768177	BnaA05T0409400ZY	0	+	0	0	3937	0.0000000
zheyou73v0_A05	41767456	41768947	BnaA05T0409500ZY	0	-	0	0	1491	0.0000000
zheyou73v0_A05	41773655	41777329	BnaA05T0409600ZY	0	-	0	0	3674	0.0000000
zheyou73v0_A05	41777342	41778304	BnaA05T0409700ZY	0	-	0	0	962	0.0000000
zheyou73v0_A05	41778693	41780554	BnaA05T0409800ZY	0	+	0	0	1861	0.0000000
zheyou73v0_A05	41781567	41782916	BnaA05T0409900ZY	0	+	0	0	1349	0.0000000
zheyou73v0_A05	41782931	41784203	BnaA05T0410000ZY	0	-	0	0	1272	0.0000000
zheyou73v0_A05	41785228	41798791	BnaA05T0410100ZY	0	+	0	0	13563	0.0000000
zheyou73v0_A05	41801962	41803800	BnaA05T0410200ZY	0	+	0	0	1838	0.0000000
zheyou73v0_A05	41804129	41808869	BnaA05T0410300ZY	0	-	0	0	4740	0.0000000
zheyou73v0_A05	41814102	41815986	BnaA05T0410400ZY	0	+	0	0	1884	0.0000000
zheyou73v0_A05	41817407	41823860	BnaA05T0410500ZY	0	+	0	0	6453	0.0000000
zheyou73v0_A05	41824585	41826247	BnaA05T0410600ZY	0	+	0	0	1662	0.0000000
zheyou73v0_A05	41824585	41826499	BnaA05T0410600ZY.1	0	+	0	0	1914	0.0000000
zheyou73v0_A05	41824585	41826499	BnaA05T0410600ZY.2	0	+	0	0	1914	0.0000000
zheyou73v0_A05	41826537	41829501	BnaA05T0410700ZY.1	0	+	0	0	2964	0.0000000
zheyou73v0_A05	41826585	41829501	BnaA05T0410700ZY	0	+	0	0	2916	0.0000000
zheyou73v0_A05	41830137	41831513	BnaA05T0410800ZY	0	+	0	0	1376	0.0000000
zheyou73v0_A05	41832046	41833887	BnaA05T0410900ZY	0	+	0	0	1841	0.0000000
zheyou73v0_A05	41833806	41835601	BnaA05T0411000ZY	0	-	0	0	1795	0.0000000
zheyou73v0_A05	41835928	41837189	BnaA05T0411100ZY	0	+	0	0	1261	0.0000000
zheyou73v0_A05	41837338	41839810	BnaA05T0411200ZY	0	-	0	0	2472	0.0000000
zheyou73v0_A05	41864708	41869190	BnaA05T0411300ZY	0	-	0	0	4482	0.0000000
zheyou73v0_A05	41870448	41872173	BnaA05T0411400ZY	0	+	0	0	1725	0.0000000
zheyou73v0_A05	41872880	41873501	BnaA05T0411500ZY	0	+	0	0	621	0.0000000
zheyou73v0_A05	41874147	41875659	BnaA05T0411600ZY	0	-	0	0	1512	0.0000000
zheyou73v0_A05	41881889	41885137	BnaA05T0411700ZY	0	+	0	0	3248	0.0000000
zheyou73v0_A05	41882468	41885137	BnaA05T0411700ZY.1	0	+	0	0	2669	0.0000000
zheyou73v0_A05	41886087	41887624	BnaA05T0411800ZY	0	+	0	0	1537	0.0000000
zheyou73v0_A05	41888509	41891566	BnaA05T0411900ZY	0	+	0	0	3057	0.0000000
zheyou73v0_A05	41891611	41893444	BnaA05T0412000ZY	0	+	0	0	1833	0.0000000
zheyou73v0_A05	41894227	41894998	BnaA05T0412100ZY	0	-	0	0	771	0.0000000
zheyou73v0_A05	41895135	41896313	BnaA05T0412200ZY	0	-	0	0	1178	0.0000000
zheyou73v0_A05	41896382	41897742	BnaA05T0412300ZY	0	-	0	0	1360	0.0000000
zheyou73v0_A05	41898111	41901351	BnaA05T0412400ZY	0	-	0	0	3240	0.0000000
zheyou73v0_A05	41903388	41906819	BnaA05T0412500ZY	0	-	0	0	3431	0.0000000
zheyou73v0_A05	41909554	41912820	BnaA05T0412600ZY	0	+	0	0	3266	0.0000000
zheyou73v0_A05	41913231	41913793	BnaA05T0412700ZY	0	-	0	0	562	0.0000000
zheyou73v0_A05	41926455	41927256	BnaA05T0412800ZY	0	+	0	0	801	0.0000000
zheyou73v0_A05	41927762	41928978	BnaA05T0412900ZY	0	-	0	0	1216	0.0000000
zheyou73v0_A05	41929380	41931848	BnaA05T0413000ZY.1	0	-	0	0	2468	0.0000000
zheyou73v0_A05	41929485	41931848	BnaA05T0413000ZY	0	-	0	0	2363	0.0000000
zheyou73v0_A05	41932274	41932593	BnaA05T0413100ZY	0	+	0	0	319	0.0000000
zheyou73v0_A05	41934798	41936422	BnaA05T0413200ZY	0	-	0	0	1624	0.0000000
zheyou73v0_A05	41938317	41941631	BnaA05T0413300ZY	0	+	0	0	3314	0.0000000
zheyou73v0_A05	41941704	41944631	BnaA05T0413400ZY	0	-	0	0	2927	0.0000000
zheyou73v0_A05	41946028	41954030	BnaA05T0413500ZY	0	+	0	0	8002	0.0000000
zheyou73v0_A05	41954888	41958441	BnaA05T0413600ZY	0	+	0	0	3553	0.0000000
zheyou73v0_A05	41954888	41958441	BnaA05T0413600ZY.1	0	+	0	0	3553	0.0000000
zheyou73v0_A05	41960682	41961920	BnaA05T0413700ZY	0	+	0	0	1238	0.0000000
zheyou73v0_A05	41963652	41965041	BnaA05T0413800ZY	0	+	0	0	1389	0.0000000
zheyou73v0_A05	41968016	41971530	BnaA05T0413900ZY	0	+	0	0	3514	0.0000000
zheyou73v0_A05	41972222	41974002	BnaA05T0414000ZY	0	-	0	0	1780	0.0000000
zheyou73v0_A05	41975671	41976425	BnaA05T0414100ZY	0	+	0	0	754	0.0000000
zheyou73v0_A05	41976729	41978763	BnaA05T0414200ZY	0	-	0	0	2034	0.0000000
zheyou73v0_A05	41979043	41981981	BnaA05T0414300ZY	0	-	0	0	2938	0.0000000
zheyou73v0_A05	41984154	41986457	BnaA05T0414400ZY	0	-	0	0	2303	0.0000000
zheyou73v0_A05	41984154	41986457	BnaA05T0414400ZY.1	0	-	0	0	2303	0.0000000
zheyou73v0_A05	41987433	41989894	BnaA05T0414500ZY	0	-	0	0	2461	0.0000000
zheyou73v0_A05	41990974	41992179	BnaA05T0414600ZY	0	+	0	0	1205	0.0000000
zheyou73v0_A05	41992257	41994522	BnaA05T0414700ZY	0	-	0	0	2265	0.0000000
zheyou73v0_A05	41997404	42000181	BnaA05T0414800ZY	0	+	0	0	2777	0.0000000
zheyou73v0_A05	42000788	42002347	BnaA05T0414900ZY	0	-	0	0	1559	0.0000000
zheyou73v0_A05	42059602	42061808	BnaA05T0415000ZY	0	+	0	0	2206	0.0000000
zheyou73v0_A05	42063806	42067052	BnaA05T0415100ZY	0	+	0	0	3246	0.0000000
zheyou73v0_A05	42067412	42067661	BnaA05T0415200ZY	0	+	0	0	249	0.0000000
zheyou73v0_A05	42067954	42069033	BnaA05T0415300ZY	0	+	0	0	1079	0.0000000
zheyou73v0_A05	42070921	42072603	BnaA05T0415400ZY	0	-	0	0	1682	0.0000000
zheyou73v0_A05	42075164	42075491	BnaA05T0415500ZY	0	+	0	0	327	0.0000000
zheyou73v0_A05	42076572	42078185	BnaA05T0415600ZY	0	-	0	0	1613	0.0000000
zheyou73v0_A05	42079056	42080636	BnaA05T0415700ZY	0	-	0	0	1580	0.0000000
zheyou73v0_A05	42081609	42086031	BnaA05T0415800ZY	0	-	0	0	4422	0.0000000
zheyou73v0_A05	42086981	42088095	BnaA05T0415900ZY	0	-	0	0	1114	0.0000000
zheyou73v0_A05	42089217	42090932	BnaA05T0416000ZY	0	-	0	0	1715	0.0000000
zheyou73v0_A05	42091122	42094166	BnaA05T0416100ZY	0	+	0	0	3044	0.0000000
zheyou73v0_A05	42094293	42095670	BnaA05T0416200ZY	0	-	0	0	1377	0.0000000
zheyou73v0_A05	42097053	42098942	BnaA05T0416300ZY	0	-	0	0	1889	0.0000000
zheyou73v0_A05	42100503	42103768	BnaA05T0416400ZY	0	+	0	0	3265	0.0000000
zheyou73v0_A05	42104023	42106313	BnaA05T0416500ZY	0	-	0	0	2290	0.0000000
zheyou73v0_A05	42108975	42109395	BnaA05T0416600ZY	0	+	0	0	420	0.0000000
zheyou73v0_A05	42112760	42114266	BnaA05T0416700ZY	0	-	0	0	1506	0.0000000
zheyou73v0_A05	42117642	42122591	BnaA05T0416800ZY	0	+	0	0	4949	0.0000000
zheyou73v0_A05	42122726	42124776	BnaA05T0416900ZY.1	0	-	0	0	2050	0.0000000
zheyou73v0_A05	42122953	42125474	BnaA05T0416900ZY	0	-	0	0	2521	0.0000000
zheyou73v0_A05	42142801	42145372	BnaA05T0417000ZY	0	-	0	0	2571	0.0000000
zheyou73v0_A05	42145539	42152767	BnaA05T0417100ZY	0	-	0	0	7228	0.0000000
zheyou73v0_A05	42149134	42152767	BnaA05T0417100ZY.1	0	-	0	0	3633	0.0000000
zheyou73v0_A05	42158502	42160722	BnaA05T0417200ZY	0	+	0	0	2220	0.0000000
zheyou73v0_A05	42161008	42161705	BnaA05T0417300ZY	0	-	0	0	697	0.0000000
zheyou73v0_A05	42162057	42163842	BnaA05T0417400ZY	0	+	0	0	1785	0.0000000
zheyou73v0_A05	42164754	42167291	BnaA05T0417500ZY	0	+	0	0	2537	0.0000000
zheyou73v0_A05	42164754	42167291	BnaA05T0417500ZY.1	0	+	0	0	2537	0.0000000
zheyou73v0_A05	42167602	42167932	BnaA05T0417600ZY	0	+	0	0	330	0.0000000
zheyou73v0_A05	42169217	42170692	BnaA05T0417700ZY	0	-	0	0	1475	0.0000000
zheyou73v0_A05	42171230	42172369	BnaA05T0417800ZY	0	+	0	0	1139	0.0000000
zheyou73v0_A05	42172710	42173898	BnaA05T0417900ZY	0	-	0	0	1188	0.0000000
zheyou73v0_A05	42176027	42178448	BnaA05T0418000ZY	0	+	0	0	2421	0.0000000
zheyou73v0_A05	42178641	42181967	BnaA05T0418100ZY	0	-	0	0	3326	0.0000000
zheyou73v0_A05	42182373	42183940	BnaA05T0418200ZY	0	+	0	0	1567	0.0000000
zheyou73v0_A05	42184513	42185319	BnaA05T0418300ZY	0	+	0	0	806	0.0000000
zheyou73v0_A05	42185448	42186445	BnaA05T0418400ZY	0	-	0	0	997	0.0000000
zheyou73v0_A05	42187528	42187990	BnaA05T0418500ZY	0	-	0	0	462	0.0000000
zheyou73v0_A05	42190159	42190894	BnaA05T0418600ZY	0	-	0	0	735	0.0000000
zheyou73v0_A05	42191990	42192741	BnaA05T0418700ZY	0	+	0	0	751	0.0000000
zheyou73v0_A05	42194411	42194726	BnaA05T0418800ZY	0	+	0	0	315	0.0000000
zheyou73v0_A05	42195140	42195437	BnaA05T0418900ZY	0	-	0	0	297	0.0000000
zheyou73v0_A05	42196838	42199301	BnaA05T0419000ZY	0	+	0	0	2463	0.0000000
zheyou73v0_A05	42199470	42204084	BnaA05T0419100ZY	0	-	0	0	4614	0.0000000
zheyou73v0_A05	42206711	42208831	BnaA05T0419200ZY	0	-	0	0	2120	0.0000000
zheyou73v0_A05	42211009	42211949	BnaA05T0419300ZY	0	-	0	0	940	0.0000000
zheyou73v0_A05	42214371	42215090	BnaA05T0419400ZY	0	+	0	0	719	0.0000000
zheyou73v0_A05	42215844	42217583	BnaA05T0419500ZY	0	+	0	0	1739	0.0000000
zheyou73v0_A05	42218862	42221034	BnaA05T0419600ZY	0	-	0	0	2172	0.0000000
zheyou73v0_A05	42218862	42221034	BnaA05T0419600ZY.1	0	-	0	0	2172	0.0000000
zheyou73v0_A05	42230803	42231706	BnaA05T0419700ZY	0	-	0	0	903	0.0000000
zheyou73v0_A05	42237896	42240422	BnaA05T0419800ZY	0	+	0	0	2526	0.0000000
zheyou73v0_A05	42237896	42240422	BnaA05T0419800ZY.1	0	+	0	0	2526	0.0000000
zheyou73v0_A05	42243352	42245332	BnaA05T0419900ZY	0	+	0	0	1980	0.0000000
zheyou73v0_A05	42247804	42249676	BnaA05T0420000ZY	0	+	0	0	1872	0.0000000
zheyou73v0_A05	42250216	42253038	BnaA05T0420100ZY	0	+	0	0	2822	0.0000000
zheyou73v0_A05	42253294	42253522	BnaA05T0420200ZY	0	+	0	0	228	0.0000000
zheyou73v0_A05	42254865	42257136	BnaA05T0420300ZY	0	+	0	0	2271	0.0000000
zheyou73v0_A05	42254865	42257086	BnaA05T0420300ZY.1	0	+	0	0	2221	0.0000000
zheyou73v0_A05	42254865	42257086	BnaA05T0420300ZY.2	0	+	0	0	2221	0.0000000
zheyou73v0_A05	42272312	42274344	BnaA05T0420400ZY	0	+	0	0	2032	0.0000000
zheyou73v0_A05	42302017	42302883	BnaA05T0420500ZY	0	+	0	0	866	0.0000000
zheyou73v0_A05	42303258	42304486	BnaA05T0420600ZY	0	-	0	0	1228	0.0000000
zheyou73v0_A05	42306038	42306861	BnaA05T0420700ZY	0	+	0	0	823	0.0000000
zheyou73v0_A05	42307010	42308652	BnaA05T0420800ZY	0	-	0	0	1642	0.0000000
zheyou73v0_A05	42312458	42315147	BnaA05T0420900ZY	0	-	0	0	2689	0.0000000
zheyou73v0_A05	42313166	42315220	BnaA05T0420900ZY.1	0	-	0	0	2054	0.0000000
zheyou73v0_A05	42316392	42318544	BnaA05T0421000ZY	0	+	0	0	2152	0.0000000
zheyou73v0_A05	42318915	42320932	BnaA05T0421100ZY	0	-	0	0	2017	0.0000000
zheyou73v0_A05	42318915	42320932	BnaA05T0421100ZY.1	0	-	0	0	2017	0.0000000
zheyou73v0_A05	42318915	42320932	BnaA05T0421100ZY.2	0	-	0	0	2017	0.0000000
zheyou73v0_A05	42318915	42320193	BnaA05T0421100ZY.3	0	-	0	0	1278	0.0000000
zheyou73v0_A05	42318915	42320193	BnaA05T0421100ZY.4	0	-	0	0	1278	0.0000000
zheyou73v0_A05	42321627	42322675	BnaA05T0421200ZY	0	-	0	0	1048	0.0000000
zheyou73v0_A05	42327141	42330101	BnaA05T0421300ZY	0	+	0	0	2960	0.0000000
zheyou73v0_A05	42330526	42331725	BnaA05T0421400ZY	0	-	0	0	1199	0.0000000
zheyou73v0_A05	42332562	42346142	BnaA05T0421500ZY	0	+	0	0	13580	0.0000000
zheyou73v0_A05	42346937	42348841	BnaA05T0421600ZY	0	+	0	0	1904	0.0000000
zheyou73v0_A05	42349228	42350086	BnaA05T0421700ZY	0	+	0	0	858	0.0000000
zheyou73v0_A05	42350249	42353105	BnaA05T0421800ZY	0	-	0	0	2856	0.0000000
zheyou73v0_A05	42354184	42357699	BnaA05T0421900ZY	0	+	0	0	3515	0.0000000
zheyou73v0_A05	42356679	42357321	BnaA05T0422000ZY	0	-	0	0	642	0.0000000
zheyou73v0_A05	42358369	42364060	BnaA05T0422100ZY	0	+	0	0	5691	0.0000000
zheyou73v0_A05	42364390	42366177	BnaA05T0422200ZY	0	+	0	0	1787	0.0000000
zheyou73v0_A05	42364390	42366177	BnaA05T0422200ZY.1	0	+	0	0	1787	0.0000000
zheyou73v0_A05	42366221	42367845	BnaA05T0422300ZY	0	-	0	0	1624	0.0000000
zheyou73v0_A05	42372094	42378443	BnaA05T0422400ZY	0	-	0	0	6349	0.0000000
zheyou73v0_A05	42379252	42382153	BnaA05T0422500ZY	0	+	0	0	2901	0.0000000
zheyou73v0_A05	42382826	42382979	BnaA05T0422600ZY	0	-	0	0	153	0.0000000
zheyou73v0_A05	42384369	42387923	BnaA05T0422700ZY	0	+	0	0	3554	0.0000000
zheyou73v0_A05	42389003	42393201	BnaA05T0422800ZY	0	+	0	0	4198	0.0000000
zheyou73v0_A05	42394772	42395156	BnaA05T0422900ZY	0	-	0	0	384	0.0000000
zheyou73v0_A05	42441601	42444827	BnaA05T0423000ZY	0	-	0	0	3226	0.0000000
zheyou73v0_A05	42445102	42447186	BnaA05T0423100ZY	0	+	0	0	2084	0.0000000
zheyou73v0_A05	42452792	42453292	BnaA05T0423200ZY	0	-	0	0	500	0.0000000
zheyou73v0_A05	42455389	42458312	BnaA05T0423300ZY	0	+	0	0	2923	0.0000000
zheyou73v0_A05	42459024	42459461	BnaA05T0423400ZY	0	-	0	0	437	0.0000000
zheyou73v0_A05	42461162	42462626	BnaA05T0423500ZY	0	-	0	0	1464	0.0000000
zheyou73v0_A05	42467396	42471493	BnaA05T0423600ZY	0	-	0	0	4097	0.0000000
zheyou73v0_A05	42472598	42474725	BnaA05T0423700ZY	0	-	0	0	2127	0.0000000
zheyou73v0_A05	42475327	42479689	BnaA05T0423800ZY	0	-	0	0	4362	0.0000000
zheyou73v0_A05	42480680	42481268	BnaA05T0423900ZY	0	-	0	0	588	0.0000000
zheyou73v0_A05	42482545	42487061	BnaA05T0424000ZY	0	-	0	0	4516	0.0000000
zheyou73v0_A05	42494217	42495065	BnaA05T0424100ZY	0	+	0	0	848	0.0000000
zheyou73v0_A05	42496243	42497863	BnaA05T0424200ZY	0	-	0	0	1620	0.0000000
zheyou73v0_A05	42498213	42498484	BnaA05T0424300ZY	0	+	0	0	271	0.0000000
zheyou73v0_A05	42499814	42505932	BnaA05T0424400ZY	0	+	0	0	6118	0.0000000
zheyou73v0_A05	42501509	42505932	BnaA05T0424400ZY.1	0	+	0	0	4423	0.0000000
zheyou73v0_A05	42507655	42508143	BnaA05T0424500ZY	0	+	0	0	488	0.0000000
zheyou73v0_A05	42512777	42516383	BnaA05T0424600ZY	0	+	0	0	3606	0.0000000
zheyou73v0_A05	42512777	42516383	BnaA05T0424600ZY.1	0	+	0	0	3606	0.0000000
zheyou73v0_A05	42516834	42520507	BnaA05T0424700ZY	0	+	0	0	3673	0.0000000
zheyou73v0_A05	42520518	42522775	BnaA05T0424800ZY	0	-	0	0	2257	0.0000000
zheyou73v0_A05	42525660	42535243	BnaA05T0424900ZY	0	+	0	0	9583	0.0000000
zheyou73v0_A05	42535457	42540408	BnaA05T0425000ZY	0	+	0	0	4951	0.0000000
zheyou73v0_A05	42541081	42542301	BnaA05T0425100ZY	0	-	0	0	1220	0.0000000
zheyou73v0_A05	42542513	42543213	BnaA05T0425200ZY	0	+	0	0	700	0.0000000
zheyou73v0_A05	42576755	42578995	BnaA05T0425300ZY	0	+	0	0	2240	0.0000000
zheyou73v0_A05	42580544	42583189	BnaA05T0425400ZY	0	+	0	0	2645	0.0000000
zheyou73v0_A05	42583547	42585871	BnaA05T0425500ZY	0	-	0	0	2324	0.0000000
zheyou73v0_A05	42597390	42606445	BnaA05T0425600ZY	0	+	0	0	9055	0.0000000
zheyou73v0_A05	42606629	42617942	BnaA05T0425700ZY	0	-	0	0	11313	0.0000000
zheyou73v0_A05	42619399	42622331	BnaA05T0425800ZY	0	-	0	0	2932	0.0000000
zheyou73v0_A05	42623441	42626945	BnaA05T0425900ZY	0	-	0	0	3504	0.0000000
zheyou73v0_A05	42637257	42639472	BnaA05T0426000ZY	0	-	0	0	2215	0.0000000
zheyou73v0_A05	42668397	42670277	BnaA05T0426100ZY	0	+	0	0	1880	0.0000000
zheyou73v0_A05	42670334	42671775	BnaA05T0426200ZY	0	+	0	0	1441	0.0000000
zheyou73v0_A05	42670334	42671775	BnaA05T0426200ZY.1	0	+	0	0	1441	0.0000000
zheyou73v0_A05	42676356	42678581	BnaA05T0426300ZY	0	+	0	0	2225	0.0000000
zheyou73v0_A05	42678766	42684329	BnaA05T0426400ZY	0	-	0	0	5563	0.0000000
zheyou73v0_A05	42687597	42688593	BnaA05T0426500ZY	0	+	0	0	996	0.0000000
zheyou73v0_A05	42691100	42695048	BnaA05T0426600ZY	0	+	0	0	3948	0.0000000
zheyou73v0_A05	42695094	42697440	BnaA05T0426700ZY	0	-	0	0	2346	0.0000000
zheyou73v0_A05	42700491	42704350	BnaA05T0426800ZY	0	+	0	0	3859	0.0000000
zheyou73v0_A05	42706335	42706685	BnaA05T0426900ZY	0	+	0	0	350	0.0000000
zheyou73v0_A05	42710032	42714272	BnaA05T0427000ZY	0	+	0	0	4240	0.0000000
zheyou73v0_A05	42714776	42717906	BnaA05T0427100ZY	0	+	0	0	3130	0.0000000
zheyou73v0_A05	42723682	42725373	BnaA05T0427200ZY	0	-	0	0	1691	0.0000000
zheyou73v0_A05	42735183	42737302	BnaA05T0427300ZY	0	-	0	0	2119	0.0000000
zheyou73v0_A05	42737581	42745380	BnaA05T0427400ZY	0	+	0	0	7799	0.0000000
zheyou73v0_A05	42747243	42748583	BnaA05T0427500ZY	0	+	0	0	1340	0.0000000
zheyou73v0_A05	42751735	42752230	BnaA05T0427600ZY	0	-	0	0	495	0.0000000
zheyou73v0_A05	42754119	42756157	BnaA05T0427700ZY	0	+	0	0	2038	0.0000000
zheyou73v0_A05	42756457	42758206	BnaA05T0427800ZY	0	-	0	0	1749	0.0000000
zheyou73v0_A05	42758943	42760263	BnaA05T0427900ZY	0	+	0	0	1320	0.0000000
zheyou73v0_A05	42765325	42769740	BnaA05T0428000ZY	0	+	0	0	4415	0.0000000
zheyou73v0_A05	42770462	42771416	BnaA05T0428100ZY	0	+	0	0	954	0.0000000
zheyou73v0_A05	42773977	42776463	BnaA05T0428200ZY	0	+	0	0	2486	0.0000000
zheyou73v0_A05	42778127	42778885	BnaA05T0428300ZY	0	+	0	0	758	0.0000000
zheyou73v0_A05	42782229	42784006	BnaA05T0428400ZY	0	+	0	0	1777	0.0000000
zheyou73v0_A05	42785869	42788319	BnaA05T0428500ZY	0	+	0	0	2450	0.0000000
zheyou73v0_A05	42793826	42794969	BnaA05T0428600ZY	0	-	0	0	1143	0.0000000
zheyou73v0_A05	42797385	42798064	BnaA05T0428700ZY	0	-	0	0	679	0.0000000
zheyou73v0_A05	42814687	42816306	BnaA05T0428800ZY	0	+	0	0	1619	0.0000000
zheyou73v0_A05	42820014	42823032	BnaA05T0428900ZY	0	+	0	0	3018	0.0000000
zheyou73v0_A05	42826930	42827768	BnaA05T0429000ZY	0	+	0	0	838	0.0000000
zheyou73v0_A05	42829363	42829552	BnaA05T0429100ZY	0	+	0	0	189	0.0000000
zheyou73v0_A05	42834133	42834382	BnaA05T0429200ZY	0	+	0	0	249	0.0000000
zheyou73v0_A05	42835785	42837841	BnaA05T0429300ZY	0	+	0	0	2056	0.0000000
zheyou73v0_A05	42838071	42839519	BnaA05T0429400ZY	0	+	0	0	1448	0.0000000
zheyou73v0_A05	42840120	42841475	BnaA05T0429500ZY	0	+	0	0	1355	0.0000000
zheyou73v0_A05	42840120	42841555	BnaA05T0429500ZY.1	0	+	0	0	1435	0.0000000
zheyou73v0_A05	42841683	42842607	BnaA05T0429600ZY	0	+	0	0	924	0.0000000
zheyou73v0_A05	42843241	42847122	BnaA05T0429700ZY	0	+	0	0	3881	0.0000000
zheyou73v0_A05	42854353	42855250	BnaA05T0429800ZY	0	-	0	0	897	0.0000000
zheyou73v0_A05	42863219	42863601	BnaA05T0429900ZY	0	+	0	0	382	0.0000000
zheyou73v0_A05	42867123	42867834	BnaA05T0430000ZY	0	-	0	0	711	0.0000000
zheyou73v0_A05	42874257	42877743	BnaA05T0430100ZY	0	+	0	0	3486	0.0000000
zheyou73v0_A05	42878202	42879014	BnaA05T0430200ZY	0	-	0	0	812	0.0000000
zheyou73v0_A05	42887342	42887915	BnaA05T0430300ZY	0	+	0	0	573	0.0000000
zheyou73v0_A05	42889062	42894235	BnaA05T0430400ZY	0	+	0	0	5173	0.0000000
zheyou73v0_A05	42895151	42897658	BnaA05T0430500ZY	0	+	0	0	2507	0.0000000
zheyou73v0_A05	42899230	42902137	BnaA05T0430600ZY	0	+	0	0	2907	0.0000000
zheyou73v0_A05	42899230	42902137	BnaA05T0430600ZY.1	0	+	0	0	2907	0.0000000
zheyou73v0_A05	42904995	42905289	BnaA05T0430700ZY	0	+	0	0	294	0.0000000
zheyou73v0_A05	42905957	42906941	BnaA05T0430800ZY	0	-	0	0	984	0.0000000
zheyou73v0_A05	42907732	42908595	BnaA05T0430900ZY	0	+	0	0	863	0.0000000
zheyou73v0_A05	42909933	42912334	BnaA05T0431000ZY	0	+	0	0	2401	0.0000000
zheyou73v0_A05	42912948	42919738	BnaA05T0431100ZY	0	+	0	0	6790	0.0000000
zheyou73v0_A05	42922484	42922758	BnaA05T0431200ZY	0	+	0	0	274	0.0000000
zheyou73v0_A05	42928972	42929983	BnaA05T0431300ZY	0	+	0	0	1011	0.0000000
zheyou73v0_A05	42965143	42966052	BnaA05T0431400ZY	0	+	0	0	909	0.0000000
zheyou73v0_A05	42970231	42970556	BnaA05T0431500ZY	0	-	0	0	325	0.0000000
zheyou73v0_A05	42974470	42978033	BnaA05T0431600ZY	0	+	0	0	3563	0.0000000
zheyou73v0_A05	42975303	42978033	BnaA05T0431600ZY.1	0	+	0	0	2730	0.0000000
zheyou73v0_A05	42978206	42981213	BnaA05T0431700ZY	0	-	0	0	3007	0.0000000
zheyou73v0_A05	42982338	42984938	BnaA05T0431800ZY	0	-	0	0	2600	0.0000000
zheyou73v0_A05	42982338	42984938	BnaA05T0431800ZY.1	0	-	0	0	2600	0.0000000
zheyou73v0_A05	42989791	42990680	BnaA05T0431900ZY	0	-	0	0	889	0.0000000
zheyou73v0_A05	42992987	42996653	BnaA05T0432000ZY	0	+	0	0	3666	0.0000000
zheyou73v0_A05	42997517	43002996	BnaA05T0432100ZY	0	-	0	0	5479	0.0000000
zheyou73v0_A05	43004665	43008412	BnaA05T0432200ZY	0	-	0	0	3747	0.0000000
zheyou73v0_A05	43010624	43012207	BnaA05T0432300ZY	0	-	0	0	1583	0.0000000
zheyou73v0_A05	43013403	43016617	BnaA05T0432400ZY	0	+	0	0	3214	0.0000000
zheyou73v0_A05	43017330	43018879	BnaA05T0432500ZY	0	-	0	0	1549	0.0000000
zheyou73v0_A05	43020611	43023232	BnaA05T0432600ZY	0	-	0	0	2621	0.0000000
zheyou73v0_A05	43024817	43027112	BnaA05T0432700ZY	0	+	0	0	2295	0.0000000
zheyou73v0_A05	43027518	43029786	BnaA05T0432800ZY	0	+	0	0	2268	0.0000000
zheyou73v0_A05	43030507	43032513	BnaA05T0432900ZY	0	+	0	0	2006	0.0000000
zheyou73v0_A05	43034181	43035802	BnaA05T0433000ZY	0	+	0	0	1621	0.0000000
zheyou73v0_A05	43035784	43036828	BnaA05T0433100ZY	0	-	0	0	1044	0.0000000
zheyou73v0_A05	43037801	43039716	BnaA05T0433200ZY	0	+	0	0	1915	0.0000000
zheyou73v0_A05	43039753	43040999	BnaA05T0433300ZY	0	-	0	0	1246	0.0000000
zheyou73v0_A05	43041287	43042888	BnaA05T0433400ZY	0	-	0	0	1601	0.0000000
zheyou73v0_A05	43043060	43044170	BnaA05T0433500ZY	0	+	0	0	1110	0.0000000
zheyou73v0_A05	43044418	43044874	BnaA05T0433600ZY	0	-	0	0	456	0.0000000
zheyou73v0_A05	43091705	43095042	BnaA05T0433700ZY	0	-	0	0	3337	0.0000000
zheyou73v0_A05	43096819	43099214	BnaA05T0433800ZY	0	-	0	0	2395	0.0000000
zheyou73v0_A05	43099920	43100903	BnaA05T0433900ZY	0	-	0	0	983	0.0000000
zheyou73v0_A05	43101270	43102748	BnaA05T0434000ZY	0	-	0	0	1478	0.0000000
zheyou73v0_A05	43104639	43105356	BnaA05T0434100ZY	0	-	0	0	717	0.0000000
zheyou73v0_A05	43106802	43109533	BnaA05T0434200ZY	0	-	0	0	2731	0.0000000
zheyou73v0_A05	43113877	43116944	BnaA05T0434300ZY	0	+	0	0	3067	0.0000000
zheyou73v0_A05	43118193	43118861	BnaA05T0434400ZY	0	-	0	0	668	0.0000000
zheyou73v0_A05	43120221	43121231	BnaA05T0434500ZY	0	+	0	0	1010	0.0000000
zheyou73v0_A05	43121691	43127471	BnaA05T0434600ZY	0	-	0	0	5780	0.0000000
zheyou73v0_A05	43127973	43129574	BnaA05T0434700ZY	0	-	0	0	1601	0.0000000
zheyou73v0_A05	43129599	43134596	BnaA05T0434800ZY	0	-	0	0	4997	0.0000000
zheyou73v0_A05	43136564	43137959	BnaA05T0434900ZY	0	+	0	0	1395	0.0000000
zheyou73v0_A05	43138309	43143081	BnaA05T0435000ZY	0	-	0	0	4772	0.0000000
zheyou73v0_A05	43144949	43148940	BnaA05T0435100ZY	0	+	0	0	3991	0.0000000
zheyou73v0_A05	43149255	43151356	BnaA05T0435200ZY	0	+	0	0	2101	0.0000000
zheyou73v0_A05	43152616	43154682	BnaA05T0435300ZY	0	+	0	0	2066	0.0000000
zheyou73v0_A05	43154982	43155939	BnaA05T0435400ZY	0	+	0	0	957	0.0000000
zheyou73v0_A05	43156056	43161978	BnaA05T0435500ZY	0	+	0	0	5922	0.0000000
zheyou73v0_A05	43162698	43165837	BnaA05T0435600ZY	0	+	0	0	3139	0.0000000
zheyou73v0_A05	43162698	43165837	BnaA05T0435600ZY.1	0	+	0	0	3139	0.0000000
zheyou73v0_A05	43166976	43168048	BnaA05T0435700ZY	0	+	0	0	1072	0.0000000
zheyou73v0_A05	43168760	43171713	BnaA05T0435800ZY	0	-	0	0	2953	0.0000000
zheyou73v0_A05	43172434	43174120	BnaA05T0435900ZY	0	+	0	0	1686	0.0000000
zheyou73v0_A05	43174106	43175411	BnaA05T0436000ZY	0	-	0	0	1305	0.0000000
zheyou73v0_A05	43176564	43178892	BnaA05T0436100ZY	0	-	0	0	2328	0.0000000
zheyou73v0_A05	43186049	43188295	BnaA05T0436200ZY	0	-	0	0	2246	0.0000000
zheyou73v0_A05	43186049	43188295	BnaA05T0436200ZY.1	0	-	0	0	2246	0.0000000
zheyou73v0_A05	43190787	43192304	BnaA05T0436300ZY	0	+	0	0	1517	0.0000000
zheyou73v0_A05	43192578	43193815	BnaA05T0436400ZY	0	-	0	0	1237	0.0000000
zheyou73v0_A05	43198488	43202726	BnaA05T0436500ZY	0	+	0	0	4238	0.0000000
zheyou73v0_A05	43204280	43207434	BnaA05T0436600ZY	0	-	0	0	3154	0.0000000
zheyou73v0_A05	43215900	43218471	BnaA05T0436700ZY	0	+	0	0	2571	0.0000000
zheyou73v0_A05	43219504	43221379	BnaA05T0436800ZY	0	+	0	0	1875	0.0000000
zheyou73v0_A05	43221573	43223445	BnaA05T0436900ZY	0	-	0	0	1872	0.0000000
zheyou73v0_A05	43226982	43229014	BnaA05T0437000ZY	0	+	0	0	2032	0.0000000
zheyou73v0_A05	43229579	43232751	BnaA05T0437100ZY	0	+	0	0	3172	0.0000000
zheyou73v0_A05	43233119	43235342	BnaA05T0437200ZY	0	-	0	0	2223	0.0000000
zheyou73v0_A05	43235689	43240818	BnaA05T0437300ZY	0	+	0	0	5129	0.0000000
zheyou73v0_A05	43235689	43240818	BnaA05T0437300ZY.1	0	+	0	0	5129	0.0000000
zheyou73v0_A05	43235689	43240818	BnaA05T0437300ZY.2	0	+	0	0	5129	0.0000000
zheyou73v0_A05	43240998	43242121	BnaA05T0437400ZY	0	-	0	0	1123	0.0000000
zheyou73v0_A05	43246643	43249505	BnaA05T0437500ZY	0	+	0	0	2862	0.0000000
zheyou73v0_A05	43255803	43256473	BnaA05T0437600ZY	0	+	0	0	670	0.0000000
zheyou73v0_A05	43258960	43262196	BnaA05T0437700ZY	0	+	0	0	3236	0.0000000
zheyou73v0_A05	43262932	43264401	BnaA05T0437800ZY	0	+	0	0	1469	0.0000000
zheyou73v0_A05	43265953	43266827	BnaA05T0437900ZY	0	+	0	0	874	0.0000000
zheyou73v0_A05	43268087	43272477	BnaA05T0438000ZY	0	+	0	0	4390	0.0000000
zheyou73v0_A05	43272899	43274710	BnaA05T0438100ZY	0	+	0	0	1811	0.0000000
zheyou73v0_A05	43275176	43282974	BnaA05T0438200ZY	0	+	0	0	7798	0.0000000
zheyou73v0_A05	43283145	43285125	BnaA05T0438300ZY	0	-	0	0	1980	0.0000000
zheyou73v0_A05	43286272	43288135	BnaA05T0438400ZY	0	-	0	0	1863	0.0000000
zheyou73v0_A05	43288676	43288844	BnaA05T0438500ZY	0	-	0	0	168	0.0000000
zheyou73v0_A05	43293487	43293850	BnaA05T0438600ZY	0	+	0	0	363	0.0000000
zheyou73v0_A05	43298759	43299122	BnaA05T0438700ZY	0	+	0	0	363	0.0000000
zheyou73v0_A05	43322409	43323108	BnaA05T0438800ZY	0	-	0	0	699	0.0000000
zheyou73v0_A05	43323921	43326460	BnaA05T0438900ZY	0	-	0	0	2539	0.0000000
zheyou73v0_A05	43323921	43326460	BnaA05T0438900ZY.1	0	-	0	0	2539	0.0000000
zheyou73v0_A05	43326695	43328284	BnaA05T0439000ZY	0	-	0	0	1589	0.0000000
zheyou73v0_A05	43329271	43330710	BnaA05T0439100ZY	0	-	0	0	1439	0.0000000
zheyou73v0_A05	43333517	43336667	BnaA05T0439200ZY	0	-	0	0	3150	0.0000000
zheyou73v0_A05	43345354	43346870	BnaA05T0439300ZY	0	-	0	0	1516	0.0000000
zheyou73v0_A05	43345354	43346870	BnaA05T0439300ZY.1	0	-	0	0	1516	0.0000000
zheyou73v0_A05	43347163	43348227	BnaA05T0439400ZY	0	+	0	0	1064	0.0000000
zheyou73v0_A05	43347536	43351330	BnaA05T0439500ZY	0	-	0	0	3794	0.0000000
zheyou73v0_A05	43352208	43353072	BnaA05T0439600ZY	0	+	0	0	864	0.0000000
zheyou73v0_A05	43355140	43367488	BnaA05T0439700ZY	0	-	0	0	12348	0.0000000
zheyou73v0_A05	43367768	43369241	BnaA05T0439800ZY	0	+	0	0	1473	0.0000000
zheyou73v0_A05	43373139	43375160	BnaA05T0439900ZY	0	+	0	0	2021	0.0000000
zheyou73v0_A05	43375771	43377919	BnaA05T0440000ZY	0	+	0	0	2148	0.0000000
zheyou73v0_A05	43378037	43384624	BnaA05T0440100ZY	0	-	0	0	6587	0.0000000
zheyou73v0_A05	43393437	43401364	BnaA05T0440200ZY	0	+	0	0	7927	0.0000000
zheyou73v0_A05	43412395	43413500	BnaA05T0440300ZY	0	-	0	0	1105	0.0000000
zheyou73v0_A05	43415213	43416471	BnaA05T0440400ZY	0	+	0	0	1258	0.0000000
zheyou73v0_A05	43417790	43418192	BnaA05T0440500ZY	0	+	0	0	402	0.0000000
zheyou73v0_A05	43422096	43422921	BnaA05T0440600ZY	0	+	0	0	825	0.0000000
zheyou73v0_A05	43450578	43454890	BnaA05T0440700ZY	0	+	0	0	4312	0.0000000
zheyou73v0_A05	43455334	43457631	BnaA05T0440800ZY	0	-	0	0	2297	0.0000000
zheyou73v0_A05	43458714	43460469	BnaA05T0440900ZY	0	-	0	0	1755	0.0000000
zheyou73v0_A05	43460859	43463282	BnaA05T0441000ZY	0	-	0	0	2423	0.0000000
zheyou73v0_A05	43506770	43508492	BnaA05T0441100ZY	0	-	0	0	1722	0.0000000
zheyou73v0_A05	43509438	43511584	BnaA05T0441200ZY	0	+	0	0	2146	0.0000000
zheyou73v0_A05	43513279	43516142	BnaA05T0441300ZY	0	+	0	0	2863	0.0000000
zheyou73v0_A05	43518643	43520858	BnaA05T0441400ZY	0	+	0	0	2215	0.0000000
zheyou73v0_A05	43521293	43524136	BnaA05T0441500ZY	0	-	0	0	2843	0.0000000
zheyou73v0_A05	43524988	43525298	BnaA05T0441600ZY	0	-	0	0	310	0.0000000
zheyou73v0_A05	43525706	43531543	BnaA05T0441700ZY	0	-	0	0	5837	0.0000000
zheyou73v0_A05	43533266	43541643	BnaA05T0441800ZY	0	-	0	0	8377	0.0000000
zheyou73v0_A05	43543562	43546004	BnaA05T0441900ZY	0	+	0	0	2442	0.0000000
zheyou73v0_A05	43546217	43549746	BnaA05T0442000ZY	0	+	0	0	3529	0.0000000
zheyou73v0_A05	43550422	43552261	BnaA05T0442100ZY.1	0	-	0	0	1839	0.0000000
zheyou73v0_A05	43550756	43552261	BnaA05T0442100ZY	0	-	0	0	1505	0.0000000
zheyou73v0_A05	43552751	43558379	BnaA05T0442200ZY	0	+	0	0	5628	0.0000000
zheyou73v0_A05	43559038	43565987	BnaA05T0442300ZY	0	+	0	0	6949	0.0000000
zheyou73v0_A05	43559038	43565987	BnaA05T0442300ZY.1	0	+	0	0	6949	0.0000000
zheyou73v0_A05	43566216	43569673	BnaA05T0442400ZY	0	-	0	0	3457	0.0000000
zheyou73v0_A05	43570550	43571078	BnaA05T0442500ZY	0	-	0	0	528	0.0000000
zheyou73v0_A05	43573560	43574492	BnaA05T0442600ZY	0	+	0	0	932	0.0000000
zheyou73v0_A05	43575880	43579509	BnaA05T0442700ZY	0	+	0	0	3629	0.0000000
zheyou73v0_A05	43580957	43584694	BnaA05T0442800ZY	0	+	0	0	3737	0.0000000
zheyou73v0_A05	43586585	43592592	BnaA05T0442900ZY	0	+	0	0	6007	0.0000000
zheyou73v0_A05	43609021	43609483	BnaA05T0443000ZY	0	-	0	0	462	0.0000000
zheyou73v0_A05	43613807	43615561	BnaA05T0443100ZY	0	+	0	0	1754	0.0000000
zheyou73v0_A05	43616173	43617432	BnaA05T0443200ZY	0	-	0	0	1259	0.0000000
zheyou73v0_A05	43617960	43619570	BnaA05T0443300ZY	0	-	0	0	1610	0.0000000
zheyou73v0_A05	43620054	43621149	BnaA05T0443400ZY	0	-	0	0	1095	0.0000000
zheyou73v0_A05	43620054	43621149	BnaA05T0443400ZY.1	0	-	0	0	1095	0.0000000
zheyou73v0_A05	43621285	43622961	BnaA05T0443500ZY	0	-	0	0	1676	0.0000000
zheyou73v0_A05	43623426	43625410	BnaA05T0443600ZY	0	+	0	0	1984	0.0000000
zheyou73v0_A05	43625504	43625777	BnaA05T0443700ZY	0	+	0	0	273	0.0000000
zheyou73v0_A05	43627570	43632633	BnaA05T0443800ZY	0	+	0	0	5063	0.0000000
zheyou73v0_A05	43633193	43636106	BnaA05T0443900ZY	0	+	0	0	2913	0.0000000
zheyou73v0_A05	43635662	43637260	BnaA05T0444000ZY	0	-	0	0	1598	0.0000000
zheyou73v0_A05	43637481	43639420	BnaA05T0444100ZY	0	-	0	0	1939	0.0000000
zheyou73v0_A05	43639951	43643127	BnaA05T0444200ZY	0	-	0	0	3176	0.0000000
zheyou73v0_A05	43643517	43644875	BnaA05T0444300ZY	0	-	0	0	1358	0.0000000
zheyou73v0_A05	43646371	43652812	BnaA05T0444400ZY	0	+	0	0	6441	0.0000000
zheyou73v0_A05	43653341	43655258	BnaA05T0444500ZY	0	+	0	0	1917	0.0000000
zheyou73v0_A05	43656013	43658669	BnaA05T0444600ZY	0	+	0	0	2656	0.0000000
zheyou73v0_A05	43658995	43660810	BnaA05T0444700ZY	0	-	0	0	1815	0.0000000
zheyou73v0_A05	43661176	43662928	BnaA05T0444800ZY	0	+	0	0	1752	0.0000000
zheyou73v0_A05	43662809	43663570	BnaA05T0444900ZY	0	+	0	0	761	0.0000000
zheyou73v0_A05	43664419	43665274	BnaA05T0445000ZY	0	+	0	0	855	0.0000000
zheyou73v0_A05	43665845	43668254	BnaA05T0445100ZY	0	-	0	0	2409	0.0000000
zheyou73v0_A05	43671172	43674614	BnaA05T0445200ZY	0	-	0	0	3442	0.0000000
zheyou73v0_A05	43671422	43672529	BnaA05T0445300ZY	0	+	0	0	1107	0.0000000
zheyou73v0_A05	43707655	43710952	BnaA05T0445400ZY	0	+	0	0	3297	0.0000000
zheyou73v0_A05	43711466	43713334	BnaA05T0445500ZY	0	+	0	0	1868	0.0000000
zheyou73v0_A05	43711466	43713334	BnaA05T0445500ZY.1	0	+	0	0	1868	0.0000000
zheyou73v0_A05	43716081	43719012	BnaA05T0445600ZY	0	+	0	0	2931	0.0000000
zheyou73v0_A05	43719835	43725001	BnaA05T0445700ZY	0	+	0	0	5166	0.0000000
zheyou73v0_A05	43725162	43726826	BnaA05T0445800ZY	0	-	0	0	1664	0.0000000
zheyou73v0_A05	43727809	43734436	BnaA05T0445900ZY	0	-	0	0	6627	0.0000000
zheyou73v0_A05	43735329	43737597	BnaA05T0446000ZY	0	+	0	0	2268	0.0000000
zheyou73v0_A05	43738046	43741480	BnaA05T0446100ZY	0	-	0	0	3434	0.0000000
zheyou73v0_A05	43742055	43745332	BnaA05T0446200ZY	0	-	0	0	3277	0.0000000
zheyou73v0_A05	43744612	43744858	BnaA05T0446300ZY	0	+	0	0	246	0.0000000
zheyou73v0_A05	43745898	43746941	BnaA05T0446400ZY	0	-	0	0	1043	0.0000000
zheyou73v0_A05	43748609	43750715	BnaA05T0446500ZY	0	-	0	0	2106	0.0000000
zheyou73v0_A05	43751991	43753695	BnaA05T0446600ZY	0	+	0	0	1704	0.0000000
zheyou73v0_A05	43754077	43755890	BnaA05T0446700ZY	0	+	0	0	1813	0.0000000
zheyou73v0_A05	43756653	43757213	BnaA05T0446800ZY	0	-	0	0	560	0.0000000
zheyou73v0_A05	43758440	43759576	BnaA05T0446900ZY	0	+	0	0	1136	0.0000000
zheyou73v0_A05	43759632	43763679	BnaA05T0447000ZY	0	-	0	0	4047	0.0000000
zheyou73v0_A05	43764526	43767102	BnaA05T0447100ZY	0	-	0	0	2576	0.0000000
zheyou73v0_A05	43770380	43771054	BnaA05T0447200ZY	0	-	0	0	674	0.0000000
zheyou73v0_A05	43771083	43771440	BnaA05T0447300ZY	0	-	0	0	357	0.0000000
zheyou73v0_A05	43771543	43772125	BnaA05T0447400ZY	0	-	0	0	582	0.0000000
zheyou73v0_A05	43831070	43833723	BnaA05T0447500ZY	0	-	0	0	2653	0.0000000
zheyou73v0_A05	43874582	43875644	BnaA05T0447600ZY	0	+	0	0	1062	0.0000000
zheyou73v0_A05	43876332	43879291	BnaA05T0447700ZY	0	+	0	0	2959	0.0000000
zheyou73v0_A05	43882983	43886320	BnaA05T0447800ZY	0	+	0	0	3337	0.0000000
zheyou73v0_A05	43888900	43889318	BnaA05T0447900ZY	0	+	0	0	418	0.0000000
zheyou73v0_A05	43890219	43891121	BnaA05T0448000ZY	0	+	0	0	902	0.0000000
zheyou73v0_A05	43892772	43894994	BnaA05T0448100ZY	0	+	0	0	2222	0.0000000
zheyou73v0_A05	43895416	43899952	BnaA05T0448200ZY	0	-	0	0	4536	0.0000000
zheyou73v0_A05	43903355	43904951	BnaA05T0448300ZY	0	+	0	0	1596	0.0000000
zheyou73v0_A05	43906868	43910508	BnaA05T0448400ZY	0	-	0	0	3640	0.0000000
zheyou73v0_A05	43915051	43915264	BnaA05T0448500ZY	0	-	0	0	213	0.0000000
zheyou73v0_A05	43918308	43918825	BnaA05T0448600ZY	0	-	0	0	517	0.0000000
zheyou73v0_A05	43924299	43925049	BnaA05T0448700ZY	0	+	0	0	750	0.0000000
zheyou73v0_A05	43925300	43926199	BnaA05T0448800ZY	0	+	0	0	899	0.0000000
zheyou73v0_A05	43927540	43931296	BnaA05T0448900ZY	0	+	0	0	3756	0.0000000
zheyou73v0_A05	43927540	43931296	BnaA05T0448900ZY.1	0	+	0	0	3756	0.0000000
zheyou73v0_A05	43927540	43931296	BnaA05T0448900ZY.3	0	+	0	0	3756	0.0000000
zheyou73v0_A05	43929086	43931296	BnaA05T0448900ZY.2	0	+	0	0	2210	0.0000000
zheyou73v0_A05	43931716	43933188	BnaA05T0449000ZY	0	-	0	0	1472	0.0000000
zheyou73v0_A05	43934107	43936032	BnaA05T0449100ZY	0	-	0	0	1925	0.0000000
zheyou73v0_A05	43944158	43945754	BnaA05T0449200ZY	0	+	0	0	1596	0.0000000
zheyou73v0_A05	43947598	43949077	BnaA05T0449300ZY	0	-	0	0	1479	0.0000000
zheyou73v0_A05	43950227	43951400	BnaA05T0449400ZY	0	-	0	0	1173	0.0000000
zheyou73v0_A05	43952743	43953377	BnaA05T0449500ZY	0	-	0	0	634	0.0000000
zheyou73v0_A05	43954767	43955049	BnaA05T0449600ZY	0	+	0	0	282	0.0000000
zheyou73v0_A05	43956313	43957689	BnaA05T0449700ZY	0	-	0	0	1376	0.0000000
zheyou73v0_A05	43965005	43966076	BnaA05T0449800ZY	0	-	0	0	1071	0.0000000
zheyou73v0_A05	43966718	43967241	BnaA05T0449900ZY	0	-	0	0	523	0.0000000
zheyou73v0_A05	43973020	43973472	BnaA05T0450000ZY	0	-	0	0	452	0.0000000
zheyou73v0_A05	43974020	43975743	BnaA05T0450100ZY	0	-	0	0	1723	0.0000000
zheyou73v0_A05	43978189	43981410	BnaA05T0450200ZY	0	+	0	0	3221	0.0000000
zheyou73v0_A05	43978189	43981410	BnaA05T0450200ZY.1	0	+	0	0	3221	0.0000000
zheyou73v0_A05	43978189	43981410	BnaA05T0450200ZY.2	0	+	0	0	3221	0.0000000
zheyou73v0_A05	43978189	43981410	BnaA05T0450200ZY.3	0	+	0	0	3221	0.0000000
zheyou73v0_A05	43981875	43982338	BnaA05T0450300ZY	0	+	0	0	463	0.0000000
zheyou73v0_A05	44043217	44062293	BnaA05T0450400ZY	0	+	0	0	19076	0.0000000
zheyou73v0_A05	44063784	44064675	BnaA05T0450500ZY	0	-	0	0	891	0.0000000
zheyou73v0_A05	44064972	44067737	BnaA05T0450600ZY	0	-	0	0	2765	0.0000000
zheyou73v0_A05	44068298	44070016	BnaA05T0450700ZY	0	-	0	0	1718	0.0000000
zheyou73v0_A05	44070626	44073849	BnaA05T0450800ZY	0	-	0	0	3223	0.0000000
zheyou73v0_A05	44074122	44075576	BnaA05T0450900ZY	0	+	0	0	1454	0.0000000
zheyou73v0_A05	44075991	44078727	BnaA05T0451000ZY	0	-	0	0	2736	0.0000000
zheyou73v0_A05	44087110	44089752	BnaA05T0451100ZY	0	-	0	0	2642	0.0000000
zheyou73v0_A05	44087110	44089802	BnaA05T0451100ZY.1	0	-	0	0	2692	0.0000000
zheyou73v0_A05	44087167	44087665	BnaA05T0451200ZY	0	+	0	0	498	0.0000000
zheyou73v0_A05	44090800	44092434	BnaA05T0451300ZY	0	-	0	0	1634	0.0000000
zheyou73v0_A05	44100183	44100803	BnaA05T0451400ZY	0	+	0	0	620	0.0000000
zheyou73v0_A05	44101927	44102807	BnaA05T0451500ZY	0	+	0	0	880	0.0000000
zheyou73v0_A05	44181621	44188823	BnaA05T0451600ZY	0	-	0	0	7202	0.0000000
zheyou73v0_A05	44190716	44194742	BnaA05T0451700ZY	0	-	0	0	4026	0.0000000
zheyou73v0_A05	44195492	44199158	BnaA05T0451800ZY	0	-	0	0	3666	0.0000000
zheyou73v0_A05	44200522	44201470	BnaA05T0451900ZY	0	-	0	0	948	0.0000000
zheyou73v0_A05	44205822	44206350	BnaA05T0452000ZY	0	+	0	0	528	0.0000000
zheyou73v0_A05	44207227	44208187	BnaA05T0452100ZY	0	+	0	0	960	0.0000000
zheyou73v0_A05	44208237	44210422	BnaA05T0452200ZY	0	+	0	0	2185	0.0000000
zheyou73v0_A05	44212928	44219953	BnaA05T0452300ZY	0	-	0	0	7025	0.0000000
zheyou73v0_A05	44212928	44219953	BnaA05T0452300ZY.1	0	-	0	0	7025	0.0000000
zheyou73v0_A05	44220612	44226239	BnaA05T0452400ZY	0	-	0	0	5627	0.0000000
zheyou73v0_A05	44226724	44228121	BnaA05T0452500ZY	0	+	0	0	1397	0.0000000
zheyou73v0_A05	44230744	44233018	BnaA05T0452600ZY	0	-	0	0	2274	0.0000000
zheyou73v0_A05	44233143	44235686	BnaA05T0452700ZY	0	-	0	0	2543	0.0000000
zheyou73v0_A05	44238118	44246517	BnaA05T0452800ZY	0	+	0	0	8399	0.0000000
zheyou73v0_A05	44248241	44249288	BnaA05T0452900ZY	0	+	0	0	1047	0.0000000
zheyou73v0_A05	44249696	44250006	BnaA05T0453000ZY	0	+	0	0	310	0.0000000
zheyou73v0_A05	44250799	44253673	BnaA05T0453100ZY	0	+	0	0	2874	0.0000000
zheyou73v0_A05	44254108	44256323	BnaA05T0453200ZY	0	-	0	0	2215	0.0000000
zheyou73v0_A05	44258822	44261682	BnaA05T0453300ZY	0	-	0	0	2860	0.0000000
zheyou73v0_A05	44263352	44265510	BnaA05T0453400ZY	0	-	0	0	2158	0.0000000
zheyou73v0_A05	44266456	44268178	BnaA05T0453500ZY	0	+	0	0	1722	0.0000000
zheyou73v0_A05	44296998	44297770	BnaA05T0453600ZY	0	+	0	0	772	0.0000000
zheyou73v0_A05	44304390	44307230	BnaA05T0453700ZY	0	-	0	0	2840	0.0000000
zheyou73v0_A05	44310692	44312259	BnaA05T0453800ZY	0	+	0	0	1567	0.0000000
zheyou73v0_A05	44312803	44314322	BnaA05T0453900ZY	0	-	0	0	1519	0.0000000
zheyou73v0_A05	44314326	44315718	BnaA05T0454000ZY	0	-	0	0	1392	0.0000000
zheyou73v0_A05	44316383	44317929	BnaA05T0454100ZY	0	-	0	0	1546	0.0000000
zheyou73v0_A05	44318240	44319028	BnaA05T0454200ZY	0	-	0	0	788	0.0000000
zheyou73v0_A05	44320485	44322153	BnaA05T0454300ZY	0	+	0	0	1668	0.0000000
zheyou73v0_A05	44322374	44324614	BnaA05T0454400ZY	0	-	0	0	2240	0.0000000
zheyou73v0_A05	44328919	44331625	BnaA05T0454500ZY	0	+	0	0	2706	0.0000000
zheyou73v0_A05	44331776	44332439	BnaA05T0454600ZY	0	-	0	0	663	0.0000000
zheyou73v0_A05	44333658	44334632	BnaA05T0454700ZY	0	+	0	0	974	0.0000000
zheyou73v0_A05	44335797	44336521	BnaA05T0454800ZY	0	+	0	0	724	0.0000000
zheyou73v0_A06	7314	10223	BnaA06T0000100ZY	0	+	0	0	2909	0.0000000
zheyou73v0_A06	10682	11169	BnaA06T0000200ZY	0	+	0	0	487	0.0000000
zheyou73v0_A06	20609	22205	BnaA06T0000300ZY	0	-	0	0	1596	0.0000000
zheyou73v0_A06	23992	26194	BnaA06T0000400ZY	0	+	0	0	2202	0.0000000
zheyou73v0_A06	24604	26194	BnaA06T0000400ZY.1	0	+	0	0	1590	0.0000000
zheyou73v0_A06	26818	27921	BnaA06T0000500ZY	0	-	0	0	1103	0.0000000
zheyou73v0_A06	29924	31789	BnaA06T0000600ZY	0	+	0	0	1865	0.0000000
zheyou73v0_A06	29924	32726	BnaA06T0000600ZY.1	0	+	0	0	2802	0.0000000
zheyou73v0_A06	35144	35377	BnaA06T0000700ZY	0	+	0	0	233	0.0000000
zheyou73v0_A06	38480	39912	BnaA06T0000800ZY	0	-	0	0	1432	0.0000000
zheyou73v0_A06	39965	40684	BnaA06T0000900ZY	0	-	0	0	719	0.0000000
zheyou73v0_A06	41115	42880	BnaA06T0001000ZY	0	+	0	0	1765	0.0000000
zheyou73v0_A06	50360	50971	BnaA06T0001100ZY	0	-	0	0	611	0.0000000
zheyou73v0_A06	51270	53804	BnaA06T0001200ZY	0	+	0	0	2534	0.0000000
zheyou73v0_A06	53934	56507	BnaA06T0001300ZY	0	-	0	0	2573	0.0000000
zheyou73v0_A06	57579	70236	BnaA06T0001400ZY	0	+	0	0	12657	0.0000000
zheyou73v0_A06	71838	74082	BnaA06T0001500ZY	0	-	0	0	2244	0.0000000
zheyou73v0_A06	76663	78647	BnaA06T0001600ZY	0	+	0	0	1984	0.0000000
zheyou73v0_A06	77074	78647	BnaA06T0001600ZY.1	0	+	0	0	1573	0.0000000
zheyou73v0_A06	110855	114018	BnaA06T0001700ZY	0	-	0	0	3163	0.0000000
zheyou73v0_A06	118892	120464	BnaA06T0001800ZY	0	+	0	0	1572	0.0000000
zheyou73v0_A06	121356	121884	BnaA06T0001900ZY	0	+	0	0	528	0.0000000
zheyou73v0_A06	129062	135802	BnaA06T0002000ZY	0	+	0	0	6740	0.0000000
zheyou73v0_A06	136185	136827	BnaA06T0002100ZY	0	+	0	0	642	0.0000000
zheyou73v0_A06	143063	144543	BnaA06T0002200ZY	0	-	0	0	1480	0.0000000
zheyou73v0_A06	146339	146756	BnaA06T0002300ZY	0	-	0	0	417	0.0000000
zheyou73v0_A06	147820	149377	BnaA06T0002400ZY	0	+	0	0	1557	0.0000000
zheyou73v0_A06	149748	153764	BnaA06T0002500ZY	0	+	0	0	4016	0.0000000
zheyou73v0_A06	161516	163900	BnaA06T0002600ZY	0	+	0	0	2384	0.0000000
zheyou73v0_A06	161516	163900	BnaA06T0002600ZY.1	0	+	0	0	2384	0.0000000
zheyou73v0_A06	162088	163900	BnaA06T0002600ZY.2	0	+	0	0	1812	0.0000000
zheyou73v0_A06	169881	170436	BnaA06T0002700ZY	0	-	0	0	555	0.0000000
zheyou73v0_A06	176558	177365	BnaA06T0002800ZY	0	+	0	0	807	0.0000000
zheyou73v0_A06	178083	179747	BnaA06T0002900ZY	0	-	0	0	1664	0.0000000
zheyou73v0_A06	187927	193795	BnaA06T0003000ZY	0	-	0	0	5868	0.0000000
zheyou73v0_A06	194601	198474	BnaA06T0003100ZY	0	-	0	0	3873	0.0000000
zheyou73v0_A06	201828	203156	BnaA06T0003200ZY	0	+	0	0	1328	0.0000000
zheyou73v0_A06	204188	205639	BnaA06T0003300ZY	0	+	0	0	1451	0.0000000
zheyou73v0_A06	206725	209095	BnaA06T0003400ZY	0	-	0	0	2370	0.0000000
zheyou73v0_A06	207728	209095	BnaA06T0003400ZY.1	0	-	0	0	1367	0.0000000
zheyou73v0_A06	210034	210735	BnaA06T0003500ZY	0	+	0	0	701	0.0000000
zheyou73v0_A06	216347	226157	BnaA06T0003600ZY	0	+	0	0	9810	0.0000000
zheyou73v0_A06	235035	236536	BnaA06T0003700ZY	0	-	0	0	1501	0.0000000
zheyou73v0_A06	235035	236212	BnaA06T0003700ZY.1	0	-	0	0	1177	0.0000000
zheyou73v0_A06	235035	236536	BnaA06T0003700ZY.2	0	-	0	0	1501	0.0000000
zheyou73v0_A06	238943	239410	BnaA06T0003800ZY	0	+	0	0	467	0.0000000
zheyou73v0_A06	239914	248876	BnaA06T0003900ZY	0	-	0	0	8962	0.0000000
zheyou73v0_A06	239914	253821	BnaA06T0003900ZY.1	0	-	0	0	13907	0.0000000
zheyou73v0_A06	255486	258180	BnaA06T0004000ZY	0	-	0	0	2694	0.0000000
zheyou73v0_A06	258535	260187	BnaA06T0004100ZY	0	+	0	0	1652	0.0000000
zheyou73v0_A06	261581	263190	BnaA06T0004200ZY	0	+	0	0	1609	0.0000000
zheyou73v0_A06	269975	271350	BnaA06T0004300ZY	0	-	0	0	1375	0.0000000
zheyou73v0_A06	277961	278528	BnaA06T0004400ZY	0	+	0	0	567	0.0000000
zheyou73v0_A06	282362	282945	BnaA06T0004500ZY	0	+	0	0	583	0.0000000
zheyou73v0_A06	284991	285552	BnaA06T0004600ZY	0	+	0	0	561	0.0000000
zheyou73v0_A06	287811	288515	BnaA06T0004700ZY	0	-	0	0	704	0.0000000
zheyou73v0_A06	290140	290845	BnaA06T0004800ZY	0	-	0	0	705	0.0000000
zheyou73v0_A06	292290	294724	BnaA06T0004900ZY	0	+	0	0	2434	0.0000000
zheyou73v0_A06	298070	299857	BnaA06T0005000ZY	0	-	0	0	1787	0.0000000
zheyou73v0_A06	300481	302241	BnaA06T0005100ZY	0	-	0	0	1760	0.0000000
zheyou73v0_A06	302335	302908	BnaA06T0005200ZY	0	-	0	0	573	0.0000000
zheyou73v0_A06	313915	314269	BnaA06T0005300ZY	0	-	0	0	354	0.0000000
zheyou73v0_A06	317680	320975	BnaA06T0005400ZY	0	-	0	0	3295	0.0000000
zheyou73v0_A06	328550	332216	BnaA06T0005500ZY	0	+	0	0	3666	0.0000000
zheyou73v0_A06	333188	333641	BnaA06T0005600ZY	0	-	0	0	453	0.0000000
zheyou73v0_A06	334962	335474	BnaA06T0005700ZY	0	+	0	0	512	0.0000000
zheyou73v0_A06	336368	337566	BnaA06T0005800ZY	0	-	0	0	1198	0.0000000
zheyou73v0_A06	336368	337566	BnaA06T0005800ZY.1	0	-	0	0	1198	0.0000000
zheyou73v0_A06	344846	345910	BnaA06T0005900ZY	0	-	0	0	1064	0.0000000
zheyou73v0_A06	384721	387046	BnaA06T0006000ZY	0	-	0	0	2325	0.0000000
zheyou73v0_A06	388307	392452	BnaA06T0006100ZY	0	+	0	0	4145	0.0000000
zheyou73v0_A06	397092	398221	BnaA06T0006200ZY	0	+	0	0	1129	0.0000000
zheyou73v0_A06	398455	400517	BnaA06T0006300ZY	0	-	0	0	2062	0.0000000
zheyou73v0_A06	401414	404655	BnaA06T0006400ZY	0	-	0	0	3241	0.0000000
zheyou73v0_A06	409969	410344	BnaA06T0006500ZY	0	-	0	0	375	0.0000000
zheyou73v0_A06	412688	414004	BnaA06T0006600ZY	0	+	0	0	1316	0.0000000
zheyou73v0_A06	415970	416411	BnaA06T0006700ZY	0	-	0	0	441	0.0000000
zheyou73v0_A06	419789	422623	BnaA06T0006800ZY	0	+	0	0	2834	0.0000000
zheyou73v0_A06	423067	425296	BnaA06T0006900ZY	0	-	0	0	2229	0.0000000
zheyou73v0_A06	452491	454414	BnaA06T0007000ZY	0	+	0	0	1923	0.0000000
zheyou73v0_A06	465019	467176	BnaA06T0007100ZY	0	-	0	0	2157	0.0000000
zheyou73v0_A06	470278	472869	BnaA06T0007200ZY	0	+	0	0	2591	0.0000000
zheyou73v0_A06	501881	503534	BnaA06T0007300ZY	0	+	0	0	1653	0.0000000
zheyou73v0_A06	510710	513280	BnaA06T0007400ZY	0	-	0	0	2570	0.0000000
zheyou73v0_A06	520500	521090	BnaA06T0007500ZY	0	-	0	0	590	0.0000000
zheyou73v0_A06	522003	524520	BnaA06T0007600ZY	0	-	0	0	2517	0.0000000
zheyou73v0_A06	525599	526205	BnaA06T0007700ZY	0	-	0	0	606	0.0000000
zheyou73v0_A06	528173	528844	BnaA06T0007800ZY	0	-	0	0	671	0.0000000
zheyou73v0_A06	533495	534166	BnaA06T0007900ZY	0	-	0	0	671	0.0000000
zheyou73v0_A06	536240	541461	BnaA06T0008000ZY	0	+	0	0	5221	0.0000000
zheyou73v0_A06	541678	544704	BnaA06T0008100ZY	0	-	0	0	3026	0.0000000
zheyou73v0_A06	546107	548083	BnaA06T0008200ZY	0	-	0	0	1976	0.0000000
zheyou73v0_A06	548548	551624	BnaA06T0008300ZY	0	-	0	0	3076	0.0000000
zheyou73v0_A06	551945	554008	BnaA06T0008400ZY	0	+	0	0	2063	0.0000000
zheyou73v0_A06	555141	556948	BnaA06T0008500ZY	0	+	0	0	1807	0.0000000
zheyou73v0_A06	559150	561757	BnaA06T0008600ZY	0	+	0	0	2607	0.0000000
zheyou73v0_A06	561643	565273	BnaA06T0008700ZY	0	-	0	0	3630	0.0000000
zheyou73v0_A06	580794	581282	BnaA06T0008800ZY	0	+	0	0	488	0.0000000
zheyou73v0_A06	582444	583099	BnaA06T0008900ZY	0	+	0	0	655	0.0000000
zheyou73v0_A06	599115	600600	BnaA06T0009000ZY	0	+	0	0	1485	0.0000000
zheyou73v0_A06	630198	632503	BnaA06T0009100ZY	0	+	0	0	2305	0.0000000
zheyou73v0_A06	632774	635224	BnaA06T0009200ZY	0	+	0	0	2450	0.0000000
zheyou73v0_A06	640223	640568	BnaA06T0009300ZY	0	+	0	0	345	0.0000000
zheyou73v0_A06	647077	647446	BnaA06T0009400ZY	0	-	0	0	369	0.0000000
zheyou73v0_A06	647692	649894	BnaA06T0009500ZY	0	-	0	0	2202	0.0000000
zheyou73v0_A06	652600	654320	BnaA06T0009600ZY	0	+	0	0	1720	0.0000000
zheyou73v0_A06	654449	656569	BnaA06T0009700ZY	0	+	0	0	2120	0.0000000
zheyou73v0_A06	654449	656569	BnaA06T0009700ZY.1	0	+	0	0	2120	0.0000000
zheyou73v0_A06	659267	663109	BnaA06T0009800ZY	0	+	0	0	3842	0.0000000
zheyou73v0_A06	663523	665196	BnaA06T0009900ZY	0	+	0	0	1673	0.0000000
zheyou73v0_A06	671601	675259	BnaA06T0010000ZY	0	-	0	0	3658	0.0000000
zheyou73v0_A06	676826	679611	BnaA06T0010100ZY	0	+	0	0	2785	0.0000000
zheyou73v0_A06	681166	683726	BnaA06T0010200ZY	0	+	0	0	2560	0.0000000
zheyou73v0_A06	684151	685787	BnaA06T0010300ZY	0	-	0	0	1636	0.0000000
zheyou73v0_A06	687116	694557	BnaA06T0010400ZY	0	-	0	0	7441	0.0000000
zheyou73v0_A06	696203	698357	BnaA06T0010500ZY	0	+	0	0	2154	0.0000000
zheyou73v0_A06	696203	698357	BnaA06T0010500ZY.1	0	+	0	0	2154	0.0000000
zheyou73v0_A06	699244	702828	BnaA06T0010600ZY	0	-	0	0	3584	0.0000000
zheyou73v0_A06	703848	710227	BnaA06T0010700ZY	0	-	0	0	6379	0.0000000
zheyou73v0_A06	710705	716094	BnaA06T0010800ZY	0	-	0	0	5389	0.0000000
zheyou73v0_A06	718531	721697	BnaA06T0010900ZY	0	+	0	0	3166	0.0000000
zheyou73v0_A06	734903	742463	BnaA06T0011000ZY	0	+	0	0	7560	0.0000000
zheyou73v0_A06	746439	747821	BnaA06T0011100ZY	0	-	0	0	1382	0.0000000
zheyou73v0_A06	748568	751403	BnaA06T0011200ZY	0	+	0	0	2835	0.0000000
zheyou73v0_A06	751856	753675	BnaA06T0011300ZY	0	+	0	0	1819	0.0000000
zheyou73v0_A06	757959	761017	BnaA06T0011400ZY	0	-	0	0	3058	0.0000000
zheyou73v0_A06	765434	766766	BnaA06T0011500ZY	0	+	0	0	1332	0.0000000
zheyou73v0_A06	767533	771185	BnaA06T0011600ZY	0	-	0	0	3652	0.0000000
zheyou73v0_A06	780405	781110	BnaA06T0011700ZY	0	+	0	0	705	0.0000000
zheyou73v0_A06	805728	806547	BnaA06T0011800ZY	0	-	0	0	819	0.0000000
zheyou73v0_A06	809675	810972	BnaA06T0011900ZY	0	-	0	0	1297	0.0000000
zheyou73v0_A06	818095	819295	BnaA06T0012000ZY	0	-	0	0	1200	0.0000000
zheyou73v0_A06	827067	827880	BnaA06T0012100ZY	0	+	0	0	813	0.0000000
zheyou73v0_A06	829656	831836	BnaA06T0012200ZY	0	-	0	0	2180	0.0000000
zheyou73v0_A06	829656	831704	BnaA06T0012200ZY.1	0	-	0	0	2048	0.0000000
zheyou73v0_A06	833846	835450	BnaA06T0012300ZY	0	+	0	0	1604	0.0000000
zheyou73v0_A06	837293	840388	BnaA06T0012400ZY	0	-	0	0	3095	0.0000000
zheyou73v0_A06	840497	841322	BnaA06T0012500ZY	0	-	0	0	825	0.0000000
zheyou73v0_A06	843321	844481	BnaA06T0012600ZY	0	-	0	0	1160	0.0000000
zheyou73v0_A06	846702	848707	BnaA06T0012700ZY	0	+	0	0	2005	0.0000000
zheyou73v0_A06	850158	853365	BnaA06T0012800ZY	0	+	0	0	3207	0.0000000
zheyou73v0_A06	850158	853365	BnaA06T0012800ZY.1	0	+	0	0	3207	0.0000000
zheyou73v0_A06	854119	855106	BnaA06T0012900ZY	0	+	0	0	987	0.0000000
zheyou73v0_A06	857093	857584	BnaA06T0013000ZY	0	+	0	0	491	0.0000000
zheyou73v0_A06	857952	860177	BnaA06T0013100ZY	0	+	0	0	2225	0.0000000
zheyou73v0_A06	861150	861681	BnaA06T0013200ZY	0	-	0	0	531	0.0000000
zheyou73v0_A06	918313	918673	BnaA06T0013300ZY	0	+	0	0	360	0.0000000
zheyou73v0_A06	919966	923335	BnaA06T0013400ZY	0	-	0	0	3369	0.0000000
zheyou73v0_A06	926285	927977	BnaA06T0013500ZY	0	-	0	0	1692	0.0000000
zheyou73v0_A06	930384	931714	BnaA06T0013600ZY	0	+	0	0	1330	0.0000000
zheyou73v0_A06	930384	931714	BnaA06T0013600ZY.2	0	+	0	0	1330	0.0000000
zheyou73v0_A06	930655	931714	BnaA06T0013600ZY.1	0	+	0	0	1059	0.0000000
zheyou73v0_A06	932309	935002	BnaA06T0013700ZY	0	+	0	0	2693	0.0000000
zheyou73v0_A06	934887	936146	BnaA06T0013800ZY	0	-	0	0	1259	0.0000000
zheyou73v0_A06	941544	942238	BnaA06T0013900ZY	0	+	0	0	694	0.0000000
zheyou73v0_A06	946315	947884	BnaA06T0014000ZY	0	+	0	0	1569	0.0000000
zheyou73v0_A06	955073	956378	BnaA06T0014100ZY	0	+	0	0	1305	0.0000000
zheyou73v0_A06	955073	956378	BnaA06T0014100ZY.1	0	+	0	0	1305	0.0000000
zheyou73v0_A06	958537	959004	BnaA06T0014200ZY	0	+	0	0	467	0.0000000
zheyou73v0_A06	959102	961090	BnaA06T0014300ZY	0	-	0	0	1988	0.0000000
zheyou73v0_A06	971982	973020	BnaA06T0014400ZY	0	+	0	0	1038	0.0000000
zheyou73v0_A06	978776	980759	BnaA06T0014500ZY	0	-	0	0	1983	0.0000000
zheyou73v0_A06	983375	984473	BnaA06T0014600ZY	0	+	0	0	1098	0.0000000
zheyou73v0_A06	984776	988325	BnaA06T0014700ZY	0	-	0	0	3549	0.0000000
zheyou73v0_A06	1001577	1003753	BnaA06T0014800ZY	0	-	0	0	2176	0.0000000
zheyou73v0_A06	1011788	1012630	BnaA06T0014900ZY	0	+	0	0	842	0.0000000
zheyou73v0_A06	1013423	1015713	BnaA06T0015000ZY	0	-	0	0	2290	0.0000000
zheyou73v0_A06	1017828	1020282	BnaA06T0015100ZY	0	+	0	0	2454	0.0000000
zheyou73v0_A06	1020725	1022054	BnaA06T0015200ZY	0	-	0	0	1329	0.0000000
zheyou73v0_A06	1022340	1024234	BnaA06T0015300ZY	0	-	0	0	1894	0.0000000
zheyou73v0_A06	1026399	1028761	BnaA06T0015400ZY	0	+	0	0	2362	0.0000000
zheyou73v0_A06	1030385	1031338	BnaA06T0015500ZY	0	+	0	0	953	0.0000000
zheyou73v0_A06	1031985	1033308	BnaA06T0015600ZY	0	-	0	0	1323	0.0000000
zheyou73v0_A06	1035219	1036821	BnaA06T0015700ZY	0	+	0	0	1602	0.0000000
zheyou73v0_A06	1037271	1039167	BnaA06T0015800ZY	0	+	0	0	1896	0.0000000
zheyou73v0_A06	1039482	1041095	BnaA06T0015900ZY	0	-	0	0	1613	0.0000000
zheyou73v0_A06	1048409	1050121	BnaA06T0016000ZY	0	-	0	0	1712	0.0000000
zheyou73v0_A06	1053340	1054398	BnaA06T0016100ZY	0	+	0	0	1058	0.0000000
zheyou73v0_A06	1057876	1058957	BnaA06T0016200ZY	0	+	0	0	1081	0.0000000
zheyou73v0_A06	1064658	1069110	BnaA06T0016300ZY	0	-	0	0	4452	0.0000000
zheyou73v0_A06	1104364	1107888	BnaA06T0016400ZY	0	-	0	0	3524	0.0000000
zheyou73v0_A06	1115070	1115831	BnaA06T0016500ZY	0	-	0	0	761	0.0000000
zheyou73v0_A06	1124368	1126178	BnaA06T0016600ZY	0	-	0	0	1810	0.0000000
zheyou73v0_A06	1129180	1130645	BnaA06T0016700ZY	0	+	0	0	1465	0.0000000
zheyou73v0_A06	1132751	1139504	BnaA06T0016800ZY	0	+	0	0	6753	0.0000000
zheyou73v0_A06	1140173	1143575	BnaA06T0016900ZY	0	-	0	0	3402	0.0000000
zheyou73v0_A06	1145552	1147539	BnaA06T0017000ZY	0	-	0	0	1987	0.0000000
zheyou73v0_A06	1147751	1151284	BnaA06T0017100ZY	0	-	0	0	3533	0.0000000
zheyou73v0_A06	1152106	1153599	BnaA06T0017200ZY	0	+	0	0	1493	0.0000000
zheyou73v0_A06	1156735	1158058	BnaA06T0017300ZY	0	+	0	0	1323	0.0000000
zheyou73v0_A06	1159559	1161288	BnaA06T0017400ZY	0	-	0	0	1729	0.0000000
zheyou73v0_A06	1162423	1166813	BnaA06T0017500ZY	0	+	0	0	4390	0.0000000
zheyou73v0_A06	1166849	1167677	BnaA06T0017600ZY	0	-	0	0	828	0.0000000
zheyou73v0_A06	1167895	1169046	BnaA06T0017700ZY	0	+	0	0	1151	0.0000000
zheyou73v0_A06	1169704	1170912	BnaA06T0017800ZY	0	+	0	0	1208	0.0000000
zheyou73v0_A06	1174026	1178468	BnaA06T0017900ZY	0	-	0	0	4442	0.0000000
zheyou73v0_A06	1184998	1185456	BnaA06T0018000ZY	0	+	0	0	458	0.0000000
zheyou73v0_A06	1185765	1188831	BnaA06T0018100ZY	0	-	0	0	3066	0.0000000
zheyou73v0_A06	1191084	1194886	BnaA06T0018200ZY	0	+	0	0	3802	0.0000000
zheyou73v0_A06	1195440	1196935	BnaA06T0018300ZY	0	-	0	0	1495	0.0000000
zheyou73v0_A06	1208453	1212897	BnaA06T0018400ZY	0	+	0	0	4444	0.0000000
zheyou73v0_A06	1214253	1215412	BnaA06T0018500ZY	0	+	0	0	1159	0.0000000
zheyou73v0_A06	1218000	1218722	BnaA06T0018600ZY	0	+	0	0	722	0.0000000
zheyou73v0_A06	1219348	1221267	BnaA06T0018700ZY	0	+	0	0	1919	0.0000000
zheyou73v0_A06	1254786	1255071	BnaA06T0018800ZY	0	+	0	0	285	0.0000000
zheyou73v0_A06	1273449	1277249	BnaA06T0018900ZY	0	+	0	0	3800	0.0000000
zheyou73v0_A06	1278203	1281728	BnaA06T0019000ZY	0	+	0	0	3525	0.0000000
zheyou73v0_A06	1282967	1284774	BnaA06T0019100ZY	0	-	0	0	1807	0.0000000
zheyou73v0_A06	1293992	1297470	BnaA06T0019200ZY	0	+	0	0	3478	0.0000000
zheyou73v0_A06	1293992	1297238	BnaA06T0019200ZY.1	0	+	0	0	3246	0.0000000
zheyou73v0_A06	1299619	1308134	BnaA06T0019300ZY	0	+	0	0	8515	0.0000000
zheyou73v0_A06	1314194	1318327	BnaA06T0019400ZY	0	+	0	0	4133	0.0000000
zheyou73v0_A06	1319447	1324067	BnaA06T0019500ZY	0	+	0	0	4620	0.0000000
zheyou73v0_A06	1325233	1329545	BnaA06T0019600ZY	0	+	0	0	4312	0.0000000
zheyou73v0_A06	1331231	1333532	BnaA06T0019700ZY	0	-	0	0	2301	0.0000000
zheyou73v0_A06	1336066	1341064	BnaA06T0019800ZY	0	-	0	0	4998	0.0000000
zheyou73v0_A06	1343269	1346855	BnaA06T0019900ZY	0	-	0	0	3586	0.0000000
zheyou73v0_A06	1348647	1356197	BnaA06T0020000ZY	0	+	0	0	7550	0.0000000
zheyou73v0_A06	1356950	1360226	BnaA06T0020100ZY	0	-	0	0	3276	0.0000000
zheyou73v0_A06	1363333	1373019	BnaA06T0020200ZY	0	-	0	0	9686	0.0000000
zheyou73v0_A06	1376105	1376930	BnaA06T0020300ZY	0	-	0	0	825	0.0000000
zheyou73v0_A06	1378881	1380525	BnaA06T0020400ZY	0	+	0	0	1644	0.0000000
zheyou73v0_A06	1380545	1380743	BnaA06T0020500ZY	0	+	0	0	198	0.0000000
zheyou73v0_A06	1381534	1383722	BnaA06T0020600ZY	0	+	0	0	2188	0.0000000
zheyou73v0_A06	1381862	1383722	BnaA06T0020600ZY.1	0	+	0	0	1860	0.0000000
zheyou73v0_A06	1383304	1385273	BnaA06T0020700ZY	0	-	0	0	1969	0.0000000
zheyou73v0_A06	1385727	1389244	BnaA06T0020800ZY	0	-	0	0	3517	0.0000000
zheyou73v0_A06	1391584	1395867	BnaA06T0020900ZY	0	+	0	0	4283	0.0000000
zheyou73v0_A06	1396224	1397244	BnaA06T0021000ZY	0	+	0	0	1020	0.0000000
zheyou73v0_A06	1415192	1417042	BnaA06T0021100ZY	0	-	0	0	1850	0.0000000
zheyou73v0_A06	1418221	1419928	BnaA06T0021200ZY	0	+	0	0	1707	0.0000000
zheyou73v0_A06	1428045	1432470	BnaA06T0021300ZY	0	+	0	0	4425	0.0000000
zheyou73v0_A06	1433246	1435295	BnaA06T0021400ZY	0	-	0	0	2049	0.0000000
zheyou73v0_A06	1437761	1439532	BnaA06T0021500ZY	0	-	0	0	1771	0.0000000
zheyou73v0_A06	1446068	1448175	BnaA06T0021600ZY	0	-	0	0	2107	0.0000000
zheyou73v0_A06	1450333	1450642	BnaA06T0021700ZY	0	+	0	0	309	0.0000000
zheyou73v0_A06	1451003	1452996	BnaA06T0021800ZY	0	-	0	0	1993	0.0000000
zheyou73v0_A06	1457084	1457255	BnaA06T0021900ZY	0	-	0	0	171	0.0000000
zheyou73v0_A06	1458899	1459458	BnaA06T0022000ZY	0	-	0	0	559	0.0000000
zheyou73v0_A06	1463045	1466079	BnaA06T0022100ZY	0	-	0	0	3034	0.0000000
zheyou73v0_A06	1476855	1478912	BnaA06T0022200ZY	0	+	0	0	2057	0.0000000
zheyou73v0_A06	1479907	1481293	BnaA06T0022300ZY	0	-	0	0	1386	0.0000000
zheyou73v0_A06	1482204	1484406	BnaA06T0022400ZY	0	-	0	0	2202	0.0000000
zheyou73v0_A06	1486333	1490382	BnaA06T0022500ZY	0	-	0	0	4049	0.0000000
zheyou73v0_A06	1512418	1513874	BnaA06T0022600ZY	0	+	0	0	1456	0.0000000
zheyou73v0_A06	1515922	1517759	BnaA06T0022700ZY	0	-	0	0	1837	0.0000000
zheyou73v0_A06	1521377	1523272	BnaA06T0022800ZY	0	+	0	0	1895	0.0000000
zheyou73v0_A06	1527137	1529328	BnaA06T0022900ZY	0	+	0	0	2191	0.0000000
zheyou73v0_A06	1529478	1530495	BnaA06T0023000ZY	0	-	0	0	1017	0.0000000
zheyou73v0_A06	1531719	1533804	BnaA06T0023100ZY	0	-	0	0	2085	0.0000000
zheyou73v0_A06	1534543	1535458	BnaA06T0023200ZY	0	-	0	0	915	0.0000000
zheyou73v0_A06	1536640	1537709	BnaA06T0023300ZY	0	+	0	0	1069	0.0000000
zheyou73v0_A06	1538192	1542400	BnaA06T0023400ZY	0	-	0	0	4208	0.0000000
zheyou73v0_A06	1544874	1549661	BnaA06T0023500ZY	0	-	0	0	4787	0.0000000
zheyou73v0_A06	1552529	1557739	BnaA06T0023600ZY	0	-	0	0	5210	0.0000000
zheyou73v0_A06	1559444	1563937	BnaA06T0023700ZY	0	-	0	0	4493	0.0000000
zheyou73v0_A06	1568352	1578115	BnaA06T0023800ZY	0	-	0	0	9763	0.0000000
zheyou73v0_A06	1584439	1585684	BnaA06T0023900ZY	0	+	0	0	1245	0.0000000
zheyou73v0_A06	1588639	1589473	BnaA06T0024000ZY	0	+	0	0	834	0.0000000
zheyou73v0_A06	1594189	1594849	BnaA06T0024100ZY	0	+	0	0	660	0.0000000
zheyou73v0_A06	1594548	1599116	BnaA06T0024200ZY	0	-	0	0	4568	0.0000000
zheyou73v0_A06	1605492	1606232	BnaA06T0024300ZY	0	-	0	0	740	0.0000000
zheyou73v0_A06	1611088	1613800	BnaA06T0024400ZY	0	+	0	0	2712	0.0000000
zheyou73v0_A06	1613502	1614498	BnaA06T0024500ZY	0	-	0	0	996	0.0000000
zheyou73v0_A06	1618494	1622911	BnaA06T0024600ZY	0	-	0	0	4417	0.0000000
zheyou73v0_A06	1624752	1627127	BnaA06T0024700ZY	0	+	0	0	2375	0.0000000
zheyou73v0_A06	1628372	1629316	BnaA06T0024800ZY	0	-	0	0	944	0.0000000
zheyou73v0_A06	1629770	1630527	BnaA06T0024900ZY	0	-	0	0	757	0.0000000
zheyou73v0_A06	1630777	1636764	BnaA06T0025000ZY	0	-	0	0	5987	0.0000000
zheyou73v0_A06	1646110	1648036	BnaA06T0025100ZY	0	-	0	0	1926	0.0000000
zheyou73v0_A06	1653717	1654182	BnaA06T0025200ZY	0	+	0	0	465	0.0000000
zheyou73v0_A06	1657552	1661107	BnaA06T0025300ZY	0	+	0	0	3555	0.0000000
zheyou73v0_A06	1661426	1662461	BnaA06T0025400ZY	0	+	0	0	1035	0.0000000
zheyou73v0_A06	1663679	1664714	BnaA06T0025500ZY	0	+	0	0	1035	0.0000000
zheyou73v0_A06	1665428	1667395	BnaA06T0025600ZY	0	+	0	0	1967	0.0000000
zheyou73v0_A06	1665428	1667571	BnaA06T0025600ZY.1	0	+	0	0	2143	0.0000000
zheyou73v0_A06	1665428	1667576	BnaA06T0025600ZY.2	0	+	0	0	2148	0.0000000
zheyou73v0_A06	1668039	1671285	BnaA06T0025700ZY	0	-	0	0	3246	0.0000000
zheyou73v0_A06	1679638	1680243	BnaA06T0025800ZY	0	+	0	0	605	0.0000000
zheyou73v0_A06	1686264	1687089	BnaA06T0025900ZY	0	+	0	0	825	0.0000000
zheyou73v0_A06	1706512	1710615	BnaA06T0026000ZY	0	+	0	0	4103	0.0000000
zheyou73v0_A06	1709858	1710479	BnaA06T0026100ZY	0	-	0	0	621	0.0000000
zheyou73v0_A06	1715263	1717718	BnaA06T0026200ZY	0	+	0	0	2455	0.0000000
zheyou73v0_A06	1724930	1726566	BnaA06T0026300ZY	0	+	0	0	1636	0.0000000
zheyou73v0_A06	1727371	1729038	BnaA06T0026400ZY	0	+	0	0	1667	0.0000000
zheyou73v0_A06	1729999	1732605	BnaA06T0026500ZY	0	+	0	0	2606	0.0000000
zheyou73v0_A06	1735035	1737323	BnaA06T0026600ZY	0	-	0	0	2288	0.0000000
zheyou73v0_A06	1739177	1740200	BnaA06T0026700ZY	0	-	0	0	1023	0.0000000
zheyou73v0_A06	1742463	1744280	BnaA06T0026800ZY	0	+	0	0	1817	0.0000000
zheyou73v0_A06	1745253	1746399	BnaA06T0026900ZY	0	+	0	0	1146	0.0000000
zheyou73v0_A06	1746757	1749934	BnaA06T0027000ZY	0	-	0	0	3177	0.0000000
zheyou73v0_A06	1752183	1755244	BnaA06T0027100ZY	0	-	0	0	3061	0.0000000
zheyou73v0_A06	1759246	1762053	BnaA06T0027200ZY	0	+	0	0	2807	0.0000000
zheyou73v0_A06	1765851	1767186	BnaA06T0027300ZY	0	+	0	0	1335	0.0000000
zheyou73v0_A06	1767522	1772129	BnaA06T0027400ZY	0	-	0	0	4607	0.0000000
zheyou73v0_A06	1773051	1775230	BnaA06T0027500ZY	0	-	0	0	2179	0.0000000
zheyou73v0_A06	1776292	1780495	BnaA06T0027600ZY	0	-	0	0	4203	0.0000000
zheyou73v0_A06	1805603	1805953	BnaA06T0027700ZY	0	-	0	0	350	0.0000000
zheyou73v0_A06	1806699	1812801	BnaA06T0027800ZY	0	-	0	0	6102	0.0000000
zheyou73v0_A06	1807907	1812801	BnaA06T0027800ZY.1	0	-	0	0	4894	0.0000000
zheyou73v0_A06	1815005	1815603	BnaA06T0027900ZY	0	-	0	0	598	0.0000000
zheyou73v0_A06	1816492	1817376	BnaA06T0028000ZY	0	+	0	0	884	0.0000000
zheyou73v0_A06	1817669	1820087	BnaA06T0028100ZY	0	-	0	0	2418	0.0000000
zheyou73v0_A06	1824103	1824466	BnaA06T0028200ZY	0	-	0	0	363	0.0000000
zheyou73v0_A06	1827503	1828550	BnaA06T0028300ZY	0	+	0	0	1047	0.0000000
zheyou73v0_A06	1834333	1834567	BnaA06T0028400ZY	0	-	0	0	234	0.0000000
zheyou73v0_A06	1838691	1845491	BnaA06T0028500ZY	0	+	0	0	6800	0.0000000
zheyou73v0_A06	1878928	1883304	BnaA06T0028600ZY	0	-	0	0	4376	0.0000000
zheyou73v0_A06	1878928	1883304	BnaA06T0028600ZY.1	0	-	0	0	4376	0.0000000
zheyou73v0_A06	1884813	1886828	BnaA06T0028700ZY	0	+	0	0	2015	0.0000000
zheyou73v0_A06	1896998	1914314	BnaA06T0028800ZY	0	+	0	0	17316	0.0000000
zheyou73v0_A06	1917929	1918428	BnaA06T0028900ZY	0	-	0	0	499	0.0000000
zheyou73v0_A06	1919738	1921086	BnaA06T0029000ZY	0	+	0	0	1348	0.0000000
zheyou73v0_A06	1921294	1923846	BnaA06T0029100ZY	0	-	0	0	2552	0.0000000
zheyou73v0_A06	1924200	1926073	BnaA06T0029200ZY	0	+	0	0	1873	0.0000000
zheyou73v0_A06	1926208	1927438	BnaA06T0029300ZY	0	-	0	0	1230	0.0000000
zheyou73v0_A06	1928233	1928837	BnaA06T0029400ZY	0	-	0	0	604	0.0000000
zheyou73v0_A06	1929101	1932536	BnaA06T0029500ZY	0	-	0	0	3435	0.0000000
zheyou73v0_A06	1933935	1935207	BnaA06T0029600ZY	0	+	0	0	1272	0.0000000
zheyou73v0_A06	1936285	1937054	BnaA06T0029700ZY	0	+	0	0	769	0.0000000
zheyou73v0_A06	1941113	1943522	BnaA06T0029800ZY	0	+	0	0	2409	0.0000000
zheyou73v0_A06	1941552	1943522	BnaA06T0029800ZY.1	0	+	0	0	1970	0.0000000
zheyou73v0_A06	1945313	1946435	BnaA06T0029900ZY	0	+	0	0	1122	0.0000000
zheyou73v0_A06	1947741	1951291	BnaA06T0030000ZY	0	-	0	0	3550	0.0000000
zheyou73v0_A06	1958516	1963293	BnaA06T0030100ZY	0	-	0	0	4777	0.0000000
zheyou73v0_A06	1965675	1966965	BnaA06T0030200ZY	0	+	0	0	1290	0.0000000
zheyou73v0_A06	1967253	1970737	BnaA06T0030300ZY	0	-	0	0	3484	0.0000000
zheyou73v0_A06	1974332	1975168	BnaA06T0030400ZY	0	-	0	0	836	0.0000000
zheyou73v0_A06	1977541	1983723	BnaA06T0030500ZY	0	-	0	0	6182	0.0000000
zheyou73v0_A06	1986472	1988255	BnaA06T0030600ZY	0	+	0	0	1783	0.0000000
zheyou73v0_A06	1998040	1998991	BnaA06T0030700ZY	0	-	0	0	951	0.0000000
zheyou73v0_A06	1999599	2000974	BnaA06T0030800ZY	0	-	0	0	1375	0.0000000
zheyou73v0_A06	2009831	2012477	BnaA06T0030900ZY	0	+	0	0	2646	0.0000000
zheyou73v0_A06	2019388	2022206	BnaA06T0031000ZY	0	-	0	0	2818	0.0000000
zheyou73v0_A06	2026765	2031788	BnaA06T0031100ZY	0	-	0	0	5023	0.0000000
zheyou73v0_A06	2037016	2038386	BnaA06T0031200ZY	0	+	0	0	1370	0.0000000
zheyou73v0_A06	2038597	2042035	BnaA06T0031300ZY	0	-	0	0	3438	0.0000000
zheyou73v0_A06	2058248	2060478	BnaA06T0031400ZY	0	+	0	0	2230	0.0000000
zheyou73v0_A06	2062374	2066225	BnaA06T0031500ZY	0	+	0	0	3851	0.0000000
zheyou73v0_A06	2073283	2075420	BnaA06T0031600ZY	0	+	0	0	2137	0.0000000
zheyou73v0_A06	2077186	2079898	BnaA06T0031700ZY	0	+	0	0	2712	0.0000000
zheyou73v0_A06	2080381	2082038	BnaA06T0031800ZY	0	-	0	0	1657	0.0000000
zheyou73v0_A06	2087072	2088410	BnaA06T0031900ZY	0	-	0	0	1338	0.0000000
zheyou73v0_A06	2101334	2104944	BnaA06T0032000ZY	0	+	0	0	3610	0.0000000
zheyou73v0_A06	2105369	2107674	BnaA06T0032100ZY	0	-	0	0	2305	0.0000000
zheyou73v0_A06	2108926	2109388	BnaA06T0032200ZY	0	-	0	0	462	0.0000000
zheyou73v0_A06	2120355	2120553	BnaA06T0032300ZY	0	+	0	0	198	0.0000000
zheyou73v0_A06	2127686	2128088	BnaA06T0032400ZY	0	-	0	0	402	0.0000000
zheyou73v0_A06	2129659	2141607	BnaA06T0032500ZY	0	-	0	0	11948	0.0000000
zheyou73v0_A06	2145370	2146617	BnaA06T0032600ZY	0	-	0	0	1247	0.0000000
zheyou73v0_A06	2163973	2164590	BnaA06T0032700ZY	0	+	0	0	617	0.0000000
zheyou73v0_A06	2173144	2174502	BnaA06T0032800ZY	0	+	0	0	1358	0.0000000
zheyou73v0_A06	2178560	2181746	BnaA06T0032900ZY	0	+	0	0	3186	0.0000000
zheyou73v0_A06	2188020	2188679	BnaA06T0033000ZY	0	-	0	0	659	0.0000000
zheyou73v0_A06	2195739	2196595	BnaA06T0033100ZY	0	-	0	0	856	0.0000000
zheyou73v0_A06	2199063	2199802	BnaA06T0033200ZY	0	-	0	0	739	0.0000000
zheyou73v0_A06	2204980	2205658	BnaA06T0033300ZY	0	-	0	0	678	0.0000000
zheyou73v0_A06	2218051	2218384	BnaA06T0033400ZY	0	+	0	0	333	0.0000000
zheyou73v0_A06	2218905	2228096	BnaA06T0033500ZY	0	+	0	0	9191	0.0000000
zheyou73v0_A06	2228507	2229816	BnaA06T0033600ZY	0	-	0	0	1309	0.0000000
zheyou73v0_A06	2230702	2232310	BnaA06T0033700ZY	0	-	0	0	1608	0.0000000
zheyou73v0_A06	2233577	2234877	BnaA06T0033800ZY	0	-	0	0	1300	0.0000000
zheyou73v0_A06	2242750	2243321	BnaA06T0033900ZY	0	+	0	0	571	0.0000000
zheyou73v0_A06	2244710	2247500	BnaA06T0034000ZY	0	-	0	0	2790	0.0000000
zheyou73v0_A06	2248788	2250354	BnaA06T0034100ZY	0	-	0	0	1566	0.0000000
zheyou73v0_A06	2284794	2329783	BnaA06T0034200ZY	0	+	0	0	44989	0.0000000
zheyou73v0_A06	2336446	2338895	BnaA06T0034300ZY	0	+	0	0	2449	0.0000000
zheyou73v0_A06	2339242	2342006	BnaA06T0034400ZY	0	-	0	0	2764	0.0000000
zheyou73v0_A06	2350744	2352853	BnaA06T0034500ZY	0	+	0	0	2109	0.0000000
zheyou73v0_A06	2354560	2355150	BnaA06T0034600ZY	0	+	0	0	590	0.0000000
zheyou73v0_A06	2356836	2357756	BnaA06T0034700ZY	0	+	0	0	920	0.0000000
zheyou73v0_A06	2358828	2360273	BnaA06T0034800ZY	0	-	0	0	1445	0.0000000
zheyou73v0_A06	2361793	2365279	BnaA06T0034900ZY	0	+	0	0	3486	0.0000000
zheyou73v0_A06	2366120	2366901	BnaA06T0035000ZY	0	-	0	0	781	0.0000000
zheyou73v0_A06	2367789	2368706	BnaA06T0035100ZY	0	-	0	0	917	0.0000000
zheyou73v0_A06	2376101	2376392	BnaA06T0035200ZY	0	-	0	0	291	0.0000000
zheyou73v0_A06	2398271	2400024	BnaA06T0035300ZY	0	+	0	0	1753	0.0000000
zheyou73v0_A06	2401641	2406816	BnaA06T0035400ZY	0	+	0	0	5175	0.0000000
zheyou73v0_A06	2408384	2410455	BnaA06T0035500ZY	0	-	0	0	2071	0.0000000
zheyou73v0_A06	2408384	2410455	BnaA06T0035500ZY.1	0	-	0	0	2071	0.0000000
zheyou73v0_A06	2411272	2412527	BnaA06T0035600ZY	0	+	0	0	1255	0.0000000
zheyou73v0_A06	2415355	2417222	BnaA06T0035700ZY	0	+	0	0	1867	0.0000000
zheyou73v0_A06	2420572	2422518	BnaA06T0035800ZY	0	+	0	0	1946	0.0000000
zheyou73v0_A06	2423414	2425866	BnaA06T0035900ZY	0	+	0	0	2452	0.0000000
zheyou73v0_A06	2427585	2431228	BnaA06T0036000ZY	0	-	0	0	3643	0.0000000
zheyou73v0_A06	2432066	2434499	BnaA06T0036100ZY	0	+	0	0	2433	0.0000000
zheyou73v0_A06	2434480	2437608	BnaA06T0036200ZY	0	-	0	0	3128	0.0000000
zheyou73v0_A06	2438423	2441121	BnaA06T0036300ZY	0	+	0	0	2698	0.0000000
zheyou73v0_A06	2441123	2443426	BnaA06T0036400ZY	0	-	0	0	2303	0.0000000
zheyou73v0_A06	2457625	2459664	BnaA06T0036500ZY	0	+	0	0	2039	0.0000000
zheyou73v0_A06	2457625	2459664	BnaA06T0036500ZY.1	0	+	0	0	2039	0.0000000
zheyou73v0_A06	2459700	2465090	BnaA06T0036600ZY	0	-	0	0	5390	0.0000000
zheyou73v0_A06	2468836	2474757	BnaA06T0036700ZY	0	+	0	0	5921	0.0000000
zheyou73v0_A06	2477689	2482323	BnaA06T0036800ZY	0	-	0	0	4634	0.0000000
zheyou73v0_A06	2483793	2485456	BnaA06T0036900ZY	0	+	0	0	1663	0.0000000
zheyou73v0_A06	2486155	2486896	BnaA06T0037000ZY	0	-	0	0	741	0.0000000
zheyou73v0_A06	2487399	2489929	BnaA06T0037100ZY	0	+	0	0	2530	0.0000000
zheyou73v0_A06	2496448	2496940	BnaA06T0037200ZY	0	+	0	0	492	0.0000000
zheyou73v0_A06	2499786	2500020	BnaA06T0037300ZY	0	-	0	0	234	0.0000000
zheyou73v0_A06	2517788	2518409	BnaA06T0037400ZY	0	+	0	0	621	0.0000000
zheyou73v0_A06	2530040	2535452	BnaA06T0037500ZY	0	+	0	0	5412	0.0000000
zheyou73v0_A06	2548086	2553567	BnaA06T0037600ZY	0	-	0	0	5481	0.0000000
zheyou73v0_A06	2548086	2553567	BnaA06T0037600ZY.1	0	-	0	0	5481	0.0000000
zheyou73v0_A06	2556735	2559156	BnaA06T0037700ZY	0	+	0	0	2421	0.0000000
zheyou73v0_A06	2559769	2562291	BnaA06T0037800ZY	0	-	0	0	2522	0.0000000
zheyou73v0_A06	2567627	2571616	BnaA06T0037900ZY	0	+	0	0	3989	0.0000000
zheyou73v0_A06	2573984	2578752	BnaA06T0038000ZY	0	+	0	0	4768	0.0000000
zheyou73v0_A06	2580307	2586240	BnaA06T0038100ZY	0	-	0	0	5933	0.0000000
zheyou73v0_A06	2587856	2590717	BnaA06T0038200ZY	0	-	0	0	2861	0.0000000
zheyou73v0_A06	2594414	2595114	BnaA06T0038300ZY	0	+	0	0	700	0.0000000
zheyou73v0_A06	2595576	2596746	BnaA06T0038400ZY	0	-	0	0	1170	0.0000000
zheyou73v0_A06	2601674	2602558	BnaA06T0038500ZY	0	-	0	0	884	0.0000000
zheyou73v0_A06	2605124	2610445	BnaA06T0038600ZY	0	+	0	0	5321	0.0000000
zheyou73v0_A06	2618502	2621655	BnaA06T0038700ZY	0	+	0	0	3153	0.0000000
zheyou73v0_A06	2622033	2624913	BnaA06T0038800ZY	0	-	0	0	2880	0.0000000
zheyou73v0_A06	2623050	2624913	BnaA06T0038800ZY.1	0	-	0	0	1863	0.0000000
zheyou73v0_A06	2633385	2635492	BnaA06T0038900ZY	0	-	0	0	2107	0.0000000
zheyou73v0_A06	2638184	2662561	BnaA06T0039000ZY	0	+	0	0	24377	0.0000000
zheyou73v0_A06	2674579	2675146	BnaA06T0039100ZY	0	+	0	0	567	0.0000000
zheyou73v0_A06	2678661	2700536	BnaA06T0039200ZY	0	+	0	0	21875	0.0000000
zheyou73v0_A06	2704151	2714880	BnaA06T0039300ZY	0	+	0	0	10729	0.0000000
zheyou73v0_A06	2715963	2718076	BnaA06T0039400ZY	0	+	0	0	2113	0.0000000
zheyou73v0_A06	2718664	2720403	BnaA06T0039500ZY	0	+	0	0	1739	0.0000000
zheyou73v0_A06	2726256	2732332	BnaA06T0039600ZY	0	-	0	0	6076	0.0000000
zheyou73v0_A06	2743643	2745258	BnaA06T0039700ZY	0	+	0	0	1615	0.0000000
zheyou73v0_A06	2748809	2750165	BnaA06T0039800ZY	0	-	0	0	1356	0.0000000
zheyou73v0_A06	2754423	2755562	BnaA06T0039900ZY	0	+	0	0	1139	0.0000000
zheyou73v0_A06	2756868	2758423	BnaA06T0040000ZY	0	+	0	0	1555	0.0000000
zheyou73v0_A06	2759447	2766666	BnaA06T0040100ZY	0	-	0	0	7219	0.0000000
zheyou73v0_A06	2769375	2770206	BnaA06T0040200ZY	0	-	0	0	831	0.0000000
zheyou73v0_A06	2770620	2771084	BnaA06T0040300ZY	0	+	0	0	464	0.0000000
zheyou73v0_A06	2775940	2778102	BnaA06T0040400ZY	0	-	0	0	2162	0.0000000
zheyou73v0_A06	2779002	2779834	BnaA06T0040500ZY.1	0	+	0	0	832	0.0000000
zheyou73v0_A06	2779039	2779834	BnaA06T0040500ZY	0	+	0	0	795	0.0000000
zheyou73v0_A06	2783794	2785363	BnaA06T0040600ZY	0	+	0	0	1569	0.0000000
zheyou73v0_A06	2785765	2786065	BnaA06T0040700ZY	0	-	0	0	300	0.0000000
zheyou73v0_A06	2787656	2787956	BnaA06T0040800ZY	0	-	0	0	300	0.0000000
zheyou73v0_A06	2797143	2797616	BnaA06T0040900ZY	0	-	0	0	473	0.0000000
zheyou73v0_A06	2798476	2800470	BnaA06T0041000ZY	0	+	0	0	1994	0.0000000
zheyou73v0_A06	2800773	2802510	BnaA06T0041100ZY	0	+	0	0	1737	0.0000000
zheyou73v0_A06	2805367	2807091	BnaA06T0041200ZY	0	+	0	0	1724	0.0000000
zheyou73v0_A06	2810047	2811774	BnaA06T0041300ZY	0	+	0	0	1727	0.0000000
zheyou73v0_A06	2812056	2825231	BnaA06T0041400ZY	0	-	0	0	13175	0.0000000
zheyou73v0_A06	2826984	2830105	BnaA06T0041500ZY	0	-	0	0	3121	0.0000000
zheyou73v0_A06	2830361	2831438	BnaA06T0041600ZY	0	+	0	0	1077	0.0000000
zheyou73v0_A06	2832842	2834552	BnaA06T0041700ZY	0	+	0	0	1710	0.0000000
zheyou73v0_A06	2834900	2837540	BnaA06T0041800ZY	0	+	0	0	2640	0.0000000
zheyou73v0_A06	2837756	2840104	BnaA06T0041900ZY	0	-	0	0	2348	0.0000000
zheyou73v0_A06	2855766	2858506	BnaA06T0042000ZY	0	+	0	0	2740	0.0000000
zheyou73v0_A06	2855766	2858506	BnaA06T0042000ZY.1	0	+	0	0	2740	0.0000000
zheyou73v0_A06	2867962	2869325	BnaA06T0042100ZY	0	+	0	0	1363	0.0000000
zheyou73v0_A06	2870319	2878066	BnaA06T0042200ZY	0	+	0	0	7747	0.0000000
zheyou73v0_A06	2878688	2881832	BnaA06T0042300ZY	0	+	0	0	3144	0.0000000
zheyou73v0_A06	2882320	2883177	BnaA06T0042400ZY	0	-	0	0	857	0.0000000
zheyou73v0_A06	2884867	2886215	BnaA06T0042500ZY	0	+	0	0	1348	0.0000000
zheyou73v0_A06	2893907	2899181	BnaA06T0042600ZY	0	+	0	0	5274	0.0000000
zheyou73v0_A06	2899830	2905157	BnaA06T0042700ZY	0	+	0	0	5327	0.0000000
zheyou73v0_A06	2908685	2912493	BnaA06T0042800ZY	0	-	0	0	3808	0.0000000
zheyou73v0_A06	2914222	2916976	BnaA06T0042900ZY	0	-	0	0	2754	0.0000000
zheyou73v0_A06	2917863	2919912	BnaA06T0043000ZY	0	-	0	0	2049	0.0000000
zheyou73v0_A06	2921286	2930721	BnaA06T0043100ZY	0	-	0	0	9435	0.0000000
zheyou73v0_A06	2933262	2936565	BnaA06T0043200ZY	0	-	0	0	3303	0.0000000
zheyou73v0_A06	2960753	2962905	BnaA06T0043300ZY	0	+	0	0	2152	0.0000000
zheyou73v0_A06	2964164	2966077	BnaA06T0043400ZY	0	-	0	0	1913	0.0000000
zheyou73v0_A06	2970727	2973021	BnaA06T0043500ZY	0	+	0	0	2294	0.0000000
zheyou73v0_A06	2970727	2973021	BnaA06T0043500ZY.1	0	+	0	0	2294	0.0000000
zheyou73v0_A06	2973100	2975217	BnaA06T0043600ZY	0	-	0	0	2117	0.0000000
zheyou73v0_A06	2975552	2979664	BnaA06T0043700ZY	0	-	0	0	4112	0.0000000
zheyou73v0_A06	2980321	2982984	BnaA06T0043800ZY	0	-	0	0	2663	0.0000000
zheyou73v0_A06	2984343	2987130	BnaA06T0043900ZY	0	-	0	0	2787	0.0000000
zheyou73v0_A06	2987940	2988602	BnaA06T0044000ZY	0	-	0	0	662	0.0000000
zheyou73v0_A06	2989076	2990073	BnaA06T0044100ZY	0	-	0	0	997	0.0000000
zheyou73v0_A06	2990571	2991589	BnaA06T0044200ZY	0	-	0	0	1018	0.0000000
zheyou73v0_A06	2992795	2993333	BnaA06T0044300ZY	0	+	0	0	538	0.0000000
zheyou73v0_A06	2996759	2997089	BnaA06T0044400ZY	0	-	0	0	330	0.0000000
zheyou73v0_A06	3002065	3007763	BnaA06T0044500ZY	0	+	0	0	5698	0.0000000
zheyou73v0_A06	3007967	3010670	BnaA06T0044600ZY	0	-	0	0	2703	0.0000000
zheyou73v0_A06	3014090	3014726	BnaA06T0044700ZY	0	+	0	0	636	0.0000000
zheyou73v0_A06	3015017	3030360	BnaA06T0044800ZY	0	+	0	0	15343	0.0000000
zheyou73v0_A06	3015017	3027539	BnaA06T0044800ZY.1	0	+	0	0	12522	0.0000000
zheyou73v0_A06	3030410	3033026	BnaA06T0044900ZY	0	-	0	0	2616	0.0000000
zheyou73v0_A06	3034440	3036304	BnaA06T0045000ZY	0	+	0	0	1864	0.0000000
zheyou73v0_A06	3036771	3039095	BnaA06T0045100ZY	0	-	0	0	2324	0.0000000
zheyou73v0_A06	3041117	3044579	BnaA06T0045200ZY	0	+	0	0	3462	0.0000000
zheyou73v0_A06	3044957	3047881	BnaA06T0045300ZY	0	+	0	0	2924	0.0000000
zheyou73v0_A06	3048260	3053895	BnaA06T0045400ZY	0	-	0	0	5635	0.0000000
zheyou73v0_A06	3048260	3052009	BnaA06T0045400ZY.1	0	-	0	0	3749	0.0000000
zheyou73v0_A06	3060977	3063039	BnaA06T0045500ZY	0	+	0	0	2062	0.0000000
zheyou73v0_A06	3063323	3066004	BnaA06T0045600ZY	0	-	0	0	2681	0.0000000
zheyou73v0_A06	3066802	3067603	BnaA06T0045700ZY	0	+	0	0	801	0.0000000
zheyou73v0_A06	3068586	3070018	BnaA06T0045800ZY	0	+	0	0	1432	0.0000000
zheyou73v0_A06	3071004	3071618	BnaA06T0045900ZY	0	-	0	0	614	0.0000000
zheyou73v0_A06	3072105	3073199	BnaA06T0046000ZY	0	+	0	0	1094	0.0000000
zheyou73v0_A06	3073337	3075934	BnaA06T0046100ZY	0	-	0	0	2597	0.0000000
zheyou73v0_A06	3076281	3077328	BnaA06T0046200ZY	0	+	0	0	1047	0.0000000
zheyou73v0_A06	3102262	3106524	BnaA06T0046300ZY	0	+	0	0	4262	0.0000000
zheyou73v0_A06	3109645	3112166	BnaA06T0046400ZY	0	-	0	0	2521	0.0000000
zheyou73v0_A06	3112356	3113160	BnaA06T0046500ZY	0	+	0	0	804	0.0000000
zheyou73v0_A06	3113493	3116212	BnaA06T0046600ZY	0	-	0	0	2719	0.0000000
zheyou73v0_A06	3117084	3119759	BnaA06T0046700ZY	0	-	0	0	2675	0.0000000
zheyou73v0_A06	3122488	3126116	BnaA06T0046800ZY	0	+	0	0	3628	0.0000000
zheyou73v0_A06	3126415	3127864	BnaA06T0046900ZY	0	+	0	0	1449	0.0000000
zheyou73v0_A06	3128250	3131380	BnaA06T0047000ZY	0	+	0	0	3130	0.0000000
zheyou73v0_A06	3132037	3134360	BnaA06T0047100ZY	0	+	0	0	2323	0.0000000
zheyou73v0_A06	3134452	3135881	BnaA06T0047200ZY	0	-	0	0	1429	0.0000000
zheyou73v0_A06	3137816	3138921	BnaA06T0047300ZY	0	+	0	0	1105	0.0000000
zheyou73v0_A06	3139567	3140644	BnaA06T0047400ZY	0	-	0	0	1077	0.0000000
zheyou73v0_A06	3141994	3151415	BnaA06T0047500ZY	0	+	0	0	9421	0.0000000
zheyou73v0_A06	3141994	3151415	BnaA06T0047500ZY.1	0	+	0	0	9421	0.0000000
zheyou73v0_A06	3165629	3168172	BnaA06T0047600ZY	0	-	0	0	2543	0.0000000
zheyou73v0_A06	3172777	3174332	BnaA06T0047700ZY	0	+	0	0	1555	0.0000000
zheyou73v0_A06	3178310	3183244	BnaA06T0047800ZY	0	-	0	0	4934	0.0000000
zheyou73v0_A06	3186652	3190139	BnaA06T0047900ZY	0	+	0	0	3487	0.0000000
zheyou73v0_A06	3191126	3192771	BnaA06T0048000ZY	0	-	0	0	1645	0.0000000
zheyou73v0_A06	3193738	3195144	BnaA06T0048100ZY	0	+	0	0	1406	0.0000000
zheyou73v0_A06	3193738	3195431	BnaA06T0048100ZY.1	0	+	0	0	1693	0.0000000
zheyou73v0_A06	3200597	3203675	BnaA06T0048200ZY	0	+	0	0	3078	0.0000000
zheyou73v0_A06	3204945	3211529	BnaA06T0048300ZY	0	+	0	0	6584	0.0000000
zheyou73v0_A06	3211553	3212177	BnaA06T0048400ZY	0	+	0	0	624	0.0000000
zheyou73v0_A06	3212398	3213407	BnaA06T0048500ZY	0	-	0	0	1009	0.0000000
zheyou73v0_A06	3214624	3215283	BnaA06T0048600ZY	0	+	0	0	659	0.0000000
zheyou73v0_A06	3216126	3219278	BnaA06T0048700ZY	0	-	0	0	3152	0.0000000
zheyou73v0_A06	3221521	3222587	BnaA06T0048800ZY	0	-	0	0	1066	0.0000000
zheyou73v0_A06	3223386	3226481	BnaA06T0048900ZY	0	-	0	0	3095	0.0000000
zheyou73v0_A06	3223386	3226272	BnaA06T0048900ZY.1	0	-	0	0	2886	0.0000000
zheyou73v0_A06	3229758	3233275	BnaA06T0049000ZY	0	+	0	0	3517	0.0000000
zheyou73v0_A06	3233681	3234381	BnaA06T0049100ZY	0	-	0	0	700	0.0000000
zheyou73v0_A06	3234991	3238215	BnaA06T0049200ZY	0	+	0	0	3224	0.0000000
zheyou73v0_A06	3239432	3243107	BnaA06T0049300ZY	0	+	0	0	3675	0.0000000
zheyou73v0_A06	3247664	3250808	BnaA06T0049400ZY	0	+	0	0	3144	0.0000000
zheyou73v0_A06	3257955	3261282	BnaA06T0049500ZY	0	+	0	0	3327	0.0000000
zheyou73v0_A06	3261944	3263542	BnaA06T0049600ZY	0	+	0	0	1598	0.0000000
zheyou73v0_A06	3264153	3265670	BnaA06T0049700ZY	0	+	0	0	1517	0.0000000
zheyou73v0_A06	3266255	3271220	BnaA06T0049800ZY	0	+	0	0	4965	0.0000000
zheyou73v0_A06	3270546	3274754	BnaA06T0049900ZY	0	-	0	0	4208	0.0000000
zheyou73v0_A06	3278411	3282606	BnaA06T0050000ZY	0	-	0	0	4195	0.0000000
zheyou73v0_A06	3288884	3289283	BnaA06T0050100ZY	0	-	0	0	399	0.0000000
zheyou73v0_A06	3295640	3296489	BnaA06T0050200ZY	0	-	0	0	849	0.0000000
zheyou73v0_A06	3305088	3308087	BnaA06T0050300ZY	0	+	0	0	2999	0.0000000
zheyou73v0_A06	3308905	3309103	BnaA06T0050400ZY	0	-	0	0	198	0.0000000
zheyou73v0_A06	3309407	3310374	BnaA06T0050500ZY	0	+	0	0	967	0.0000000
zheyou73v0_A06	3310734	3313992	BnaA06T0050600ZY	0	-	0	0	3258	0.0000000
zheyou73v0_A06	3310734	3313992	BnaA06T0050600ZY.1	0	-	0	0	3258	0.0000000
zheyou73v0_A06	3310734	3313992	BnaA06T0050600ZY.2	0	-	0	0	3258	0.0000000
zheyou73v0_A06	3314164	3315685	BnaA06T0050700ZY	0	+	0	0	1521	0.0000000
zheyou73v0_A06	3318354	3318780	BnaA06T0050800ZY	0	-	0	0	426	0.0000000
zheyou73v0_A06	3318887	3323634	BnaA06T0050900ZY	0	-	0	0	4747	0.0000000
zheyou73v0_A06	3323837	3325305	BnaA06T0051000ZY	0	+	0	0	1468	0.0000000
zheyou73v0_A06	3324739	3326438	BnaA06T0051100ZY	0	-	0	0	1699	0.0000000
zheyou73v0_A06	3330775	3333837	BnaA06T0051200ZY	0	-	0	0	3062	0.0000000
zheyou73v0_A06	3337889	3338861	BnaA06T0051300ZY	0	+	0	0	972	0.0000000
zheyou73v0_A06	3339488	3340106	BnaA06T0051400ZY	0	+	0	0	618	0.0000000
zheyou73v0_A06	3346858	3347371	BnaA06T0051500ZY	0	+	0	0	513	0.0000000
zheyou73v0_A06	3348254	3350874	BnaA06T0051600ZY	0	+	0	0	2620	0.0000000
zheyou73v0_A06	3351214	3353683	BnaA06T0051700ZY	0	-	0	0	2469	0.0000000
zheyou73v0_A06	3354676	3355465	BnaA06T0051800ZY	0	+	0	0	789	0.0000000
zheyou73v0_A06	3355524	3358141	BnaA06T0051900ZY	0	-	0	0	2617	0.0000000
zheyou73v0_A06	3358409	3360188	BnaA06T0052000ZY	0	-	0	0	1779	0.0000000
zheyou73v0_A06	3360430	3363240	BnaA06T0052100ZY	0	+	0	0	2810	0.0000000
zheyou73v0_A06	3360430	3363240	BnaA06T0052100ZY.1	0	+	0	0	2810	0.0000000
zheyou73v0_A06	3368218	3368995	BnaA06T0052200ZY	0	+	0	0	777	0.0000000
zheyou73v0_A06	3374212	3374668	BnaA06T0052300ZY	0	-	0	0	456	0.0000000
zheyou73v0_A06	3374881	3375536	BnaA06T0052400ZY	0	+	0	0	655	0.0000000
zheyou73v0_A06	3377097	3377727	BnaA06T0052500ZY	0	+	0	0	630	0.0000000
zheyou73v0_A06	3378698	3379316	BnaA06T0052600ZY	0	+	0	0	618	0.0000000
zheyou73v0_A06	3383926	3384445	BnaA06T0052700ZY	0	+	0	0	519	0.0000000
zheyou73v0_A06	3384871	3388030	BnaA06T0052800ZY	0	-	0	0	3159	0.0000000
zheyou73v0_A06	3390717	3393199	BnaA06T0052900ZY	0	+	0	0	2482	0.0000000
zheyou73v0_A06	3393906	3394551	BnaA06T0053000ZY	0	+	0	0	645	0.0000000
zheyou73v0_A06	3395326	3397072	BnaA06T0053100ZY	0	-	0	0	1746	0.0000000
zheyou73v0_A06	3398800	3400199	BnaA06T0053200ZY	0	+	0	0	1399	0.0000000
zheyou73v0_A06	3400462	3401674	BnaA06T0053300ZY	0	-	0	0	1212	0.0000000
zheyou73v0_A06	3404522	3406230	BnaA06T0053400ZY	0	+	0	0	1708	0.0000000
zheyou73v0_A06	3406953	3416612	BnaA06T0053500ZY	0	+	0	0	9659	0.0000000
zheyou73v0_A06	3418621	3424660	BnaA06T0053600ZY	0	-	0	0	6039	0.0000000
zheyou73v0_A06	3424670	3425390	BnaA06T0053700ZY	0	-	0	0	720	0.0000000
zheyou73v0_A06	3433382	3435549	BnaA06T0053800ZY	0	+	0	0	2167	0.0000000
zheyou73v0_A06	3445195	3446777	BnaA06T0053900ZY	0	+	0	0	1582	0.0000000
zheyou73v0_A06	3447897	3449193	BnaA06T0054000ZY	0	-	0	0	1296	0.0000000
zheyou73v0_A06	3450463	3451591	BnaA06T0054100ZY	0	+	0	0	1128	0.0000000
zheyou73v0_A06	3452204	3456797	BnaA06T0054200ZY	0	-	0	0	4593	0.0000000
zheyou73v0_A06	3459872	3462027	BnaA06T0054300ZY	0	+	0	0	2155	0.0000000
zheyou73v0_A06	3468714	3470166	BnaA06T0054400ZY	0	+	0	0	1452	0.0000000
zheyou73v0_A06	3470885	3472058	BnaA06T0054500ZY	0	+	0	0	1173	0.0000000
zheyou73v0_A06	3472666	3476388	BnaA06T0054600ZY	0	+	0	0	3722	0.0000000
zheyou73v0_A06	3476913	3480176	BnaA06T0054700ZY	0	-	0	0	3263	0.0000000
zheyou73v0_A06	3481918	3483388	BnaA06T0054800ZY	0	-	0	0	1470	0.0000000
zheyou73v0_A06	3483846	3486052	BnaA06T0054900ZY	0	+	0	0	2206	0.0000000
zheyou73v0_A06	3486545	3488025	BnaA06T0055000ZY	0	+	0	0	1480	0.0000000
zheyou73v0_A06	3488029	3490250	BnaA06T0055100ZY	0	-	0	0	2221	0.0000000
zheyou73v0_A06	3490747	3491521	BnaA06T0055200ZY	0	+	0	0	774	0.0000000
zheyou73v0_A06	3492651	3494717	BnaA06T0055300ZY	0	-	0	0	2066	0.0000000
zheyou73v0_A06	3494982	3495866	BnaA06T0055400ZY	0	-	0	0	884	0.0000000
zheyou73v0_A06	3496079	3497858	BnaA06T0055500ZY	0	-	0	0	1779	0.0000000
zheyou73v0_A06	3506108	3509036	BnaA06T0055600ZY	0	+	0	0	2928	0.0000000
zheyou73v0_A06	3509079	3511853	BnaA06T0055700ZY	0	-	0	0	2774	0.0000000
zheyou73v0_A06	3512449	3519272	BnaA06T0055800ZY	0	-	0	0	6823	0.0000000
zheyou73v0_A06	3519598	3520500	BnaA06T0055900ZY	0	+	0	0	902	0.0000000
zheyou73v0_A06	3521222	3523641	BnaA06T0056000ZY	0	-	0	0	2419	0.0000000
zheyou73v0_A06	3523812	3527093	BnaA06T0056100ZY	0	+	0	0	3281	0.0000000
zheyou73v0_A06	3527720	3530169	BnaA06T0056200ZY	0	-	0	0	2449	0.0000000
zheyou73v0_A06	3531203	3532626	BnaA06T0056300ZY	0	+	0	0	1423	0.0000000
zheyou73v0_A06	3533203	3536749	BnaA06T0056400ZY	0	+	0	0	3546	0.0000000
zheyou73v0_A06	3536990	3541474	BnaA06T0056500ZY	0	-	0	0	4484	0.0000000
zheyou73v0_A06	3542147	3543131	BnaA06T0056600ZY	0	+	0	0	984	0.0000000
zheyou73v0_A06	3543456	3546592	BnaA06T0056700ZY	0	-	0	0	3136	0.0000000
zheyou73v0_A06	3556772	3558059	BnaA06T0056800ZY	0	+	0	0	1287	0.0000000
zheyou73v0_A06	3558326	3559100	BnaA06T0056900ZY	0	+	0	0	774	0.0000000
zheyou73v0_A06	3559706	3561695	BnaA06T0057000ZY	0	-	0	0	1989	0.0000000
zheyou73v0_A06	3561919	3564393	BnaA06T0057100ZY	0	-	0	0	2474	0.0000000
zheyou73v0_A06	3564608	3568555	BnaA06T0057200ZY	0	-	0	0	3947	0.0000000
zheyou73v0_A06	3569538	3573107	BnaA06T0057300ZY	0	+	0	0	3569	0.0000000
zheyou73v0_A06	3569538	3573107	BnaA06T0057300ZY.1	0	+	0	0	3569	0.0000000
zheyou73v0_A06	3572401	3573562	BnaA06T0057400ZY	0	-	0	0	1161	0.0000000
zheyou73v0_A06	3575036	3578052	BnaA06T0057500ZY	0	+	0	0	3016	0.0000000
zheyou73v0_A06	3575036	3578052	BnaA06T0057500ZY.1	0	+	0	0	3016	0.0000000
zheyou73v0_A06	3577913	3581322	BnaA06T0057600ZY	0	-	0	0	3409	0.0000000
zheyou73v0_A06	3584238	3588055	BnaA06T0057700ZY	0	-	0	0	3817	0.0000000
zheyou73v0_A06	3588147	3589929	BnaA06T0057800ZY	0	+	0	0	1782	0.0000000
zheyou73v0_A06	3590076	3593877	BnaA06T0057900ZY	0	-	0	0	3801	0.0000000
zheyou73v0_A06	3594384	3598210	BnaA06T0058000ZY	0	-	0	0	3826	0.0000000
zheyou73v0_A06	3605858	3607745	BnaA06T0058100ZY	0	-	0	0	1887	0.0000000
zheyou73v0_A06	3611146	3611882	BnaA06T0058200ZY	0	-	0	0	736	0.0000000
zheyou73v0_A06	3617181	3620334	BnaA06T0058300ZY	0	+	0	0	3153	0.0000000
zheyou73v0_A06	3623032	3631977	BnaA06T0058400ZY	0	+	0	0	8945	0.0000000
zheyou73v0_A06	3633087	3637495	BnaA06T0058500ZY	0	-	0	0	4408	0.0000000
zheyou73v0_A06	3638540	3642409	BnaA06T0058600ZY	0	+	0	0	3869	0.0000000
zheyou73v0_A06	3644137	3646360	BnaA06T0058700ZY	0	+	0	0	2223	0.0000000
zheyou73v0_A06	3653353	3656421	BnaA06T0058800ZY	0	+	0	0	3068	0.0000000
zheyou73v0_A06	3657018	3659367	BnaA06T0058900ZY	0	-	0	0	2349	0.0000000
zheyou73v0_A06	3664943	3667233	BnaA06T0059000ZY	0	+	0	0	2290	0.0000000
zheyou73v0_A06	3668694	3673150	BnaA06T0059100ZY	0	+	0	0	4456	0.0000000
zheyou73v0_A06	3668694	3673150	BnaA06T0059100ZY.2	0	+	0	0	4456	0.0000000
zheyou73v0_A06	3668694	3673150	BnaA06T0059100ZY.3	0	+	0	0	4456	0.0000000
zheyou73v0_A06	3670022	3673424	BnaA06T0059100ZY.1	0	+	0	0	3402	0.0000000
zheyou73v0_A06	3675714	3678518	BnaA06T0059200ZY	0	+	0	0	2804	0.0000000
zheyou73v0_A06	3678632	3680151	BnaA06T0059300ZY	0	-	0	0	1519	0.0000000
zheyou73v0_A06	3688259	3698038	BnaA06T0059400ZY	0	+	0	0	9779	0.0000000
zheyou73v0_A06	3698935	3699448	BnaA06T0059500ZY	0	-	0	0	513	0.0000000
zheyou73v0_A06	3701136	3701833	BnaA06T0059600ZY	0	+	0	0	697	0.0000000
zheyou73v0_A06	3702274	3703076	BnaA06T0059700ZY	0	-	0	0	802	0.0000000
zheyou73v0_A06	3704246	3707600	BnaA06T0059800ZY	0	-	0	0	3354	0.0000000
zheyou73v0_A06	3712169	3712535	BnaA06T0059900ZY	0	+	0	0	366	0.0000000
zheyou73v0_A06	3713066	3713793	BnaA06T0060000ZY	0	-	0	0	727	0.0000000
zheyou73v0_A06	3714598	3716256	BnaA06T0060100ZY	0	-	0	0	1658	0.0000000
zheyou73v0_A06	3717460	3719956	BnaA06T0060200ZY	0	+	0	0	2496	0.0000000
zheyou73v0_A06	3721008	3728867	BnaA06T0060300ZY	0	+	0	0	7859	0.0000000
zheyou73v0_A06	3733439	3735551	BnaA06T0060400ZY	0	+	0	0	2112	0.0000000
zheyou73v0_A06	3736151	3738474	BnaA06T0060500ZY	0	-	0	0	2323	0.0000000
zheyou73v0_A06	3742042	3749144	BnaA06T0060600ZY	0	+	0	0	7102	0.0000000
zheyou73v0_A06	3749319	3752005	BnaA06T0060700ZY	0	+	0	0	2686	0.0000000
zheyou73v0_A06	3752103	3752571	BnaA06T0060800ZY	0	-	0	0	468	0.0000000
zheyou73v0_A06	3755566	3756274	BnaA06T0060900ZY	0	-	0	0	708	0.0000000
zheyou73v0_A06	3766248	3766763	BnaA06T0061000ZY	0	-	0	0	515	0.0000000
zheyou73v0_A06	3767150	3770521	BnaA06T0061100ZY	0	-	0	0	3371	0.0000000
zheyou73v0_A06	3770988	3772757	BnaA06T0061200ZY	0	+	0	0	1769	0.0000000
zheyou73v0_A06	3773227	3775964	BnaA06T0061300ZY	0	-	0	0	2737	0.0000000
zheyou73v0_A06	3776375	3776666	BnaA06T0061400ZY	0	-	0	0	291	0.0000000
zheyou73v0_A06	3778228	3779858	BnaA06T0061500ZY	0	+	0	0	1630	0.0000000
zheyou73v0_A06	3778228	3779858	BnaA06T0061500ZY.1	0	+	0	0	1630	0.0000000
zheyou73v0_A06	3780664	3781898	BnaA06T0061600ZY	0	-	0	0	1234	0.0000000
zheyou73v0_A06	3783959	3785741	BnaA06T0061700ZY	0	+	0	0	1782	0.0000000
zheyou73v0_A06	3785917	3790492	BnaA06T0061800ZY	0	-	0	0	4575	0.0000000
zheyou73v0_A06	3791599	3794247	BnaA06T0061900ZY	0	-	0	0	2648	0.0000000
zheyou73v0_A06	3800724	3800956	BnaA06T0062000ZY	0	-	0	0	232	0.0000000
zheyou73v0_A06	3802912	3805958	BnaA06T0062100ZY	0	-	0	0	3046	0.0000000
zheyou73v0_A06	3802912	3805958	BnaA06T0062100ZY.1	0	-	0	0	3046	0.0000000
zheyou73v0_A06	3809331	3810869	BnaA06T0062200ZY	0	+	0	0	1538	0.0000000
zheyou73v0_A06	3811273	3812999	BnaA06T0062300ZY	0	-	0	0	1726	0.0000000
zheyou73v0_A06	3819628	3825299	BnaA06T0062400ZY	0	+	0	0	5671	0.0000000
zheyou73v0_A06	3826773	3827892	BnaA06T0062500ZY	0	-	0	0	1119	0.0000000
zheyou73v0_A06	3840562	3843325	BnaA06T0062600ZY	0	+	0	0	2763	0.0000000
zheyou73v0_A06	3843450	3845689	BnaA06T0062700ZY	0	+	0	0	2239	0.0000000
zheyou73v0_A06	3847818	3848490	BnaA06T0062800ZY	0	-	0	0	672	0.0000000
zheyou73v0_A06	3849512	3850605	BnaA06T0062900ZY	0	-	0	0	1093	0.0000000
zheyou73v0_A06	3862376	3867608	BnaA06T0063000ZY	0	-	0	0	5232	0.0000000
zheyou73v0_A06	3870955	3871497	BnaA06T0063100ZY	0	+	0	0	542	0.0000000
zheyou73v0_A06	3872573	3873658	BnaA06T0063200ZY	0	-	0	0	1085	0.0000000
zheyou73v0_A06	3876021	3876312	BnaA06T0063300ZY	0	+	0	0	291	0.0000000
zheyou73v0_A06	3876537	3876947	BnaA06T0063400ZY	0	-	0	0	410	0.0000000
zheyou73v0_A06	3881020	3882446	BnaA06T0063500ZY	0	-	0	0	1426	0.0000000
zheyou73v0_A06	3881699	3882446	BnaA06T0063500ZY.1	0	-	0	0	747	0.0000000
zheyou73v0_A06	3882645	3886150	BnaA06T0063600ZY	0	+	0	0	3505	0.0000000
zheyou73v0_A06	3882645	3886150	BnaA06T0063600ZY.1	0	+	0	0	3505	0.0000000
zheyou73v0_A06	3886807	3888363	BnaA06T0063700ZY	0	+	0	0	1556	0.0000000
zheyou73v0_A06	3889556	3891884	BnaA06T0063800ZY	0	+	0	0	2328	0.0000000
zheyou73v0_A06	3894023	3897018	BnaA06T0063900ZY	0	+	0	0	2995	0.0000000
zheyou73v0_A06	3906779	3908477	BnaA06T0064000ZY	0	-	0	0	1698	0.0000000
zheyou73v0_A06	3909511	3909850	BnaA06T0064100ZY	0	-	0	0	339	0.0000000
zheyou73v0_A06	3914875	3915161	BnaA06T0064200ZY	0	-	0	0	286	0.0000000
zheyou73v0_A06	3916128	3916847	BnaA06T0064300ZY	0	+	0	0	719	0.0000000
zheyou73v0_A06	3917450	3918541	BnaA06T0064400ZY	0	-	0	0	1091	0.0000000
zheyou73v0_A06	3918788	3920166	BnaA06T0064500ZY	0	+	0	0	1378	0.0000000
zheyou73v0_A06	3918788	3920166	BnaA06T0064500ZY.1	0	+	0	0	1378	0.0000000
zheyou73v0_A06	3918788	3920166	BnaA06T0064500ZY.2	0	+	0	0	1378	0.0000000
zheyou73v0_A06	3920716	3923025	BnaA06T0064600ZY	0	+	0	0	2309	0.0000000
zheyou73v0_A06	3923141	3923680	BnaA06T0064700ZY	0	-	0	0	539	0.0000000
zheyou73v0_A06	3924011	3926203	BnaA06T0064800ZY	0	-	0	0	2192	0.0000000
zheyou73v0_A06	3927428	3929880	BnaA06T0064900ZY	0	-	0	0	2452	0.0000000
zheyou73v0_A06	3945136	3946306	BnaA06T0065000ZY	0	-	0	0	1170	0.0000000
zheyou73v0_A06	3951600	3953805	BnaA06T0065100ZY	0	-	0	0	2205	0.0000000
zheyou73v0_A06	3957810	3958930	BnaA06T0065200ZY	0	+	0	0	1120	0.0000000
zheyou73v0_A06	3957810	3958930	BnaA06T0065200ZY.1	0	+	0	0	1120	0.0000000
zheyou73v0_A06	3959577	3961649	BnaA06T0065300ZY	0	+	0	0	2072	0.0000000
zheyou73v0_A06	3959577	3961649	BnaA06T0065300ZY.1	0	+	0	0	2072	0.0000000
zheyou73v0_A06	3959577	3961649	BnaA06T0065300ZY.2	0	+	0	0	2072	0.0000000
zheyou73v0_A06	3963125	3969267	BnaA06T0065400ZY	0	-	0	0	6142	0.0000000
zheyou73v0_A06	3976592	3977389	BnaA06T0065500ZY	0	-	0	0	797	0.0000000
zheyou73v0_A06	3981065	3983424	BnaA06T0065600ZY.1	0	+	0	0	2359	0.0000000
zheyou73v0_A06	3981101	3983199	BnaA06T0065600ZY	0	+	0	0	2098	0.0000000
zheyou73v0_A06	3983493	3984265	BnaA06T0065700ZY	0	+	0	0	772	0.0000000
zheyou73v0_A06	3987588	3990328	BnaA06T0065800ZY	0	+	0	0	2740	0.0000000
zheyou73v0_A06	3987588	3990328	BnaA06T0065800ZY.1	0	+	0	0	2740	0.0000000
zheyou73v0_A06	3992957	3993771	BnaA06T0065900ZY	0	-	0	0	814	0.0000000
zheyou73v0_A06	3996004	3997958	BnaA06T0066000ZY	0	+	0	0	1954	0.0000000
zheyou73v0_A06	3998051	3998784	BnaA06T0066100ZY	0	-	0	0	733	0.0000000
zheyou73v0_A06	3998863	4002521	BnaA06T0066200ZY	0	-	0	0	3658	0.0000000
zheyou73v0_A06	3998863	4002521	BnaA06T0066200ZY.1	0	-	0	0	3658	0.0000000
zheyou73v0_A06	3998863	4001806	BnaA06T0066200ZY.2	0	-	0	0	2943	0.0000000
zheyou73v0_A06	4003702	4005610	BnaA06T0066300ZY	0	-	0	0	1908	0.0000000
zheyou73v0_A06	4005665	4007997	BnaA06T0066400ZY	0	-	0	0	2332	0.0000000
zheyou73v0_A06	4009467	4012090	BnaA06T0066500ZY	0	+	0	0	2623	0.0000000
zheyou73v0_A06	4012328	4017061	BnaA06T0066600ZY	0	-	0	0	4733	0.0000000
zheyou73v0_A06	4017907	4019703	BnaA06T0066700ZY	0	-	0	0	1796	0.0000000
zheyou73v0_A06	4017907	4019703	BnaA06T0066700ZY.1	0	-	0	0	1796	0.0000000
zheyou73v0_A06	4020255	4021464	BnaA06T0066800ZY	0	-	0	0	1209	0.0000000
zheyou73v0_A06	4022274	4025045	BnaA06T0066900ZY	0	+	0	0	2771	0.0000000
zheyou73v0_A06	4022918	4025045	BnaA06T0066900ZY.2	0	+	0	0	2127	0.0000000
zheyou73v0_A06	4023198	4025045	BnaA06T0066900ZY.1	0	+	0	0	1847	0.0000000
zheyou73v0_A06	4024782	4028309	BnaA06T0067000ZY	0	-	0	0	3527	0.0000000
zheyou73v0_A06	4038912	4042208	BnaA06T0067100ZY	0	+	0	0	3296	0.0000000
zheyou73v0_A06	4042569	4044347	BnaA06T0067200ZY	0	-	0	0	1778	0.0000000
zheyou73v0_A06	4044497	4046961	BnaA06T0067300ZY	0	-	0	0	2464	0.0000000
zheyou73v0_A06	4044497	4046961	BnaA06T0067300ZY.1	0	-	0	0	2464	0.0000000
zheyou73v0_A06	4054787	4058466	BnaA06T0067400ZY	0	+	0	0	3679	0.0000000
zheyou73v0_A06	4054787	4058183	BnaA06T0067400ZY.1	0	+	0	0	3396	0.0000000
zheyou73v0_A06	4058663	4059394	BnaA06T0067500ZY	0	+	0	0	731	0.0000000
zheyou73v0_A06	4059394	4059949	BnaA06T0067600ZY	0	-	0	0	555	0.0000000
zheyou73v0_A06	4060600	4062242	BnaA06T0067700ZY	0	-	0	0	1642	0.0000000
zheyou73v0_A06	4063503	4067999	BnaA06T0067800ZY	0	+	0	0	4496	0.0000000
zheyou73v0_A06	4068373	4071816	BnaA06T0067900ZY	0	-	0	0	3443	0.0000000
zheyou73v0_A06	4073752	4076928	BnaA06T0068000ZY.1	0	-	0	0	3176	0.0000000
zheyou73v0_A06	4073752	4076914	BnaA06T0068000ZY.2	0	-	0	0	3162	0.0000000
zheyou73v0_A06	4073843	4075998	BnaA06T0068000ZY.3	0	-	0	0	2155	0.0000000
zheyou73v0_A06	4073843	4076912	BnaA06T0068000ZY.4	0	-	0	0	3069	0.0000000
zheyou73v0_A06	4073856	4076912	BnaA06T0068000ZY	0	-	0	0	3056	0.0000000
zheyou73v0_A06	4080040	4081217	BnaA06T0068100ZY	0	-	0	0	1177	0.0000000
zheyou73v0_A06	4084019	4086199	BnaA06T0068200ZY	0	+	0	0	2180	0.0000000
zheyou73v0_A06	4087333	4087692	BnaA06T0068300ZY	0	-	0	0	359	0.0000000
zheyou73v0_A06	4092046	4094359	BnaA06T0068400ZY	0	+	0	0	2313	0.0000000
zheyou73v0_A06	4095827	4096792	BnaA06T0068500ZY	0	+	0	0	965	0.0000000
zheyou73v0_A06	4100728	4101107	BnaA06T0068600ZY	0	+	0	0	379	0.0000000
zheyou73v0_A06	4102144	4106181	BnaA06T0068700ZY	0	+	0	0	4037	0.0000000
zheyou73v0_A06	4108692	4111544	BnaA06T0068800ZY	0	+	0	0	2852	0.0000000
zheyou73v0_A06	4112155	4121757	BnaA06T0068900ZY	0	+	0	0	9602	0.0000000
zheyou73v0_A06	4122835	4124119	BnaA06T0069000ZY	0	-	0	0	1284	0.0000000
zheyou73v0_A06	4127882	4128161	BnaA06T0069100ZY	0	-	0	0	279	0.0000000
zheyou73v0_A06	4128396	4128732	BnaA06T0069200ZY	0	-	0	0	336	0.0000000
zheyou73v0_A06	4143040	4144329	BnaA06T0069300ZY	0	-	0	0	1289	0.0000000
zheyou73v0_A06	4144754	4145724	BnaA06T0069400ZY	0	+	0	0	970	0.0000000
zheyou73v0_A06	4147986	4148793	BnaA06T0069500ZY	0	+	0	0	807	0.0000000
zheyou73v0_A06	4156451	4159887	BnaA06T0069600ZY	0	+	0	0	3436	0.0000000
zheyou73v0_A06	4156451	4159887	BnaA06T0069600ZY.1	0	+	0	0	3436	0.0000000
zheyou73v0_A06	4159578	4162652	BnaA06T0069700ZY	0	-	0	0	3074	0.0000000
zheyou73v0_A06	4169989	4171634	BnaA06T0069800ZY	0	+	0	0	1645	0.0000000
zheyou73v0_A06	4199048	4200305	BnaA06T0069900ZY	0	-	0	0	1257	0.0000000
zheyou73v0_A06	4200888	4202325	BnaA06T0070000ZY	0	+	0	0	1437	0.0000000
zheyou73v0_A06	4200888	4202325	BnaA06T0070000ZY.1	0	+	0	0	1437	0.0000000
zheyou73v0_A06	4202822	4205767	BnaA06T0070100ZY	0	-	0	0	2945	0.0000000
zheyou73v0_A06	4206440	4207509	BnaA06T0070200ZY	0	+	0	0	1069	0.0000000
zheyou73v0_A06	4207969	4212273	BnaA06T0070300ZY	0	-	0	0	4304	0.0000000
zheyou73v0_A06	4233887	4237237	BnaA06T0070400ZY	0	+	0	0	3350	0.0000000
zheyou73v0_A06	4240982	4242600	BnaA06T0070500ZY	0	+	0	0	1618	0.0000000
zheyou73v0_A06	4243093	4244218	BnaA06T0070600ZY	0	+	0	0	1125	0.0000000
zheyou73v0_A06	4247747	4247906	BnaA06T0070700ZY	0	-	0	0	159	0.0000000
zheyou73v0_A06	4250529	4250817	BnaA06T0070800ZY	0	-	0	0	288	0.0000000
zheyou73v0_A06	4251628	4252966	BnaA06T0070900ZY	0	+	0	0	1338	0.0000000
zheyou73v0_A06	4253812	4256915	BnaA06T0071000ZY	0	-	0	0	3103	0.0000000
zheyou73v0_A06	4257492	4258643	BnaA06T0071100ZY	0	-	0	0	1151	0.0000000
zheyou73v0_A06	4259364	4260105	BnaA06T0071200ZY	0	+	0	0	741	0.0000000
zheyou73v0_A06	4260162	4261399	BnaA06T0071300ZY	0	-	0	0	1237	0.0000000
zheyou73v0_A06	4265605	4267085	BnaA06T0071400ZY	0	-	0	0	1480	0.0000000
zheyou73v0_A06	4268873	4269354	BnaA06T0071500ZY	0	+	0	0	481	0.0000000
zheyou73v0_A06	4282420	4287258	BnaA06T0071600ZY	0	+	0	0	4838	0.0000000
zheyou73v0_A06	4288585	4289788	BnaA06T0071700ZY	0	-	0	0	1203	0.0000000
zheyou73v0_A06	4298280	4299314	BnaA06T0071800ZY	0	-	0	0	1034	0.0000000
zheyou73v0_A06	4306233	4310863	BnaA06T0071900ZY	0	-	0	0	4630	0.0000000
zheyou73v0_A06	4312364	4313729	BnaA06T0072000ZY	0	-	0	0	1365	0.0000000
zheyou73v0_A06	4315115	4315460	BnaA06T0072100ZY	0	+	0	0	345	0.0000000
zheyou73v0_A06	4316062	4318888	BnaA06T0072200ZY	0	+	0	0	2826	0.0000000
zheyou73v0_A06	4321440	4323984	BnaA06T0072300ZY	0	+	0	0	2544	0.0000000
zheyou73v0_A06	4321667	4323984	BnaA06T0072300ZY.1	0	+	0	0	2317	0.0000000
zheyou73v0_A06	4325187	4325606	BnaA06T0072400ZY	0	+	0	0	419	0.0000000
zheyou73v0_A06	4325731	4326297	BnaA06T0072500ZY	0	+	0	0	566	0.0000000
zheyou73v0_A06	4331202	4332147	BnaA06T0072600ZY	0	+	0	0	945	0.0000000
zheyou73v0_A06	4334589	4336563	BnaA06T0072700ZY	0	+	0	0	1974	0.0000000
zheyou73v0_A06	4336998	4345739	BnaA06T0072800ZY	0	+	0	0	8741	0.0000000
zheyou73v0_A06	4348540	4349246	BnaA06T0072900ZY	0	-	0	0	706	0.0000000
zheyou73v0_A06	4358131	4358837	BnaA06T0073000ZY	0	-	0	0	706	0.0000000
zheyou73v0_A06	4359555	4361548	BnaA06T0073100ZY	0	-	0	0	1993	0.0000000
zheyou73v0_A06	4362401	4364406	BnaA06T0073200ZY.1	0	-	0	0	2005	0.0000000
zheyou73v0_A06	4362696	4364406	BnaA06T0073200ZY	0	-	0	0	1710	0.0000000
zheyou73v0_A06	4362696	4364406	BnaA06T0073200ZY.2	0	-	0	0	1710	0.0000000
zheyou73v0_A06	4377536	4379298	BnaA06T0073300ZY	0	+	0	0	1762	0.0000000
zheyou73v0_A06	4384540	4392954	BnaA06T0073400ZY	0	+	0	0	8414	0.0000000
zheyou73v0_A06	4395482	4396884	BnaA06T0073500ZY	0	-	0	0	1402	0.0000000
zheyou73v0_A06	4398849	4400102	BnaA06T0073600ZY	0	+	0	0	1253	0.0000000
zheyou73v0_A06	4401241	4402447	BnaA06T0073700ZY	0	+	0	0	1206	0.0000000
zheyou73v0_A06	4415169	4416447	BnaA06T0073800ZY	0	+	0	0	1278	0.0000000
zheyou73v0_A06	4416940	4420905	BnaA06T0073900ZY	0	+	0	0	3965	0.0000000
zheyou73v0_A06	4419664	4422313	BnaA06T0074000ZY	0	-	0	0	2649	0.0000000
zheyou73v0_A06	4432042	4433653	BnaA06T0074100ZY	0	-	0	0	1611	0.0000000
zheyou73v0_A06	4439089	4439623	BnaA06T0074200ZY	0	-	0	0	534	0.0000000
zheyou73v0_A06	4454039	4455447	BnaA06T0074300ZY	0	+	0	0	1408	0.0000000
zheyou73v0_A06	4459194	4460437	BnaA06T0074400ZY	0	-	0	0	1243	0.0000000
zheyou73v0_A06	4480833	4481826	BnaA06T0074500ZY	0	+	0	0	993	0.0000000
zheyou73v0_A06	4486720	4488033	BnaA06T0074600ZY	0	+	0	0	1313	0.0000000
zheyou73v0_A06	4493731	4495584	BnaA06T0074700ZY	0	-	0	0	1853	0.0000000
zheyou73v0_A06	4495998	4500788	BnaA06T0074800ZY	0	-	0	0	4790	0.0000000
zheyou73v0_A06	4502838	4515802	BnaA06T0074900ZY	0	+	0	0	12964	0.0000000
zheyou73v0_A06	4516223	4518560	BnaA06T0075000ZY	0	-	0	0	2337	0.0000000
zheyou73v0_A06	4518823	4522803	BnaA06T0075100ZY	0	-	0	0	3980	0.0000000
zheyou73v0_A06	4520988	4522803	BnaA06T0075100ZY.1	0	-	0	0	1815	0.0000000
zheyou73v0_A06	4524969	4528443	BnaA06T0075200ZY	0	+	0	0	3474	0.0000000
zheyou73v0_A06	4535773	4537378	BnaA06T0075300ZY	0	+	0	0	1605	0.0000000
zheyou73v0_A06	4537552	4542006	BnaA06T0075400ZY	0	-	0	0	4454	0.0000000
zheyou73v0_A06	4562946	4565332	BnaA06T0075500ZY	0	-	0	0	2386	0.0000000
zheyou73v0_A06	4565746	4569115	BnaA06T0075600ZY	0	-	0	0	3369	0.0000000
zheyou73v0_A06	4570559	4580261	BnaA06T0075700ZY	0	+	0	0	9702	0.0000000
zheyou73v0_A06	4580724	4582254	BnaA06T0075800ZY	0	-	0	0	1530	0.0000000
zheyou73v0_A06	4592211	4593187	BnaA06T0075900ZY	0	-	0	0	976	0.0000000
zheyou73v0_A06	4599437	4607166	BnaA06T0076000ZY	0	+	0	0	7729	0.0000000
zheyou73v0_A06	4607474	4608709	BnaA06T0076100ZY	0	-	0	0	1235	0.0000000
zheyou73v0_A06	4612186	4612894	BnaA06T0076200ZY	0	+	0	0	708	0.0000000
zheyou73v0_A06	4614040	4614244	BnaA06T0076300ZY	0	+	0	0	204	0.0000000
zheyou73v0_A06	4618015	4619757	BnaA06T0076400ZY	0	+	0	0	1742	0.0000000
zheyou73v0_A06	4634358	4636192	BnaA06T0076500ZY	0	-	0	0	1834	0.0000000
zheyou73v0_A06	4634358	4636147	BnaA06T0076500ZY.1	0	-	0	0	1789	0.0000000
zheyou73v0_A06	4638029	4638573	BnaA06T0076600ZY	0	+	0	0	544	0.0000000
zheyou73v0_A06	4638984	4641254	BnaA06T0076700ZY	0	-	0	0	2270	0.0000000
zheyou73v0_A06	4643179	4643404	BnaA06T0076800ZY	0	-	0	0	225	0.0000000
zheyou73v0_A06	4650825	4652001	BnaA06T0076900ZY	0	+	0	0	1176	0.0000000
zheyou73v0_A06	4656238	4656451	BnaA06T0077000ZY	0	+	0	0	213	0.0000000
zheyou73v0_A06	4657585	4659624	BnaA06T0077100ZY	0	+	0	0	2039	0.0000000
zheyou73v0_A06	4660493	4664033	BnaA06T0077200ZY	0	+	0	0	3540	0.0000000
zheyou73v0_A06	4664914	4665178	BnaA06T0077300ZY	0	+	0	0	264	0.0000000
zheyou73v0_A06	4666352	4670968	BnaA06T0077400ZY	0	+	0	0	4616	0.0000000
zheyou73v0_A06	4671181	4673306	BnaA06T0077500ZY	0	-	0	0	2125	0.0000000
zheyou73v0_A06	4675952	4678151	BnaA06T0077600ZY	0	-	0	0	2199	0.0000000
zheyou73v0_A06	4689160	4690813	BnaA06T0077700ZY	0	+	0	0	1653	0.0000000
zheyou73v0_A06	4691505	4693123	BnaA06T0077800ZY	0	+	0	0	1618	0.0000000
zheyou73v0_A06	4694191	4694942	BnaA06T0077900ZY	0	-	0	0	751	0.0000000
zheyou73v0_A06	4700041	4700540	BnaA06T0078000ZY	0	-	0	0	499	0.0000000
zheyou73v0_A06	4702635	4704958	BnaA06T0078100ZY	0	+	0	0	2323	0.0000000
zheyou73v0_A06	4708568	4709356	BnaA06T0078200ZY	0	+	0	0	788	0.0000000
zheyou73v0_A06	4715170	4715713	BnaA06T0078300ZY	0	-	0	0	543	0.0000000
zheyou73v0_A06	4715776	4716508	BnaA06T0078400ZY	0	-	0	0	732	0.0000000
zheyou73v0_A06	4718203	4719375	BnaA06T0078500ZY	0	-	0	0	1172	0.0000000
zheyou73v0_A06	4721215	4722695	BnaA06T0078600ZY	0	-	0	0	1480	0.0000000
zheyou73v0_A06	4725078	4726893	BnaA06T0078700ZY	0	-	0	0	1815	0.0000000
zheyou73v0_A06	4727887	4728959	BnaA06T0078800ZY	0	-	0	0	1072	0.0000000
zheyou73v0_A06	4731024	4731820	BnaA06T0078900ZY	0	-	0	0	796	0.0000000
zheyou73v0_A06	4737566	4738705	BnaA06T0079000ZY	0	+	0	0	1139	0.0000000
zheyou73v0_A06	4745191	4746999	BnaA06T0079100ZY	0	+	0	0	1808	0.0000000
zheyou73v0_A06	4755517	4758139	BnaA06T0079200ZY	0	+	0	0	2622	0.0000000
zheyou73v0_A06	4755517	4758139	BnaA06T0079200ZY.1	0	+	0	0	2622	0.0000000
zheyou73v0_A06	4758064	4764360	BnaA06T0079300ZY	0	-	0	0	6296	0.0000000
zheyou73v0_A06	4767695	4770672	BnaA06T0079400ZY	0	-	0	0	2977	0.0000000
zheyou73v0_A06	4771967	4773897	BnaA06T0079500ZY	0	-	0	0	1930	0.0000000
zheyou73v0_A06	4778065	4782610	BnaA06T0079600ZY	0	+	0	0	4545	0.0000000
zheyou73v0_A06	4786846	4787740	BnaA06T0079700ZY	0	+	0	0	894	0.0000000
zheyou73v0_A06	4792705	4795586	BnaA06T0079800ZY	0	+	0	0	2881	0.0000000
zheyou73v0_A06	4792705	4795586	BnaA06T0079800ZY.1	0	+	0	0	2881	0.0000000
zheyou73v0_A06	4797169	4801495	BnaA06T0079900ZY	0	-	0	0	4326	0.0000000
zheyou73v0_A06	4804966	4807323	BnaA06T0080000ZY	0	+	0	0	2357	0.0000000
zheyou73v0_A06	4814891	4819866	BnaA06T0080100ZY	0	-	0	0	4975	0.0000000
zheyou73v0_A06	4827176	4829351	BnaA06T0080200ZY	0	-	0	0	2175	0.0000000
zheyou73v0_A06	4832424	4833223	BnaA06T0080300ZY	0	-	0	0	799	0.0000000
zheyou73v0_A06	4833452	4834422	BnaA06T0080400ZY	0	+	0	0	970	0.0000000
zheyou73v0_A06	4835855	4836885	BnaA06T0080500ZY	0	+	0	0	1030	0.0000000
zheyou73v0_A06	4839165	4839744	BnaA06T0080600ZY	0	+	0	0	579	0.0000000
zheyou73v0_A06	4843908	4844634	BnaA06T0080700ZY	0	+	0	0	726	0.0000000
zheyou73v0_A06	4845355	4857268	BnaA06T0080800ZY	0	+	0	0	11913	0.0000000
zheyou73v0_A06	4861918	4865662	BnaA06T0080900ZY	0	-	0	0	3744	0.0000000
zheyou73v0_A06	4869331	4871725	BnaA06T0081000ZY	0	-	0	0	2394	0.0000000
zheyou73v0_A06	4874825	4877234	BnaA06T0081100ZY	0	-	0	0	2409	0.0000000
zheyou73v0_A06	4883441	4884795	BnaA06T0081200ZY	0	+	0	0	1354	0.0000000
zheyou73v0_A06	4888935	4893000	BnaA06T0081300ZY	0	-	0	0	4065	0.0000000
zheyou73v0_A06	4911342	4913387	BnaA06T0081400ZY	0	-	0	0	2045	0.0000000
zheyou73v0_A06	4918594	4919008	BnaA06T0081500ZY	0	+	0	0	414	0.0000000
zheyou73v0_A06	4928033	4929676	BnaA06T0081600ZY	0	-	0	0	1643	0.0000000
zheyou73v0_A06	4934434	4936375	BnaA06T0081700ZY	0	+	0	0	1941	0.0000000
zheyou73v0_A06	4937028	4937367	BnaA06T0081800ZY	0	+	0	0	339	0.0000000
zheyou73v0_A06	4937421	4940774	BnaA06T0081900ZY	0	-	0	0	3353	0.0000000
zheyou73v0_A06	4947514	4949040	BnaA06T0082000ZY	0	+	0	0	1526	0.0000000
zheyou73v0_A06	4954281	4954948	BnaA06T0082100ZY	0	+	0	0	667	0.0000000
zheyou73v0_A06	4957435	4958846	BnaA06T0082200ZY	0	-	0	0	1411	0.0000000
zheyou73v0_A06	4963208	4966871	BnaA06T0082300ZY	0	+	0	0	3663	0.0000000
zheyou73v0_A06	4963208	4966871	BnaA06T0082300ZY.1	0	+	0	0	3663	0.0000000
zheyou73v0_A06	4968568	4971254	BnaA06T0082400ZY	0	+	0	0	2686	0.0000000
zheyou73v0_A06	4971901	4972138	BnaA06T0082500ZY	0	-	0	0	237	0.0000000
zheyou73v0_A06	4974853	4978289	BnaA06T0082600ZY	0	+	0	0	3436	0.0000000
zheyou73v0_A06	4981571	4982186	BnaA06T0082700ZY	0	+	0	0	615	0.0000000
zheyou73v0_A06	4983373	4984975	BnaA06T0082800ZY	0	+	0	0	1602	0.0000000
zheyou73v0_A06	4986371	4987780	BnaA06T0082900ZY	0	+	0	0	1409	0.0000000
zheyou73v0_A06	4988041	4989478	BnaA06T0083000ZY	0	-	0	0	1437	0.0000000
zheyou73v0_A06	4992050	4995852	BnaA06T0083100ZY	0	+	0	0	3802	0.0000000
zheyou73v0_A06	4996105	4998032	BnaA06T0083200ZY	0	-	0	0	1927	0.0000000
zheyou73v0_A06	4999235	5001299	BnaA06T0083300ZY	0	-	0	0	2064	0.0000000
zheyou73v0_A06	5005040	5006290	BnaA06T0083400ZY	0	+	0	0	1250	0.0000000
zheyou73v0_A06	5006589	5008323	BnaA06T0083500ZY	0	-	0	0	1734	0.0000000
zheyou73v0_A06	5008680	5010732	BnaA06T0083600ZY	0	-	0	0	2052	0.0000000
zheyou73v0_A06	5013032	5015179	BnaA06T0083700ZY	0	-	0	0	2147	0.0000000
zheyou73v0_A06	5016182	5018457	BnaA06T0083800ZY	0	+	0	0	2275	0.0000000
zheyou73v0_A06	5018569	5020090	BnaA06T0083900ZY	0	-	0	0	1521	0.0000000
zheyou73v0_A06	5020575	5023834	BnaA06T0084000ZY	0	-	0	0	3259	0.0000000
zheyou73v0_A06	5030255	5032050	BnaA06T0084100ZY	0	-	0	0	1795	0.0000000
zheyou73v0_A06	5030255	5032157	BnaA06T0084100ZY.1	0	-	0	0	1902	0.0000000
zheyou73v0_A06	5036046	5036689	BnaA06T0084200ZY	0	+	0	0	643	0.0000000
zheyou73v0_A06	5036046	5036689	BnaA06T0084200ZY.1	0	+	0	0	643	0.0000000
zheyou73v0_A06	5042492	5043074	BnaA06T0084300ZY	0	-	0	0	582	0.0000000
zheyou73v0_A06	5056950	5057501	BnaA06T0084400ZY	0	+	0	0	551	0.0000000
zheyou73v0_A06	5065962	5066431	BnaA06T0084500ZY	0	-	0	0	469	0.0000000
zheyou73v0_A06	5066520	5068214	BnaA06T0084600ZY	0	-	0	0	1694	0.0000000
zheyou73v0_A06	5073393	5074367	BnaA06T0084700ZY	0	-	0	0	974	0.0000000
zheyou73v0_A06	5080861	5083216	BnaA06T0084800ZY	0	-	0	0	2355	0.0000000
zheyou73v0_A06	5091357	5092289	BnaA06T0084900ZY	0	+	0	0	932	0.0000000
zheyou73v0_A06	5094372	5097921	BnaA06T0085000ZY	0	-	0	0	3549	0.0000000
zheyou73v0_A06	5098845	5100537	BnaA06T0085100ZY	0	+	0	0	1692	0.0000000
zheyou73v0_A06	5114018	5115135	BnaA06T0085200ZY	0	-	0	0	1117	0.0000000
zheyou73v0_A06	5119638	5126951	BnaA06T0085300ZY	0	+	0	0	7313	0.0000000
zheyou73v0_A06	5127040	5128355	BnaA06T0085400ZY	0	-	0	0	1315	0.0000000
zheyou73v0_A06	5136165	5137818	BnaA06T0085500ZY	0	-	0	0	1653	0.0000000
zheyou73v0_A06	5155541	5157658	BnaA06T0085600ZY	0	+	0	0	2117	0.0000000
zheyou73v0_A06	5159118	5160399	BnaA06T0085700ZY	0	+	0	0	1281	0.0000000
zheyou73v0_A06	5160648	5163138	BnaA06T0085800ZY	0	-	0	0	2490	0.0000000
zheyou73v0_A06	5164204	5166980	BnaA06T0085900ZY	0	+	0	0	2776	0.0000000
zheyou73v0_A06	5164204	5166980	BnaA06T0085900ZY.1	0	+	0	0	2776	0.0000000
zheyou73v0_A06	5177482	5179361	BnaA06T0086000ZY	0	+	0	0	1879	0.0000000
zheyou73v0_A06	5177482	5179361	BnaA06T0086000ZY.1	0	+	0	0	1879	0.0000000
zheyou73v0_A06	5190137	5192046	BnaA06T0086100ZY	0	+	0	0	1909	0.0000000
zheyou73v0_A06	5192178	5194883	BnaA06T0086200ZY	0	-	0	0	2705	0.0000000
zheyou73v0_A06	5195217	5197579	BnaA06T0086300ZY.1	0	+	0	0	2362	0.0000000
zheyou73v0_A06	5195217	5197579	BnaA06T0086300ZY.2	0	+	0	0	2362	0.0000000
zheyou73v0_A06	5195217	5197579	BnaA06T0086300ZY.3	0	+	0	0	2362	0.0000000
zheyou73v0_A06	5195243	5196967	BnaA06T0086300ZY	0	+	0	0	1724	0.0000000
zheyou73v0_A06	5197344	5198241	BnaA06T0086400ZY	0	-	0	0	897	0.0000000
zheyou73v0_A06	5202366	5206308	BnaA06T0086500ZY	0	-	0	0	3942	0.0000000
zheyou73v0_A06	5207207	5208993	BnaA06T0086600ZY	0	+	0	0	1786	0.0000000
zheyou73v0_A06	5214835	5215282	BnaA06T0086700ZY	0	+	0	0	447	0.0000000
zheyou73v0_A06	5224013	5226172	BnaA06T0086800ZY	0	+	0	0	2159	0.0000000
zheyou73v0_A06	5226755	5228880	BnaA06T0086900ZY	0	-	0	0	2125	0.0000000
zheyou73v0_A06	5235273	5240817	BnaA06T0087000ZY	0	+	0	0	5544	0.0000000
zheyou73v0_A06	5240879	5242457	BnaA06T0087100ZY	0	+	0	0	1578	0.0000000
zheyou73v0_A06	5243089	5246077	BnaA06T0087200ZY	0	+	0	0	2988	0.0000000
zheyou73v0_A06	5246258	5246900	BnaA06T0087300ZY	0	+	0	0	642	0.0000000
zheyou73v0_A06	5263624	5277892	BnaA06T0087400ZY	0	+	0	0	14268	0.0000000
zheyou73v0_A06	5289707	5296091	BnaA06T0087500ZY	0	+	0	0	6384	0.0000000
zheyou73v0_A06	5299894	5301603	BnaA06T0087600ZY	0	+	0	0	1709	0.0000000
zheyou73v0_A06	5308080	5310607	BnaA06T0087700ZY	0	+	0	0	2527	0.0000000
zheyou73v0_A06	5311405	5312983	BnaA06T0087800ZY	0	+	0	0	1578	0.0000000
zheyou73v0_A06	5316506	5317638	BnaA06T0087900ZY	0	+	0	0	1132	0.0000000
zheyou73v0_A06	5318284	5319943	BnaA06T0088000ZY	0	+	0	0	1659	0.0000000
zheyou73v0_A06	5320648	5321348	BnaA06T0088100ZY	0	+	0	0	700	0.0000000
zheyou73v0_A06	5329086	5329956	BnaA06T0088200ZY	0	+	0	0	870	0.0000000
zheyou73v0_A06	5331792	5334759	BnaA06T0088300ZY	0	-	0	0	2967	0.0000000
zheyou73v0_A06	5347894	5349821	BnaA06T0088400ZY	0	-	0	0	1927	0.0000000
zheyou73v0_A06	5352056	5353251	BnaA06T0088500ZY	0	-	0	0	1195	0.0000000
zheyou73v0_A06	5354245	5355314	BnaA06T0088600ZY	0	+	0	0	1069	0.0000000
zheyou73v0_A06	5357889	5359626	BnaA06T0088700ZY	0	-	0	0	1737	0.0000000
zheyou73v0_A06	5359627	5360225	BnaA06T0088800ZY	0	-	0	0	598	0.0000000
zheyou73v0_A06	5362474	5364251	BnaA06T0088900ZY	0	+	0	0	1777	0.0000000
zheyou73v0_A06	5365366	5366069	BnaA06T0089000ZY	0	-	0	0	703	0.0000000
zheyou73v0_A06	5366653	5369330	BnaA06T0089100ZY	0	+	0	0	2677	0.0000000
zheyou73v0_A06	5375319	5377324	BnaA06T0089200ZY	0	-	0	0	2005	0.0000000
zheyou73v0_A06	5383202	5386231	BnaA06T0089300ZY	0	+	0	0	3029	0.0000000
zheyou73v0_A06	5383202	5386231	BnaA06T0089300ZY.1	0	+	0	0	3029	0.0000000
zheyou73v0_A06	5386887	5389366	BnaA06T0089400ZY	0	+	0	0	2479	0.0000000
zheyou73v0_A06	5390436	5392385	BnaA06T0089500ZY	0	+	0	0	1949	0.0000000
zheyou73v0_A06	5392544	5394385	BnaA06T0089600ZY	0	-	0	0	1841	0.0000000
zheyou73v0_A06	5394898	5396368	BnaA06T0089700ZY	0	+	0	0	1470	0.0000000
zheyou73v0_A06	5397326	5398779	BnaA06T0089800ZY	0	-	0	0	1453	0.0000000
zheyou73v0_A06	5403807	5405817	BnaA06T0089900ZY	0	-	0	0	2010	0.0000000
zheyou73v0_A06	5406113	5407836	BnaA06T0090000ZY	0	+	0	0	1723	0.0000000
zheyou73v0_A06	5406113	5407836	BnaA06T0090000ZY.1	0	+	0	0	1723	0.0000000
zheyou73v0_A06	5408346	5409549	BnaA06T0090100ZY	0	+	0	0	1203	0.0000000
zheyou73v0_A06	5410715	5412841	BnaA06T0090200ZY	0	-	0	0	2126	0.0000000
zheyou73v0_A06	5410715	5412841	BnaA06T0090200ZY.1	0	-	0	0	2126	0.0000000
zheyou73v0_A06	5419655	5420623	BnaA06T0090300ZY	0	+	0	0	968	0.0000000
zheyou73v0_A06	5420870	5421452	BnaA06T0090400ZY	0	+	0	0	582	0.0000000
zheyou73v0_A06	5434106	5434313	BnaA06T0090500ZY	0	+	0	0	207	0.0000000
zheyou73v0_A06	5442894	5445266	BnaA06T0090600ZY	0	+	0	0	2372	0.0000000
zheyou73v0_A06	5446037	5447555	BnaA06T0090700ZY	0	-	0	0	1518	0.0000000
zheyou73v0_A06	5448653	5450656	BnaA06T0090800ZY	0	+	0	0	2003	0.0000000
zheyou73v0_A06	5452517	5452853	BnaA06T0090900ZY	0	-	0	0	336	0.0000000
zheyou73v0_A06	5454478	5456133	BnaA06T0091000ZY	0	+	0	0	1655	0.0000000
zheyou73v0_A06	5456411	5459178	BnaA06T0091100ZY	0	-	0	0	2767	0.0000000
zheyou73v0_A06	5470482	5473195	BnaA06T0091200ZY	0	+	0	0	2713	0.0000000
zheyou73v0_A06	5473587	5475026	BnaA06T0091300ZY	0	-	0	0	1439	0.0000000
zheyou73v0_A06	5476303	5478317	BnaA06T0091400ZY	0	-	0	0	2014	0.0000000
zheyou73v0_A06	5479256	5480933	BnaA06T0091500ZY	0	+	0	0	1677	0.0000000
zheyou73v0_A06	5482833	5484729	BnaA06T0091600ZY	0	-	0	0	1896	0.0000000
zheyou73v0_A06	5489457	5490339	BnaA06T0091700ZY	0	-	0	0	882	0.0000000
zheyou73v0_A06	5489457	5490339	BnaA06T0091700ZY.1	0	-	0	0	882	0.0000000
zheyou73v0_A06	5491312	5495289	BnaA06T0091800ZY	0	-	0	0	3977	0.0000000
zheyou73v0_A06	5498687	5499186	BnaA06T0091900ZY	0	+	0	0	499	0.0000000
zheyou73v0_A06	5500309	5501982	BnaA06T0092000ZY	0	+	0	0	1673	0.0000000
zheyou73v0_A06	5502460	5503956	BnaA06T0092100ZY	0	+	0	0	1496	0.0000000
zheyou73v0_A06	5510287	5511087	BnaA06T0092200ZY	0	-	0	0	800	0.0000000
zheyou73v0_A06	5511526	5513818	BnaA06T0092300ZY	0	-	0	0	2292	0.0000000
zheyou73v0_A06	5511526	5513334	BnaA06T0092300ZY.1	0	-	0	0	1808	0.0000000
zheyou73v0_A06	5515475	5517400	BnaA06T0092400ZY	0	-	0	0	1925	0.0000000
zheyou73v0_A06	5515475	5517465	BnaA06T0092400ZY.1	0	-	0	0	1990	0.0000000
zheyou73v0_A06	5515475	5517465	BnaA06T0092400ZY.2	0	-	0	0	1990	0.0000000
zheyou73v0_A06	5515475	5517465	BnaA06T0092400ZY.3	0	-	0	0	1990	0.0000000
zheyou73v0_A06	5519087	5520908	BnaA06T0092500ZY	0	-	0	0	1821	0.0000000
zheyou73v0_A06	5521879	5523471	BnaA06T0092600ZY	0	-	0	0	1592	0.0000000
zheyou73v0_A06	5525376	5527785	BnaA06T0092700ZY	0	+	0	0	2409	0.0000000
zheyou73v0_A06	5529439	5531992	BnaA06T0092800ZY	0	+	0	0	2553	0.0000000
zheyou73v0_A06	5537244	5539145	BnaA06T0092900ZY	0	+	0	0	1901	0.0000000
zheyou73v0_A06	5542528	5543645	BnaA06T0093000ZY	0	+	0	0	1117	0.0000000
zheyou73v0_A06	5543686	5544280	BnaA06T0093100ZY	0	+	0	0	594	0.0000000
zheyou73v0_A06	5547359	5551425	BnaA06T0093200ZY	0	-	0	0	4066	0.0000000
zheyou73v0_A06	5558604	5561165	BnaA06T0093300ZY	0	-	0	0	2561	0.0000000
zheyou73v0_A06	5561767	5567314	BnaA06T0093400ZY	0	-	0	0	5547	0.0000000
zheyou73v0_A06	5580979	5582351	BnaA06T0093500ZY	0	+	0	0	1372	0.0000000
zheyou73v0_A06	5585705	5586378	BnaA06T0093600ZY	0	-	0	0	673	0.0000000
zheyou73v0_A06	5614307	5615676	BnaA06T0093700ZY	0	+	0	0	1369	0.0000000
zheyou73v0_A06	5623783	5626499	BnaA06T0093800ZY	0	+	0	0	2716	0.0000000
zheyou73v0_A06	5627747	5632055	BnaA06T0093900ZY	0	-	0	0	4308	0.0000000
zheyou73v0_A06	5638032	5641055	BnaA06T0094000ZY	0	+	0	0	3023	0.0000000
zheyou73v0_A06	5641652	5642767	BnaA06T0094100ZY	0	-	0	0	1115	0.0000000
zheyou73v0_A06	5643065	5652497	BnaA06T0094200ZY	0	-	0	0	9432	0.0000000
zheyou73v0_A06	5662237	5663540	BnaA06T0094300ZY	0	+	0	0	1303	0.0000000
zheyou73v0_A06	5663874	5666705	BnaA06T0094400ZY	0	-	0	0	2831	0.0000000
zheyou73v0_A06	5668206	5670604	BnaA06T0094500ZY	0	-	0	0	2398	0.0000000
zheyou73v0_A06	5671277	5671978	BnaA06T0094600ZY	0	+	0	0	701	0.0000000
zheyou73v0_A06	5673085	5673767	BnaA06T0094700ZY	0	-	0	0	682	0.0000000
zheyou73v0_A06	5676968	5678412	BnaA06T0094800ZY	0	-	0	0	1444	0.0000000
zheyou73v0_A06	5680402	5683683	BnaA06T0094900ZY	0	+	0	0	3281	0.0000000
zheyou73v0_A06	5683724	5687577	BnaA06T0095000ZY	0	-	0	0	3853	0.0000000
zheyou73v0_A06	5683724	5687577	BnaA06T0095000ZY.1	0	-	0	0	3853	0.0000000
zheyou73v0_A06	5688272	5690405	BnaA06T0095100ZY	0	-	0	0	2133	0.0000000
zheyou73v0_A06	5690784	5692068	BnaA06T0095200ZY	0	-	0	0	1284	0.0000000
zheyou73v0_A06	5694899	5697747	BnaA06T0095300ZY	0	-	0	0	2848	0.0000000
zheyou73v0_A06	5698732	5705163	BnaA06T0095400ZY	0	-	0	0	6431	0.0000000
zheyou73v0_A06	5709660	5711283	BnaA06T0095500ZY	0	+	0	0	1623	0.0000000
zheyou73v0_A06	5716563	5717639	BnaA06T0095600ZY	0	-	0	0	1076	0.0000000
zheyou73v0_A06	5720337	5720712	BnaA06T0095700ZY	0	-	0	0	375	0.0000000
zheyou73v0_A06	5722613	5722979	BnaA06T0095800ZY	0	+	0	0	366	0.0000000
zheyou73v0_A06	5724306	5724976	BnaA06T0095900ZY	0	+	0	0	670	0.0000000
zheyou73v0_A06	5726578	5730274	BnaA06T0096000ZY	0	-	0	0	3696	0.0000000
zheyou73v0_A06	5726578	5730274	BnaA06T0096000ZY.1	0	-	0	0	3696	0.0000000
zheyou73v0_A06	5726578	5730274	BnaA06T0096000ZY.2	0	-	0	0	3696	0.0000000
zheyou73v0_A06	5736900	5744257	BnaA06T0096100ZY	0	-	0	0	7357	0.0000000
zheyou73v0_A06	5745260	5746329	BnaA06T0096200ZY	0	+	0	0	1069	0.0000000
zheyou73v0_A06	5751866	5752540	BnaA06T0096300ZY	0	-	0	0	674	0.0000000
zheyou73v0_A06	5773386	5774455	BnaA06T0096400ZY	0	+	0	0	1069	0.0000000
zheyou73v0_A06	5779988	5780662	BnaA06T0096500ZY	0	-	0	0	674	0.0000000
zheyou73v0_A06	5841213	5843500	BnaA06T0096600ZY	0	-	0	0	2287	0.0000000
zheyou73v0_A06	5841723	5843500	BnaA06T0096600ZY.1	0	-	0	0	1777	0.0000000
zheyou73v0_A06	5844047	5845085	BnaA06T0096700ZY	0	-	0	0	1038	0.0000000
zheyou73v0_A06	5845643	5846677	BnaA06T0096800ZY	0	-	0	0	1034	0.0000000
zheyou73v0_A06	5847004	5848629	BnaA06T0096900ZY	0	+	0	0	1625	0.0000000
zheyou73v0_A06	5851101	5851533	BnaA06T0097000ZY	0	+	0	0	432	0.0000000
zheyou73v0_A06	5852271	5855465	BnaA06T0097100ZY	0	-	0	0	3194	0.0000000
zheyou73v0_A06	5856533	5858449	BnaA06T0097200ZY	0	+	0	0	1916	0.0000000
zheyou73v0_A06	5858558	5859722	BnaA06T0097300ZY	0	-	0	0	1164	0.0000000
zheyou73v0_A06	5860606	5861874	BnaA06T0097400ZY	0	-	0	0	1268	0.0000000
zheyou73v0_A06	5862899	5865180	BnaA06T0097500ZY	0	-	0	0	2281	0.0000000
zheyou73v0_A06	5868785	5869393	BnaA06T0097600ZY	0	-	0	0	608	0.0000000
zheyou73v0_A06	5874280	5878869	BnaA06T0097700ZY	0	+	0	0	4589	0.0000000
zheyou73v0_A06	5884785	5886205	BnaA06T0097800ZY	0	+	0	0	1420	0.0000000
zheyou73v0_A06	5886237	5890048	BnaA06T0097900ZY	0	-	0	0	3811	0.0000000
zheyou73v0_A06	5890236	5891922	BnaA06T0098000ZY	0	-	0	0	1686	0.0000000
zheyou73v0_A06	5892827	5894843	BnaA06T0098100ZY	0	+	0	0	2016	0.0000000
zheyou73v0_A06	5895351	5896083	BnaA06T0098200ZY	0	+	0	0	732	0.0000000
zheyou73v0_A06	5896246	5899076	BnaA06T0098300ZY	0	-	0	0	2830	0.0000000
zheyou73v0_A06	5900798	5907198	BnaA06T0098400ZY	0	+	0	0	6400	0.0000000
zheyou73v0_A06	5909598	5915183	BnaA06T0098500ZY	0	-	0	0	5585	0.0000000
zheyou73v0_A06	5919064	5920684	BnaA06T0098600ZY	0	+	0	0	1620	0.0000000
zheyou73v0_A06	5921211	5922702	BnaA06T0098700ZY	0	-	0	0	1491	0.0000000
zheyou73v0_A06	5922940	5923729	BnaA06T0098800ZY	0	-	0	0	789	0.0000000
zheyou73v0_A06	5924132	5929020	BnaA06T0098900ZY	0	+	0	0	4888	0.0000000
zheyou73v0_A06	5929524	5930073	BnaA06T0099000ZY	0	+	0	0	549	0.0000000
zheyou73v0_A06	5930460	5931368	BnaA06T0099100ZY	0	-	0	0	908	0.0000000
zheyou73v0_A06	5931803	5933392	BnaA06T0099200ZY	0	+	0	0	1589	0.0000000
zheyou73v0_A06	5933879	5938111	BnaA06T0099300ZY	0	+	0	0	4232	0.0000000
zheyou73v0_A06	5938485	5946142	BnaA06T0099400ZY	0	-	0	0	7657	0.0000000
zheyou73v0_A06	5953486	5955692	BnaA06T0099500ZY	0	-	0	0	2206	0.0000000
zheyou73v0_A06	5956102	5957793	BnaA06T0099600ZY	0	-	0	0	1691	0.0000000
zheyou73v0_A06	5957924	5959216	BnaA06T0099700ZY	0	+	0	0	1292	0.0000000
zheyou73v0_A06	5959663	5963768	BnaA06T0099800ZY	0	-	0	0	4105	0.0000000
zheyou73v0_A06	5964081	5964894	BnaA06T0099900ZY	0	-	0	0	813	0.0000000
zheyou73v0_A06	5972029	5972828	BnaA06T0100000ZY	0	+	0	0	799	0.0000000
zheyou73v0_A06	5982713	5984082	BnaA06T0100100ZY	0	+	0	0	1369	0.0000000
zheyou73v0_A06	5986943	5988106	BnaA06T0100200ZY	0	+	0	0	1163	0.0000000
zheyou73v0_A06	5989200	5989428	BnaA06T0100300ZY	0	-	0	0	228	0.0000000
zheyou73v0_A06	5990911	5993632	BnaA06T0100400ZY	0	-	0	0	2721	0.0000000
zheyou73v0_A06	5993820	5994936	BnaA06T0100500ZY	0	+	0	0	1116	0.0000000
zheyou73v0_A06	5995138	5996607	BnaA06T0100600ZY	0	-	0	0	1469	0.0000000
zheyou73v0_A06	5997217	5998333	BnaA06T0100700ZY	0	+	0	0	1116	0.0000000
zheyou73v0_A06	5998535	5999467	BnaA06T0100800ZY	0	-	0	0	932	0.0000000
zheyou73v0_A06	6001678	6002724	BnaA06T0100900ZY	0	+	0	0	1046	0.0000000
zheyou73v0_A06	6003621	6005414	BnaA06T0101000ZY	0	-	0	0	1793	0.0000000
zheyou73v0_A06	6011330	6012726	BnaA06T0101100ZY	0	+	0	0	1396	0.0000000
zheyou73v0_A06	6013181	6020269	BnaA06T0101200ZY	0	-	0	0	7088	0.0000000
zheyou73v0_A06	6028394	6030448	BnaA06T0101300ZY	0	+	0	0	2054	0.0000000
zheyou73v0_A06	6031382	6033263	BnaA06T0101400ZY	0	+	0	0	1881	0.0000000
zheyou73v0_A06	6032314	6036079	BnaA06T0101500ZY	0	-	0	0	3765	0.0000000
zheyou73v0_A06	6047372	6050137	BnaA06T0101600ZY	0	+	0	0	2765	0.0000000
zheyou73v0_A06	6050884	6053710	BnaA06T0101700ZY	0	+	0	0	2826	0.0000000
zheyou73v0_A06	6053757	6059762	BnaA06T0101800ZY	0	-	0	0	6005	0.0000000
zheyou73v0_A06	6066597	6067902	BnaA06T0101900ZY	0	+	0	0	1305	0.0000000
zheyou73v0_A06	6068896	6070718	BnaA06T0102000ZY	0	-	0	0	1822	0.0000000
zheyou73v0_A06	6068896	6070718	BnaA06T0102000ZY.1	0	-	0	0	1822	0.0000000
zheyou73v0_A06	6072043	6073631	BnaA06T0102100ZY	0	-	0	0	1588	0.0000000
zheyou73v0_A06	6098166	6101572	BnaA06T0102200ZY	0	+	0	0	3406	0.0000000
zheyou73v0_A06	6102054	6103886	BnaA06T0102300ZY	0	+	0	0	1832	0.0000000
zheyou73v0_A06	6104507	6104819	BnaA06T0102400ZY	0	+	0	0	312	0.0000000
zheyou73v0_A06	6105947	6109557	BnaA06T0102500ZY	0	+	0	0	3610	0.0000000
zheyou73v0_A06	6115791	6117258	BnaA06T0102600ZY	0	+	0	0	1467	0.0000000
zheyou73v0_A06	6126122	6129343	BnaA06T0102700ZY	0	+	0	0	3221	0.0000000
zheyou73v0_A06	6129478	6132403	BnaA06T0102800ZY	0	-	0	0	2925	0.0000000
zheyou73v0_A06	6133566	6137406	BnaA06T0102900ZY	0	+	0	0	3840	0.0000000
zheyou73v0_A06	6133566	6137406	BnaA06T0102900ZY.1	0	+	0	0	3840	0.0000000
zheyou73v0_A06	6137443	6143354	BnaA06T0103000ZY	0	-	0	0	5911	0.0000000
zheyou73v0_A06	6151331	6151906	BnaA06T0103100ZY	0	-	0	0	575	0.0000000
zheyou73v0_A06	6158047	6158656	BnaA06T0103200ZY	0	+	0	0	609	0.0000000
zheyou73v0_A06	6167754	6170209	BnaA06T0103300ZY	0	-	0	0	2455	0.0000000
zheyou73v0_A06	6167754	6170209	BnaA06T0103300ZY.1	0	-	0	0	2455	0.0000000
zheyou73v0_A06	6229315	6230419	BnaA06T0103400ZY	0	-	0	0	1104	0.0000000
zheyou73v0_A06	6232862	6234872	BnaA06T0103500ZY	0	+	0	0	2010	0.0000000
zheyou73v0_A06	6235174	6236061	BnaA06T0103600ZY	0	-	0	0	887	0.0000000
zheyou73v0_A06	6239939	6243748	BnaA06T0103700ZY	0	+	0	0	3809	0.0000000
zheyou73v0_A06	6243989	6244945	BnaA06T0103800ZY	0	+	0	0	956	0.0000000
zheyou73v0_A06	6245101	6246876	BnaA06T0103900ZY	0	-	0	0	1775	0.0000000
zheyou73v0_A06	6248126	6248673	BnaA06T0104000ZY	0	+	0	0	547	0.0000000
zheyou73v0_A06	6248952	6252242	BnaA06T0104100ZY	0	+	0	0	3290	0.0000000
zheyou73v0_A06	6252949	6255160	BnaA06T0104200ZY	0	+	0	0	2211	0.0000000
zheyou73v0_A06	6255884	6259790	BnaA06T0104300ZY	0	+	0	0	3906	0.0000000
zheyou73v0_A06	6260801	6269532	BnaA06T0104400ZY	0	+	0	0	8731	0.0000000
zheyou73v0_A06	6260801	6262547	BnaA06T0104400ZY.1	0	+	0	0	1746	0.0000000
zheyou73v0_A06	6269258	6275734	BnaA06T0104500ZY	0	-	0	0	6476	0.0000000
zheyou73v0_A06	6278672	6280535	BnaA06T0104600ZY	0	+	0	0	1863	0.0000000
zheyou73v0_A06	6280606	6283821	BnaA06T0104700ZY	0	-	0	0	3215	0.0000000
zheyou73v0_A06	6291215	6291893	BnaA06T0104800ZY	0	-	0	0	678	0.0000000
zheyou73v0_A06	6292634	6294222	BnaA06T0104900ZY	0	-	0	0	1588	0.0000000
zheyou73v0_A06	6295314	6295875	BnaA06T0105000ZY	0	-	0	0	561	0.0000000
zheyou73v0_A06	6300701	6302862	BnaA06T0105100ZY	0	+	0	0	2161	0.0000000
zheyou73v0_A06	6305305	6308060	BnaA06T0105200ZY	0	+	0	0	2755	0.0000000
zheyou73v0_A06	6308292	6310186	BnaA06T0105300ZY	0	-	0	0	1894	0.0000000
zheyou73v0_A06	6311806	6313379	BnaA06T0105400ZY	0	+	0	0	1573	0.0000000
zheyou73v0_A06	6313731	6314150	BnaA06T0105500ZY	0	-	0	0	419	0.0000000
zheyou73v0_A06	6317018	6318726	BnaA06T0105600ZY	0	-	0	0	1708	0.0000000
zheyou73v0_A06	6320665	6323400	BnaA06T0105700ZY	0	+	0	0	2735	0.0000000
zheyou73v0_A06	6320665	6323400	BnaA06T0105700ZY.1	0	+	0	0	2735	0.0000000
zheyou73v0_A06	6324099	6325975	BnaA06T0105800ZY	0	+	0	0	1876	0.0000000
zheyou73v0_A06	6326210	6327615	BnaA06T0105900ZY	0	-	0	0	1405	0.0000000
zheyou73v0_A06	6326520	6327615	BnaA06T0105900ZY.1	0	-	0	0	1095	0.0000000
zheyou73v0_A06	6327671	6328555	BnaA06T0106000ZY	0	+	0	0	884	0.0000000
zheyou73v0_A06	6328612	6329167	BnaA06T0106100ZY	0	+	0	0	555	0.0000000
zheyou73v0_A06	6330234	6334929	BnaA06T0106200ZY	0	+	0	0	4695	0.0000000
zheyou73v0_A06	6337839	6338319	BnaA06T0106300ZY	0	-	0	0	480	0.0000000
zheyou73v0_A06	6338485	6339298	BnaA06T0106400ZY	0	+	0	0	813	0.0000000
zheyou73v0_A06	6339571	6342847	BnaA06T0106500ZY	0	-	0	0	3276	0.0000000
zheyou73v0_A06	6343174	6346675	BnaA06T0106600ZY	0	+	0	0	3501	0.0000000
zheyou73v0_A06	6347742	6349927	BnaA06T0106700ZY	0	+	0	0	2185	0.0000000
zheyou73v0_A06	6351360	6352318	BnaA06T0106800ZY	0	+	0	0	958	0.0000000
zheyou73v0_A06	6352726	6357994	BnaA06T0106900ZY	0	-	0	0	5268	0.0000000
zheyou73v0_A06	6358425	6360710	BnaA06T0107000ZY	0	+	0	0	2285	0.0000000
zheyou73v0_A06	6358425	6360710	BnaA06T0107000ZY.1	0	+	0	0	2285	0.0000000
zheyou73v0_A06	6380849	6401683	BnaA06T0107100ZY	0	-	0	0	20834	0.0000000
zheyou73v0_A06	6404030	6406216	BnaA06T0107200ZY	0	+	0	0	2186	0.0000000
zheyou73v0_A06	6406838	6407860	BnaA06T0107300ZY	0	+	0	0	1022	0.0000000
zheyou73v0_A06	6407996	6410125	BnaA06T0107400ZY	0	+	0	0	2129	0.0000000
zheyou73v0_A06	6410472	6413391	BnaA06T0107500ZY	0	-	0	0	2919	0.0000000
zheyou73v0_A06	6414055	6414256	BnaA06T0107600ZY	0	+	0	0	201	0.0000000
zheyou73v0_A06	6417487	6418009	BnaA06T0107700ZY	0	+	0	0	522	0.0000000
zheyou73v0_A06	6418071	6422210	BnaA06T0107800ZY	0	-	0	0	4139	0.0000000
zheyou73v0_A06	6423627	6424114	BnaA06T0107900ZY	0	+	0	0	487	0.0000000
zheyou73v0_A06	6430158	6430538	BnaA06T0108000ZY	0	+	0	0	380	0.0000000
zheyou73v0_A06	6431553	6439419	BnaA06T0108100ZY	0	-	0	0	7866	0.0000000
zheyou73v0_A06	6439743	6440988	BnaA06T0108200ZY	0	-	0	0	1245	0.0000000
zheyou73v0_A06	6443768	6444248	BnaA06T0108300ZY	0	-	0	0	480	0.0000000
zheyou73v0_A06	6450543	6451553	BnaA06T0108400ZY	0	+	0	0	1010	0.0000000
zheyou73v0_A06	6459900	6464360	BnaA06T0108500ZY	0	+	0	0	4460	0.0000000
zheyou73v0_A06	6467712	6468486	BnaA06T0108600ZY	0	-	0	0	774	0.0000000
zheyou73v0_A06	6472096	6472604	BnaA06T0108700ZY	0	-	0	0	508	0.0000000
zheyou73v0_A06	6474155	6476258	BnaA06T0108800ZY	0	+	0	0	2103	0.0000000
zheyou73v0_A06	6476578	6478392	BnaA06T0108900ZY	0	-	0	0	1814	0.0000000
zheyou73v0_A06	6483473	6489152	BnaA06T0109000ZY	0	+	0	0	5679	0.0000000
zheyou73v0_A06	6491407	6495595	BnaA06T0109100ZY	0	-	0	0	4188	0.0000000
zheyou73v0_A06	6503034	6508579	BnaA06T0109200ZY	0	+	0	0	5545	0.0000000
zheyou73v0_A06	6508705	6511688	BnaA06T0109300ZY	0	-	0	0	2983	0.0000000
zheyou73v0_A06	6509076	6511688	BnaA06T0109300ZY.1	0	-	0	0	2612	0.0000000
zheyou73v0_A06	6515446	6519340	BnaA06T0109400ZY	0	+	0	0	3894	0.0000000
zheyou73v0_A06	6519958	6522445	BnaA06T0109500ZY	0	-	0	0	2487	0.0000000
zheyou73v0_A06	6525031	6526081	BnaA06T0109600ZY	0	+	0	0	1050	0.0000000
zheyou73v0_A06	6526521	6529425	BnaA06T0109700ZY	0	+	0	0	2904	0.0000000
zheyou73v0_A06	6526521	6529425	BnaA06T0109700ZY.1	0	+	0	0	2904	0.0000000
zheyou73v0_A06	6531322	6532933	BnaA06T0109800ZY	0	+	0	0	1611	0.0000000
zheyou73v0_A06	6534632	6537842	BnaA06T0109900ZY	0	+	0	0	3210	0.0000000
zheyou73v0_A06	6538154	6539810	BnaA06T0110000ZY	0	+	0	0	1656	0.0000000
zheyou73v0_A06	6541036	6548196	BnaA06T0110100ZY	0	+	0	0	7160	0.0000000
zheyou73v0_A06	6551297	6554578	BnaA06T0110200ZY	0	+	0	0	3281	0.0000000
zheyou73v0_A06	6555244	6556334	BnaA06T0110300ZY	0	+	0	0	1090	0.0000000
zheyou73v0_A06	6557682	6561232	BnaA06T0110400ZY	0	+	0	0	3550	0.0000000
zheyou73v0_A06	6562101	6562664	BnaA06T0110500ZY	0	+	0	0	563	0.0000000
zheyou73v0_A06	6564012	6565254	BnaA06T0110600ZY	0	+	0	0	1242	0.0000000
zheyou73v0_A06	6568919	6570827	BnaA06T0110700ZY	0	+	0	0	1908	0.0000000
zheyou73v0_A06	6570952	6571948	BnaA06T0110800ZY	0	-	0	0	996	0.0000000
zheyou73v0_A06	6572443	6573254	BnaA06T0110900ZY	0	-	0	0	811	0.0000000
zheyou73v0_A06	6579002	6581661	BnaA06T0111000ZY	0	+	0	0	2659	0.0000000
zheyou73v0_A06	6579002	6581661	BnaA06T0111000ZY.1	0	+	0	0	2659	0.0000000
zheyou73v0_A06	6582071	6584479	BnaA06T0111100ZY	0	-	0	0	2408	0.0000000
zheyou73v0_A06	6584896	6586677	BnaA06T0111200ZY	0	+	0	0	1781	0.0000000
zheyou73v0_A06	6587094	6588525	BnaA06T0111300ZY	0	-	0	0	1431	0.0000000
zheyou73v0_A06	6589122	6592069	BnaA06T0111400ZY	0	-	0	0	2947	0.0000000
zheyou73v0_A06	6589122	6592069	BnaA06T0111400ZY.1	0	-	0	0	2947	0.0000000
zheyou73v0_A06	6592576	6592864	BnaA06T0111500ZY	0	-	0	0	288	0.0000000
zheyou73v0_A06	6592906	6593894	BnaA06T0111600ZY	0	-	0	0	988	0.0000000
zheyou73v0_A06	6594083	6601991	BnaA06T0111700ZY	0	+	0	0	7908	0.0000000
zheyou73v0_A06	6602808	6604043	BnaA06T0111800ZY	0	-	0	0	1235	0.0000000
zheyou73v0_A06	6606003	6608006	BnaA06T0111900ZY	0	+	0	0	2003	0.0000000
zheyou73v0_A06	6615529	6616687	BnaA06T0112000ZY	0	+	0	0	1158	0.0000000
zheyou73v0_A06	6618324	6618609	BnaA06T0112100ZY	0	+	0	0	285	0.0000000
zheyou73v0_A06	6620425	6624222	BnaA06T0112200ZY	0	-	0	0	3797	0.0000000
zheyou73v0_A06	6625755	6629810	BnaA06T0112300ZY	0	+	0	0	4055	0.0000000
zheyou73v0_A06	6634280	6638368	BnaA06T0112400ZY	0	+	0	0	4088	0.0000000
zheyou73v0_A06	6638468	6641129	BnaA06T0112500ZY	0	-	0	0	2661	0.0000000
zheyou73v0_A06	6638468	6641129	BnaA06T0112500ZY.1	0	-	0	0	2661	0.0000000
zheyou73v0_A06	6642419	6644175	BnaA06T0112600ZY	0	+	0	0	1756	0.0000000
zheyou73v0_A06	6646072	6654315	BnaA06T0112700ZY	0	+	0	0	8243	0.0000000
zheyou73v0_A06	6654847	6658242	BnaA06T0112800ZY	0	+	0	0	3395	0.0000000
zheyou73v0_A06	6654847	6658242	BnaA06T0112800ZY.1	0	+	0	0	3395	0.0000000
zheyou73v0_A06	6654847	6658242	BnaA06T0112800ZY.2	0	+	0	0	3395	0.0000000
zheyou73v0_A06	6664192	6666338	BnaA06T0112900ZY	0	+	0	0	2146	0.0000000
zheyou73v0_A06	6668604	6671711	BnaA06T0113000ZY	0	-	0	0	3107	0.0000000
zheyou73v0_A06	6673863	6674650	BnaA06T0113100ZY	0	+	0	0	787	0.0000000
zheyou73v0_A06	6680847	6681126	BnaA06T0113200ZY	0	-	0	0	279	0.0000000
zheyou73v0_A06	6685216	6686706	BnaA06T0113300ZY	0	+	0	0	1490	0.0000000
zheyou73v0_A06	6686292	6690012	BnaA06T0113400ZY	0	-	0	0	3720	0.0000000
zheyou73v0_A06	6692431	6694994	BnaA06T0113500ZY	0	+	0	0	2563	0.0000000
zheyou73v0_A06	6694649	6695913	BnaA06T0113600ZY	0	-	0	0	1264	0.0000000
zheyou73v0_A06	6697999	6699723	BnaA06T0113700ZY	0	-	0	0	1724	0.0000000
zheyou73v0_A06	6700352	6700649	BnaA06T0113800ZY	0	-	0	0	297	0.0000000
zheyou73v0_A06	6705820	6707050	BnaA06T0113900ZY	0	+	0	0	1230	0.0000000
zheyou73v0_A06	6707159	6708985	BnaA06T0114000ZY	0	-	0	0	1826	0.0000000
zheyou73v0_A06	6707159	6709009	BnaA06T0114000ZY.1	0	-	0	0	1850	0.0000000
zheyou73v0_A06	6714060	6715100	BnaA06T0114100ZY	0	+	0	0	1040	0.0000000
zheyou73v0_A06	6716051	6717111	BnaA06T0114200ZY	0	+	0	0	1060	0.0000000
zheyou73v0_A06	6718099	6719088	BnaA06T0114300ZY	0	+	0	0	989	0.0000000
zheyou73v0_A06	6722675	6723881	BnaA06T0114400ZY	0	+	0	0	1206	0.0000000
zheyou73v0_A06	6724696	6728745	BnaA06T0114500ZY	0	-	0	0	4049	0.0000000
zheyou73v0_A06	6729064	6733928	BnaA06T0114600ZY	0	+	0	0	4864	0.0000000
zheyou73v0_A06	6738376	6742419	BnaA06T0114700ZY	0	+	0	0	4043	0.0000000
zheyou73v0_A06	6745569	6748240	BnaA06T0114800ZY	0	-	0	0	2671	0.0000000
zheyou73v0_A06	6745569	6748240	BnaA06T0114800ZY.1	0	-	0	0	2671	0.0000000
zheyou73v0_A06	6749234	6749629	BnaA06T0114900ZY	0	+	0	0	395	0.0000000
zheyou73v0_A06	6754592	6757774	BnaA06T0115000ZY	0	+	0	0	3182	0.0000000
zheyou73v0_A06	6758415	6760074	BnaA06T0115100ZY	0	+	0	0	1659	0.0000000
zheyou73v0_A06	6762032	6765952	BnaA06T0115200ZY	0	+	0	0	3920	0.0000000
zheyou73v0_A06	6766322	6766529	BnaA06T0115300ZY	0	+	0	0	207	0.0000000
zheyou73v0_A06	6768894	6769293	BnaA06T0115400ZY	0	+	0	0	399	0.0000000
zheyou73v0_A06	6772385	6774141	BnaA06T0115500ZY	0	+	0	0	1756	0.0000000
zheyou73v0_A06	6776433	6781631	BnaA06T0115600ZY	0	+	0	0	5198	0.0000000
zheyou73v0_A06	6781844	6783590	BnaA06T0115700ZY	0	-	0	0	1746	0.0000000
zheyou73v0_A06	6783826	6785298	BnaA06T0115800ZY	0	-	0	0	1472	0.0000000
zheyou73v0_A06	6791769	6793336	BnaA06T0115900ZY	0	-	0	0	1567	0.0000000
zheyou73v0_A06	6812350	6815249	BnaA06T0116000ZY	0	-	0	0	2899	0.0000000
zheyou73v0_A06	6818258	6821712	BnaA06T0116100ZY	0	+	0	0	3454	0.0000000
zheyou73v0_A06	6821905	6825126	BnaA06T0116200ZY	0	+	0	0	3221	0.0000000
zheyou73v0_A06	6821947	6825126	BnaA06T0116200ZY.1	0	+	0	0	3179	0.0000000
zheyou73v0_A06	6825201	6826927	BnaA06T0116300ZY	0	-	0	0	1726	0.0000000
zheyou73v0_A06	6827918	6829019	BnaA06T0116400ZY	0	-	0	0	1101	0.0000000
zheyou73v0_A06	6831919	6832548	BnaA06T0116500ZY	0	+	0	0	629	0.0000000
zheyou73v0_A06	6832646	6833388	BnaA06T0116600ZY	0	-	0	0	742	0.0000000
zheyou73v0_A06	6833390	6836205	BnaA06T0116700ZY	0	-	0	0	2815	0.0000000
zheyou73v0_A06	6833761	6836076	BnaA06T0116700ZY.1	0	-	0	0	2315	0.0000000
zheyou73v0_A06	6836516	6837417	BnaA06T0116800ZY	0	+	0	0	901	0.0000000
zheyou73v0_A06	6837929	6840867	BnaA06T0116900ZY	0	-	0	0	2938	0.0000000
zheyou73v0_A06	6841465	6844247	BnaA06T0117000ZY	0	+	0	0	2782	0.0000000
zheyou73v0_A06	6844727	6845716	BnaA06T0117100ZY	0	-	0	0	989	0.0000000
zheyou73v0_A06	6847953	6849588	BnaA06T0117200ZY	0	+	0	0	1635	0.0000000
zheyou73v0_A06	6855682	6856580	BnaA06T0117300ZY	0	+	0	0	898	0.0000000
zheyou73v0_A06	6858669	6861054	BnaA06T0117400ZY	0	+	0	0	2385	0.0000000
zheyou73v0_A06	6861230	6863327	BnaA06T0117500ZY	0	-	0	0	2097	0.0000000
zheyou73v0_A06	6861230	6862675	BnaA06T0117500ZY.1	0	-	0	0	1445	0.0000000
zheyou73v0_A06	6863338	6865754	BnaA06T0117600ZY	0	-	0	0	2416	0.0000000
zheyou73v0_A06	6866345	6868281	BnaA06T0117700ZY	0	-	0	0	1936	0.0000000
zheyou73v0_A06	6869785	6875808	BnaA06T0117800ZY	0	+	0	0	6023	0.0000000
zheyou73v0_A06	6869785	6875808	BnaA06T0117800ZY.1	0	+	0	0	6023	0.0000000
zheyou73v0_A06	6878825	6879432	BnaA06T0117900ZY	0	+	0	0	607	0.0000000
zheyou73v0_A06	6882387	6883552	BnaA06T0118000ZY	0	-	0	0	1165	0.0000000
zheyou73v0_A06	6885460	6889664	BnaA06T0118100ZY	0	-	0	0	4204	0.0000000
zheyou73v0_A06	6897719	6913455	BnaA06T0118200ZY	0	+	0	0	15736	0.0000000
zheyou73v0_A06	6919554	7004480	BnaA06T0118300ZY	0	-	0	0	84926	0.0000000
zheyou73v0_A06	7005466	7006800	BnaA06T0118400ZY	0	+	0	0	1334	0.0000000
zheyou73v0_A06	7006807	7009953	BnaA06T0118500ZY	0	-	0	0	3146	0.0000000
zheyou73v0_A06	7010949	7013158	BnaA06T0118600ZY	0	-	0	0	2209	0.0000000
zheyou73v0_A06	7015867	7019340	BnaA06T0118700ZY	0	+	0	0	3473	0.0000000
zheyou73v0_A06	7019136	7021946	BnaA06T0118800ZY	0	-	0	0	2810	0.0000000
zheyou73v0_A06	7019136	7021946	BnaA06T0118800ZY.1	0	-	0	0	2810	0.0000000
zheyou73v0_A06	7022802	7023469	BnaA06T0118900ZY	0	+	0	0	667	0.0000000
zheyou73v0_A06	7022802	7025699	BnaA06T0119000ZY	0	-	0	0	2897	0.0000000
zheyou73v0_A06	7026029	7026878	BnaA06T0119100ZY	0	-	0	0	849	0.0000000
zheyou73v0_A06	7027640	7029067	BnaA06T0119200ZY	0	-	0	0	1427	0.0000000
zheyou73v0_A06	7027640	7029067	BnaA06T0119200ZY.1	0	-	0	0	1427	0.0000000
zheyou73v0_A06	7031563	7035782	BnaA06T0119300ZY	0	-	0	0	4219	0.0000000
zheyou73v0_A06	7035813	7037598	BnaA06T0119400ZY	0	-	0	0	1785	0.0000000
zheyou73v0_A06	7042582	7043402	BnaA06T0119500ZY	0	-	0	0	820	0.0000000
zheyou73v0_A06	7059363	7062506	BnaA06T0119600ZY.3	0	-	0	0	3143	0.0000000
zheyou73v0_A06	7059701	7062922	BnaA06T0119600ZY	0	-	0	0	3221	0.0000000
zheyou73v0_A06	7059701	7062728	BnaA06T0119600ZY.1	0	-	0	0	3027	0.0000000
zheyou73v0_A06	7059701	7062126	BnaA06T0119600ZY.2	0	-	0	0	2425	0.0000000
zheyou73v0_A06	7059701	7062922	BnaA06T0119600ZY.4	0	-	0	0	3221	0.0000000
zheyou73v0_A06	7094244	7104371	BnaA06T0119700ZY	0	+	0	0	10127	0.0000000
zheyou73v0_A06	7108906	7132628	BnaA06T0119800ZY	0	+	0	0	23722	0.0000000
zheyou73v0_A06	7154028	7156262	BnaA06T0119900ZY	0	+	0	0	2234	0.0000000
zheyou73v0_A06	7159829	7161995	BnaA06T0120000ZY	0	+	0	0	2166	0.0000000
zheyou73v0_A06	7164532	7165234	BnaA06T0120100ZY	0	-	0	0	702	0.0000000
zheyou73v0_A06	7165350	7167059	BnaA06T0120200ZY	0	-	0	0	1709	0.0000000
zheyou73v0_A06	7173090	7177541	BnaA06T0120300ZY	0	+	0	0	4451	0.0000000
zheyou73v0_A06	7178842	7181008	BnaA06T0120400ZY	0	+	0	0	2166	0.0000000
zheyou73v0_A06	7183546	7198606	BnaA06T0120500ZY	0	-	0	0	15060	0.0000000
zheyou73v0_A06	7210170	7211897	BnaA06T0120600ZY	0	+	0	0	1727	0.0000000
zheyou73v0_A06	7213109	7215101	BnaA06T0120700ZY	0	-	0	0	1992	0.0000000
zheyou73v0_A06	7217229	7220534	BnaA06T0120800ZY	0	-	0	0	3305	0.0000000
zheyou73v0_A06	7222448	7222775	BnaA06T0120900ZY	0	-	0	0	327	0.0000000
zheyou73v0_A06	7226495	7231512	BnaA06T0121000ZY	0	+	0	0	5017	0.0000000
zheyou73v0_A06	7232202	7233983	BnaA06T0121100ZY	0	+	0	0	1781	0.0000000
zheyou73v0_A06	7234358	7237997	BnaA06T0121200ZY	0	-	0	0	3639	0.0000000
zheyou73v0_A06	7244604	7244985	BnaA06T0121300ZY	0	+	0	0	381	0.0000000
zheyou73v0_A06	7246551	7247055	BnaA06T0121400ZY	0	-	0	0	504	0.0000000
zheyou73v0_A06	7249692	7250836	BnaA06T0121500ZY	0	-	0	0	1144	0.0000000
zheyou73v0_A06	7251915	7254580	BnaA06T0121600ZY	0	-	0	0	2665	0.0000000
zheyou73v0_A06	7254940	7255973	BnaA06T0121700ZY	0	-	0	0	1033	0.0000000
zheyou73v0_A06	7256174	7266057	BnaA06T0121800ZY	0	-	0	0	9883	0.0000000
zheyou73v0_A06	7267305	7268222	BnaA06T0121900ZY	0	+	0	0	917	0.0000000
zheyou73v0_A06	7270279	7270959	BnaA06T0122000ZY	0	+	0	0	680	0.0000000
zheyou73v0_A06	7272711	7273690	BnaA06T0122100ZY	0	+	0	0	979	0.0000000
zheyou73v0_A06	7274053	7276622	BnaA06T0122200ZY	0	-	0	0	2569	0.0000000
zheyou73v0_A06	7288906	7289852	BnaA06T0122300ZY	0	-	0	0	946	0.0000000
zheyou73v0_A06	7290803	7292821	BnaA06T0122400ZY	0	-	0	0	2018	0.0000000
zheyou73v0_A06	7294307	7296414	BnaA06T0122500ZY	0	-	0	0	2107	0.0000000
zheyou73v0_A06	7294307	7296414	BnaA06T0122500ZY.1	0	-	0	0	2107	0.0000000
zheyou73v0_A06	7298258	7302784	BnaA06T0122600ZY	0	-	0	0	4526	0.0000000
zheyou73v0_A06	7314988	7320434	BnaA06T0122700ZY	0	+	0	0	5446	0.0000000
zheyou73v0_A06	7321897	7323622	BnaA06T0122800ZY	0	+	0	0	1725	0.0000000
zheyou73v0_A06	7321897	7323622	BnaA06T0122800ZY.1	0	+	0	0	1725	0.0000000
zheyou73v0_A06	7328981	7329369	BnaA06T0122900ZY	0	+	0	0	388	0.0000000
zheyou73v0_A06	7332415	7337939	BnaA06T0123000ZY	0	-	0	0	5524	0.0000000
zheyou73v0_A06	7339499	7340518	BnaA06T0123100ZY	0	-	0	0	1019	0.0000000
zheyou73v0_A06	7340880	7343180	BnaA06T0123200ZY	0	+	0	0	2300	0.0000000
zheyou73v0_A06	7343381	7345426	BnaA06T0123300ZY	0	+	0	0	2045	0.0000000
zheyou73v0_A06	7345618	7349476	BnaA06T0123400ZY	0	+	0	0	3858	0.0000000
zheyou73v0_A06	7349934	7353563	BnaA06T0123500ZY	0	-	0	0	3629	0.0000000
zheyou73v0_A06	7362217	7363876	BnaA06T0123600ZY	0	+	0	0	1659	0.0000000
zheyou73v0_A06	7365808	7366552	BnaA06T0123700ZY	0	+	0	0	744	0.0000000
zheyou73v0_A06	7368234	7368597	BnaA06T0123800ZY	0	+	0	0	363	0.0000000
zheyou73v0_A06	7369986	7371473	BnaA06T0123900ZY	0	+	0	0	1487	0.0000000
zheyou73v0_A06	7369986	7371473	BnaA06T0123900ZY.1	0	+	0	0	1487	0.0000000
zheyou73v0_A06	7369986	7371473	BnaA06T0123900ZY.2	0	+	0	0	1487	0.0000000
zheyou73v0_A06	7371852	7375258	BnaA06T0124000ZY	0	+	0	0	3406	0.0000000
zheyou73v0_A06	7375530	7376358	BnaA06T0124100ZY	0	+	0	0	828	0.0000000
zheyou73v0_A06	7376872	7377859	BnaA06T0124200ZY	0	+	0	0	987	0.0000000
zheyou73v0_A06	7378207	7378717	BnaA06T0124300ZY	0	+	0	0	510	0.0000000
zheyou73v0_A06	7378675	7380014	BnaA06T0124400ZY	0	-	0	0	1339	0.0000000
zheyou73v0_A06	7380467	7383118	BnaA06T0124500ZY	0	-	0	0	2651	0.0000000
zheyou73v0_A06	7384663	7384840	BnaA06T0124600ZY	0	-	0	0	177	0.0000000
zheyou73v0_A06	7411068	7413632	BnaA06T0124700ZY	0	+	0	0	2564	0.0000000
zheyou73v0_A06	7416446	7419070	BnaA06T0124800ZY	0	+	0	0	2624	0.0000000
zheyou73v0_A06	7427131	7428435	BnaA06T0124900ZY	0	+	0	0	1304	0.0000000
zheyou73v0_A06	7431008	7431200	BnaA06T0125000ZY	0	-	0	0	192	0.0000000
zheyou73v0_A06	7451017	7454430	BnaA06T0125100ZY	0	+	0	0	3413	0.0000000
zheyou73v0_A06	7464765	7465866	BnaA06T0125200ZY	0	-	0	0	1101	0.0000000
zheyou73v0_A06	7471173	7473977	BnaA06T0125300ZY	0	+	0	0	2804	0.0000000
zheyou73v0_A06	7483618	7484522	BnaA06T0125400ZY	0	+	0	0	904	0.0000000
zheyou73v0_A06	7484721	7488717	BnaA06T0125500ZY	0	-	0	0	3996	0.0000000
zheyou73v0_A06	7494707	7498433	BnaA06T0125600ZY	0	+	0	0	3726	0.0000000
zheyou73v0_A06	7498738	7500232	BnaA06T0125700ZY	0	+	0	0	1494	0.0000000
zheyou73v0_A06	7500342	7502066	BnaA06T0125800ZY	0	+	0	0	1724	0.0000000
zheyou73v0_A06	7512636	7513898	BnaA06T0125900ZY	0	+	0	0	1262	0.0000000
zheyou73v0_A06	7525888	7529471	BnaA06T0126000ZY	0	+	0	0	3583	0.0000000
zheyou73v0_A06	7562086	7564982	BnaA06T0126100ZY	0	+	0	0	2896	0.0000000
zheyou73v0_A06	7573970	7575596	BnaA06T0126200ZY	0	+	0	0	1626	0.0000000
zheyou73v0_A06	7578468	7579938	BnaA06T0126300ZY	0	+	0	0	1470	0.0000000
zheyou73v0_A06	7581405	7616127	BnaA06T0126400ZY	0	+	0	0	34722	0.0000000
zheyou73v0_A06	7617941	7619801	BnaA06T0126500ZY	0	-	0	0	1860	0.0000000
zheyou73v0_A06	7622379	7623489	BnaA06T0126600ZY	0	-	0	0	1110	0.0000000
zheyou73v0_A06	7626509	7627631	BnaA06T0126700ZY	0	-	0	0	1122	0.0000000
zheyou73v0_A06	7630210	7630835	BnaA06T0126800ZY	0	-	0	0	625	0.0000000
zheyou73v0_A06	7640218	7640547	BnaA06T0126900ZY	0	-	0	0	329	0.0000000
zheyou73v0_A06	7641995	7644781	BnaA06T0127000ZY	0	-	0	0	2786	0.0000000
zheyou73v0_A06	7641995	7644781	BnaA06T0127000ZY.1	0	-	0	0	2786	0.0000000
zheyou73v0_A06	7641995	7644781	BnaA06T0127000ZY.2	0	-	0	0	2786	0.0000000
zheyou73v0_A06	7641995	7644543	BnaA06T0127000ZY.3	0	-	0	0	2548	0.0000000
zheyou73v0_A06	7645853	7647452	BnaA06T0127100ZY	0	-	0	0	1599	0.0000000
zheyou73v0_A06	7659590	7660411	BnaA06T0127200ZY	0	+	0	0	821	0.0000000
zheyou73v0_A06	7665804	7666774	BnaA06T0127300ZY	0	+	0	0	970	0.0000000
zheyou73v0_A06	7669438	7678463	BnaA06T0127400ZY	0	+	0	0	9025	0.0000000
zheyou73v0_A06	7683263	7685679	BnaA06T0127500ZY	0	-	0	0	2416	0.0000000
zheyou73v0_A06	7683604	7685679	BnaA06T0127500ZY.1	0	-	0	0	2075	0.0000000
zheyou73v0_A06	7688167	7691092	BnaA06T0127600ZY	0	+	0	0	2925	0.0000000
zheyou73v0_A06	7691378	7692959	BnaA06T0127700ZY	0	-	0	0	1581	0.0000000
zheyou73v0_A06	7691378	7692959	BnaA06T0127700ZY.1	0	-	0	0	1581	0.0000000
zheyou73v0_A06	7693235	7694445	BnaA06T0127800ZY	0	-	0	0	1210	0.0000000
zheyou73v0_A06	7699867	7700074	BnaA06T0127900ZY	0	-	0	0	207	0.0000000
zheyou73v0_A06	7702375	7705286	BnaA06T0128000ZY	0	+	0	0	2911	0.0000000
zheyou73v0_A06	7711866	7716676	BnaA06T0128100ZY	0	+	0	0	4810	0.0000000
zheyou73v0_A06	7723859	7724664	BnaA06T0128200ZY	0	-	0	0	805	0.0000000
zheyou73v0_A06	7725092	7726923	BnaA06T0128300ZY	0	-	0	0	1831	0.0000000
zheyou73v0_A06	7728467	7729240	BnaA06T0128400ZY	0	-	0	0	773	0.0000000
zheyou73v0_A06	7731319	7732958	BnaA06T0128500ZY	0	-	0	0	1639	0.0000000
zheyou73v0_A06	7731319	7732958	BnaA06T0128500ZY.1	0	-	0	0	1639	0.0000000
zheyou73v0_A06	7731319	7732958	BnaA06T0128500ZY.2	0	-	0	0	1639	0.0000000
zheyou73v0_A06	7731319	7732958	BnaA06T0128500ZY.3	0	-	0	0	1639	0.0000000
zheyou73v0_A06	7731319	7732958	BnaA06T0128500ZY.4	0	-	0	0	1639	0.0000000
zheyou73v0_A06	7731319	7732958	BnaA06T0128500ZY.5	0	-	0	0	1639	0.0000000
zheyou73v0_A06	7731319	7732958	BnaA06T0128500ZY.6	0	-	0	0	1639	0.0000000
zheyou73v0_A06	7731319	7732958	BnaA06T0128500ZY.7	0	-	0	0	1639	0.0000000
zheyou73v0_A06	7731319	7732958	BnaA06T0128500ZY.8	0	-	0	0	1639	0.0000000
zheyou73v0_A06	7731319	7732958	BnaA06T0128500ZY.9	0	-	0	0	1639	0.0000000
zheyou73v0_A06	7734215	7734615	BnaA06T0128600ZY	0	+	0	0	400	0.0000000
zheyou73v0_A06	7734698	7736284	BnaA06T0128700ZY	0	-	0	0	1586	0.0000000
zheyou73v0_A06	7758104	7760514	BnaA06T0128800ZY	0	+	0	0	2410	0.0000000
zheyou73v0_A06	7763116	7766844	BnaA06T0128900ZY	0	+	0	0	3728	0.0000000
zheyou73v0_A06	7773427	7775143	BnaA06T0129000ZY	0	-	0	0	1716	0.0000000
zheyou73v0_A06	7773427	7775143	BnaA06T0129000ZY.1	0	-	0	0	1716	0.0000000
zheyou73v0_A06	7784361	7785962	BnaA06T0129100ZY	0	+	0	0	1601	0.0000000
zheyou73v0_A06	7786508	7787300	BnaA06T0129200ZY	0	+	0	0	792	0.0000000
zheyou73v0_A06	7793257	7794312	BnaA06T0129300ZY	0	-	0	0	1055	0.0000000
zheyou73v0_A06	7807721	7808254	BnaA06T0129400ZY	0	-	0	0	533	0.0000000
zheyou73v0_A06	7808713	7813182	BnaA06T0129500ZY	0	-	0	0	4469	0.0000000
zheyou73v0_A06	7808713	7812367	BnaA06T0129500ZY.1	0	-	0	0	3654	0.0000000
zheyou73v0_A06	7826540	7832126	BnaA06T0129600ZY	0	+	0	0	5586	0.0000000
zheyou73v0_A06	7837207	7837949	BnaA06T0129700ZY	0	-	0	0	742	0.0000000
zheyou73v0_A06	7838487	7841111	BnaA06T0129800ZY	0	-	0	0	2624	0.0000000
zheyou73v0_A06	7850219	7853407	BnaA06T0129900ZY	0	-	0	0	3188	0.0000000
zheyou73v0_A06	7857663	7860662	BnaA06T0130000ZY	0	+	0	0	2999	0.0000000
zheyou73v0_A06	7865849	7867180	BnaA06T0130100ZY	0	-	0	0	1331	0.0000000
zheyou73v0_A06	7870806	7872430	BnaA06T0130200ZY	0	-	0	0	1624	0.0000000
zheyou73v0_A06	7882684	7883860	BnaA06T0130300ZY	0	+	0	0	1176	0.0000000
zheyou73v0_A06	7888305	7890370	BnaA06T0130400ZY	0	-	0	0	2065	0.0000000
zheyou73v0_A06	7890877	7892043	BnaA06T0130500ZY	0	+	0	0	1166	0.0000000
zheyou73v0_A06	7893310	7895898	BnaA06T0130600ZY	0	-	0	0	2588	0.0000000
zheyou73v0_A06	7893310	7895898	BnaA06T0130600ZY.1	0	-	0	0	2588	0.0000000
zheyou73v0_A06	7897645	7899800	BnaA06T0130700ZY	0	+	0	0	2155	0.0000000
zheyou73v0_A06	7900788	7902411	BnaA06T0130800ZY	0	+	0	0	1623	0.0000000
zheyou73v0_A06	7902411	7904355	BnaA06T0130900ZY	0	-	0	0	1944	0.0000000
zheyou73v0_A06	7905319	7907491	BnaA06T0131000ZY	0	-	0	0	2172	0.0000000
zheyou73v0_A06	7917621	7921195	BnaA06T0131100ZY	0	-	0	0	3574	0.0000000
zheyou73v0_A06	7922093	7925673	BnaA06T0131200ZY	0	-	0	0	3580	0.0000000
zheyou73v0_A06	7922093	7925673	BnaA06T0131200ZY.1	0	-	0	0	3580	0.0000000
zheyou73v0_A06	7929212	7930727	BnaA06T0131300ZY	0	+	0	0	1515	0.0000000
zheyou73v0_A06	7945791	7945983	BnaA06T0131400ZY	0	-	0	0	192	0.0000000
zheyou73v0_A06	7994325	7997575	BnaA06T0131500ZY	0	-	0	0	3250	0.0000000
zheyou73v0_A06	7994325	7997575	BnaA06T0131500ZY.1	0	-	0	0	3250	0.0000000
zheyou73v0_A06	7999621	8001639	BnaA06T0131600ZY	0	+	0	0	2018	0.0000000
zheyou73v0_A06	8002121	8006422	BnaA06T0131700ZY	0	+	0	0	4301	0.0000000
zheyou73v0_A06	8006854	8008956	BnaA06T0131800ZY	0	-	0	0	2102	0.0000000
zheyou73v0_A06	8009003	8010588	BnaA06T0131900ZY	0	-	0	0	1585	0.0000000
zheyou73v0_A06	8011047	8012178	BnaA06T0132000ZY	0	-	0	0	1131	0.0000000
zheyou73v0_A06	8015201	8017631	BnaA06T0132100ZY	0	+	0	0	2430	0.0000000
zheyou73v0_A06	8018811	8019977	BnaA06T0132200ZY	0	+	0	0	1166	0.0000000
zheyou73v0_A06	8021102	8022895	BnaA06T0132300ZY	0	+	0	0	1793	0.0000000
zheyou73v0_A06	8023599	8023946	BnaA06T0132400ZY	0	-	0	0	347	0.0000000
zheyou73v0_A06	8024617	8027953	BnaA06T0132500ZY	0	+	0	0	3336	0.0000000
zheyou73v0_A06	8029203	8031336	BnaA06T0132600ZY	0	+	0	0	2133	0.0000000
zheyou73v0_A06	8029203	8031336	BnaA06T0132600ZY.1	0	+	0	0	2133	0.0000000
zheyou73v0_A06	8043279	8044299	BnaA06T0132700ZY	0	+	0	0	1020	0.0000000
zheyou73v0_A06	8045317	8048157	BnaA06T0132800ZY	0	-	0	0	2840	0.0000000
zheyou73v0_A06	8045973	8048157	BnaA06T0132800ZY.1	0	-	0	0	2184	0.0000000
zheyou73v0_A06	8052524	8058655	BnaA06T0132900ZY	0	-	0	0	6131	0.0000000
zheyou73v0_A06	8064720	8065152	BnaA06T0133000ZY	0	-	0	0	432	0.0000000
zheyou73v0_A06	8065933	8067482	BnaA06T0133100ZY	0	-	0	0	1549	0.0000000
zheyou73v0_A06	8068111	8070084	BnaA06T0133200ZY	0	-	0	0	1973	0.0000000
zheyou73v0_A06	8068111	8070084	BnaA06T0133200ZY.1	0	-	0	0	1973	0.0000000
zheyou73v0_A06	8072238	8074995	BnaA06T0133300ZY	0	-	0	0	2757	0.0000000
zheyou73v0_A06	8072238	8074598	BnaA06T0133300ZY.1	0	-	0	0	2360	0.0000000
zheyou73v0_A06	8076590	8078496	BnaA06T0133400ZY	0	+	0	0	1906	0.0000000
zheyou73v0_A06	8078721	8085804	BnaA06T0133500ZY	0	-	0	0	7083	0.0000000
zheyou73v0_A06	8086103	8087371	BnaA06T0133600ZY	0	+	0	0	1268	0.0000000
zheyou73v0_A06	8088680	8090105	BnaA06T0133700ZY	0	+	0	0	1425	0.0000000
zheyou73v0_A06	8094116	8095611	BnaA06T0133800ZY	0	+	0	0	1495	0.0000000
zheyou73v0_A06	8100945	8102421	BnaA06T0133900ZY	0	-	0	0	1476	0.0000000
zheyou73v0_A06	8104610	8105842	BnaA06T0134000ZY	0	+	0	0	1232	0.0000000
zheyou73v0_A06	8106135	8107474	BnaA06T0134100ZY	0	-	0	0	1339	0.0000000
zheyou73v0_A06	8111526	8112869	BnaA06T0134200ZY	0	-	0	0	1343	0.0000000
zheyou73v0_A06	8124879	8126410	BnaA06T0134300ZY	0	+	0	0	1531	0.0000000
zheyou73v0_A06	8124879	8126410	BnaA06T0134300ZY.1	0	+	0	0	1531	0.0000000
zheyou73v0_A06	8124879	8126410	BnaA06T0134300ZY.2	0	+	0	0	1531	0.0000000
zheyou73v0_A06	8124879	8126410	BnaA06T0134300ZY.3	0	+	0	0	1531	0.0000000
zheyou73v0_A06	8124879	8126410	BnaA06T0134300ZY.4	0	+	0	0	1531	0.0000000
zheyou73v0_A06	8131563	8132278	BnaA06T0134400ZY	0	+	0	0	715	0.0000000
zheyou73v0_A06	8135678	8136348	BnaA06T0134500ZY	0	+	0	0	670	0.0000000
zheyou73v0_A06	8152469	8156812	BnaA06T0134600ZY	0	-	0	0	4343	0.0000000
zheyou73v0_A06	8152469	8156812	BnaA06T0134600ZY.1	0	-	0	0	4343	0.0000000
zheyou73v0_A06	8152469	8155956	BnaA06T0134600ZY.2	0	-	0	0	3487	0.0000000
zheyou73v0_A06	8166815	8168646	BnaA06T0134700ZY	0	+	0	0	1831	0.0000000
zheyou73v0_A06	8188875	8189812	BnaA06T0134800ZY	0	-	0	0	937	0.0000000
zheyou73v0_A06	8215364	8216427	BnaA06T0134900ZY	0	-	0	0	1063	0.0000000
zheyou73v0_A06	8248709	8252576	BnaA06T0135000ZY	0	+	0	0	3867	0.0000000
zheyou73v0_A06	8252595	8254953	BnaA06T0135100ZY	0	-	0	0	2358	0.0000000
zheyou73v0_A06	8258193	8261429	BnaA06T0135200ZY	0	-	0	0	3236	0.0000000
zheyou73v0_A06	8263016	8263202	BnaA06T0135300ZY	0	-	0	0	186	0.0000000
zheyou73v0_A06	8268813	8275776	BnaA06T0135400ZY	0	-	0	0	6963	0.0000000
zheyou73v0_A06	8276292	8276597	BnaA06T0135500ZY	0	+	0	0	305	0.0000000
zheyou73v0_A06	8277692	8278090	BnaA06T0135600ZY	0	+	0	0	398	0.0000000
zheyou73v0_A06	8293605	8295409	BnaA06T0135700ZY	0	-	0	0	1804	0.0000000
zheyou73v0_A06	8307615	8308269	BnaA06T0135800ZY	0	+	0	0	654	0.0000000
zheyou73v0_A06	8308925	8313987	BnaA06T0135900ZY	0	-	0	0	5062	0.0000000
zheyou73v0_A06	8314768	8317565	BnaA06T0136000ZY	0	-	0	0	2797	0.0000000
zheyou73v0_A06	8324227	8326548	BnaA06T0136100ZY	0	+	0	0	2321	0.0000000
zheyou73v0_A06	8329759	8333165	BnaA06T0136200ZY	0	+	0	0	3406	0.0000000
zheyou73v0_A06	8329759	8332149	BnaA06T0136200ZY.1	0	+	0	0	2390	0.0000000
zheyou73v0_A06	8332306	8334448	BnaA06T0136300ZY	0	-	0	0	2142	0.0000000
zheyou73v0_A06	8332306	8334448	BnaA06T0136300ZY.1	0	-	0	0	2142	0.0000000
zheyou73v0_A06	8334918	8336591	BnaA06T0136400ZY	0	+	0	0	1673	0.0000000
zheyou73v0_A06	8337139	8339950	BnaA06T0136500ZY	0	-	0	0	2811	0.0000000
zheyou73v0_A06	8340134	8341418	BnaA06T0136600ZY	0	-	0	0	1284	0.0000000
zheyou73v0_A06	8343607	8344553	BnaA06T0136700ZY	0	+	0	0	946	0.0000000
zheyou73v0_A06	8345054	8345639	BnaA06T0136800ZY	0	-	0	0	585	0.0000000
zheyou73v0_A06	8347096	8352156	BnaA06T0136900ZY	0	+	0	0	5060	0.0000000
zheyou73v0_A06	8352740	8354365	BnaA06T0137000ZY	0	-	0	0	1625	0.0000000
zheyou73v0_A06	8354676	8356244	BnaA06T0137100ZY	0	+	0	0	1568	0.0000000
zheyou73v0_A06	8356832	8366829	BnaA06T0137200ZY	0	+	0	0	9997	0.0000000
zheyou73v0_A06	8375334	8376385	BnaA06T0137300ZY	0	+	0	0	1051	0.0000000
zheyou73v0_A06	8377015	8378843	BnaA06T0137400ZY	0	-	0	0	1828	0.0000000
zheyou73v0_A06	8385316	8386765	BnaA06T0137500ZY	0	+	0	0	1449	0.0000000
zheyou73v0_A06	8388098	8391314	BnaA06T0137600ZY	0	-	0	0	3216	0.0000000
zheyou73v0_A06	8388098	8391314	BnaA06T0137600ZY.1	0	-	0	0	3216	0.0000000
zheyou73v0_A06	8396594	8398024	BnaA06T0137700ZY	0	+	0	0	1430	0.0000000
zheyou73v0_A06	8398496	8400548	BnaA06T0137800ZY	0	-	0	0	2052	0.0000000
zheyou73v0_A06	8402151	8404065	BnaA06T0137900ZY	0	-	0	0	1914	0.0000000
zheyou73v0_A06	8405072	8406449	BnaA06T0138000ZY	0	-	0	0	1377	0.0000000
zheyou73v0_A06	8406721	8409004	BnaA06T0138100ZY	0	+	0	0	2283	0.0000000
zheyou73v0_A06	8414085	8417336	BnaA06T0138200ZY	0	+	0	0	3251	0.0000000
zheyou73v0_A06	8417716	8420046	BnaA06T0138300ZY	0	-	0	0	2330	0.0000000
zheyou73v0_A06	8417716	8420046	BnaA06T0138300ZY.1	0	-	0	0	2330	0.0000000
zheyou73v0_A06	8422912	8424701	BnaA06T0138400ZY	0	+	0	0	1789	0.0000000
zheyou73v0_A06	8426664	8427455	BnaA06T0138500ZY	0	+	0	0	791	0.0000000
zheyou73v0_A06	8430936	8434191	BnaA06T0138600ZY	0	-	0	0	3255	0.0000000
zheyou73v0_A06	8469003	8469968	BnaA06T0138700ZY	0	+	0	0	965	0.0000000
zheyou73v0_A06	8473717	8474831	BnaA06T0138800ZY	0	-	0	0	1114	0.0000000
zheyou73v0_A06	8481651	8482514	BnaA06T0138900ZY	0	-	0	0	863	0.0000000
zheyou73v0_A06	8482908	8483999	BnaA06T0139000ZY	0	-	0	0	1091	0.0000000
zheyou73v0_A06	8524117	8527714	BnaA06T0139100ZY	0	+	0	0	3597	0.0000000
zheyou73v0_A06	8524117	8527714	BnaA06T0139100ZY.1	0	+	0	0	3597	0.0000000
zheyou73v0_A06	8528338	8530985	BnaA06T0139200ZY	0	-	0	0	2647	0.0000000
zheyou73v0_A06	8532702	8539680	BnaA06T0139300ZY	0	-	0	0	6978	0.0000000
zheyou73v0_A06	8554474	8556123	BnaA06T0139400ZY	0	-	0	0	1649	0.0000000
zheyou73v0_A06	8562145	8563687	BnaA06T0139500ZY	0	+	0	0	1542	0.0000000
zheyou73v0_A06	8565435	8565891	BnaA06T0139600ZY	0	+	0	0	456	0.0000000
zheyou73v0_A06	8566102	8568069	BnaA06T0139700ZY	0	-	0	0	1967	0.0000000
zheyou73v0_A06	8568875	8574303	BnaA06T0139800ZY	0	-	0	0	5428	0.0000000
zheyou73v0_A06	8578906	8581407	BnaA06T0139900ZY	0	+	0	0	2501	0.0000000
zheyou73v0_A06	8578906	8581407	BnaA06T0139900ZY.1	0	+	0	0	2501	0.0000000
zheyou73v0_A06	8581747	8584467	BnaA06T0140000ZY	0	-	0	0	2720	0.0000000
zheyou73v0_A06	8589929	8590766	BnaA06T0140100ZY	0	-	0	0	837	0.0000000
zheyou73v0_A06	8594193	8595664	BnaA06T0140200ZY	0	-	0	0	1471	0.0000000
zheyou73v0_A06	8596171	8599067	BnaA06T0140300ZY	0	-	0	0	2896	0.0000000
zheyou73v0_A06	8600192	8601745	BnaA06T0140400ZY	0	+	0	0	1553	0.0000000
zheyou73v0_A06	8602122	8604150	BnaA06T0140500ZY	0	-	0	0	2028	0.0000000
zheyou73v0_A06	8604522	8607147	BnaA06T0140600ZY	0	+	0	0	2625	0.0000000
zheyou73v0_A06	8612727	8618517	BnaA06T0140700ZY	0	+	0	0	5790	0.0000000
zheyou73v0_A06	8628673	8631341	BnaA06T0140800ZY	0	+	0	0	2668	0.0000000
zheyou73v0_A06	8636090	8639350	BnaA06T0140900ZY	0	+	0	0	3260	0.0000000
zheyou73v0_A06	8639799	8641451	BnaA06T0141000ZY	0	-	0	0	1652	0.0000000
zheyou73v0_A06	8644314	8645289	BnaA06T0141100ZY	0	+	0	0	975	0.0000000
zheyou73v0_A06	8645731	8646277	BnaA06T0141200ZY	0	+	0	0	546	0.0000000
zheyou73v0_A06	8652183	8655571	BnaA06T0141300ZY	0	-	0	0	3388	0.0000000
zheyou73v0_A06	8665030	8666543	BnaA06T0141400ZY	0	+	0	0	1513	0.0000000
zheyou73v0_A06	8667767	8668863	BnaA06T0141500ZY	0	+	0	0	1096	0.0000000
zheyou73v0_A06	8669625	8676536	BnaA06T0141600ZY	0	-	0	0	6911	0.0000000
zheyou73v0_A06	8685526	8686770	BnaA06T0141700ZY	0	+	0	0	1244	0.0000000
zheyou73v0_A06	8692108	8694518	BnaA06T0141800ZY	0	-	0	0	2410	0.0000000
zheyou73v0_A06	8697836	8698415	BnaA06T0141900ZY	0	-	0	0	579	0.0000000
zheyou73v0_A06	8701012	8702262	BnaA06T0142000ZY	0	-	0	0	1250	0.0000000
zheyou73v0_A06	8703125	8704364	BnaA06T0142100ZY	0	+	0	0	1239	0.0000000
zheyou73v0_A06	8715253	8720083	BnaA06T0142200ZY	0	+	0	0	4830	0.0000000
zheyou73v0_A06	8715535	8720083	BnaA06T0142200ZY.1	0	+	0	0	4548	0.0000000
zheyou73v0_A06	8721176	8721611	BnaA06T0142300ZY	0	-	0	0	435	0.0000000
zheyou73v0_A06	8721964	8725713	BnaA06T0142400ZY	0	+	0	0	3749	0.0000000
zheyou73v0_A06	8730090	8731005	BnaA06T0142500ZY	0	+	0	0	915	0.0000000
zheyou73v0_A06	8741920	8743849	BnaA06T0142600ZY	0	+	0	0	1929	0.0000000
zheyou73v0_A06	8743674	8747208	BnaA06T0142700ZY	0	-	0	0	3534	0.0000000
zheyou73v0_A06	8750948	8751446	BnaA06T0142800ZY	0	+	0	0	498	0.0000000
zheyou73v0_A06	8753064	8756535	BnaA06T0142900ZY	0	-	0	0	3471	0.0000000
zheyou73v0_A06	8757904	8758816	BnaA06T0143000ZY	0	-	0	0	912	0.0000000
zheyou73v0_A06	8759647	8762316	BnaA06T0143100ZY	0	-	0	0	2669	0.0000000
zheyou73v0_A06	8762588	8764864	BnaA06T0143200ZY	0	-	0	0	2276	0.0000000
zheyou73v0_A06	8773733	8775169	BnaA06T0143300ZY	0	+	0	0	1436	0.0000000
zheyou73v0_A06	8777985	8781363	BnaA06T0143400ZY	0	-	0	0	3378	0.0000000
zheyou73v0_A06	8786513	8790032	BnaA06T0143500ZY	0	+	0	0	3519	0.0000000
zheyou73v0_A06	8792092	8793960	BnaA06T0143600ZY	0	+	0	0	1868	0.0000000
zheyou73v0_A06	8827386	8831173	BnaA06T0143700ZY	0	-	0	0	3787	0.0000000
zheyou73v0_A06	8852712	8858303	BnaA06T0143800ZY	0	+	0	0	5591	0.0000000
zheyou73v0_A06	8852712	8858303	BnaA06T0143800ZY.1	0	+	0	0	5591	0.0000000
zheyou73v0_A06	8871743	8876604	BnaA06T0143900ZY	0	+	0	0	4861	0.0000000
zheyou73v0_A06	8878083	8879678	BnaA06T0144000ZY	0	-	0	0	1595	0.0000000
zheyou73v0_A06	8896971	8898748	BnaA06T0144100ZY	0	+	0	0	1777	0.0000000
zheyou73v0_A06	8909311	8910297	BnaA06T0144200ZY	0	+	0	0	986	0.0000000
zheyou73v0_A06	8927642	8928674	BnaA06T0144300ZY	0	+	0	0	1032	0.0000000
zheyou73v0_A06	8937430	8937851	BnaA06T0144400ZY	0	-	0	0	421	0.0000000
zheyou73v0_A06	8937897	8939201	BnaA06T0144500ZY	0	-	0	0	1304	0.0000000
zheyou73v0_A06	8937897	8939201	BnaA06T0144500ZY.1	0	-	0	0	1304	0.0000000
zheyou73v0_A06	8937897	8939201	BnaA06T0144500ZY.2	0	-	0	0	1304	0.0000000
zheyou73v0_A06	8937897	8939201	BnaA06T0144500ZY.3	0	-	0	0	1304	0.0000000
zheyou73v0_A06	8937897	8939201	BnaA06T0144500ZY.4	0	-	0	0	1304	0.0000000
zheyou73v0_A06	8939746	8941978	BnaA06T0144600ZY	0	+	0	0	2232	0.0000000
zheyou73v0_A06	8942276	8943494	BnaA06T0144700ZY	0	+	0	0	1218	0.0000000
zheyou73v0_A06	8944026	8945403	BnaA06T0144800ZY	0	-	0	0	1377	0.0000000
zheyou73v0_A06	8948264	8951273	BnaA06T0144900ZY	0	-	0	0	3009	0.0000000
zheyou73v0_A06	8957966	8960095	BnaA06T0145000ZY	0	+	0	0	2129	0.0000000
zheyou73v0_A06	8957966	8960095	BnaA06T0145000ZY.1	0	+	0	0	2129	0.0000000
zheyou73v0_A06	8960598	8962004	BnaA06T0145100ZY	0	-	0	0	1406	0.0000000
zheyou73v0_A06	8965917	8967341	BnaA06T0145200ZY	0	-	0	0	1424	0.0000000
zheyou73v0_A06	8974475	8974892	BnaA06T0145300ZY	0	-	0	0	417	0.0000000
zheyou73v0_A06	8999945	9000949	BnaA06T0145400ZY	0	+	0	0	1004	0.0000000
zheyou73v0_A06	9001131	9002079	BnaA06T0145500ZY	0	-	0	0	948	0.0000000
zheyou73v0_A06	9005382	9006012	BnaA06T0145600ZY	0	+	0	0	630	0.0000000
zheyou73v0_A06	9008801	9010540	BnaA06T0145700ZY	0	+	0	0	1739	0.0000000
zheyou73v0_A06	9061407	9063007	BnaA06T0145800ZY	0	-	0	0	1600	0.0000000
zheyou73v0_A06	9070019	9071299	BnaA06T0145900ZY	0	+	0	0	1280	0.0000000
zheyou73v0_A06	9073283	9073983	BnaA06T0146000ZY	0	-	0	0	700	0.0000000
zheyou73v0_A06	9082277	9082544	BnaA06T0146100ZY	0	-	0	0	267	0.0000000
zheyou73v0_A06	9120921	9121683	BnaA06T0146200ZY	0	+	0	0	762	0.0000000
zheyou73v0_A06	9121707	9123525	BnaA06T0146300ZY	0	-	0	0	1818	0.0000000
zheyou73v0_A06	9121707	9123525	BnaA06T0146300ZY.1	0	-	0	0	1818	0.0000000
zheyou73v0_A06	9129882	9131849	BnaA06T0146400ZY	0	+	0	0	1967	0.0000000
zheyou73v0_A06	9137492	9139402	BnaA06T0146500ZY	0	+	0	0	1910	0.0000000
zheyou73v0_A06	9139258	9142021	BnaA06T0146600ZY	0	-	0	0	2763	0.0000000
zheyou73v0_A06	9142351	9143839	BnaA06T0146700ZY	0	-	0	0	1488	0.0000000
zheyou73v0_A06	9149435	9152309	BnaA06T0146800ZY	0	+	0	0	2874	0.0000000
zheyou73v0_A06	9149435	9152309	BnaA06T0146800ZY.1	0	+	0	0	2874	0.0000000
zheyou73v0_A06	9154841	9156065	BnaA06T0146900ZY	0	+	0	0	1224	0.0000000
zheyou73v0_A06	9156274	9158066	BnaA06T0147000ZY	0	-	0	0	1792	0.0000000
zheyou73v0_A06	9161681	9163972	BnaA06T0147100ZY	0	+	0	0	2291	0.0000000
zheyou73v0_A06	9163977	9165310	BnaA06T0147200ZY	0	-	0	0	1333	0.0000000
zheyou73v0_A06	9163977	9165310	BnaA06T0147200ZY.1	0	-	0	0	1333	0.0000000
zheyou73v0_A06	9163977	9165310	BnaA06T0147200ZY.2	0	-	0	0	1333	0.0000000
zheyou73v0_A06	9171959	9174387	BnaA06T0147300ZY	0	-	0	0	2428	0.0000000
zheyou73v0_A06	9171959	9174387	BnaA06T0147300ZY.1	0	-	0	0	2428	0.0000000
zheyou73v0_A06	9182602	9186656	BnaA06T0147400ZY	0	-	0	0	4054	0.0000000
zheyou73v0_A06	9188308	9188946	BnaA06T0147500ZY	0	-	0	0	638	0.0000000
zheyou73v0_A06	9189395	9190450	BnaA06T0147600ZY	0	-	0	0	1055	0.0000000
zheyou73v0_A06	9197997	9198165	BnaA06T0147700ZY	0	-	0	0	168	0.0000000
zheyou73v0_A06	9200275	9200546	BnaA06T0147800ZY	0	-	0	0	271	0.0000000
zheyou73v0_A06	9213183	9213396	BnaA06T0147900ZY	0	-	0	0	213	0.0000000
zheyou73v0_A06	9228539	9228749	BnaA06T0148000ZY	0	-	0	0	210	0.0000000
zheyou73v0_A06	9239884	9242142	BnaA06T0148100ZY	0	-	0	0	2258	0.0000000
zheyou73v0_A06	9244917	9245343	BnaA06T0148200ZY	0	-	0	0	426	0.0000000
zheyou73v0_A06	9248141	9250093	BnaA06T0148300ZY	0	+	0	0	1952	0.0000000
zheyou73v0_A06	9250471	9255145	BnaA06T0148400ZY	0	-	0	0	4674	0.0000000
zheyou73v0_A06	9260729	9264120	BnaA06T0148500ZY	0	-	0	0	3391	0.0000000
zheyou73v0_A06	9265712	9267938	BnaA06T0148600ZY	0	-	0	0	2226	0.0000000
zheyou73v0_A06	9268348	9274999	BnaA06T0148700ZY	0	+	0	0	6651	0.0000000
zheyou73v0_A06	9275449	9278804	BnaA06T0148800ZY	0	+	0	0	3355	0.0000000
zheyou73v0_A06	9279937	9282719	BnaA06T0148900ZY	0	-	0	0	2782	0.0000000
zheyou73v0_A06	9282967	9284237	BnaA06T0149000ZY	0	+	0	0	1270	0.0000000
zheyou73v0_A06	9284871	9288006	BnaA06T0149100ZY	0	+	0	0	3135	0.0000000
zheyou73v0_A06	9294956	9297200	BnaA06T0149200ZY	0	+	0	0	2244	0.0000000
zheyou73v0_A06	9300524	9302813	BnaA06T0149300ZY	0	+	0	0	2289	0.0000000
zheyou73v0_A06	9302960	9305900	BnaA06T0149400ZY	0	+	0	0	2940	0.0000000
zheyou73v0_A06	9306407	9307016	BnaA06T0149500ZY	0	+	0	0	609	0.0000000
zheyou73v0_A06	9307272	9310396	BnaA06T0149600ZY	0	-	0	0	3124	0.0000000
zheyou73v0_A06	9311801	9313131	BnaA06T0149700ZY	0	+	0	0	1330	0.0000000
zheyou73v0_A06	9320958	9323129	BnaA06T0149800ZY	0	+	0	0	2171	0.0000000
zheyou73v0_A06	9323526	9324283	BnaA06T0149900ZY	0	+	0	0	757	0.0000000
zheyou73v0_A06	9332349	9338361	BnaA06T0150000ZY	0	+	0	0	6012	0.0000000
zheyou73v0_A06	9346049	9349319	BnaA06T0150100ZY	0	+	0	0	3270	0.0000000
zheyou73v0_A06	9349648	9352321	BnaA06T0150200ZY	0	+	0	0	2673	0.0000000
zheyou73v0_A06	9360800	9363084	BnaA06T0150300ZY	0	+	0	0	2284	0.0000000
zheyou73v0_A06	9363275	9363761	BnaA06T0150400ZY	0	-	0	0	486	0.0000000
zheyou73v0_A06	9364052	9365261	BnaA06T0150500ZY	0	+	0	0	1209	0.0000000
zheyou73v0_A06	9367168	9368336	BnaA06T0150600ZY	0	+	0	0	1168	0.0000000
zheyou73v0_A06	9371383	9372310	BnaA06T0150700ZY	0	-	0	0	927	0.0000000
zheyou73v0_A06	9379906	9381914	BnaA06T0150800ZY	0	+	0	0	2008	0.0000000
zheyou73v0_A06	9386128	9387219	BnaA06T0150900ZY	0	-	0	0	1091	0.0000000
zheyou73v0_A06	9388413	9390312	BnaA06T0151000ZY	0	+	0	0	1899	0.0000000
zheyou73v0_A06	9391252	9394086	BnaA06T0151100ZY	0	+	0	0	2834	0.0000000
zheyou73v0_A06	9404927	9408560	BnaA06T0151200ZY	0	+	0	0	3633	0.0000000
zheyou73v0_A06	9404927	9408560	BnaA06T0151200ZY.1	0	+	0	0	3633	0.0000000
zheyou73v0_A06	9406778	9408944	BnaA06T0151300ZY	0	-	0	0	2166	0.0000000
zheyou73v0_A06	9415901	9417950	BnaA06T0151400ZY	0	-	0	0	2049	0.0000000
zheyou73v0_A06	9418462	9420133	BnaA06T0151500ZY	0	+	0	0	1671	0.0000000
zheyou73v0_A06	9431790	9433018	BnaA06T0151600ZY	0	-	0	0	1228	0.0000000
zheyou73v0_A06	9445284	9447503	BnaA06T0151700ZY	0	-	0	0	2219	0.0000000
zheyou73v0_A06	9458722	9461129	BnaA06T0151800ZY	0	+	0	0	2407	0.0000000
zheyou73v0_A06	9462391	9464343	BnaA06T0151900ZY	0	+	0	0	1952	0.0000000
zheyou73v0_A06	9468326	9471314	BnaA06T0152000ZY	0	-	0	0	2988	0.0000000
zheyou73v0_A06	9468326	9470603	BnaA06T0152000ZY.1	0	-	0	0	2277	0.0000000
zheyou73v0_A06	9482419	9485105	BnaA06T0152100ZY	0	-	0	0	2686	0.0000000
zheyou73v0_A06	9487186	9489366	BnaA06T0152200ZY	0	+	0	0	2180	0.0000000
zheyou73v0_A06	9494064	9494528	BnaA06T0152300ZY	0	-	0	0	464	0.0000000
zheyou73v0_A06	9497422	9498448	BnaA06T0152400ZY	0	-	0	0	1026	0.0000000
zheyou73v0_A06	9502411	9508174	BnaA06T0152500ZY	0	+	0	0	5763	0.0000000
zheyou73v0_A06	9508510	9509571	BnaA06T0152600ZY	0	-	0	0	1061	0.0000000
zheyou73v0_A06	9511858	9512351	BnaA06T0152700ZY	0	+	0	0	493	0.0000000
zheyou73v0_A06	9522291	9531146	BnaA06T0152800ZY	0	+	0	0	8855	0.0000000
zheyou73v0_A06	9532449	9532911	BnaA06T0152900ZY	0	+	0	0	462	0.0000000
zheyou73v0_A06	9533567	9535371	BnaA06T0153000ZY	0	-	0	0	1804	0.0000000
zheyou73v0_A06	9536928	9537417	BnaA06T0153100ZY	0	-	0	0	489	0.0000000
zheyou73v0_A06	9540676	9541690	BnaA06T0153200ZY	0	-	0	0	1014	0.0000000
zheyou73v0_A06	9555655	9557860	BnaA06T0153300ZY	0	+	0	0	2205	0.0000000
zheyou73v0_A06	9558933	9562105	BnaA06T0153400ZY	0	+	0	0	3172	0.0000000
zheyou73v0_A06	9576238	9586758	BnaA06T0153500ZY	0	+	0	0	10520	0.0000000
zheyou73v0_A06	9588691	9589054	BnaA06T0153600ZY	0	+	0	0	363	0.0000000
zheyou73v0_A06	9596624	9597346	BnaA06T0153700ZY	0	+	0	0	722	0.0000000
zheyou73v0_A06	9611120	9614172	BnaA06T0153800ZY	0	-	0	0	3052	0.0000000
zheyou73v0_A06	9611120	9614172	BnaA06T0153800ZY.1	0	-	0	0	3052	0.0000000
zheyou73v0_A06	9619801	9622190	BnaA06T0153900ZY	0	+	0	0	2389	0.0000000
zheyou73v0_A06	9619801	9622190	BnaA06T0153900ZY.1	0	+	0	0	2389	0.0000000
zheyou73v0_A06	9625775	9627628	BnaA06T0154000ZY	0	+	0	0	1853	0.0000000
zheyou73v0_A06	9638151	9639003	BnaA06T0154100ZY	0	-	0	0	852	0.0000000
zheyou73v0_A06	9640385	9643421	BnaA06T0154200ZY	0	+	0	0	3036	0.0000000
zheyou73v0_A06	9648088	9649843	BnaA06T0154300ZY	0	+	0	0	1755	0.0000000
zheyou73v0_A06	9650481	9651283	BnaA06T0154400ZY	0	-	0	0	802	0.0000000
zheyou73v0_A06	9652597	9654871	BnaA06T0154500ZY	0	+	0	0	2274	0.0000000
zheyou73v0_A06	9672631	9674189	BnaA06T0154600ZY	0	-	0	0	1558	0.0000000
zheyou73v0_A06	9672631	9674189	BnaA06T0154600ZY.1	0	-	0	0	1558	0.0000000
zheyou73v0_A06	9672631	9674189	BnaA06T0154600ZY.2	0	-	0	0	1558	0.0000000
zheyou73v0_A06	9676865	9678201	BnaA06T0154700ZY	0	-	0	0	1336	0.0000000
zheyou73v0_A06	9701923	9702769	BnaA06T0154800ZY	0	+	0	0	846	0.0000000
zheyou73v0_A06	9706916	9709881	BnaA06T0154900ZY	0	+	0	0	2965	0.0000000
zheyou73v0_A06	9711779	9713260	BnaA06T0155000ZY	0	-	0	0	1481	0.0000000
zheyou73v0_A06	9718937	9723034	BnaA06T0155100ZY	0	-	0	0	4097	0.0000000
zheyou73v0_A06	9732164	9732853	BnaA06T0155200ZY	0	+	0	0	689	0.0000000
zheyou73v0_A06	9733015	9736642	BnaA06T0155300ZY	0	-	0	0	3627	0.0000000
zheyou73v0_A06	9736623	9738932	BnaA06T0155400ZY	0	+	0	0	2309	0.0000000
zheyou73v0_A06	9736623	9738932	BnaA06T0155400ZY.1	0	+	0	0	2309	0.0000000
zheyou73v0_A06	9739222	9741049	BnaA06T0155500ZY	0	-	0	0	1827	0.0000000
zheyou73v0_A06	9758660	9762291	BnaA06T0155600ZY	0	-	0	0	3631	0.0000000
zheyou73v0_A06	9793814	9795693	BnaA06T0155700ZY	0	+	0	0	1879	0.0000000
zheyou73v0_A06	9796582	9797332	BnaA06T0155800ZY	0	+	0	0	750	0.0000000
zheyou73v0_A06	9797337	9799913	BnaA06T0155900ZY	0	-	0	0	2576	0.0000000
zheyou73v0_A06	9802817	9805569	BnaA06T0156000ZY	0	+	0	0	2752	0.0000000
zheyou73v0_A06	9805925	9807931	BnaA06T0156100ZY	0	+	0	0	2006	0.0000000
zheyou73v0_A06	9809205	9812649	BnaA06T0156200ZY	0	+	0	0	3444	0.0000000
zheyou73v0_A06	9816001	9842381	BnaA06T0156300ZY	0	-	0	0	26380	0.0000000
zheyou73v0_A06	9853853	9855164	BnaA06T0156400ZY	0	-	0	0	1311	0.0000000
zheyou73v0_A06	9855354	9857404	BnaA06T0156500ZY	0	+	0	0	2050	0.0000000
zheyou73v0_A06	9857888	9858875	BnaA06T0156600ZY	0	-	0	0	987	0.0000000
zheyou73v0_A06	9865452	9866439	BnaA06T0156700ZY	0	-	0	0	987	0.0000000
zheyou73v0_A06	9868906	9870153	BnaA06T0156800ZY	0	+	0	0	1247	0.0000000
zheyou73v0_A06	9870791	9887825	BnaA06T0156900ZY	0	+	0	0	17034	0.0000000
zheyou73v0_A06	9887508	9889988	BnaA06T0157000ZY	0	-	0	0	2480	0.0000000
zheyou73v0_A06	9894985	9896470	BnaA06T0157100ZY	0	+	0	0	1485	0.0000000
zheyou73v0_A06	9896771	9897163	BnaA06T0157200ZY	0	-	0	0	392	0.0000000
zheyou73v0_A06	9898940	9901435	BnaA06T0157300ZY	0	+	0	0	2495	0.0000000
zheyou73v0_A06	9904160	9910759	BnaA06T0157400ZY	0	+	0	0	6599	0.0000000
zheyou73v0_A06	9916691	9919588	BnaA06T0157500ZY	0	-	0	0	2897	0.0000000
zheyou73v0_A06	9921534	9922609	BnaA06T0157600ZY	0	+	0	0	1075	0.0000000
zheyou73v0_A06	9922852	9930440	BnaA06T0157700ZY	0	-	0	0	7588	0.0000000
zheyou73v0_A06	9948730	9950034	BnaA06T0157800ZY	0	+	0	0	1304	0.0000000
zheyou73v0_A06	9951959	9953305	BnaA06T0157900ZY	0	+	0	0	1346	0.0000000
zheyou73v0_A06	9953329	9954968	BnaA06T0158000ZY	0	-	0	0	1639	0.0000000
zheyou73v0_A06	9966295	9967846	BnaA06T0158100ZY	0	-	0	0	1551	0.0000000
zheyou73v0_A06	9970949	9971643	BnaA06T0158200ZY	0	-	0	0	694	0.0000000
zheyou73v0_A06	9974142	9978249	BnaA06T0158300ZY	0	+	0	0	4107	0.0000000
zheyou73v0_A06	9977610	9982930	BnaA06T0158400ZY	0	-	0	0	5320	0.0000000
zheyou73v0_A06	9992597	9993748	BnaA06T0158500ZY	0	+	0	0	1151	0.0000000
zheyou73v0_A06	9999575	10009467	BnaA06T0158600ZY	0	+	0	0	9892	0.0000000
zheyou73v0_A06	10009528	10011673	BnaA06T0158700ZY	0	-	0	0	2145	0.0000000
zheyou73v0_A06	10025129	10027754	BnaA06T0158800ZY	0	+	0	0	2625	0.0000000
zheyou73v0_A06	10028614	10032021	BnaA06T0158900ZY	0	-	0	0	3407	0.0000000
zheyou73v0_A06	10052992	10053418	BnaA06T0159000ZY	0	-	0	0	426	0.0000000
zheyou73v0_A06	10059304	10061336	BnaA06T0159100ZY	0	+	0	0	2032	0.0000000
zheyou73v0_A06	10063185	10065539	BnaA06T0159200ZY	0	-	0	0	2354	0.0000000
zheyou73v0_A06	10097432	10098764	BnaA06T0159300ZY	0	+	0	0	1332	0.0000000
zheyou73v0_A06	10098937	10099598	BnaA06T0159400ZY	0	-	0	0	661	0.0000000
zheyou73v0_A06	10101351	10102816	BnaA06T0159500ZY	0	-	0	0	1465	0.0000000
zheyou73v0_A06	10104204	10108979	BnaA06T0159600ZY	0	-	0	0	4775	0.0000000
zheyou73v0_A06	10109095	10109305	BnaA06T0159700ZY	0	-	0	0	210	0.0000000
zheyou73v0_A06	10114539	10116956	BnaA06T0159800ZY	0	+	0	0	2417	0.0000000
zheyou73v0_A06	10124316	10124982	BnaA06T0159900ZY	0	+	0	0	666	0.0000000
zheyou73v0_A06	10125915	10127135	BnaA06T0160000ZY	0	+	0	0	1220	0.0000000
zheyou73v0_A06	10142638	10144629	BnaA06T0160100ZY	0	+	0	0	1991	0.0000000
zheyou73v0_A06	10147965	10148756	BnaA06T0160200ZY	0	+	0	0	791	0.0000000
zheyou73v0_A06	10163872	10164527	BnaA06T0160300ZY	0	-	0	0	655	0.0000000
zheyou73v0_A06	10171415	10173415	BnaA06T0160400ZY	0	-	0	0	2000	0.0000000
zheyou73v0_A06	10193020	10194594	BnaA06T0160500ZY	0	+	0	0	1574	0.0000000
zheyou73v0_A06	10198655	10199786	BnaA06T0160600ZY	0	+	0	0	1131	0.0000000
zheyou73v0_A06	10200979	10202272	BnaA06T0160700ZY	0	+	0	0	1293	0.0000000
zheyou73v0_A06	10202449	10203254	BnaA06T0160800ZY	0	-	0	0	805	0.0000000
zheyou73v0_A06	10206266	10209059	BnaA06T0160900ZY	0	-	0	0	2793	0.0000000
zheyou73v0_A06	10215971	10216344	BnaA06T0161000ZY	0	+	0	0	373	0.0000000
zheyou73v0_A06	10216743	10219117	BnaA06T0161100ZY	0	-	0	0	2374	0.0000000
zheyou73v0_A06	10226314	10232024	BnaA06T0161200ZY	0	-	0	0	5710	0.0000000
zheyou73v0_A06	10232780	10235356	BnaA06T0161300ZY	0	-	0	0	2576	0.0000000
zheyou73v0_A06	10240631	10240823	BnaA06T0161400ZY	0	-	0	0	192	0.0000000
zheyou73v0_A06	10241680	10242646	BnaA06T0161500ZY	0	+	0	0	966	0.0000000
zheyou73v0_A06	10242775	10243809	BnaA06T0161600ZY	0	+	0	0	1034	0.0000000
zheyou73v0_A06	10244291	10244465	BnaA06T0161700ZY	0	+	0	0	174	0.0000000
zheyou73v0_A06	10244627	10246455	BnaA06T0161800ZY	0	-	0	0	1828	0.0000000
zheyou73v0_A06	10250657	10257432	BnaA06T0161900ZY	0	+	0	0	6775	0.0000000
zheyou73v0_A06	10257690	10261255	BnaA06T0162000ZY	0	-	0	0	3565	0.0000000
zheyou73v0_A06	10276897	10277147	BnaA06T0162100ZY	0	+	0	0	250	0.0000000
zheyou73v0_A06	10284746	10285766	BnaA06T0162200ZY	0	+	0	0	1020	0.0000000
zheyou73v0_A06	10287221	10288426	BnaA06T0162300ZY	0	+	0	0	1205	0.0000000
zheyou73v0_A06	10288672	10291376	BnaA06T0162400ZY	0	+	0	0	2704	0.0000000
zheyou73v0_A06	10291671	10293915	BnaA06T0162500ZY	0	-	0	0	2244	0.0000000
zheyou73v0_A06	10309735	10311622	BnaA06T0162600ZY	0	-	0	0	1887	0.0000000
zheyou73v0_A06	10321856	10322642	BnaA06T0162700ZY	0	-	0	0	786	0.0000000
zheyou73v0_A06	10328361	10330020	BnaA06T0162800ZY	0	-	0	0	1659	0.0000000
zheyou73v0_A06	10331570	10332053	BnaA06T0162900ZY	0	+	0	0	483	0.0000000
zheyou73v0_A06	10334511	10334709	BnaA06T0163000ZY	0	+	0	0	198	0.0000000
zheyou73v0_A06	10337737	10339543	BnaA06T0163100ZY	0	+	0	0	1806	0.0000000
zheyou73v0_A06	10341450	10341639	BnaA06T0163200ZY	0	+	0	0	189	0.0000000
zheyou73v0_A06	10345304	10345935	BnaA06T0163300ZY	0	-	0	0	631	0.0000000
zheyou73v0_A06	10347827	10350388	BnaA06T0163400ZY	0	+	0	0	2561	0.0000000
zheyou73v0_A06	10355783	10357667	BnaA06T0163500ZY	0	+	0	0	1884	0.0000000
zheyou73v0_A06	10358066	10359469	BnaA06T0163600ZY	0	-	0	0	1403	0.0000000
zheyou73v0_A06	10370570	10371988	BnaA06T0163700ZY	0	+	0	0	1418	0.0000000
zheyou73v0_A06	10370570	10371988	BnaA06T0163700ZY.1	0	+	0	0	1418	0.0000000
zheyou73v0_A06	10383782	10388523	BnaA06T0163800ZY	0	+	0	0	4741	0.0000000
zheyou73v0_A06	10388769	10399562	BnaA06T0163900ZY	0	-	0	0	10793	0.0000000
zheyou73v0_A06	10441612	10443903	BnaA06T0164000ZY	0	-	0	0	2291	0.0000000
zheyou73v0_A06	10456594	10459072	BnaA06T0164100ZY	0	+	0	0	2478	0.0000000
zheyou73v0_A06	10459720	10461101	BnaA06T0164200ZY	0	-	0	0	1381	0.0000000
zheyou73v0_A06	10463608	10465892	BnaA06T0164300ZY	0	-	0	0	2284	0.0000000
zheyou73v0_A06	10463608	10465892	BnaA06T0164300ZY.1	0	-	0	0	2284	0.0000000
zheyou73v0_A06	10468202	10470083	BnaA06T0164400ZY	0	+	0	0	1881	0.0000000
zheyou73v0_A06	10471727	10474062	BnaA06T0164500ZY	0	+	0	0	2335	0.0000000
zheyou73v0_A06	10476648	10478372	BnaA06T0164600ZY	0	-	0	0	1724	0.0000000
zheyou73v0_A06	10481725	10482949	BnaA06T0164700ZY	0	+	0	0	1224	0.0000000
zheyou73v0_A06	10484000	10484830	BnaA06T0164800ZY	0	-	0	0	830	0.0000000
zheyou73v0_A06	10485357	10488372	BnaA06T0164900ZY	0	+	0	0	3015	0.0000000
zheyou73v0_A06	10490628	10493662	BnaA06T0165000ZY	0	+	0	0	3034	0.0000000
zheyou73v0_A06	10494051	10496821	BnaA06T0165100ZY	0	+	0	0	2770	0.0000000
zheyou73v0_A06	10501239	10503674	BnaA06T0165200ZY	0	-	0	0	2435	0.0000000
zheyou73v0_A06	10542705	10545586	BnaA06T0165300ZY	0	+	0	0	2881	0.0000000
zheyou73v0_A06	10555056	10561510	BnaA06T0165400ZY	0	-	0	0	6454	0.0000000
zheyou73v0_A06	10574100	10576140	BnaA06T0165500ZY	0	+	0	0	2040	0.0000000
zheyou73v0_A06	10576252	10579392	BnaA06T0165600ZY	0	-	0	0	3140	0.0000000
zheyou73v0_A06	10579962	10587864	BnaA06T0165700ZY	0	+	0	0	7902	0.0000000
zheyou73v0_A06	10588932	10590380	BnaA06T0165800ZY	0	+	0	0	1448	0.0000000
zheyou73v0_A06	10590719	10593252	BnaA06T0165900ZY	0	-	0	0	2533	0.0000000
zheyou73v0_A06	10597164	10598901	BnaA06T0166000ZY	0	+	0	0	1737	0.0000000
zheyou73v0_A06	10599177	10600182	BnaA06T0166100ZY	0	+	0	0	1005	0.0000000
zheyou73v0_A06	10600317	10601608	BnaA06T0166200ZY	0	-	0	0	1291	0.0000000
zheyou73v0_A06	10614091	10615640	BnaA06T0166300ZY	0	+	0	0	1549	0.0000000
zheyou73v0_A06	10617956	10624339	BnaA06T0166400ZY	0	+	0	0	6383	0.0000000
zheyou73v0_A06	10624461	10626360	BnaA06T0166500ZY	0	-	0	0	1899	0.0000000
zheyou73v0_A06	10671043	10671821	BnaA06T0166600ZY	0	-	0	0	778	0.0000000
zheyou73v0_A06	10707838	10710700	BnaA06T0166700ZY	0	+	0	0	2862	0.0000000
zheyou73v0_A06	10707838	10710700	BnaA06T0166700ZY.1	0	+	0	0	2862	0.0000000
zheyou73v0_A06	10707838	10710700	BnaA06T0166700ZY.2	0	+	0	0	2862	0.0000000
zheyou73v0_A06	10716464	10718554	BnaA06T0166800ZY	0	-	0	0	2090	0.0000000
zheyou73v0_A06	10721597	10721864	BnaA06T0166900ZY	0	-	0	0	267	0.0000000
zheyou73v0_A06	10727351	10728046	BnaA06T0167000ZY	0	-	0	0	695	0.0000000
zheyou73v0_A06	10728722	10729418	BnaA06T0167100ZY	0	-	0	0	696	0.0000000
zheyou73v0_A06	10732512	10733483	BnaA06T0167200ZY	0	+	0	0	971	0.0000000
zheyou73v0_A06	10733769	10735474	BnaA06T0167300ZY	0	-	0	0	1705	0.0000000
zheyou73v0_A06	10746646	10749264	BnaA06T0167400ZY	0	+	0	0	2618	0.0000000
zheyou73v0_A06	10760985	10763224	BnaA06T0167500ZY	0	+	0	0	2239	0.0000000
zheyou73v0_A06	10770174	10772048	BnaA06T0167600ZY	0	-	0	0	1874	0.0000000
zheyou73v0_A06	10783948	10786088	BnaA06T0167700ZY	0	-	0	0	2140	0.0000000
zheyou73v0_A06	10796828	10800164	BnaA06T0167800ZY	0	-	0	0	3336	0.0000000
zheyou73v0_A06	10815033	10830180	BnaA06T0167900ZY	0	+	0	0	15147	0.0000000
zheyou73v0_A06	10836324	10838842	BnaA06T0168000ZY	0	+	0	0	2518	0.0000000
zheyou73v0_A06	10839228	10839453	BnaA06T0168100ZY	0	+	0	0	225	0.0000000
zheyou73v0_A06	10839786	10843630	BnaA06T0168200ZY	0	-	0	0	3844	0.0000000
zheyou73v0_A06	10845672	10847276	BnaA06T0168300ZY	0	-	0	0	1604	0.0000000
zheyou73v0_A06	10848881	10850090	BnaA06T0168400ZY	0	-	0	0	1209	0.0000000
zheyou73v0_A06	10857950	10859007	BnaA06T0168500ZY	0	-	0	0	1057	0.0000000
zheyou73v0_A06	10869426	10869618	BnaA06T0168600ZY	0	+	0	0	192	0.0000000
zheyou73v0_A06	10880582	10881431	BnaA06T0168700ZY	0	+	0	0	849	0.0000000
zheyou73v0_A06	10900681	10902760	BnaA06T0168800ZY	0	+	0	0	2079	0.0000000
zheyou73v0_A06	10921470	10923039	BnaA06T0168900ZY	0	-	0	0	1569	0.0000000
zheyou73v0_A06	10931884	10932547	BnaA06T0169000ZY	0	+	0	0	663	0.0000000
zheyou73v0_A06	10941875	10943115	BnaA06T0169100ZY	0	+	0	0	1240	0.0000000
zheyou73v0_A06	10943544	10950160	BnaA06T0169200ZY	0	-	0	0	6616	0.0000000
zheyou73v0_A06	10951510	10956758	BnaA06T0169300ZY	0	+	0	0	5248	0.0000000
zheyou73v0_A06	10959634	10959895	BnaA06T0169400ZY	0	-	0	0	261	0.0000000
zheyou73v0_A06	10960530	10963455	BnaA06T0169500ZY	0	+	0	0	2925	0.0000000
zheyou73v0_A06	10963606	10964660	BnaA06T0169600ZY	0	-	0	0	1054	0.0000000
zheyou73v0_A06	10965035	10965972	BnaA06T0169700ZY	0	-	0	0	937	0.0000000
zheyou73v0_A06	10976094	10976301	BnaA06T0169800ZY	0	+	0	0	207	0.0000000
zheyou73v0_A06	10976909	10977191	BnaA06T0169900ZY	0	-	0	0	282	0.0000000
zheyou73v0_A06	10989391	10992365	BnaA06T0170000ZY	0	+	0	0	2974	0.0000000
zheyou73v0_A06	10990060	10992365	BnaA06T0170000ZY.1	0	+	0	0	2305	0.0000000
zheyou73v0_A06	10999819	11000494	BnaA06T0170100ZY	0	+	0	0	675	0.0000000
zheyou73v0_A06	11001306	11003524	BnaA06T0170200ZY	0	-	0	0	2218	0.0000000
zheyou73v0_A06	11004612	11007232	BnaA06T0170300ZY	0	-	0	0	2620	0.0000000
zheyou73v0_A06	11004612	11007232	BnaA06T0170300ZY.1	0	-	0	0	2620	0.0000000
zheyou73v0_A06	11032961	11035661	BnaA06T0170400ZY	0	+	0	0	2700	0.0000000
zheyou73v0_A06	11037172	11038000	BnaA06T0170500ZY	0	-	0	0	828	0.0000000
zheyou73v0_A06	11076385	11077247	BnaA06T0170600ZY	0	+	0	0	862	0.0000000
zheyou73v0_A06	11079848	11082867	BnaA06T0170700ZY	0	+	0	0	3019	0.0000000
zheyou73v0_A06	11084104	11084446	BnaA06T0170800ZY	0	-	0	0	342	0.0000000
zheyou73v0_A06	11091721	11093803	BnaA06T0170900ZY	0	+	0	0	2082	0.0000000
zheyou73v0_A06	11091721	11093803	BnaA06T0170900ZY.1	0	+	0	0	2082	0.0000000
zheyou73v0_A06	11095176	11096608	BnaA06T0171000ZY	0	+	0	0	1432	0.0000000
zheyou73v0_A06	11097248	11100410	BnaA06T0171100ZY	0	+	0	0	3162	0.0000000
zheyou73v0_A06	11116914	11118486	BnaA06T0171200ZY	0	+	0	0	1572	0.0000000
zheyou73v0_A06	11120753	11125473	BnaA06T0171300ZY	0	-	0	0	4720	0.0000000
zheyou73v0_A06	11120753	11125603	BnaA06T0171300ZY.1	0	-	0	0	4850	0.0000000
zheyou73v0_A06	11121053	11121368	BnaA06T0171400ZY	0	+	0	0	315	0.0000000
zheyou73v0_A06	11133228	11137749	BnaA06T0171500ZY	0	+	0	0	4521	0.0000000
zheyou73v0_A06	11145986	11148604	BnaA06T0171600ZY	0	+	0	0	2618	0.0000000
zheyou73v0_A06	11155557	11160374	BnaA06T0171700ZY	0	-	0	0	4817	0.0000000
zheyou73v0_A06	11178787	11181338	BnaA06T0171800ZY	0	+	0	0	2551	0.0000000
zheyou73v0_A06	11182736	11185539	BnaA06T0171900ZY	0	+	0	0	2803	0.0000000
zheyou73v0_A06	11186438	11188108	BnaA06T0172000ZY	0	-	0	0	1670	0.0000000
zheyou73v0_A06	11194743	11195095	BnaA06T0172100ZY	0	-	0	0	352	0.0000000
zheyou73v0_A06	11196179	11198552	BnaA06T0172200ZY	0	+	0	0	2373	0.0000000
zheyou73v0_A06	11200056	11209224	BnaA06T0172300ZY	0	+	0	0	9168	0.0000000
zheyou73v0_A06	11211603	11218282	BnaA06T0172400ZY	0	+	0	0	6679	0.0000000
zheyou73v0_A06	11218563	11219901	BnaA06T0172500ZY	0	-	0	0	1338	0.0000000
zheyou73v0_A06	11221146	11222784	BnaA06T0172600ZY	0	-	0	0	1638	0.0000000
zheyou73v0_A06	11226101	11228067	BnaA06T0172700ZY	0	+	0	0	1966	0.0000000
zheyou73v0_A06	11231644	11232294	BnaA06T0172800ZY	0	-	0	0	650	0.0000000
zheyou73v0_A06	11249579	11250963	BnaA06T0172900ZY	0	-	0	0	1384	0.0000000
zheyou73v0_A06	11251665	11253278	BnaA06T0173000ZY	0	-	0	0	1613	0.0000000
zheyou73v0_A06	11251665	11253278	BnaA06T0173000ZY.1	0	-	0	0	1613	0.0000000
zheyou73v0_A06	11255202	11264227	BnaA06T0173100ZY	0	-	0	0	9025	0.0000000
zheyou73v0_A06	11278342	11279017	BnaA06T0173200ZY	0	-	0	0	675	0.0000000
zheyou73v0_A06	11281178	11282882	BnaA06T0173300ZY.1	0	+	0	0	1704	0.0000000
zheyou73v0_A06	11281179	11282882	BnaA06T0173300ZY	0	+	0	0	1703	0.0000000
zheyou73v0_A06	11289762	11291934	BnaA06T0173400ZY	0	+	0	0	2172	0.0000000
zheyou73v0_A06	11295085	11295499	BnaA06T0173500ZY	0	+	0	0	414	0.0000000
zheyou73v0_A06	11296459	11296903	BnaA06T0173600ZY	0	-	0	0	444	0.0000000
zheyou73v0_A06	11297846	11299697	BnaA06T0173700ZY	0	-	0	0	1851	0.0000000
zheyou73v0_A06	11301458	11303656	BnaA06T0173800ZY	0	+	0	0	2198	0.0000000
zheyou73v0_A06	11313633	11315213	BnaA06T0173900ZY	0	-	0	0	1580	0.0000000
zheyou73v0_A06	11316219	11319488	BnaA06T0174000ZY	0	+	0	0	3269	0.0000000
zheyou73v0_A06	11329539	11331532	BnaA06T0174100ZY	0	-	0	0	1993	0.0000000
zheyou73v0_A06	11336745	11338117	BnaA06T0174200ZY	0	+	0	0	1372	0.0000000
zheyou73v0_A06	11356652	11358634	BnaA06T0174300ZY	0	+	0	0	1982	0.0000000
zheyou73v0_A06	11359718	11360586	BnaA06T0174400ZY	0	+	0	0	868	0.0000000
zheyou73v0_A06	11360749	11361004	BnaA06T0174500ZY	0	+	0	0	255	0.0000000
zheyou73v0_A06	11367648	11369253	BnaA06T0174600ZY	0	+	0	0	1605	0.0000000
zheyou73v0_A06	11369140	11371159	BnaA06T0174700ZY	0	-	0	0	2019	0.0000000
zheyou73v0_A06	11382097	11384797	BnaA06T0174800ZY	0	+	0	0	2700	0.0000000
zheyou73v0_A06	11382097	11384797	BnaA06T0174800ZY.1	0	+	0	0	2700	0.0000000
zheyou73v0_A06	11385755	11390198	BnaA06T0174900ZY	0	-	0	0	4443	0.0000000
zheyou73v0_A06	11394932	11395349	BnaA06T0175000ZY	0	+	0	0	417	0.0000000
zheyou73v0_A06	11395645	11398470	BnaA06T0175100ZY	0	-	0	0	2825	0.0000000
zheyou73v0_A06	11422039	11424289	BnaA06T0175200ZY	0	+	0	0	2250	0.0000000
zheyou73v0_A06	11426169	11432582	BnaA06T0175300ZY	0	+	0	0	6413	0.0000000
zheyou73v0_A06	11442409	11443030	BnaA06T0175400ZY	0	+	0	0	621	0.0000000
zheyou73v0_A06	11443332	11447908	BnaA06T0175500ZY	0	-	0	0	4576	0.0000000
zheyou73v0_A06	11448504	11449994	BnaA06T0175600ZY	0	+	0	0	1490	0.0000000
zheyou73v0_A06	11450329	11452044	BnaA06T0175700ZY	0	-	0	0	1715	0.0000000
zheyou73v0_A06	11461594	11462613	BnaA06T0175800ZY	0	-	0	0	1019	0.0000000
zheyou73v0_A06	11464066	11464620	BnaA06T0175900ZY	0	-	0	0	554	0.0000000
zheyou73v0_A06	11464921	11466129	BnaA06T0176000ZY	0	-	0	0	1208	0.0000000
zheyou73v0_A06	11492312	11493746	BnaA06T0176100ZY	0	+	0	0	1434	0.0000000
zheyou73v0_A06	11506525	11507529	BnaA06T0176200ZY	0	-	0	0	1004	0.0000000
zheyou73v0_A06	11513149	11517205	BnaA06T0176300ZY	0	-	0	0	4056	0.0000000
zheyou73v0_A06	11538747	11539658	BnaA06T0176400ZY	0	-	0	0	911	0.0000000
zheyou73v0_A06	11542292	11543075	BnaA06T0176500ZY	0	+	0	0	783	0.0000000
zheyou73v0_A06	11543554	11548471	BnaA06T0176600ZY	0	-	0	0	4917	0.0000000
zheyou73v0_A06	11555509	11556847	BnaA06T0176700ZY	0	+	0	0	1338	0.0000000
zheyou73v0_A06	11555925	11556847	BnaA06T0176700ZY.1	0	+	0	0	922	0.0000000
zheyou73v0_A06	11563527	11564183	BnaA06T0176800ZY	0	+	0	0	656	0.0000000
zheyou73v0_A06	11565586	11569879	BnaA06T0176900ZY	0	-	0	0	4293	0.0000000
zheyou73v0_A06	11578686	11580293	BnaA06T0177000ZY	0	+	0	0	1607	0.0000000
zheyou73v0_A06	11580409	11582704	BnaA06T0177100ZY	0	-	0	0	2295	0.0000000
zheyou73v0_A06	11583901	11585347	BnaA06T0177200ZY	0	+	0	0	1446	0.0000000
zheyou73v0_A06	11585646	11587895	BnaA06T0177300ZY	0	-	0	0	2249	0.0000000
zheyou73v0_A06	11598871	11602867	BnaA06T0177400ZY	0	-	0	0	3996	0.0000000
zheyou73v0_A06	11598871	11602867	BnaA06T0177400ZY.1	0	-	0	0	3996	0.0000000
zheyou73v0_A06	11609176	11615515	BnaA06T0177500ZY	0	+	0	0	6339	0.0000000
zheyou73v0_A06	11632161	11632984	BnaA06T0177600ZY	0	-	0	0	823	0.0000000
zheyou73v0_A06	11633206	11634634	BnaA06T0177700ZY	0	-	0	0	1428	0.0000000
zheyou73v0_A06	11640205	11642262	BnaA06T0177800ZY	0	+	0	0	2057	0.0000000
zheyou73v0_A06	11647288	11649586	BnaA06T0177900ZY	0	-	0	0	2298	0.0000000
zheyou73v0_A06	11660886	11670884	BnaA06T0178000ZY	0	-	0	0	9998	0.0000000
zheyou73v0_A06	11671395	11673512	BnaA06T0178100ZY	0	-	0	0	2117	0.0000000
zheyou73v0_A06	11686636	11691330	BnaA06T0178200ZY	0	+	0	0	4694	0.0000000
zheyou73v0_A06	11691753	11693818	BnaA06T0178300ZY	0	-	0	0	2065	0.0000000
zheyou73v0_A06	11699766	11702489	BnaA06T0178400ZY	0	+	0	0	2723	0.0000000
zheyou73v0_A06	11706415	11707805	BnaA06T0178500ZY	0	-	0	0	1390	0.0000000
zheyou73v0_A06	11708114	11712023	BnaA06T0178600ZY	0	-	0	0	3909	0.0000000
zheyou73v0_A06	11732582	11734923	BnaA06T0178700ZY	0	+	0	0	2341	0.0000000
zheyou73v0_A06	11735156	11737691	BnaA06T0178800ZY	0	+	0	0	2535	0.0000000
zheyou73v0_A06	11738710	11740545	BnaA06T0178900ZY	0	-	0	0	1835	0.0000000
zheyou73v0_A06	11760616	11765252	BnaA06T0179000ZY	0	+	0	0	4636	0.0000000
zheyou73v0_A06	11771802	11777042	BnaA06T0179100ZY	0	+	0	0	5240	0.0000000
zheyou73v0_A06	11777153	11777634	BnaA06T0179200ZY	0	+	0	0	481	0.0000000
zheyou73v0_A06	11783657	11786297	BnaA06T0179300ZY	0	+	0	0	2640	0.0000000
zheyou73v0_A06	11791255	11792978	BnaA06T0179400ZY	0	+	0	0	1723	0.0000000
zheyou73v0_A06	11805073	11807137	BnaA06T0179500ZY	0	+	0	0	2064	0.0000000
zheyou73v0_A06	11834570	11835083	BnaA06T0179600ZY	0	-	0	0	513	0.0000000
zheyou73v0_A06	11848332	11852720	BnaA06T0179700ZY	0	+	0	0	4388	0.0000000
zheyou73v0_A06	11848332	11851918	BnaA06T0179700ZY.1	0	+	0	0	3586	0.0000000
zheyou73v0_A06	11848332	11851918	BnaA06T0179700ZY.2	0	+	0	0	3586	0.0000000
zheyou73v0_A06	11853498	11854253	BnaA06T0179800ZY	0	+	0	0	755	0.0000000
zheyou73v0_A06	11856168	11862107	BnaA06T0179900ZY	0	+	0	0	5939	0.0000000
zheyou73v0_A06	11856267	11862107	BnaA06T0179900ZY.1	0	+	0	0	5840	0.0000000
zheyou73v0_A06	11856267	11862107	BnaA06T0179900ZY.2	0	+	0	0	5840	0.0000000
zheyou73v0_A06	11873921	11877967	BnaA06T0180000ZY	0	+	0	0	4046	0.0000000
zheyou73v0_A06	11873921	11877967	BnaA06T0180000ZY.1	0	+	0	0	4046	0.0000000
zheyou73v0_A06	11894810	11897744	BnaA06T0180100ZY	0	+	0	0	2934	0.0000000
zheyou73v0_A06	11899587	11900018	BnaA06T0180200ZY	0	+	0	0	431	0.0000000
zheyou73v0_A06	11966352	11968072	BnaA06T0180300ZY	0	+	0	0	1720	0.0000000
zheyou73v0_A06	11983856	11987088	BnaA06T0180400ZY	0	-	0	0	3232	0.0000000
zheyou73v0_A06	11983947	11984355	BnaA06T0180500ZY	0	+	0	0	408	0.0000000
zheyou73v0_A06	12044536	12046745	BnaA06T0180600ZY	0	+	0	0	2209	0.0000000
zheyou73v0_A06	12049371	12050094	BnaA06T0180700ZY	0	-	0	0	723	0.0000000
zheyou73v0_A06	12050211	12051167	BnaA06T0180800ZY	0	-	0	0	956	0.0000000
zheyou73v0_A06	12054423	12055250	BnaA06T0180900ZY	0	-	0	0	827	0.0000000
zheyou73v0_A06	12083271	12086009	BnaA06T0181000ZY	0	-	0	0	2738	0.0000000
zheyou73v0_A06	12112788	12123404	BnaA06T0181100ZY	0	+	0	0	10616	0.0000000
zheyou73v0_A06	12124034	12124821	BnaA06T0181200ZY	0	-	0	0	787	0.0000000
zheyou73v0_A06	12132976	12136013	BnaA06T0181300ZY	0	+	0	0	3037	0.0000000
zheyou73v0_A06	12132976	12136013	BnaA06T0181300ZY.1	0	+	0	0	3037	0.0000000
zheyou73v0_A06	12132976	12136013	BnaA06T0181300ZY.2	0	+	0	0	3037	0.0000000
zheyou73v0_A06	12141294	12142669	BnaA06T0181400ZY	0	-	0	0	1375	0.0000000
zheyou73v0_A06	12141294	12142669	BnaA06T0181400ZY.1	0	-	0	0	1375	0.0000000
zheyou73v0_A06	12151236	12151485	BnaA06T0181500ZY	0	+	0	0	249	0.0000000
zheyou73v0_A06	12155359	12158932	BnaA06T0181600ZY	0	+	0	0	3573	0.0000000
zheyou73v0_A06	12171801	12175321	BnaA06T0181700ZY	0	+	0	0	3520	0.0000000
zheyou73v0_A06	12181945	12183006	BnaA06T0181800ZY	0	+	0	0	1061	0.0000000
zheyou73v0_A06	12198175	12203378	BnaA06T0181900ZY	0	-	0	0	5203	0.0000000
zheyou73v0_A06	12233081	12237351	BnaA06T0182000ZY	0	-	0	0	4270	0.0000000
zheyou73v0_A06	12256129	12256683	BnaA06T0182100ZY	0	-	0	0	554	0.0000000
zheyou73v0_A06	12263616	12269506	BnaA06T0182200ZY	0	-	0	0	5890	0.0000000
zheyou73v0_A06	12282291	12284704	BnaA06T0182300ZY	0	+	0	0	2413	0.0000000
zheyou73v0_A06	12308271	12308574	BnaA06T0182400ZY	0	-	0	0	303	0.0000000
zheyou73v0_A06	12310107	12314045	BnaA06T0182500ZY	0	+	0	0	3938	0.0000000
zheyou73v0_A06	12344223	12345927	BnaA06T0182600ZY	0	+	0	0	1704	0.0000000
zheyou73v0_A06	12368128	12369048	BnaA06T0182700ZY	0	+	0	0	920	0.0000000
zheyou73v0_A06	12373010	12376792	BnaA06T0182800ZY	0	+	0	0	3782	0.0000000
zheyou73v0_A06	12413356	12415446	BnaA06T0182900ZY	0	+	0	0	2090	0.0000000
zheyou73v0_A06	12428390	12435121	BnaA06T0183000ZY	0	+	0	0	6731	0.0000000
zheyou73v0_A06	12443472	12447650	BnaA06T0183100ZY	0	+	0	0	4178	0.0000000
zheyou73v0_A06	12457895	12459990	BnaA06T0183200ZY	0	-	0	0	2095	0.0000000
zheyou73v0_A06	12460562	12462609	BnaA06T0183300ZY	0	-	0	0	2047	0.0000000
zheyou73v0_A06	12495062	12495437	BnaA06T0183400ZY	0	-	0	0	375	0.0000000
zheyou73v0_A06	12515393	12516934	BnaA06T0183500ZY	0	+	0	0	1541	0.0000000
zheyou73v0_A06	12515393	12516934	BnaA06T0183500ZY.1	0	+	0	0	1541	0.0000000
zheyou73v0_A06	12523726	12526048	BnaA06T0183600ZY	0	-	0	0	2322	0.0000000
zheyou73v0_A06	12533673	12534492	BnaA06T0183700ZY	0	+	0	0	819	0.0000000
zheyou73v0_A06	12540343	12541724	BnaA06T0183800ZY	0	-	0	0	1381	0.0000000
zheyou73v0_A06	12558295	12562520	BnaA06T0183900ZY	0	-	0	0	4225	0.0000000
zheyou73v0_A06	12584897	12585439	BnaA06T0184000ZY	0	-	0	0	542	0.0000000
zheyou73v0_A06	12591772	12593465	BnaA06T0184100ZY	0	+	0	0	1693	0.0000000
zheyou73v0_A06	12605416	12606827	BnaA06T0184200ZY	0	-	0	0	1411	0.0000000
zheyou73v0_A06	12607763	12608237	BnaA06T0184300ZY	0	-	0	0	474	0.0000000
zheyou73v0_A06	12611013	12611843	BnaA06T0184400ZY	0	+	0	0	830	0.0000000
zheyou73v0_A06	12631287	12633581	BnaA06T0184500ZY	0	+	0	0	2294	0.0000000
zheyou73v0_A06	12631287	12633886	BnaA06T0184500ZY.1	0	+	0	0	2599	0.0000000
zheyou73v0_A06	12634085	12635541	BnaA06T0184600ZY	0	-	0	0	1456	0.0000000
zheyou73v0_A06	12654712	12657006	BnaA06T0184700ZY	0	+	0	0	2294	0.0000000
zheyou73v0_A06	12654712	12657311	BnaA06T0184700ZY.1	0	+	0	0	2599	0.0000000
zheyou73v0_A06	12657632	12658873	BnaA06T0184800ZY	0	-	0	0	1241	0.0000000
zheyou73v0_A06	12674751	12676916	BnaA06T0184900ZY	0	-	0	0	2165	0.0000000
zheyou73v0_A06	12678727	12679812	BnaA06T0185000ZY	0	+	0	0	1085	0.0000000
zheyou73v0_A06	12678727	12679812	BnaA06T0185000ZY.1	0	+	0	0	1085	0.0000000
zheyou73v0_A06	12680025	12685335	BnaA06T0185100ZY	0	-	0	0	5310	0.0000000
zheyou73v0_A06	12692527	12693363	BnaA06T0185200ZY	0	+	0	0	836	0.0000000
zheyou73v0_A06	12714735	12717973	BnaA06T0185300ZY	0	-	0	0	3238	0.0000000
zheyou73v0_A06	12718966	12722203	BnaA06T0185400ZY	0	-	0	0	3237	0.0000000
zheyou73v0_A06	12726328	12728086	BnaA06T0185500ZY	0	-	0	0	1758	0.0000000
zheyou73v0_A06	12728256	12729179	BnaA06T0185600ZY	0	+	0	0	923	0.0000000
zheyou73v0_A06	12734978	12736548	BnaA06T0185700ZY	0	+	0	0	1570	0.0000000
zheyou73v0_A06	12751257	12754272	BnaA06T0185800ZY	0	-	0	0	3015	0.0000000
zheyou73v0_A06	12817319	12825079	BnaA06T0185900ZY	0	+	0	0	7760	0.0000000
zheyou73v0_A06	12825103	12825645	BnaA06T0186000ZY	0	-	0	0	542	0.0000000
zheyou73v0_A06	12917275	12918753	BnaA06T0186100ZY	0	+	0	0	1478	0.0000000
zheyou73v0_A06	12919942	12921127	BnaA06T0186200ZY	0	+	0	0	1185	0.0000000
zheyou73v0_A06	12930010	12934954	BnaA06T0186300ZY	0	+	0	0	4944	0.0000000
zheyou73v0_A06	12935737	12936623	BnaA06T0186400ZY	0	-	0	0	886	0.0000000
zheyou73v0_A06	12937968	12944534	BnaA06T0186500ZY	0	+	0	0	6566	0.0000000
zheyou73v0_A06	12946756	12946936	BnaA06T0186600ZY	0	+	0	0	180	0.0000000
zheyou73v0_A06	12947813	12950034	BnaA06T0186700ZY	0	-	0	0	2221	0.0000000
zheyou73v0_A06	12963190	12963353	BnaA06T0186800ZY	0	+	0	0	163	0.0000000
zheyou73v0_A06	12963381	12963585	BnaA06T0186900ZY	0	+	0	0	204	0.0000000
zheyou73v0_A06	12983710	12985716	BnaA06T0187000ZY	0	-	0	0	2006	0.0000000
zheyou73v0_A06	12993787	12994251	BnaA06T0187100ZY	0	+	0	0	464	0.0000000
zheyou73v0_A06	13024551	13025687	BnaA06T0187200ZY	0	-	0	0	1136	0.0000000
zheyou73v0_A06	13056457	13057107	BnaA06T0187300ZY	0	+	0	0	650	0.0000000
zheyou73v0_A06	13116168	13120036	BnaA06T0187400ZY	0	+	0	0	3868	0.0000000
zheyou73v0_A06	13129213	13130083	BnaA06T0187500ZY	0	+	0	0	870	0.0000000
zheyou73v0_A06	13170424	13171188	BnaA06T0187600ZY	0	+	0	0	764	0.0000000
zheyou73v0_A06	13179110	13183194	BnaA06T0187700ZY	0	+	0	0	4084	0.0000000
zheyou73v0_A06	13193819	13195449	BnaA06T0187800ZY	0	-	0	0	1630	0.0000000
zheyou73v0_A06	13231565	13232387	BnaA06T0187900ZY	0	-	0	0	822	0.0000000
zheyou73v0_A06	13232421	13232862	BnaA06T0188000ZY	0	-	0	0	441	0.0000000
zheyou73v0_A06	13236387	13237823	BnaA06T0188100ZY	0	+	0	0	1436	0.0000000
zheyou73v0_A06	13240824	13242260	BnaA06T0188200ZY	0	+	0	0	1436	0.0000000
zheyou73v0_A06	13245017	13249803	BnaA06T0188300ZY	0	-	0	0	4786	0.0000000
zheyou73v0_A06	13251366	13252134	BnaA06T0188400ZY	0	+	0	0	768	0.0000000
zheyou73v0_A06	13252313	13258834	BnaA06T0188500ZY	0	-	0	0	6521	0.0000000
zheyou73v0_A06	13271045	13277550	BnaA06T0188600ZY	0	+	0	0	6505	0.0000000
zheyou73v0_A06	13321475	13321728	BnaA06T0188700ZY	0	+	0	0	253	0.0000000
zheyou73v0_A06	13322840	13325619	BnaA06T0188800ZY	0	-	0	0	2779	0.0000000
zheyou73v0_A06	13398117	13401100	BnaA06T0188900ZY	0	+	0	0	2983	0.0000000
zheyou73v0_A06	13420968	13423432	BnaA06T0189000ZY	0	-	0	0	2464	0.0000000
zheyou73v0_A06	13420968	13423432	BnaA06T0189000ZY.1	0	-	0	0	2464	0.0000000
zheyou73v0_A06	13498536	13499891	BnaA06T0189100ZY	0	+	0	0	1355	0.0000000
zheyou73v0_A06	13517196	13520212	BnaA06T0189200ZY	0	+	0	0	3016	0.0000000
zheyou73v0_A06	13561499	13562151	BnaA06T0189300ZY	0	-	0	0	652	0.0000000
zheyou73v0_A06	13634258	13634453	BnaA06T0189400ZY	0	+	0	0	195	0.0000000
zheyou73v0_A06	13825240	13827023	BnaA06T0189500ZY	0	-	0	0	1783	0.0000000
zheyou73v0_A06	13832573	13836686	BnaA06T0189600ZY	0	+	0	0	4113	0.0000000
zheyou73v0_A06	14092821	14095115	BnaA06T0189700ZY	0	+	0	0	2294	0.0000000
zheyou73v0_A06	14097557	14109181	BnaA06T0189800ZY	0	-	0	0	11624	0.0000000
zheyou73v0_A06	14204678	14205900	BnaA06T0189900ZY	0	-	0	0	1222	0.0000000
zheyou73v0_A06	14211062	14212267	BnaA06T0190000ZY	0	-	0	0	1205	0.0000000
zheyou73v0_A06	14212526	14213986	BnaA06T0190100ZY	0	-	0	0	1460	0.0000000
zheyou73v0_A06	14238974	14249275	BnaA06T0190200ZY	0	+	0	0	10301	0.0000000
zheyou73v0_A06	14249384	14250240	BnaA06T0190300ZY	0	+	0	0	856	0.0000000
zheyou73v0_A06	14264121	14264313	BnaA06T0190400ZY	0	-	0	0	192	0.0000000
zheyou73v0_A06	14342773	14348724	BnaA06T0190500ZY	0	+	0	0	5951	0.0000000
zheyou73v0_A06	14355218	14360071	BnaA06T0190600ZY	0	-	0	0	4853	0.0000000
zheyou73v0_A06	14412968	14415051	BnaA06T0190700ZY	0	+	0	0	2083	0.0000000
zheyou73v0_A06	14453179	14455885	BnaA06T0190800ZY	0	+	0	0	2706	0.0000000
zheyou73v0_A06	14466414	14467968	BnaA06T0190900ZY	0	-	0	0	1554	0.0000000
zheyou73v0_A06	14496745	14498857	BnaA06T0191000ZY	0	+	0	0	2112	0.0000000
zheyou73v0_A06	14523987	14524188	BnaA06T0191100ZY	0	-	0	0	201	0.0000000
zheyou73v0_A06	14526935	14527187	BnaA06T0191200ZY	0	+	0	0	252	0.0000000
zheyou73v0_A06	14528845	14529682	BnaA06T0191300ZY	0	-	0	0	837	0.0000000
zheyou73v0_A06	14532474	14533221	BnaA06T0191400ZY	0	-	0	0	747	0.0000000
zheyou73v0_A06	14534906	14535128	BnaA06T0191500ZY	0	+	0	0	222	0.0000000
zheyou73v0_A06	14560473	14561028	BnaA06T0191600ZY	0	-	0	0	555	0.0000000
zheyou73v0_A06	14562226	14563696	BnaA06T0191700ZY	0	-	0	0	1470	0.0000000
zheyou73v0_A06	14564369	14565809	BnaA06T0191800ZY	0	-	0	0	1440	0.0000000
zheyou73v0_A06	14565963	14568488	BnaA06T0191900ZY	0	+	0	0	2525	0.0000000
zheyou73v0_A06	14627620	14627872	BnaA06T0192000ZY	0	+	0	0	252	0.0000000
zheyou73v0_A06	14629426	14630323	BnaA06T0192100ZY	0	-	0	0	897	0.0000000
zheyou73v0_A06	14631771	14632326	BnaA06T0192200ZY	0	-	0	0	555	0.0000000
zheyou73v0_A06	14633524	14634994	BnaA06T0192300ZY	0	-	0	0	1470	0.0000000
zheyou73v0_A06	14635667	14637107	BnaA06T0192400ZY	0	-	0	0	1440	0.0000000
zheyou73v0_A06	14637261	14639786	BnaA06T0192500ZY	0	+	0	0	2525	0.0000000
zheyou73v0_A06	14677626	14678564	BnaA06T0192600ZY	0	+	0	0	938	0.0000000
zheyou73v0_A06	14679758	14681282	BnaA06T0192700ZY	0	+	0	0	1524	0.0000000
zheyou73v0_A06	14683779	14683965	BnaA06T0192800ZY	0	-	0	0	186	0.0000000
zheyou73v0_A06	14699754	14700048	BnaA06T0192900ZY	0	+	0	0	294	0.0000000
zheyou73v0_A06	14700520	14701064	BnaA06T0193000ZY	0	-	0	0	544	0.0000000
zheyou73v0_A06	14704128	14705227	BnaA06T0193100ZY	0	+	0	0	1099	0.0000000
zheyou73v0_A06	14706578	14706830	BnaA06T0193200ZY	0	-	0	0	252	0.0000000
zheyou73v0_A06	14729411	14730465	BnaA06T0193300ZY	0	+	0	0	1054	0.0000000
zheyou73v0_A06	14730539	14731266	BnaA06T0193400ZY	0	+	0	0	727	0.0000000
zheyou73v0_A06	14731370	14734870	BnaA06T0193500ZY	0	+	0	0	3500	0.0000000
zheyou73v0_A06	14735693	14735987	BnaA06T0193600ZY	0	+	0	0	294	0.0000000
zheyou73v0_A06	14736459	14737003	BnaA06T0193700ZY	0	-	0	0	544	0.0000000
zheyou73v0_A06	14737560	14738181	BnaA06T0193800ZY	0	-	0	0	621	0.0000000
zheyou73v0_A06	14749327	14749699	BnaA06T0193900ZY	0	+	0	0	372	0.0000000
zheyou73v0_A06	14767260	14769169	BnaA06T0194000ZY	0	-	0	0	1909	0.0000000
zheyou73v0_A06	14785581	14785869	BnaA06T0194100ZY	0	-	0	0	288	0.0000000
zheyou73v0_A06	14811262	14811511	BnaA06T0194200ZY	0	-	0	0	249	0.0000000
zheyou73v0_A06	14826675	14827155	BnaA06T0194300ZY	0	+	0	0	480	0.0000000
zheyou73v0_A06	14830375	14832082	BnaA06T0194400ZY	0	+	0	0	1707	0.0000000
zheyou73v0_A06	14900875	14902511	BnaA06T0194500ZY	0	-	0	0	1636	0.0000000
zheyou73v0_A06	14915535	14915866	BnaA06T0194600ZY	0	+	0	0	331	0.0000000
zheyou73v0_A06	16132256	16132760	BnaA06T0194700ZY	0	+	0	0	504	0.0000000
zheyou73v0_A06	16306157	16307092	BnaA06T0194800ZY	0	-	0	0	935	0.0000000
zheyou73v0_A06	16307448	16307616	BnaA06T0194900ZY	0	+	0	0	168	0.0000000
zheyou73v0_A06	16308082	16309216	BnaA06T0195000ZY	0	+	0	0	1134	0.0000000
zheyou73v0_A06	16309441	16310652	BnaA06T0195100ZY	0	-	0	0	1211	0.0000000
zheyou73v0_A06	16320561	16321496	BnaA06T0195200ZY	0	-	0	0	935	0.0000000
zheyou73v0_A06	16321852	16322020	BnaA06T0195300ZY	0	+	0	0	168	0.0000000
zheyou73v0_A06	16322486	16323620	BnaA06T0195400ZY	0	+	0	0	1134	0.0000000
zheyou73v0_A06	16323845	16325056	BnaA06T0195500ZY	0	-	0	0	1211	0.0000000
zheyou73v0_A06	16329135	16330070	BnaA06T0195600ZY	0	-	0	0	935	0.0000000
zheyou73v0_A06	16330426	16337804	BnaA06T0195700ZY	0	+	0	0	7378	0.0000000
zheyou73v0_A06	16338029	16339240	BnaA06T0195800ZY	0	-	0	0	1211	0.0000000
zheyou73v0_A06	16343319	16344254	BnaA06T0195900ZY	0	-	0	0	935	0.0000000
zheyou73v0_A06	16344610	16344778	BnaA06T0196000ZY	0	+	0	0	168	0.0000000
zheyou73v0_A06	16345244	16346789	BnaA06T0196100ZY	0	+	0	0	1545	0.0000000
zheyou73v0_A06	16583977	16584912	BnaA06T0196200ZY	0	-	0	0	935	0.0000000
zheyou73v0_A06	16585268	16585436	BnaA06T0196300ZY	0	+	0	0	168	0.0000000
zheyou73v0_A06	16586142	16588211	BnaA06T0196400ZY	0	-	0	0	2069	0.0000000
zheyou73v0_A06	16623065	16624032	BnaA06T0196500ZY	0	-	0	0	967	0.0000000
zheyou73v0_A06	16626962	16627908	BnaA06T0196600ZY	0	-	0	0	946	0.0000000
zheyou73v0_A06	16632042	16632210	BnaA06T0196700ZY	0	+	0	0	168	0.0000000
zheyou73v0_A06	16632676	16634217	BnaA06T0196800ZY	0	+	0	0	1541	0.0000000
zheyou73v0_A06	16643226	16644200	BnaA06T0196900ZY	0	-	0	0	974	0.0000000
zheyou73v0_A06	16651802	16652096	BnaA06T0197000ZY	0	-	0	0	294	0.0000000
zheyou73v0_A06	16652427	16653493	BnaA06T0197100ZY	0	+	0	0	1066	0.0000000
zheyou73v0_A06	16654543	16655403	BnaA06T0197200ZY	0	+	0	0	860	0.0000000
zheyou73v0_A06	16655429	16656418	BnaA06T0197300ZY	0	-	0	0	989	0.0000000
zheyou73v0_A06	16656572	16660735	BnaA06T0197400ZY	0	-	0	0	4163	0.0000000
zheyou73v0_A06	16664811	16665746	BnaA06T0197500ZY	0	-	0	0	935	0.0000000
zheyou73v0_A06	16666102	16667843	BnaA06T0197600ZY	0	+	0	0	1741	0.0000000
zheyou73v0_A06	16667917	16668379	BnaA06T0197700ZY	0	-	0	0	462	0.0000000
zheyou73v0_A06	16675439	16676374	BnaA06T0197800ZY	0	-	0	0	935	0.0000000
zheyou73v0_A06	16676730	16678908	BnaA06T0197900ZY	0	+	0	0	2178	0.0000000
zheyou73v0_A06	16689680	16690615	BnaA06T0198000ZY	0	-	0	0	935	0.0000000
zheyou73v0_A06	16690973	16691141	BnaA06T0198100ZY	0	+	0	0	168	0.0000000
zheyou73v0_A06	16691607	16693153	BnaA06T0198200ZY	0	+	0	0	1546	0.0000000
zheyou73v0_A06	16698968	16699905	BnaA06T0198300ZY	0	-	0	0	937	0.0000000
zheyou73v0_A06	16700261	16700429	BnaA06T0198400ZY	0	+	0	0	168	0.0000000
zheyou73v0_A06	16700895	16702440	BnaA06T0198500ZY	0	+	0	0	1545	0.0000000
zheyou73v0_A06	16702500	16703465	BnaA06T0198600ZY	0	-	0	0	965	0.0000000
zheyou73v0_A06	16723463	16724398	BnaA06T0198700ZY	0	-	0	0	935	0.0000000
zheyou73v0_A06	16724754	16724922	BnaA06T0198800ZY	0	+	0	0	168	0.0000000
zheyou73v0_A06	16725388	16726347	BnaA06T0198900ZY	0	+	0	0	959	0.0000000
zheyou73v0_A06	16732008	16732943	BnaA06T0199000ZY	0	-	0	0	935	0.0000000
zheyou73v0_A06	16733300	16733468	BnaA06T0199100ZY	0	+	0	0	168	0.0000000
zheyou73v0_A06	16758605	16759344	BnaA06T0199200ZY	0	-	0	0	739	0.0000000
zheyou73v0_A06	16760572	16761537	BnaA06T0199300ZY	0	-	0	0	965	0.0000000
zheyou73v0_A06	16761732	16762639	BnaA06T0199400ZY	0	-	0	0	907	0.0000000
zheyou73v0_A06	16771090	16771300	BnaA06T0199500ZY	0	+	0	0	210	0.0000000
zheyou73v0_A06	16775441	16776374	BnaA06T0199600ZY	0	-	0	0	933	0.0000000
zheyou73v0_A06	16776730	16776898	BnaA06T0199700ZY	0	+	0	0	168	0.0000000
zheyou73v0_A06	16777277	16778908	BnaA06T0199800ZY	0	+	0	0	1631	0.0000000
zheyou73v0_A06	16798241	16800421	BnaA06T0199900ZY	0	+	0	0	2180	0.0000000
zheyou73v0_A06	16806894	16807062	BnaA06T0200000ZY	0	+	0	0	168	0.0000000
zheyou73v0_A06	16824287	16824620	BnaA06T0200100ZY	0	-	0	0	333	0.0000000
zheyou73v0_A06	16827555	16829733	BnaA06T0200200ZY	0	+	0	0	2178	0.0000000
zheyou73v0_A06	16829793	16830758	BnaA06T0200300ZY	0	-	0	0	965	0.0000000
zheyou73v0_A06	16847939	16852626	BnaA06T0200400ZY	0	-	0	0	4687	0.0000000
zheyou73v0_A06	16852945	16855161	BnaA06T0200500ZY	0	+	0	0	2216	0.0000000
zheyou73v0_A06	16879540	16881721	BnaA06T0200600ZY	0	+	0	0	2181	0.0000000
zheyou73v0_A06	16883004	16883214	BnaA06T0200700ZY	0	+	0	0	210	0.0000000
zheyou73v0_A06	16906665	16906833	BnaA06T0200800ZY	0	+	0	0	168	0.0000000
zheyou73v0_A06	16907299	16908845	BnaA06T0200900ZY	0	+	0	0	1546	0.0000000
zheyou73v0_A06	16918758	16921454	BnaA06T0201000ZY	0	+	0	0	2696	0.0000000
zheyou73v0_A06	16949245	16949413	BnaA06T0201100ZY	0	+	0	0	168	0.0000000
zheyou73v0_A06	16949419	16951423	BnaA06T0201200ZY	0	+	0	0	2004	0.0000000
zheyou73v0_A06	16956496	16957431	BnaA06T0201300ZY	0	-	0	0	935	0.0000000
zheyou73v0_A06	16959375	16959585	BnaA06T0201400ZY	0	+	0	0	210	0.0000000
zheyou73v0_A06	16973922	16976102	BnaA06T0201500ZY	0	+	0	0	2180	0.0000000
zheyou73v0_A06	16992083	16993875	BnaA06T0201600ZY	0	+	0	0	1792	0.0000000
zheyou73v0_A06	16994100	16995308	BnaA06T0201700ZY	0	-	0	0	1208	0.0000000
zheyou73v0_A06	16999427	17000363	BnaA06T0201800ZY	0	-	0	0	936	0.0000000
zheyou73v0_A06	17000553	17002898	BnaA06T0201900ZY	0	+	0	0	2345	0.0000000
zheyou73v0_A06	17018158	17018326	BnaA06T0202000ZY	0	+	0	0	168	0.0000000
zheyou73v0_A06	17018512	17019996	BnaA06T0202100ZY	0	-	0	0	1484	0.0000000
zheyou73v0_A06	17180980	17181160	BnaA06T0202200ZY	0	+	0	0	180	0.0000000
zheyou73v0_A06	17253408	17253689	BnaA06T0202300ZY	0	-	0	0	281	0.0000000
zheyou73v0_A06	17477385	17477699	BnaA06T0202400ZY	0	-	0	0	314	0.0000000
zheyou73v0_A06	17477973	17479959	BnaA06T0202500ZY	0	+	0	0	1986	0.0000000
zheyou73v0_A06	17480663	17480831	BnaA06T0202600ZY	0	-	0	0	168	0.0000000
zheyou73v0_A06	17481789	17482445	BnaA06T0202700ZY	0	+	0	0	656	0.0000000
zheyou73v0_A06	17502836	17505181	BnaA06T0202800ZY	0	+	0	0	2345	0.0000000
zheyou73v0_A06	17510379	17511314	BnaA06T0202900ZY	0	-	0	0	935	0.0000000
zheyou73v0_A06	17511670	17511838	BnaA06T0203000ZY	0	+	0	0	168	0.0000000
zheyou73v0_A06	17511976	17513509	BnaA06T0203100ZY	0	-	0	0	1533	0.0000000
zheyou73v0_A06	17513663	17514874	BnaA06T0203200ZY	0	-	0	0	1211	0.0000000
zheyou73v0_A06	17515131	17515341	BnaA06T0203300ZY	0	+	0	0	210	0.0000000
zheyou73v0_A06	17519065	17520001	BnaA06T0203400ZY	0	-	0	0	936	0.0000000
zheyou73v0_A06	17520357	17520525	BnaA06T0203500ZY	0	+	0	0	168	0.0000000
zheyou73v0_A06	17520991	17522125	BnaA06T0203600ZY	0	+	0	0	1134	0.0000000
zheyou73v0_A06	17522350	17523561	BnaA06T0203700ZY	0	-	0	0	1211	0.0000000
zheyou73v0_A06	17628581	17629716	BnaA06T0203800ZY	0	-	0	0	1135	0.0000000
zheyou73v0_A06	17630181	17630349	BnaA06T0203900ZY	0	-	0	0	168	0.0000000
zheyou73v0_A06	17630705	17631640	BnaA06T0204000ZY	0	+	0	0	935	0.0000000
zheyou73v0_A06	17645587	17647655	BnaA06T0204100ZY	0	+	0	0	2068	0.0000000
zheyou73v0_A06	17648698	17649836	BnaA06T0204200ZY	0	+	0	0	1138	0.0000000
zheyou73v0_A06	17915670	17917263	BnaA06T0204300ZY	0	+	0	0	1593	0.0000000
zheyou73v0_A06	17917663	17918874	BnaA06T0204400ZY	0	-	0	0	1211	0.0000000
zheyou73v0_A06	17923032	17923968	BnaA06T0204500ZY	0	-	0	0	936	0.0000000
zheyou73v0_A06	17987766	17997826	BnaA06T0204600ZY	0	+	0	0	10060	0.0000000
zheyou73v0_A06	18000933	18001143	BnaA06T0204700ZY	0	-	0	0	210	0.0000000
zheyou73v0_A06	18002425	18003970	BnaA06T0204800ZY	0	-	0	0	1545	0.0000000
zheyou73v0_A06	18004436	18004604	BnaA06T0204900ZY	0	-	0	0	168	0.0000000
zheyou73v0_A06	18005522	18007198	BnaA06T0205000ZY	0	-	0	0	1676	0.0000000
zheyou73v0_A06	18096956	18098549	BnaA06T0205100ZY	0	+	0	0	1593	0.0000000
zheyou73v0_A06	18165548	18167439	BnaA06T0205200ZY	0	+	0	0	1891	0.0000000
zheyou73v0_A06	18206790	18207285	BnaA06T0205300ZY	0	+	0	0	495	0.0000000
zheyou73v0_A06	18500185	18505113	BnaA06T0205400ZY	0	-	0	0	4928	0.0000000
zheyou73v0_A06	18562852	18563347	BnaA06T0205500ZY	0	+	0	0	495	0.0000000
zheyou73v0_A06	18985244	18988990	BnaA06T0205600ZY	0	+	0	0	3746	0.0000000
zheyou73v0_A06	19105235	19105709	BnaA06T0205700ZY	0	-	0	0	474	0.0000000
zheyou73v0_A06	19142493	19142790	BnaA06T0205800ZY	0	-	0	0	297	0.0000000
zheyou73v0_A06	19145653	19148143	BnaA06T0205900ZY	0	+	0	0	2490	0.0000000
zheyou73v0_A06	19148952	19149156	BnaA06T0206000ZY	0	-	0	0	204	0.0000000
zheyou73v0_A06	19149510	19150305	BnaA06T0206100ZY	0	-	0	0	795	0.0000000
zheyou73v0_A06	19162523	19162736	BnaA06T0206200ZY	0	+	0	0	213	0.0000000
zheyou73v0_A06	19172893	19174438	BnaA06T0206300ZY	0	-	0	0	1545	0.0000000
zheyou73v0_A06	19174904	19175072	BnaA06T0206400ZY	0	-	0	0	168	0.0000000
zheyou73v0_A06	19175428	19176363	BnaA06T0206500ZY	0	+	0	0	935	0.0000000
zheyou73v0_A06	19180350	19182417	BnaA06T0206600ZY	0	+	0	0	2067	0.0000000
zheyou73v0_A06	19182468	19183291	BnaA06T0206700ZY	0	-	0	0	823	0.0000000
zheyou73v0_A06	19183647	19184582	BnaA06T0206800ZY	0	+	0	0	935	0.0000000
zheyou73v0_A06	19188296	19189478	BnaA06T0206900ZY	0	+	0	0	1182	0.0000000
zheyou73v0_A06	19382330	19383265	BnaA06T0207000ZY	0	-	0	0	935	0.0000000
zheyou73v0_A06	19383621	19383789	BnaA06T0207100ZY	0	+	0	0	168	0.0000000
zheyou73v0_A06	19384255	19385389	BnaA06T0207200ZY	0	+	0	0	1134	0.0000000
zheyou73v0_A06	19385614	19386825	BnaA06T0207300ZY	0	-	0	0	1211	0.0000000
zheyou73v0_A06	19390904	19391839	BnaA06T0207400ZY	0	-	0	0	935	0.0000000
zheyou73v0_A06	19392195	19392363	BnaA06T0207500ZY	0	+	0	0	168	0.0000000
zheyou73v0_A06	19412230	19412821	BnaA06T0207600ZY	0	+	0	0	591	0.0000000
zheyou73v0_A06	19429648	19431223	BnaA06T0207700ZY	0	+	0	0	1575	0.0000000
zheyou73v0_A06	19484939	19485527	BnaA06T0207800ZY	0	+	0	0	588	0.0000000
zheyou73v0_A06	19610551	19611500	BnaA06T0207900ZY	0	+	0	0	949	0.0000000
zheyou73v0_A06	19611725	19613500	BnaA06T0208000ZY	0	-	0	0	1775	0.0000000
zheyou73v0_A06	19613832	19614767	BnaA06T0208100ZY	0	+	0	0	935	0.0000000
zheyou73v0_A06	19619124	19620669	BnaA06T0208200ZY	0	-	0	0	1545	0.0000000
zheyou73v0_A06	19621135	19621303	BnaA06T0208300ZY	0	-	0	0	168	0.0000000
zheyou73v0_A06	19621659	19622584	BnaA06T0208400ZY	0	+	0	0	925	0.0000000
zheyou73v0_A06	19626235	19626445	BnaA06T0208500ZY	0	-	0	0	210	0.0000000
zheyou73v0_A06	19626702	19627820	BnaA06T0208600ZY	0	+	0	0	1118	0.0000000
zheyou73v0_A06	19628067	19629032	BnaA06T0208700ZY	0	+	0	0	965	0.0000000
zheyou73v0_A06	19629742	19629910	BnaA06T0208800ZY	0	-	0	0	168	0.0000000
zheyou73v0_A06	19637992	19639202	BnaA06T0208900ZY	0	+	0	0	1210	0.0000000
zheyou73v0_A06	19639602	19640539	BnaA06T0209000ZY	0	-	0	0	937	0.0000000
zheyou73v0_A06	19640989	19641157	BnaA06T0209100ZY	0	-	0	0	168	0.0000000
zheyou73v0_A06	19641513	19649363	BnaA06T0209200ZY	0	+	0	0	7850	0.0000000
zheyou73v0_A06	19663938	19666913	BnaA06T0209300ZY	0	-	0	0	2975	0.0000000
zheyou73v0_A06	19666919	19667087	BnaA06T0209400ZY	0	-	0	0	168	0.0000000
zheyou73v0_A06	19667443	19668378	BnaA06T0209500ZY	0	+	0	0	935	0.0000000
zheyou73v0_A06	19672532	19673741	BnaA06T0209600ZY	0	+	0	0	1209	0.0000000
zheyou73v0_A06	19675501	19675732	BnaA06T0209700ZY	0	-	0	0	231	0.0000000
zheyou73v0_A06	19676088	19677023	BnaA06T0209800ZY	0	+	0	0	935	0.0000000
zheyou73v0_A06	19683054	19685380	BnaA06T0209900ZY	0	+	0	0	2326	0.0000000
zheyou73v0_A06	19697744	19699768	BnaA06T0210000ZY	0	+	0	0	2024	0.0000000
zheyou73v0_A06	19711218	19711428	BnaA06T0210100ZY	0	-	0	0	210	0.0000000
zheyou73v0_A06	19713027	19714512	BnaA06T0210200ZY	0	+	0	0	1485	0.0000000
zheyou73v0_A06	19714698	19714866	BnaA06T0210300ZY	0	-	0	0	168	0.0000000
zheyou73v0_A06	19857441	19858986	BnaA06T0210400ZY	0	-	0	0	1545	0.0000000
zheyou73v0_A06	19859452	19859620	BnaA06T0210500ZY	0	-	0	0	168	0.0000000
zheyou73v0_A06	19873042	19874587	BnaA06T0210600ZY	0	-	0	0	1545	0.0000000
zheyou73v0_A06	19875053	19875221	BnaA06T0210700ZY	0	-	0	0	168	0.0000000
zheyou73v0_A06	19875577	19876512	BnaA06T0210800ZY	0	+	0	0	935	0.0000000
zheyou73v0_A06	19901915	19904094	BnaA06T0210900ZY	0	-	0	0	2179	0.0000000
zheyou73v0_A06	19904450	19905385	BnaA06T0211000ZY	0	+	0	0	935	0.0000000
zheyou73v0_A06	19927638	19929643	BnaA06T0211100ZY	0	-	0	0	2005	0.0000000
zheyou73v0_A06	19929694	19929862	BnaA06T0211200ZY	0	-	0	0	168	0.0000000
zheyou73v0_A06	19930219	19931154	BnaA06T0211300ZY	0	+	0	0	935	0.0000000
zheyou73v0_A06	19936459	19939623	BnaA06T0211400ZY	0	-	0	0	3164	0.0000000
zheyou73v0_A06	19942795	19943730	BnaA06T0211500ZY	0	-	0	0	935	0.0000000
zheyou73v0_A06	19944086	19944254	BnaA06T0211600ZY	0	+	0	0	168	0.0000000
zheyou73v0_A06	19944720	19945854	BnaA06T0211700ZY	0	+	0	0	1134	0.0000000
zheyou73v0_A06	19946079	19947290	BnaA06T0211800ZY	0	-	0	0	1211	0.0000000
zheyou73v0_A06	20016916	20018870	BnaA06T0211900ZY	0	-	0	0	1954	0.0000000
zheyou73v0_A06	20097974	20098706	BnaA06T0212000ZY	0	+	0	0	732	0.0000000
zheyou73v0_A06	20346325	20346867	BnaA06T0212100ZY	0	+	0	0	542	0.0000000
zheyou73v0_A06	20415365	20416289	BnaA06T0212200ZY	0	+	0	0	924	0.0000000
zheyou73v0_A06	20526111	20527351	BnaA06T0212300ZY	0	-	0	0	1240	0.0000000
zheyou73v0_A06	20533337	20533925	BnaA06T0212400ZY	0	+	0	0	588	0.0000000
zheyou73v0_A06	20562157	20563092	BnaA06T0212500ZY	0	-	0	0	935	0.0000000
zheyou73v0_A06	20563448	20563616	BnaA06T0212600ZY	0	+	0	0	168	0.0000000
zheyou73v0_A06	20564082	20565216	BnaA06T0212700ZY	0	+	0	0	1134	0.0000000
zheyou73v0_A06	20565441	20566652	BnaA06T0212800ZY	0	-	0	0	1211	0.0000000
zheyou73v0_A06	20570798	20571733	BnaA06T0212900ZY	0	-	0	0	935	0.0000000
zheyou73v0_A06	20572089	20572257	BnaA06T0213000ZY	0	+	0	0	168	0.0000000
zheyou73v0_A06	20572723	20573857	BnaA06T0213100ZY	0	+	0	0	1134	0.0000000
zheyou73v0_A06	20574082	20575293	BnaA06T0213200ZY	0	-	0	0	1211	0.0000000
zheyou73v0_A06	20580180	20580348	BnaA06T0213300ZY	0	+	0	0	168	0.0000000
zheyou73v0_A06	20580835	20582113	BnaA06T0213400ZY	0	-	0	0	1278	0.0000000
zheyou73v0_A06	20645149	20645740	BnaA06T0213500ZY	0	+	0	0	591	0.0000000
zheyou73v0_A06	20646584	20648962	BnaA06T0213600ZY	0	+	0	0	2378	0.0000000
zheyou73v0_A06	20649339	20649930	BnaA06T0213700ZY	0	+	0	0	591	0.0000000
zheyou73v0_A06	20662967	20666103	BnaA06T0213800ZY	0	+	0	0	3136	0.0000000
zheyou73v0_A06	20669426	20670361	BnaA06T0213900ZY	0	-	0	0	935	0.0000000
zheyou73v0_A06	20670719	20672311	BnaA06T0214000ZY	0	+	0	0	1592	0.0000000
zheyou73v0_A06	20688995	20691371	BnaA06T0214100ZY	0	+	0	0	2376	0.0000000
zheyou73v0_A06	20691596	20692805	BnaA06T0214200ZY	0	-	0	0	1209	0.0000000
zheyou73v0_A06	20693062	20693272	BnaA06T0214300ZY	0	+	0	0	210	0.0000000
zheyou73v0_A06	20697127	20698062	BnaA06T0214400ZY	0	-	0	0	935	0.0000000
zheyou73v0_A06	20698407	20698575	BnaA06T0214500ZY	0	+	0	0	168	0.0000000
zheyou73v0_A06	20699041	20700586	BnaA06T0214600ZY	0	+	0	0	1545	0.0000000
zheyou73v0_A06	20701867	20702077	BnaA06T0214700ZY	0	+	0	0	210	0.0000000
zheyou73v0_A06	20718974	20723428	BnaA06T0214800ZY	0	+	0	0	4454	0.0000000
zheyou73v0_A06	20724345	20726523	BnaA06T0214900ZY	0	+	0	0	2178	0.0000000
zheyou73v0_A06	20731661	20735000	BnaA06T0215000ZY	0	-	0	0	3339	0.0000000
zheyou73v0_A06	20735356	20735524	BnaA06T0215100ZY	0	+	0	0	168	0.0000000
zheyou73v0_A06	20736230	20738560	BnaA06T0215200ZY	0	-	0	0	2330	0.0000000
zheyou73v0_A06	20746121	20748470	BnaA06T0215300ZY	0	-	0	0	2349	0.0000000
zheyou73v0_A06	20761234	20761444	BnaA06T0215400ZY	0	+	0	0	210	0.0000000
zheyou73v0_A06	20766381	20767973	BnaA06T0215500ZY	0	+	0	0	1592	0.0000000
zheyou73v0_A06	20768373	20769583	BnaA06T0215600ZY	0	-	0	0	1210	0.0000000
zheyou73v0_A06	20778769	20780361	BnaA06T0215700ZY	0	+	0	0	1592	0.0000000
zheyou73v0_A06	21028046	21028256	BnaA06T0215800ZY	0	+	0	0	210	0.0000000
zheyou73v0_A06	21082318	21082528	BnaA06T0215900ZY	0	-	0	0	210	0.0000000
zheyou73v0_A06	21084417	21086653	BnaA06T0216000ZY	0	-	0	0	2236	0.0000000
zheyou73v0_A06	21092394	21107546	BnaA06T0216100ZY	0	-	0	0	15152	0.0000000
zheyou73v0_A06	21114931	21115264	BnaA06T0216200ZY	0	+	0	0	333	0.0000000
zheyou73v0_A06	21131506	21132858	BnaA06T0216300ZY	0	-	0	0	1352	0.0000000
zheyou73v0_A06	21139017	21140562	BnaA06T0216400ZY	0	-	0	0	1545	0.0000000
zheyou73v0_A06	21141028	21141196	BnaA06T0216500ZY	0	-	0	0	168	0.0000000
zheyou73v0_A06	21141552	21142487	BnaA06T0216600ZY	0	+	0	0	935	0.0000000
zheyou73v0_A06	21157169	21158380	BnaA06T0216700ZY	0	+	0	0	1211	0.0000000
zheyou73v0_A06	21158605	21159739	BnaA06T0216800ZY	0	-	0	0	1134	0.0000000
zheyou73v0_A06	21160206	21160374	BnaA06T0216900ZY	0	-	0	0	168	0.0000000
zheyou73v0_A06	21209761	21210094	BnaA06T0217000ZY	0	+	0	0	333	0.0000000
zheyou73v0_A06	21214086	21214419	BnaA06T0217100ZY	0	+	0	0	333	0.0000000
zheyou73v0_A06	21220154	21221699	BnaA06T0217200ZY	0	-	0	0	1545	0.0000000
zheyou73v0_A06	21222165	21222333	BnaA06T0217300ZY	0	-	0	0	168	0.0000000
zheyou73v0_A06	21230938	21232790	BnaA06T0217400ZY	0	+	0	0	1852	0.0000000
zheyou73v0_A06	21233495	21233663	BnaA06T0217500ZY	0	-	0	0	168	0.0000000
zheyou73v0_A06	21234580	21243752	BnaA06T0217600ZY	0	-	0	0	9172	0.0000000
zheyou73v0_A06	21247198	21249267	BnaA06T0217700ZY	0	+	0	0	2069	0.0000000
zheyou73v0_A06	21249973	21250141	BnaA06T0217800ZY	0	-	0	0	168	0.0000000
zheyou73v0_A06	21251921	21253649	BnaA06T0217900ZY	0	-	0	0	1728	0.0000000
zheyou73v0_A06	21258622	21259487	BnaA06T0218000ZY	0	-	0	0	865	0.0000000
zheyou73v0_A06	21262299	21262766	BnaA06T0218100ZY	0	-	0	0	467	0.0000000
zheyou73v0_A06	21262920	21264131	BnaA06T0218200ZY	0	-	0	0	1211	0.0000000
zheyou73v0_A06	21264389	21264599	BnaA06T0218300ZY	0	+	0	0	210	0.0000000
zheyou73v0_A06	21269563	21271467	BnaA06T0218400ZY	0	+	0	0	1904	0.0000000
zheyou73v0_A06	21279447	21281200	BnaA06T0218500ZY	0	-	0	0	1753	0.0000000
zheyou73v0_A06	21309249	21310208	BnaA06T0218600ZY	0	-	0	0	959	0.0000000
zheyou73v0_A06	21310674	21310842	BnaA06T0218700ZY	0	-	0	0	168	0.0000000
zheyou73v0_A06	21312968	21315145	BnaA06T0218800ZY	0	-	0	0	2177	0.0000000
zheyou73v0_A06	21315501	21316475	BnaA06T0218900ZY	0	+	0	0	974	0.0000000
zheyou73v0_A06	21318755	21319046	BnaA06T0219000ZY	0	+	0	0	291	0.0000000
zheyou73v0_A06	21322803	21323094	BnaA06T0219100ZY	0	+	0	0	291	0.0000000
zheyou73v0_A06	21330829	21338494	BnaA06T0219200ZY	0	-	0	0	7665	0.0000000
zheyou73v0_A06	21339852	21342196	BnaA06T0219300ZY	0	-	0	0	2344	0.0000000
zheyou73v0_A06	21342386	21343321	BnaA06T0219400ZY	0	+	0	0	935	0.0000000
zheyou73v0_A06	21378362	21380542	BnaA06T0219500ZY	0	-	0	0	2180	0.0000000
zheyou73v0_A06	21380898	21381833	BnaA06T0219600ZY	0	+	0	0	935	0.0000000
zheyou73v0_A06	21386231	21387075	BnaA06T0219700ZY	0	+	0	0	844	0.0000000
zheyou73v0_A06	21387923	21388299	BnaA06T0219800ZY	0	+	0	0	376	0.0000000
zheyou73v0_A06	21389003	21389171	BnaA06T0219900ZY	0	-	0	0	168	0.0000000
zheyou73v0_A06	21389527	21390460	BnaA06T0220000ZY	0	+	0	0	933	0.0000000
zheyou73v0_A06	21397920	21403815	BnaA06T0220100ZY	0	-	0	0	5895	0.0000000
zheyou73v0_A06	21405073	21405511	BnaA06T0220200ZY	0	+	0	0	438	0.0000000
zheyou73v0_A06	21410565	21413405	BnaA06T0220300ZY	0	-	0	0	2840	0.0000000
zheyou73v0_A06	21424821	21427133	BnaA06T0220400ZY	0	-	0	0	2312	0.0000000
zheyou73v0_A06	21427356	21428095	BnaA06T0220500ZY	0	+	0	0	739	0.0000000
zheyou73v0_A06	21448206	21448416	BnaA06T0220600ZY	0	-	0	0	210	0.0000000
zheyou73v0_A06	21448772	21449668	BnaA06T0220700ZY	0	+	0	0	896	0.0000000
zheyou73v0_A06	21467048	21469041	BnaA06T0220800ZY	0	-	0	0	1993	0.0000000
zheyou73v0_A06	21469059	21469227	BnaA06T0220900ZY	0	-	0	0	168	0.0000000
zheyou73v0_A06	21486317	21486527	BnaA06T0221000ZY	0	-	0	0	210	0.0000000
zheyou73v0_A06	21487809	21489354	BnaA06T0221100ZY	0	-	0	0	1545	0.0000000
zheyou73v0_A06	21489820	21489988	BnaA06T0221200ZY	0	-	0	0	168	0.0000000
zheyou73v0_A06	21493639	21493972	BnaA06T0221300ZY	0	+	0	0	333	0.0000000
zheyou73v0_A06	21497973	21498306	BnaA06T0221400ZY	0	+	0	0	333	0.0000000
zheyou73v0_A06	21523599	21525191	BnaA06T0221500ZY	0	-	0	0	1592	0.0000000
zheyou73v0_A06	21540162	21541707	BnaA06T0221600ZY	0	-	0	0	1545	0.0000000
zheyou73v0_A06	21543117	21543285	BnaA06T0221700ZY	0	-	0	0	168	0.0000000
zheyou73v0_A06	21550282	21551241	BnaA06T0221800ZY	0	-	0	0	959	0.0000000
zheyou73v0_A06	21552231	21553121	BnaA06T0221900ZY	0	+	0	0	890	0.0000000
zheyou73v0_A06	21554483	21556387	BnaA06T0222000ZY	0	+	0	0	1904	0.0000000
zheyou73v0_A06	21565485	21567553	BnaA06T0222100ZY	0	+	0	0	2068	0.0000000
zheyou73v0_A06	21567823	21568241	BnaA06T0222200ZY	0	-	0	0	418	0.0000000
zheyou73v0_A06	21568259	21568427	BnaA06T0222300ZY	0	-	0	0	168	0.0000000
zheyou73v0_A06	21568783	21569718	BnaA06T0222400ZY	0	+	0	0	935	0.0000000
zheyou73v0_A06	21580047	21580257	BnaA06T0222500ZY	0	-	0	0	210	0.0000000
zheyou73v0_A06	21581539	21584382	BnaA06T0222600ZY	0	-	0	0	2843	0.0000000
zheyou73v0_A06	21585069	21585885	BnaA06T0222700ZY	0	-	0	0	816	0.0000000
zheyou73v0_A06	21593482	21594762	BnaA06T0222800ZY	0	+	0	0	1280	0.0000000
zheyou73v0_A06	21595249	21595417	BnaA06T0222900ZY	0	-	0	0	168	0.0000000
zheyou73v0_A06	21599847	21600057	BnaA06T0223000ZY	0	-	0	0	210	0.0000000
zheyou73v0_A06	21601338	21602883	BnaA06T0223100ZY	0	-	0	0	1545	0.0000000
zheyou73v0_A06	21603349	21603517	BnaA06T0223200ZY	0	-	0	0	168	0.0000000
zheyou73v0_A06	21604402	21604970	BnaA06T0223300ZY	0	-	0	0	568	0.0000000
zheyou73v0_A06	21665493	21668336	BnaA06T0223400ZY	0	-	0	0	2843	0.0000000
zheyou73v0_A06	21678386	21679930	BnaA06T0223500ZY	0	-	0	0	1544	0.0000000
zheyou73v0_A06	21680920	21681921	BnaA06T0223600ZY	0	+	0	0	1001	0.0000000
zheyou73v0_A06	21682896	21683745	BnaA06T0223700ZY	0	-	0	0	849	0.0000000
zheyou73v0_A06	21683751	21683919	BnaA06T0223800ZY	0	-	0	0	168	0.0000000
zheyou73v0_A06	21684275	21685276	BnaA06T0223900ZY	0	+	0	0	1001	0.0000000
zheyou73v0_A06	21693962	21696142	BnaA06T0224000ZY	0	-	0	0	2180	0.0000000
zheyou73v0_A06	21696498	21705575	BnaA06T0224100ZY	0	+	0	0	9077	0.0000000
zheyou73v0_A06	21727229	21731314	BnaA06T0224200ZY	0	-	0	0	4085	0.0000000
zheyou73v0_A06	21744311	21745856	BnaA06T0224300ZY	0	-	0	0	1545	0.0000000
zheyou73v0_A06	21746322	21746490	BnaA06T0224400ZY	0	-	0	0	168	0.0000000
zheyou73v0_A06	21746846	21747781	BnaA06T0224500ZY	0	+	0	0	935	0.0000000
zheyou73v0_A06	21753561	21754129	BnaA06T0224600ZY	0	+	0	0	568	0.0000000
zheyou73v0_A06	21754835	21755003	BnaA06T0224700ZY	0	-	0	0	168	0.0000000
zheyou73v0_A06	21755359	21756294	BnaA06T0224800ZY	0	+	0	0	935	0.0000000
zheyou73v0_A06	21767646	21767856	BnaA06T0224900ZY	0	-	0	0	210	0.0000000
zheyou73v0_A06	21792481	21792691	BnaA06T0225000ZY	0	-	0	0	210	0.0000000
zheyou73v0_A06	21793973	21796151	BnaA06T0225100ZY	0	-	0	0	2178	0.0000000
zheyou73v0_A06	21796926	21797494	BnaA06T0225200ZY	0	-	0	0	568	0.0000000
zheyou73v0_A06	21818296	21820072	BnaA06T0225300ZY	0	+	0	0	1776	0.0000000
zheyou73v0_A06	21821183	21821393	BnaA06T0225400ZY	0	-	0	0	210	0.0000000
zheyou73v0_A06	21830092	21831303	BnaA06T0225500ZY	0	+	0	0	1211	0.0000000
zheyou73v0_A06	21831737	21833275	BnaA06T0225600ZY	0	-	0	0	1538	0.0000000
zheyou73v0_A06	21833631	21834566	BnaA06T0225700ZY	0	+	0	0	935	0.0000000
zheyou73v0_A06	21839497	21841683	BnaA06T0225800ZY	0	-	0	0	2186	0.0000000
zheyou73v0_A06	21842039	21842777	BnaA06T0225900ZY	0	+	0	0	738	0.0000000
zheyou73v0_A06	22096493	22096661	BnaA06T0226000ZY	0	-	0	0	168	0.0000000
zheyou73v0_A06	22105754	22106493	BnaA06T0226100ZY	0	+	0	0	739	0.0000000
zheyou73v0_A06	22318669	22319002	BnaA06T0226200ZY	0	-	0	0	333	0.0000000
zheyou73v0_A06	22320165	22324081	BnaA06T0226300ZY	0	+	0	0	3916	0.0000000
zheyou73v0_A06	22933710	22934256	BnaA06T0226400ZY	0	+	0	0	546	0.0000000
zheyou73v0_A06	22939304	22939490	BnaA06T0226500ZY	0	-	0	0	186	0.0000000
zheyou73v0_A06	23001717	23002652	BnaA06T0226600ZY	0	-	0	0	935	0.0000000
zheyou73v0_A06	23003008	23005187	BnaA06T0226700ZY	0	+	0	0	2179	0.0000000
zheyou73v0_A06	24431568	24432276	BnaA06T0226800ZY	0	-	0	0	708	0.0000000
zheyou73v0_A06	24432632	24432800	BnaA06T0226900ZY	0	+	0	0	168	0.0000000
zheyou73v0_A06	24433214	24434191	BnaA06T0227000ZY	0	+	0	0	977	0.0000000
zheyou73v0_A06	24527299	24528234	BnaA06T0227100ZY	0	-	0	0	935	0.0000000
zheyou73v0_A06	24528358	24537660	BnaA06T0227200ZY	0	+	0	0	9302	0.0000000
zheyou73v0_A06	24538942	24539152	BnaA06T0227300ZY	0	+	0	0	210	0.0000000
zheyou73v0_A06	24564619	24565553	BnaA06T0227400ZY	0	-	0	0	934	0.0000000
zheyou73v0_A06	24565909	24568087	BnaA06T0227500ZY	0	+	0	0	2178	0.0000000
zheyou73v0_A06	24573194	24574129	BnaA06T0227600ZY	0	-	0	0	935	0.0000000
zheyou73v0_A06	24574485	24576077	BnaA06T0227700ZY	0	+	0	0	1592	0.0000000
zheyou73v0_A06	24584056	24585290	BnaA06T0227800ZY	0	-	0	0	1234	0.0000000
zheyou73v0_A06	24587427	24587640	BnaA06T0227900ZY	0	-	0	0	213	0.0000000
zheyou73v0_A06	24603525	24604250	BnaA06T0228000ZY	0	-	0	0	725	0.0000000
zheyou73v0_A06	24606034	24607231	BnaA06T0228100ZY	0	-	0	0	1197	0.0000000
zheyou73v0_A06	24753240	24755419	BnaA06T0228200ZY	0	+	0	0	2179	0.0000000
zheyou73v0_A06	24760266	24769701	BnaA06T0228300ZY	0	+	0	0	9435	0.0000000
zheyou73v0_A06	24778465	24780246	BnaA06T0228400ZY	0	-	0	0	1781	0.0000000
zheyou73v0_A06	24787336	24790164	BnaA06T0228500ZY	0	+	0	0	2828	0.0000000
zheyou73v0_A06	24795321	24796256	BnaA06T0228600ZY	0	-	0	0	935	0.0000000
zheyou73v0_A06	24798070	24798238	BnaA06T0228700ZY	0	+	0	0	168	0.0000000
zheyou73v0_A06	24798704	24799838	BnaA06T0228800ZY	0	+	0	0	1134	0.0000000
zheyou73v0_A06	24800063	24801274	BnaA06T0228900ZY	0	-	0	0	1211	0.0000000
zheyou73v0_A06	24805414	24806349	BnaA06T0229000ZY	0	-	0	0	935	0.0000000
zheyou73v0_A06	24806705	24806873	BnaA06T0229100ZY	0	+	0	0	168	0.0000000
zheyou73v0_A06	24807339	24808473	BnaA06T0229200ZY	0	+	0	0	1134	0.0000000
zheyou73v0_A06	24808698	24809909	BnaA06T0229300ZY	0	-	0	0	1211	0.0000000
zheyou73v0_A06	24816707	24817918	BnaA06T0229400ZY	0	-	0	0	1211	0.0000000
zheyou73v0_A06	24822070	24823005	BnaA06T0229500ZY	0	-	0	0	935	0.0000000
zheyou73v0_A06	24824235	24828177	BnaA06T0229600ZY	0	-	0	0	3942	0.0000000
zheyou73v0_A06	24829380	24830391	BnaA06T0229700ZY	0	+	0	0	1011	0.0000000
zheyou73v0_A06	24831350	24835085	BnaA06T0229800ZY	0	+	0	0	3735	0.0000000
zheyou73v0_A06	24854315	24854781	BnaA06T0229900ZY	0	-	0	0	466	0.0000000
zheyou73v0_A06	24854935	24856052	BnaA06T0230000ZY	0	-	0	0	1117	0.0000000
zheyou73v0_A06	24888899	24889572	BnaA06T0230100ZY	0	-	0	0	673	0.0000000
zheyou73v0_A06	24889928	24890096	BnaA06T0230200ZY	0	+	0	0	168	0.0000000
zheyou73v0_A06	24890563	24891429	BnaA06T0230300ZY	0	+	0	0	866	0.0000000
zheyou73v0_A06	24891922	24893133	BnaA06T0230400ZY	0	-	0	0	1211	0.0000000
zheyou73v0_A06	24899354	24901661	BnaA06T0230500ZY	0	-	0	0	2307	0.0000000
zheyou73v0_A06	24914813	24915146	BnaA06T0230600ZY	0	+	0	0	333	0.0000000
zheyou73v0_A06	24919076	24919409	BnaA06T0230700ZY	0	+	0	0	333	0.0000000
zheyou73v0_A06	24919986	24920885	BnaA06T0230800ZY	0	-	0	0	899	0.0000000
zheyou73v0_A06	24921241	24921409	BnaA06T0230900ZY	0	+	0	0	168	0.0000000
zheyou73v0_A06	24921415	24923009	BnaA06T0231000ZY	0	+	0	0	1594	0.0000000
zheyou73v0_A06	24923234	24924445	BnaA06T0231100ZY	0	-	0	0	1211	0.0000000
zheyou73v0_A06	24931480	24932720	BnaA06T0231200ZY	0	-	0	0	1240	0.0000000
zheyou73v0_A06	24963984	24964374	BnaA06T0231300ZY	0	-	0	0	390	0.0000000
zheyou73v0_A06	24969606	24969890	BnaA06T0231400ZY	0	-	0	0	284	0.0000000
zheyou73v0_A06	25131471	25131794	BnaA06T0231500ZY	0	+	0	0	323	0.0000000
zheyou73v0_A06	25132112	25132545	BnaA06T0231600ZY	0	+	0	0	433	0.0000000
zheyou73v0_A06	25430853	25431375	BnaA06T0231700ZY	0	+	0	0	522	0.0000000
zheyou73v0_A06	25432167	25434396	BnaA06T0231800ZY	0	-	0	0	2229	0.0000000
zheyou73v0_A06	25435717	25436407	BnaA06T0231900ZY	0	+	0	0	690	0.0000000
zheyou73v0_A06	26083700	26083970	BnaA06T0232000ZY	0	+	0	0	270	0.0000000
zheyou73v0_A06	26084825	26085086	BnaA06T0232100ZY	0	-	0	0	261	0.0000000
zheyou73v0_A06	26227836	26228284	BnaA06T0232200ZY	0	+	0	0	448	0.0000000
zheyou73v0_A06	26232946	26235188	BnaA06T0232300ZY	0	-	0	0	2242	0.0000000
zheyou73v0_A06	26236510	26237200	BnaA06T0232400ZY	0	+	0	0	690	0.0000000
zheyou73v0_A06	26254094	26256269	BnaA06T0232500ZY	0	+	0	0	2175	0.0000000
zheyou73v0_A06	26472504	26473041	BnaA06T0232600ZY	0	+	0	0	537	0.0000000
zheyou73v0_A06	26687533	26688373	BnaA06T0232700ZY	0	+	0	0	840	0.0000000
zheyou73v0_A06	26688527	26688897	BnaA06T0232800ZY	0	+	0	0	370	0.0000000
zheyou73v0_A06	27299933	27300489	BnaA06T0232900ZY	0	+	0	0	556	0.0000000
zheyou73v0_A06	27309696	27310503	BnaA06T0233000ZY	0	+	0	0	807	0.0000000
zheyou73v0_A06	27357720	27372939	BnaA06T0233100ZY	0	-	0	0	15219	0.0000000
zheyou73v0_A06	27416308	27416740	BnaA06T0233200ZY	0	-	0	0	432	0.0000000
zheyou73v0_A06	27440712	27441647	BnaA06T0233300ZY	0	-	0	0	935	0.0000000
zheyou73v0_A06	27442003	27442171	BnaA06T0233400ZY	0	+	0	0	168	0.0000000
zheyou73v0_A06	27442637	27443771	BnaA06T0233500ZY	0	+	0	0	1134	0.0000000
zheyou73v0_A06	27443996	27445207	BnaA06T0233600ZY	0	-	0	0	1211	0.0000000
zheyou73v0_A06	27451548	27453616	BnaA06T0233700ZY	0	-	0	0	2068	0.0000000
zheyou73v0_A06	27458233	27459168	BnaA06T0233800ZY	0	-	0	0	935	0.0000000
zheyou73v0_A06	27459524	27459692	BnaA06T0233900ZY	0	+	0	0	168	0.0000000
zheyou73v0_A06	27459973	27467728	BnaA06T0234000ZY	0	+	0	0	7755	0.0000000
zheyou73v0_A06	27467953	27469164	BnaA06T0234100ZY	0	-	0	0	1211	0.0000000
zheyou73v0_A06	27473519	27474454	BnaA06T0234200ZY	0	-	0	0	935	0.0000000
zheyou73v0_A06	27474810	27474978	BnaA06T0234300ZY	0	+	0	0	168	0.0000000
zheyou73v0_A06	27475444	27476989	BnaA06T0234400ZY	0	+	0	0	1545	0.0000000
zheyou73v0_A06	27479208	27479376	BnaA06T0234500ZY	0	-	0	0	168	0.0000000
zheyou73v0_A06	27479732	27480667	BnaA06T0234600ZY	0	+	0	0	935	0.0000000
zheyou73v0_A06	27509657	27512500	BnaA06T0234700ZY	0	-	0	0	2843	0.0000000
zheyou73v0_A06	27512753	27513122	BnaA06T0234800ZY	0	-	0	0	369	0.0000000
zheyou73v0_A06	27636767	27637987	BnaA06T0234900ZY	0	+	0	0	1220	0.0000000
zheyou73v0_A06	27638340	27638544	BnaA06T0235000ZY	0	+	0	0	204	0.0000000
zheyou73v0_A06	27735801	27737976	BnaA06T0235100ZY	0	-	0	0	2175	0.0000000
zheyou73v0_A06	27753351	27754632	BnaA06T0235200ZY	0	+	0	0	1281	0.0000000
zheyou73v0_A06	28275631	28275793	BnaA06T0235300ZY	0	-	0	0	162	0.0000000
zheyou73v0_A06	28276571	28276944	BnaA06T0235400ZY	0	-	0	0	373	0.0000000
zheyou73v0_A06	28298627	28299688	BnaA06T0235500ZY	0	+	0	0	1061	0.0000000
zheyou73v0_A06	28418099	28419101	BnaA06T0235600ZY	0	-	0	0	1002	0.0000000
zheyou73v0_A06	28422573	28423374	BnaA06T0235700ZY	0	-	0	0	801	0.0000000
zheyou73v0_A06	28429587	28430032	BnaA06T0235800ZY	0	-	0	0	445	0.0000000
zheyou73v0_A06	28430101	28430289	BnaA06T0235900ZY	0	-	0	0	188	0.0000000
zheyou73v0_A06	28722196	28723233	BnaA06T0236000ZY	0	-	0	0	1037	0.0000000
zheyou73v0_A06	28726734	28727389	BnaA06T0236100ZY	0	-	0	0	655	0.0000000
zheyou73v0_A06	28728967	28729582	BnaA06T0236200ZY	0	+	0	0	615	0.0000000
zheyou73v0_A06	28996213	28997939	BnaA06T0236300ZY	0	-	0	0	1726	0.0000000
zheyou73v0_A06	29026410	29026880	BnaA06T0236400ZY	0	+	0	0	470	0.0000000
zheyou73v0_A06	29034995	29035930	BnaA06T0236500ZY	0	+	0	0	935	0.0000000
zheyou73v0_A06	29558337	29558541	BnaA06T0236600ZY	0	-	0	0	204	0.0000000
zheyou73v0_A06	29724741	29725079	BnaA06T0236700ZY	0	-	0	0	338	0.0000000
zheyou73v0_A06	29751634	29753746	BnaA06T0236800ZY	0	+	0	0	2112	0.0000000
zheyou73v0_A06	29777849	29779396	BnaA06T0236900ZY	0	-	0	0	1547	0.0000000
zheyou73v0_A06	29786563	29788108	BnaA06T0237000ZY	0	-	0	0	1545	0.0000000
zheyou73v0_A06	29788574	29788742	BnaA06T0237100ZY	0	-	0	0	168	0.0000000
zheyou73v0_A06	29789098	29790033	BnaA06T0237200ZY	0	+	0	0	935	0.0000000
zheyou73v0_A06	29795071	29796616	BnaA06T0237300ZY	0	-	0	0	1545	0.0000000
zheyou73v0_A06	29797082	29797250	BnaA06T0237400ZY	0	-	0	0	168	0.0000000
zheyou73v0_A06	29797606	29798541	BnaA06T0237500ZY	0	+	0	0	935	0.0000000
zheyou73v0_A06	29804234	29805779	BnaA06T0237600ZY	0	-	0	0	1545	0.0000000
zheyou73v0_A06	29806245	29806413	BnaA06T0237700ZY	0	-	0	0	168	0.0000000
zheyou73v0_A06	29806769	29807704	BnaA06T0237800ZY	0	+	0	0	935	0.0000000
zheyou73v0_A06	29829579	29829789	BnaA06T0237900ZY	0	-	0	0	210	0.0000000
zheyou73v0_A06	29830308	29832380	BnaA06T0238000ZY	0	+	0	0	2072	0.0000000
zheyou73v0_A06	29832431	29833255	BnaA06T0238100ZY	0	-	0	0	824	0.0000000
zheyou73v0_A06	29833611	29835043	BnaA06T0238200ZY	0	+	0	0	1432	0.0000000
zheyou73v0_A06	29855958	29857167	BnaA06T0238300ZY	0	+	0	0	1209	0.0000000
zheyou73v0_A06	29857567	29859161	BnaA06T0238400ZY	0	-	0	0	1594	0.0000000
zheyou73v0_A06	29859518	29860453	BnaA06T0238500ZY	0	+	0	0	935	0.0000000
zheyou73v0_A06	29882675	29884184	BnaA06T0238600ZY	0	-	0	0	1509	0.0000000
zheyou73v0_A06	29884650	29884818	BnaA06T0238700ZY	0	-	0	0	168	0.0000000
zheyou73v0_A06	29885174	29886109	BnaA06T0238800ZY	0	+	0	0	935	0.0000000
zheyou73v0_A06	29889628	29890839	BnaA06T0238900ZY	0	+	0	0	1211	0.0000000
zheyou73v0_A06	29891064	29892830	BnaA06T0239000ZY	0	-	0	0	1766	0.0000000
zheyou73v0_A06	29893186	29894121	BnaA06T0239100ZY	0	+	0	0	935	0.0000000
zheyou73v0_A06	29906242	29908399	BnaA06T0239200ZY	0	-	0	0	2157	0.0000000
zheyou73v0_A06	29908755	29909690	BnaA06T0239300ZY	0	+	0	0	935	0.0000000
zheyou73v0_A06	29909974	29910184	BnaA06T0239400ZY	0	+	0	0	210	0.0000000
zheyou73v0_A06	29920851	29921786	BnaA06T0239500ZY	0	-	0	0	935	0.0000000
zheyou73v0_A06	29921877	29923910	BnaA06T0239600ZY	0	+	0	0	2033	0.0000000
zheyou73v0_A06	29924135	29925346	BnaA06T0239700ZY	0	-	0	0	1211	0.0000000
zheyou73v0_A06	29925603	29925813	BnaA06T0239800ZY	0	+	0	0	210	0.0000000
zheyou73v0_A06	29942116	29943357	BnaA06T0239900ZY	0	-	0	0	1241	0.0000000
zheyou73v0_A06	29946462	29948668	BnaA06T0240000ZY	0	+	0	0	2206	0.0000000
zheyou73v0_A06	29965841	29966009	BnaA06T0240100ZY	0	+	0	0	168	0.0000000
zheyou73v0_A06	29966490	29966835	BnaA06T0240200ZY	0	+	0	0	345	0.0000000
zheyou73v0_A06	29988596	29989093	BnaA06T0240300ZY	0	+	0	0	497	0.0000000
zheyou73v0_A06	30223339	30224304	BnaA06T0240400ZY	0	-	0	0	965	0.0000000
zheyou73v0_A06	30253930	30256773	BnaA06T0240500ZY	0	+	0	0	2843	0.0000000
zheyou73v0_A06	30266923	30267133	BnaA06T0240600ZY	0	+	0	0	210	0.0000000
zheyou73v0_A06	30288717	30289652	BnaA06T0240700ZY	0	-	0	0	935	0.0000000
zheyou73v0_A06	30290008	30290176	BnaA06T0240800ZY	0	+	0	0	168	0.0000000
zheyou73v0_A06	30290489	30291776	BnaA06T0240900ZY	0	+	0	0	1287	0.0000000
zheyou73v0_A06	30292001	30293206	BnaA06T0241000ZY	0	-	0	0	1205	0.0000000
zheyou73v0_A06	30297400	30298335	BnaA06T0241100ZY	0	-	0	0	935	0.0000000
zheyou73v0_A06	30298383	30300865	BnaA06T0241200ZY	0	+	0	0	2482	0.0000000
zheyou73v0_A06	30302136	30302346	BnaA06T0241300ZY	0	+	0	0	210	0.0000000
zheyou73v0_A06	30306015	30306950	BnaA06T0241400ZY	0	-	0	0	935	0.0000000
zheyou73v0_A06	30307306	30307474	BnaA06T0241500ZY	0	+	0	0	168	0.0000000
zheyou73v0_A06	30309500	30314100	BnaA06T0241600ZY	0	+	0	0	4600	0.0000000
zheyou73v0_A06	30314500	30315711	BnaA06T0241700ZY	0	-	0	0	1211	0.0000000
zheyou73v0_A06	30323168	30323974	BnaA06T0241800ZY	0	+	0	0	806	0.0000000
zheyou73v0_A06	30327577	30328383	BnaA06T0241900ZY	0	+	0	0	806	0.0000000
zheyou73v0_A06	30332350	30332560	BnaA06T0242000ZY	0	-	0	0	210	0.0000000
zheyou73v0_A06	30361253	30361421	BnaA06T0242100ZY	0	-	0	0	168	0.0000000
zheyou73v0_A06	30361777	30362712	BnaA06T0242200ZY	0	+	0	0	935	0.0000000
zheyou73v0_A06	30364098	30364266	BnaA06T0242300ZY	0	-	0	0	168	0.0000000
zheyou73v0_A06	30364622	30365557	BnaA06T0242400ZY	0	+	0	0	935	0.0000000
zheyou73v0_A06	30366943	30367111	BnaA06T0242500ZY	0	-	0	0	168	0.0000000
zheyou73v0_A06	30367467	30368402	BnaA06T0242600ZY	0	+	0	0	935	0.0000000
zheyou73v0_A06	30382435	30385177	BnaA06T0242700ZY	0	-	0	0	2742	0.0000000
zheyou73v0_A06	30395655	30395865	BnaA06T0242800ZY	0	-	0	0	210	0.0000000
zheyou73v0_A06	30410862	30412407	BnaA06T0242900ZY	0	-	0	0	1545	0.0000000
zheyou73v0_A06	30412873	30413041	BnaA06T0243000ZY	0	-	0	0	168	0.0000000
zheyou73v0_A06	30413154	30414090	BnaA06T0243100ZY	0	+	0	0	936	0.0000000
zheyou73v0_A06	30417633	30419108	BnaA06T0243200ZY	0	-	0	0	1475	0.0000000
zheyou73v0_A06	30419464	30420399	BnaA06T0243300ZY	0	+	0	0	935	0.0000000
zheyou73v0_A06	30429082	30431260	BnaA06T0243400ZY	0	-	0	0	2178	0.0000000
zheyou73v0_A06	30431616	30441474	BnaA06T0243500ZY	0	+	0	0	9858	0.0000000
zheyou73v0_A06	30445636	30447181	BnaA06T0243600ZY	0	-	0	0	1545	0.0000000
zheyou73v0_A06	30454122	30454290	BnaA06T0243700ZY	0	-	0	0	168	0.0000000
zheyou73v0_A06	30454646	30455581	BnaA06T0243800ZY	0	+	0	0	935	0.0000000
zheyou73v0_A06	30475191	30477635	BnaA06T0243900ZY	0	-	0	0	2444	0.0000000
zheyou73v0_A06	30477726	30478661	BnaA06T0244000ZY	0	+	0	0	935	0.0000000
zheyou73v0_A06	30487490	30488535	BnaA06T0244100ZY	0	+	0	0	1045	0.0000000
zheyou73v0_A06	30488974	30489178	BnaA06T0244200ZY	0	+	0	0	204	0.0000000
zheyou73v0_A06	30490485	30491183	BnaA06T0244300ZY	0	-	0	0	698	0.0000000
zheyou73v0_A06	30491569	30492335	BnaA06T0244400ZY	0	-	0	0	766	0.0000000
zheyou73v0_A06	30618217	30618412	BnaA06T0244500ZY	0	+	0	0	195	0.0000000
zheyou73v0_A06	30619428	30633552	BnaA06T0244600ZY	0	+	0	0	14124	0.0000000
zheyou73v0_A06	30633894	30635266	BnaA06T0244700ZY	0	-	0	0	1372	0.0000000
zheyou73v0_A06	30676011	30676179	BnaA06T0244800ZY	0	+	0	0	168	0.0000000
zheyou73v0_A06	30677959	30678872	BnaA06T0244900ZY	0	-	0	0	913	0.0000000
zheyou73v0_A06	30988422	30988745	BnaA06T0245000ZY	0	+	0	0	323	0.0000000
zheyou73v0_A06	30989054	30989487	BnaA06T0245100ZY	0	+	0	0	433	0.0000000
zheyou73v0_A06	31172134	31172578	BnaA06T0245200ZY	0	-	0	0	444	0.0000000
zheyou73v0_A06	31291457	31291661	BnaA06T0245300ZY	0	+	0	0	204	0.0000000
zheyou73v0_A06	31893200	31894391	BnaA06T0245400ZY	0	+	0	0	1191	0.0000000
zheyou73v0_A06	31981226	31982161	BnaA06T0245500ZY	0	-	0	0	935	0.0000000
zheyou73v0_A06	31982517	31982685	BnaA06T0245600ZY	0	+	0	0	168	0.0000000
zheyou73v0_A06	31983151	31984285	BnaA06T0245700ZY	0	+	0	0	1134	0.0000000
zheyou73v0_A06	31984510	31985721	BnaA06T0245800ZY	0	-	0	0	1211	0.0000000
zheyou73v0_A06	31990017	31990952	BnaA06T0245900ZY	0	-	0	0	935	0.0000000
zheyou73v0_A06	31991309	31991477	BnaA06T0246000ZY	0	+	0	0	168	0.0000000
zheyou73v0_A06	32058311	32059522	BnaA06T0246100ZY	0	-	0	0	1211	0.0000000
zheyou73v0_A06	32063083	32072155	BnaA06T0246200ZY	0	-	0	0	9072	0.0000000
zheyou73v0_A06	32072511	32072679	BnaA06T0246300ZY	0	+	0	0	168	0.0000000
zheyou73v0_A06	32074662	32075715	BnaA06T0246400ZY	0	-	0	0	1053	0.0000000
zheyou73v0_A06	32079361	32080296	BnaA06T0246500ZY	0	-	0	0	935	0.0000000
zheyou73v0_A06	32080651	32080819	BnaA06T0246600ZY	0	+	0	0	168	0.0000000
zheyou73v0_A06	32081525	32082490	BnaA06T0246700ZY	0	-	0	0	965	0.0000000
zheyou73v0_A06	32082644	32083855	BnaA06T0246800ZY	0	-	0	0	1211	0.0000000
zheyou73v0_A06	32094475	32095410	BnaA06T0246900ZY	0	-	0	0	935	0.0000000
zheyou73v0_A06	32096400	32097945	BnaA06T0247000ZY	0	+	0	0	1545	0.0000000
zheyou73v0_A06	32099227	32099437	BnaA06T0247100ZY	0	+	0	0	210	0.0000000
zheyou73v0_A06	32103125	32104060	BnaA06T0247200ZY	0	-	0	0	935	0.0000000
zheyou73v0_A06	32104416	32113727	BnaA06T0247300ZY	0	+	0	0	9311	0.0000000
zheyou73v0_A06	32113952	32114902	BnaA06T0247400ZY	0	-	0	0	950	0.0000000
zheyou73v0_A06	32119423	32120358	BnaA06T0247500ZY	0	-	0	0	935	0.0000000
zheyou73v0_A06	32120714	32120882	BnaA06T0247600ZY	0	+	0	0	168	0.0000000
zheyou73v0_A06	32121348	32122482	BnaA06T0247700ZY	0	+	0	0	1134	0.0000000
zheyou73v0_A06	32122707	32123918	BnaA06T0247800ZY	0	-	0	0	1211	0.0000000
zheyou73v0_A06	32128139	32129074	BnaA06T0247900ZY	0	-	0	0	935	0.0000000
zheyou73v0_A06	32129430	32129598	BnaA06T0248000ZY	0	+	0	0	168	0.0000000
zheyou73v0_A06	32146768	32147979	BnaA06T0248100ZY	0	-	0	0	1211	0.0000000
zheyou73v0_A06	32148236	32148446	BnaA06T0248200ZY	0	+	0	0	210	0.0000000
zheyou73v0_A06	32158582	32159517	BnaA06T0248300ZY	0	-	0	0	935	0.0000000
zheyou73v0_A06	32159873	32160041	BnaA06T0248400ZY	0	+	0	0	168	0.0000000
zheyou73v0_A06	32160720	32161685	BnaA06T0248500ZY	0	-	0	0	965	0.0000000
zheyou73v0_A06	32170058	32171020	BnaA06T0248600ZY	0	+	0	0	962	0.0000000
zheyou73v0_A06	32171420	32172631	BnaA06T0248700ZY	0	-	0	0	1211	0.0000000
zheyou73v0_A06	32183371	32184306	BnaA06T0248800ZY	0	-	0	0	935	0.0000000
zheyou73v0_A06	32184662	32184830	BnaA06T0248900ZY	0	+	0	0	168	0.0000000
zheyou73v0_A06	32185296	32186430	BnaA06T0249000ZY	0	+	0	0	1134	0.0000000
zheyou73v0_A06	32186655	32187866	BnaA06T0249100ZY	0	-	0	0	1211	0.0000000
zheyou73v0_A06	32192112	32193047	BnaA06T0249200ZY	0	-	0	0	935	0.0000000
zheyou73v0_A06	32193403	32193571	BnaA06T0249300ZY	0	+	0	0	168	0.0000000
zheyou73v0_A06	32207403	32208201	BnaA06T0249400ZY	0	+	0	0	798	0.0000000
zheyou73v0_A06	32226554	32226764	BnaA06T0249500ZY	0	+	0	0	210	0.0000000
zheyou73v0_A06	32228481	32228703	BnaA06T0249600ZY	0	+	0	0	222	0.0000000
zheyou73v0_A06	32230773	32231386	BnaA06T0249700ZY	0	+	0	0	613	0.0000000
zheyou73v0_A06	32233455	32234457	BnaA06T0249800ZY	0	-	0	0	1002	0.0000000
zheyou73v0_A06	32238195	32238953	BnaA06T0249900ZY	0	+	0	0	758	0.0000000
zheyou73v0_A06	32251682	32256286	BnaA06T0250000ZY	0	+	0	0	4604	0.0000000
zheyou73v0_A06	32251682	32256286	BnaA06T0250000ZY.1	0	+	0	0	4604	0.0000000
zheyou73v0_A06	32251682	32256286	BnaA06T0250000ZY.2	0	+	0	0	4604	0.0000000
zheyou73v0_A06	32269099	32271911	BnaA06T0250100ZY	0	+	0	0	2812	0.0000000
zheyou73v0_A06	32273460	32283319	BnaA06T0250200ZY	0	-	0	0	9859	0.0000000
zheyou73v0_A06	32285952	32287163	BnaA06T0250300ZY	0	+	0	0	1211	0.0000000
zheyou73v0_A06	32287200	32292020	BnaA06T0250400ZY	0	-	0	0	4820	0.0000000
zheyou73v0_A06	32292556	32293791	BnaA06T0250500ZY	0	+	0	0	1235	0.0000000
zheyou73v0_A06	32294187	32295569	BnaA06T0250600ZY	0	+	0	0	1382	0.0000000
zheyou73v0_A06	32312712	32319244	BnaA06T0250700ZY	0	-	0	0	6532	0.0000000
zheyou73v0_A06	32323082	32325654	BnaA06T0250800ZY	0	+	0	0	2572	0.0000000
zheyou73v0_A06	32354614	32357455	BnaA06T0250900ZY	0	-	0	0	2841	0.0000000
zheyou73v0_A06	32361925	32368086	BnaA06T0251000ZY	0	+	0	0	6161	0.0000000
zheyou73v0_A06	32361925	32368086	BnaA06T0251000ZY.1	0	+	0	0	6161	0.0000000
zheyou73v0_A06	32375520	32378247	BnaA06T0251100ZY	0	-	0	0	2727	0.0000000
zheyou73v0_A06	32375520	32378247	BnaA06T0251100ZY.1	0	-	0	0	2727	0.0000000
zheyou73v0_A06	32390300	32399854	BnaA06T0251200ZY	0	+	0	0	9554	0.0000000
zheyou73v0_A06	32415023	32415351	BnaA06T0251300ZY	0	+	0	0	328	0.0000000
zheyou73v0_A06	32416949	32419358	BnaA06T0251400ZY	0	+	0	0	2409	0.0000000
zheyou73v0_A06	32434699	32441471	BnaA06T0251500ZY.1	0	+	0	0	6772	0.0000000
zheyou73v0_A06	32434699	32441471	BnaA06T0251500ZY.2	0	+	0	0	6772	0.0000000
zheyou73v0_A06	32434877	32441471	BnaA06T0251500ZY	0	+	0	0	6594	0.0000000
zheyou73v0_A06	32434877	32441471	BnaA06T0251500ZY.3	0	+	0	0	6594	0.0000000
zheyou73v0_A06	32444598	32448353	BnaA06T0251600ZY	0	+	0	0	3755	0.0000000
zheyou73v0_A06	32478657	32482232	BnaA06T0251700ZY	0	+	0	0	3575	0.0000000
zheyou73v0_A06	32485169	32486771	BnaA06T0251800ZY	0	-	0	0	1602	0.0000000
zheyou73v0_A06	32519817	32527055	BnaA06T0251900ZY	0	+	0	0	7238	0.0000000
zheyou73v0_A06	32528933	32531545	BnaA06T0252000ZY	0	-	0	0	2612	0.0000000
zheyou73v0_A06	32541613	32544889	BnaA06T0252100ZY	0	-	0	0	3276	0.0000000
zheyou73v0_A06	32612722	32613379	BnaA06T0252200ZY	0	+	0	0	657	0.0000000
zheyou73v0_A06	32628808	32630750	BnaA06T0252300ZY	0	-	0	0	1942	0.0000000
zheyou73v0_A06	32631674	32631983	BnaA06T0252400ZY	0	-	0	0	309	0.0000000
zheyou73v0_A06	32632021	32632258	BnaA06T0252500ZY	0	-	0	0	237	0.0000000
zheyou73v0_A06	32633693	32635832	BnaA06T0252600ZY	0	-	0	0	2139	0.0000000
zheyou73v0_A06	32655844	32657065	BnaA06T0252700ZY	0	+	0	0	1221	0.0000000
zheyou73v0_A06	32687447	32695989	BnaA06T0252800ZY	0	+	0	0	8542	0.0000000
zheyou73v0_A06	32698791	32700338	BnaA06T0252900ZY	0	+	0	0	1547	0.0000000
zheyou73v0_A06	32698791	32700338	BnaA06T0252900ZY.1	0	+	0	0	1547	0.0000000
zheyou73v0_A06	32698791	32700338	BnaA06T0252900ZY.2	0	+	0	0	1547	0.0000000
zheyou73v0_A06	32700741	32701251	BnaA06T0253000ZY	0	-	0	0	510	0.0000000
zheyou73v0_A06	32705771	32706284	BnaA06T0253100ZY	0	-	0	0	513	0.0000000
zheyou73v0_A06	32757723	32759612	BnaA06T0253200ZY	0	+	0	0	1889	0.0000000
zheyou73v0_A06	32767126	32767415	BnaA06T0253300ZY	0	+	0	0	289	0.0000000
zheyou73v0_A06	32774593	32776991	BnaA06T0253400ZY	0	-	0	0	2398	0.0000000
zheyou73v0_A06	32807309	32812277	BnaA06T0253500ZY	0	+	0	0	4968	0.0000000
zheyou73v0_A06	32834957	32837070	BnaA06T0253600ZY	0	+	0	0	2113	0.0000000
zheyou73v0_A06	32852627	32853054	BnaA06T0253700ZY	0	+	0	0	427	0.0000000
zheyou73v0_A06	32858356	32859868	BnaA06T0253800ZY	0	-	0	0	1512	0.0000000
zheyou73v0_A06	32881479	32884282	BnaA06T0253900ZY	0	-	0	0	2803	0.0000000
zheyou73v0_A06	32898573	32899099	BnaA06T0254000ZY	0	-	0	0	526	0.0000000
zheyou73v0_A06	32899547	32902637	BnaA06T0254100ZY	0	-	0	0	3090	0.0000000
zheyou73v0_A06	32903523	32905299	BnaA06T0254200ZY	0	-	0	0	1776	0.0000000
zheyou73v0_A06	32926672	32927160	BnaA06T0254300ZY	0	-	0	0	488	0.0000000
zheyou73v0_A06	32937415	32939315	BnaA06T0254400ZY	0	-	0	0	1900	0.0000000
zheyou73v0_A06	32983451	32984224	BnaA06T0254500ZY	0	-	0	0	773	0.0000000
zheyou73v0_A06	32996976	32997757	BnaA06T0254600ZY	0	-	0	0	781	0.0000000
zheyou73v0_A06	33020640	33023397	BnaA06T0254700ZY	0	-	0	0	2757	0.0000000
zheyou73v0_A06	33052624	33053169	BnaA06T0254800ZY	0	-	0	0	545	0.0000000
zheyou73v0_A06	33076399	33080354	BnaA06T0254900ZY	0	+	0	0	3955	0.0000000
zheyou73v0_A06	33106782	33107478	BnaA06T0255000ZY	0	-	0	0	696	0.0000000
zheyou73v0_A06	33124169	33124593	BnaA06T0255100ZY	0	+	0	0	424	0.0000000
zheyou73v0_A06	33124672	33126811	BnaA06T0255200ZY	0	-	0	0	2139	0.0000000
zheyou73v0_A06	33133710	33134103	BnaA06T0255300ZY	0	+	0	0	393	0.0000000
zheyou73v0_A06	33136017	33138378	BnaA06T0255400ZY	0	+	0	0	2361	0.0000000
zheyou73v0_A06	33142446	33143746	BnaA06T0255500ZY	0	+	0	0	1300	0.0000000
zheyou73v0_A06	33143932	33144580	BnaA06T0255600ZY	0	+	0	0	648	0.0000000
zheyou73v0_A06	33152918	33156511	BnaA06T0255700ZY	0	+	0	0	3593	0.0000000
zheyou73v0_A06	33158570	33159180	BnaA06T0255800ZY	0	+	0	0	610	0.0000000
zheyou73v0_A06	33160522	33165003	BnaA06T0255900ZY	0	+	0	0	4481	0.0000000
zheyou73v0_A06	33165178	33166440	BnaA06T0256000ZY	0	-	0	0	1262	0.0000000
zheyou73v0_A06	33170331	33172759	BnaA06T0256100ZY	0	-	0	0	2428	0.0000000
zheyou73v0_A06	33175990	33179063	BnaA06T0256200ZY	0	-	0	0	3073	0.0000000
zheyou73v0_A06	33182127	33183913	BnaA06T0256300ZY	0	-	0	0	1786	0.0000000
zheyou73v0_A06	33200444	33201801	BnaA06T0256400ZY	0	+	0	0	1357	0.0000000
zheyou73v0_A06	33206015	33207744	BnaA06T0256500ZY	0	-	0	0	1729	0.0000000
zheyou73v0_A06	33206015	33207744	BnaA06T0256500ZY.1	0	-	0	0	1729	0.0000000
zheyou73v0_A06	33210863	33212162	BnaA06T0256600ZY	0	-	0	0	1299	0.0000000
zheyou73v0_A06	33213922	33215698	BnaA06T0256700ZY	0	-	0	0	1776	0.0000000
zheyou73v0_A06	33218144	33220823	BnaA06T0256800ZY	0	-	0	0	2679	0.0000000
zheyou73v0_A06	33225452	33229110	BnaA06T0256900ZY	0	-	0	0	3658	0.0000000
zheyou73v0_A06	33237788	33239773	BnaA06T0257000ZY	0	-	0	0	1985	0.0000000
zheyou73v0_A06	33265202	33266190	BnaA06T0257100ZY	0	+	0	0	988	0.0000000
zheyou73v0_A06	33275025	33278726	BnaA06T0257200ZY	0	-	0	0	3701	0.0000000
zheyou73v0_A06	33279412	33279959	BnaA06T0257300ZY	0	-	0	0	547	0.0000000
zheyou73v0_A06	33290459	33317054	BnaA06T0257400ZY	0	+	0	0	26595	0.0000000
zheyou73v0_A06	33329103	33329662	BnaA06T0257500ZY	0	+	0	0	559	0.0000000
zheyou73v0_A06	33331486	33332249	BnaA06T0257600ZY	0	-	0	0	763	0.0000000
zheyou73v0_A06	33342597	33343167	BnaA06T0257700ZY	0	+	0	0	570	0.0000000
zheyou73v0_A06	33360572	33362130	BnaA06T0257800ZY	0	+	0	0	1558	0.0000000
zheyou73v0_A06	33365991	33369611	BnaA06T0257900ZY	0	+	0	0	3620	0.0000000
zheyou73v0_A06	33380696	33381541	BnaA06T0258000ZY	0	+	0	0	845	0.0000000
zheyou73v0_A06	33402029	33403841	BnaA06T0258100ZY	0	-	0	0	1812	0.0000000
zheyou73v0_A06	33409216	33411664	BnaA06T0258200ZY	0	-	0	0	2448	0.0000000
zheyou73v0_A06	33419542	33421320	BnaA06T0258300ZY	0	+	0	0	1778	0.0000000
zheyou73v0_A06	33423176	33424481	BnaA06T0258400ZY	0	-	0	0	1305	0.0000000
zheyou73v0_A06	33423176	33424508	BnaA06T0258400ZY.1	0	-	0	0	1332	0.0000000
zheyou73v0_A06	33425008	33427231	BnaA06T0258500ZY	0	+	0	0	2223	0.0000000
zheyou73v0_A06	33427263	33427506	BnaA06T0258600ZY	0	+	0	0	243	0.0000000
zheyou73v0_A06	33427599	33430535	BnaA06T0258700ZY	0	-	0	0	2936	0.0000000
zheyou73v0_A06	33465909	33468716	BnaA06T0258800ZY	0	+	0	0	2807	0.0000000
zheyou73v0_A06	33475056	33477186	BnaA06T0258900ZY	0	-	0	0	2130	0.0000000
zheyou73v0_A06	33482327	33484008	BnaA06T0259000ZY	0	+	0	0	1681	0.0000000
zheyou73v0_A06	33482327	33484008	BnaA06T0259000ZY.1	0	+	0	0	1681	0.0000000
zheyou73v0_A06	33493896	33498408	BnaA06T0259100ZY	0	+	0	0	4512	0.0000000
zheyou73v0_A06	33498926	33500430	BnaA06T0259200ZY	0	-	0	0	1504	0.0000000
zheyou73v0_A06	33504246	33505939	BnaA06T0259300ZY	0	+	0	0	1693	0.0000000
zheyou73v0_A06	33518525	33519302	BnaA06T0259400ZY	0	-	0	0	777	0.0000000
zheyou73v0_A06	33524543	33528333	BnaA06T0259500ZY	0	-	0	0	3790	0.0000000
zheyou73v0_A06	33524543	33528333	BnaA06T0259500ZY.1	0	-	0	0	3790	0.0000000
zheyou73v0_A06	33524543	33528333	BnaA06T0259500ZY.2	0	-	0	0	3790	0.0000000
zheyou73v0_A06	33534345	33535854	BnaA06T0259600ZY	0	-	0	0	1509	0.0000000
zheyou73v0_A06	33542463	33543603	BnaA06T0259700ZY	0	+	0	0	1140	0.0000000
zheyou73v0_A06	33558706	33561771	BnaA06T0259800ZY	0	+	0	0	3065	0.0000000
zheyou73v0_A06	33594252	33594821	BnaA06T0259900ZY	0	-	0	0	569	0.0000000
zheyou73v0_A06	33595637	33600935	BnaA06T0260000ZY	0	+	0	0	5298	0.0000000
zheyou73v0_A06	33604012	33606449	BnaA06T0260100ZY	0	-	0	0	2437	0.0000000
zheyou73v0_A06	33656390	33658451	BnaA06T0260200ZY	0	+	0	0	2061	0.0000000
zheyou73v0_A06	33656390	33658451	BnaA06T0260200ZY.1	0	+	0	0	2061	0.0000000
zheyou73v0_A06	33660297	33660447	BnaA06T0260300ZY	0	-	0	0	150	0.0000000
zheyou73v0_A06	33668975	33669626	BnaA06T0260400ZY	0	-	0	0	651	0.0000000
zheyou73v0_A06	33678215	33678866	BnaA06T0260500ZY	0	-	0	0	651	0.0000000
zheyou73v0_A06	33680497	33681073	BnaA06T0260600ZY	0	+	0	0	576	0.0000000
zheyou73v0_A06	33695844	33696262	BnaA06T0260700ZY	0	+	0	0	418	0.0000000
zheyou73v0_A06	33700944	33703423	BnaA06T0260800ZY	0	+	0	0	2479	0.0000000
zheyou73v0_A06	33706216	33712246	BnaA06T0260900ZY	0	+	0	0	6030	0.0000000
zheyou73v0_A06	33713791	33714079	BnaA06T0261000ZY	0	-	0	0	288	0.0000000
zheyou73v0_A06	33714850	33717753	BnaA06T0261100ZY	0	-	0	0	2903	0.0000000
zheyou73v0_A06	33718685	33721037	BnaA06T0261200ZY	0	-	0	0	2352	0.0000000
zheyou73v0_A06	33718685	33721037	BnaA06T0261200ZY.1	0	-	0	0	2352	0.0000000
zheyou73v0_A06	33724524	33738177	BnaA06T0261300ZY	0	+	0	0	13653	0.0000000
zheyou73v0_A06	33738687	33739884	BnaA06T0261400ZY	0	-	0	0	1197	0.0000000
zheyou73v0_A06	33745824	33748503	BnaA06T0261500ZY	0	+	0	0	2679	0.0000000
zheyou73v0_A06	33749701	33751153	BnaA06T0261600ZY	0	-	0	0	1452	0.0000000
zheyou73v0_A06	33752791	33753529	BnaA06T0261700ZY	0	+	0	0	738	0.0000000
zheyou73v0_A06	33761006	33761467	BnaA06T0261800ZY	0	+	0	0	461	0.0000000
zheyou73v0_A06	33762845	33768253	BnaA06T0261900ZY	0	-	0	0	5408	0.0000000
zheyou73v0_A06	33770789	33771477	BnaA06T0262000ZY	0	-	0	0	688	0.0000000
zheyou73v0_A06	33776874	33778175	BnaA06T0262100ZY	0	+	0	0	1301	0.0000000
zheyou73v0_A06	33777060	33777956	BnaA06T0262100ZY.1	0	+	0	0	896	0.0000000
zheyou73v0_A06	33780841	33781944	BnaA06T0262200ZY	0	+	0	0	1103	0.0000000
zheyou73v0_A06	33797980	33798896	BnaA06T0262300ZY	0	-	0	0	916	0.0000000
zheyou73v0_A06	33799546	33799777	BnaA06T0262400ZY	0	+	0	0	231	0.0000000
zheyou73v0_A06	33839179	33842621	BnaA06T0262500ZY	0	+	0	0	3442	0.0000000
zheyou73v0_A06	33846813	33850909	BnaA06T0262600ZY	0	-	0	0	4096	0.0000000
zheyou73v0_A06	33897450	33901006	BnaA06T0262700ZY	0	+	0	0	3556	0.0000000
zheyou73v0_A06	33914272	33916189	BnaA06T0262800ZY	0	+	0	0	1917	0.0000000
zheyou73v0_A06	33916692	33918618	BnaA06T0262900ZY	0	-	0	0	1926	0.0000000
zheyou73v0_A06	33942541	33946843	BnaA06T0263000ZY	0	+	0	0	4302	0.0000000
zheyou73v0_A06	33954347	33954914	BnaA06T0263100ZY	0	+	0	0	567	0.0000000
zheyou73v0_A06	33958979	33961046	BnaA06T0263200ZY	0	-	0	0	2067	0.0000000
zheyou73v0_A06	33969708	33970079	BnaA06T0263300ZY	0	-	0	0	371	0.0000000
zheyou73v0_A06	33970413	33971059	BnaA06T0263400ZY	0	+	0	0	646	0.0000000
zheyou73v0_A06	33971906	33972730	BnaA06T0263500ZY	0	-	0	0	824	0.0000000
zheyou73v0_A06	33975738	33977166	BnaA06T0263600ZY	0	-	0	0	1428	0.0000000
zheyou73v0_A06	33987415	33990706	BnaA06T0263700ZY	0	-	0	0	3291	0.0000000
zheyou73v0_A06	33987415	33990599	BnaA06T0263700ZY.1	0	-	0	0	3184	0.0000000
zheyou73v0_A06	33994011	33996531	BnaA06T0263800ZY	0	-	0	0	2520	0.0000000
zheyou73v0_A06	34009820	34012101	BnaA06T0263900ZY	0	+	0	0	2281	0.0000000
zheyou73v0_A06	34009820	34012101	BnaA06T0263900ZY.1	0	+	0	0	2281	0.0000000
zheyou73v0_A06	34020784	34023366	BnaA06T0264000ZY	0	+	0	0	2582	0.0000000
zheyou73v0_A06	34024974	34028074	BnaA06T0264100ZY	0	-	0	0	3100	0.0000000
zheyou73v0_A06	34028609	34032057	BnaA06T0264200ZY	0	-	0	0	3448	0.0000000
zheyou73v0_A06	34035024	34036764	BnaA06T0264300ZY	0	-	0	0	1740	0.0000000
zheyou73v0_A06	34039407	34039937	BnaA06T0264400ZY	0	+	0	0	530	0.0000000
zheyou73v0_A06	34045722	34046898	BnaA06T0264500ZY	0	+	0	0	1176	0.0000000
zheyou73v0_A06	34054844	34057236	BnaA06T0264600ZY	0	+	0	0	2392	0.0000000
zheyou73v0_A06	34054844	34057236	BnaA06T0264600ZY.1	0	+	0	0	2392	0.0000000
zheyou73v0_A06	34057339	34062916	BnaA06T0264700ZY	0	-	0	0	5577	0.0000000
zheyou73v0_A06	34065249	34065615	BnaA06T0264800ZY	0	-	0	0	366	0.0000000
zheyou73v0_A06	34066054	34066363	BnaA06T0264900ZY	0	-	0	0	309	0.0000000
zheyou73v0_A06	34088611	34092393	BnaA06T0265000ZY	0	-	0	0	3782	0.0000000
zheyou73v0_A06	34104553	34105475	BnaA06T0265100ZY	0	+	0	0	922	0.0000000
zheyou73v0_A06	34116571	34120720	BnaA06T0265200ZY	0	-	0	0	4149	0.0000000
zheyou73v0_A06	34137845	34141145	BnaA06T0265300ZY	0	-	0	0	3300	0.0000000
zheyou73v0_A06	34142889	34144232	BnaA06T0265400ZY	0	+	0	0	1343	0.0000000
zheyou73v0_A06	34146915	34148555	BnaA06T0265500ZY	0	+	0	0	1640	0.0000000
zheyou73v0_A06	34150353	34156018	BnaA06T0265600ZY	0	+	0	0	5665	0.0000000
zheyou73v0_A06	34167754	34170566	BnaA06T0265700ZY	0	-	0	0	2812	0.0000000
zheyou73v0_A06	34170931	34172510	BnaA06T0265800ZY	0	-	0	0	1579	0.0000000
zheyou73v0_A06	34172664	34174423	BnaA06T0265900ZY	0	-	0	0	1759	0.0000000
zheyou73v0_A06	34189805	34191882	BnaA06T0266000ZY	0	-	0	0	2077	0.0000000
zheyou73v0_A06	34196308	34197499	BnaA06T0266100ZY	0	+	0	0	1191	0.0000000
zheyou73v0_A06	34197681	34199422	BnaA06T0266200ZY	0	-	0	0	1741	0.0000000
zheyou73v0_A06	34197681	34199422	BnaA06T0266200ZY.1	0	-	0	0	1741	0.0000000
zheyou73v0_A06	34212846	34215602	BnaA06T0266300ZY	0	+	0	0	2756	0.0000000
zheyou73v0_A06	34220482	34221054	BnaA06T0266400ZY	0	-	0	0	572	0.0000000
zheyou73v0_A06	34221463	34223650	BnaA06T0266500ZY	0	+	0	0	2187	0.0000000
zheyou73v0_A06	34230308	34231365	BnaA06T0266600ZY	0	-	0	0	1057	0.0000000
zheyou73v0_A06	34245281	34248644	BnaA06T0266700ZY	0	-	0	0	3363	0.0000000
zheyou73v0_A06	34253904	34254911	BnaA06T0266800ZY	0	+	0	0	1007	0.0000000
zheyou73v0_A06	34253904	34254911	BnaA06T0266800ZY.1	0	+	0	0	1007	0.0000000
zheyou73v0_A06	34256410	34262189	BnaA06T0266900ZY	0	-	0	0	5779	0.0000000
zheyou73v0_A06	34272418	34272715	BnaA06T0267000ZY	0	+	0	0	297	0.0000000
zheyou73v0_A06	34274106	34274799	BnaA06T0267100ZY	0	-	0	0	693	0.0000000
zheyou73v0_A06	34274824	34275643	BnaA06T0267200ZY	0	-	0	0	819	0.0000000
zheyou73v0_A06	34285557	34289886	BnaA06T0267300ZY	0	+	0	0	4329	0.0000000
zheyou73v0_A06	34285557	34289692	BnaA06T0267300ZY.1	0	+	0	0	4135	0.0000000
zheyou73v0_A06	34292260	34297688	BnaA06T0267400ZY	0	+	0	0	5428	0.0000000
zheyou73v0_A06	34298164	34301685	BnaA06T0267500ZY	0	-	0	0	3521	0.0000000
zheyou73v0_A06	34316634	34320589	BnaA06T0267600ZY	0	+	0	0	3955	0.0000000
zheyou73v0_A06	34333977	34335932	BnaA06T0267700ZY	0	+	0	0	1955	0.0000000
zheyou73v0_A06	34333977	34335932	BnaA06T0267700ZY.1	0	+	0	0	1955	0.0000000
zheyou73v0_A06	34336827	34337849	BnaA06T0267800ZY	0	+	0	0	1022	0.0000000
zheyou73v0_A06	34338060	34338554	BnaA06T0267900ZY	0	+	0	0	494	0.0000000
zheyou73v0_A06	34348707	34349765	BnaA06T0268000ZY	0	+	0	0	1058	0.0000000
zheyou73v0_A06	34350055	34353185	BnaA06T0268100ZY	0	-	0	0	3130	0.0000000
zheyou73v0_A06	34353756	34354282	BnaA06T0268200ZY	0	+	0	0	526	0.0000000
zheyou73v0_A06	34354238	34357488	BnaA06T0268300ZY	0	-	0	0	3250	0.0000000
zheyou73v0_A06	34371993	34375944	BnaA06T0268400ZY	0	-	0	0	3951	0.0000000
zheyou73v0_A06	34393882	34394873	BnaA06T0268500ZY	0	-	0	0	991	0.0000000
zheyou73v0_A06	34408209	34409176	BnaA06T0268600ZY	0	+	0	0	967	0.0000000
zheyou73v0_A06	34413217	34413529	BnaA06T0268700ZY	0	-	0	0	312	0.0000000
zheyou73v0_A06	34416847	34417388	BnaA06T0268800ZY	0	+	0	0	541	0.0000000
zheyou73v0_A06	34423289	34423831	BnaA06T0268900ZY	0	-	0	0	542	0.0000000
zheyou73v0_A06	34437408	34440113	BnaA06T0269000ZY	0	-	0	0	2705	0.0000000
zheyou73v0_A06	34500156	34502799	BnaA06T0269100ZY	0	-	0	0	2643	0.0000000
zheyou73v0_A06	34528747	34531285	BnaA06T0269200ZY	0	-	0	0	2538	0.0000000
zheyou73v0_A06	34532319	34534220	BnaA06T0269300ZY	0	+	0	0	1901	0.0000000
zheyou73v0_A06	34555016	34557221	BnaA06T0269400ZY	0	-	0	0	2205	0.0000000
zheyou73v0_A06	34582662	34583877	BnaA06T0269500ZY	0	+	0	0	1215	0.0000000
zheyou73v0_A06	34597350	34602698	BnaA06T0269600ZY	0	+	0	0	5348	0.0000000
zheyou73v0_A06	34603131	34605382	BnaA06T0269700ZY	0	-	0	0	2251	0.0000000
zheyou73v0_A06	34606144	34608428	BnaA06T0269800ZY	0	+	0	0	2284	0.0000000
zheyou73v0_A06	34609761	34611968	BnaA06T0269900ZY	0	+	0	0	2207	0.0000000
zheyou73v0_A06	34613539	34615400	BnaA06T0270000ZY	0	+	0	0	1861	0.0000000
zheyou73v0_A06	34613539	34615400	BnaA06T0270000ZY.1	0	+	0	0	1861	0.0000000
zheyou73v0_A06	34624287	34625454	BnaA06T0270100ZY	0	+	0	0	1167	0.0000000
zheyou73v0_A06	34634818	34636309	BnaA06T0270200ZY	0	+	0	0	1491	0.0000000
zheyou73v0_A06	34637416	34642749	BnaA06T0270300ZY	0	+	0	0	5333	0.0000000
zheyou73v0_A06	34643138	34644098	BnaA06T0270400ZY	0	-	0	0	960	0.0000000
zheyou73v0_A06	34650028	34651928	BnaA06T0270500ZY	0	-	0	0	1900	0.0000000
zheyou73v0_A06	34660545	34669402	BnaA06T0270600ZY	0	+	0	0	8857	0.0000000
zheyou73v0_A06	34672689	34672971	BnaA06T0270700ZY	0	-	0	0	282	0.0000000
zheyou73v0_A06	34701566	34701869	BnaA06T0270800ZY	0	+	0	0	303	0.0000000
zheyou73v0_A06	34701943	34702147	BnaA06T0270900ZY	0	+	0	0	204	0.0000000
zheyou73v0_A06	34703355	34704338	BnaA06T0271000ZY	0	-	0	0	983	0.0000000
zheyou73v0_A06	34711486	34712244	BnaA06T0271100ZY	0	+	0	0	758	0.0000000
zheyou73v0_A06	34712822	34719085	BnaA06T0271200ZY	0	+	0	0	6263	0.0000000
zheyou73v0_A06	34722712	34724263	BnaA06T0271300ZY	0	+	0	0	1551	0.0000000
zheyou73v0_A06	34731971	34732343	BnaA06T0271400ZY	0	-	0	0	372	0.0000000
zheyou73v0_A06	34733310	34734851	BnaA06T0271500ZY	0	-	0	0	1541	0.0000000
zheyou73v0_A06	34736549	34737891	BnaA06T0271600ZY	0	-	0	0	1342	0.0000000
zheyou73v0_A06	34753724	34754413	BnaA06T0271700ZY	0	-	0	0	689	0.0000000
zheyou73v0_A06	34754844	34755119	BnaA06T0271800ZY	0	-	0	0	275	0.0000000
zheyou73v0_A06	34755319	34756420	BnaA06T0271900ZY	0	+	0	0	1101	0.0000000
zheyou73v0_A06	34756431	34757929	BnaA06T0272000ZY	0	+	0	0	1498	0.0000000
zheyou73v0_A06	34760244	34762080	BnaA06T0272100ZY	0	-	0	0	1836	0.0000000
zheyou73v0_A06	34798962	34800330	BnaA06T0272200ZY	0	+	0	0	1368	0.0000000
zheyou73v0_A06	34800544	34801249	BnaA06T0272300ZY	0	-	0	0	705	0.0000000
zheyou73v0_A06	34801861	34803074	BnaA06T0272400ZY	0	+	0	0	1213	0.0000000
zheyou73v0_A06	34808865	34809279	BnaA06T0272500ZY	0	+	0	0	414	0.0000000
zheyou73v0_A06	34810207	34812761	BnaA06T0272600ZY	0	-	0	0	2554	0.0000000
zheyou73v0_A06	34814593	34816291	BnaA06T0272700ZY	0	+	0	0	1698	0.0000000
zheyou73v0_A06	34832311	34833578	BnaA06T0272800ZY	0	-	0	0	1267	0.0000000
zheyou73v0_A06	34854252	34855555	BnaA06T0272900ZY	0	+	0	0	1303	0.0000000
zheyou73v0_A06	34857371	34860957	BnaA06T0273000ZY	0	-	0	0	3586	0.0000000
zheyou73v0_A06	34862097	34862712	BnaA06T0273100ZY	0	+	0	0	615	0.0000000
zheyou73v0_A06	34862755	34864780	BnaA06T0273200ZY	0	-	0	0	2025	0.0000000
zheyou73v0_A06	34870780	34873159	BnaA06T0273300ZY	0	+	0	0	2379	0.0000000
zheyou73v0_A06	34875703	34877744	BnaA06T0273400ZY	0	+	0	0	2041	0.0000000
zheyou73v0_A06	34879388	34887433	BnaA06T0273500ZY	0	-	0	0	8045	0.0000000
zheyou73v0_A06	34892088	34895106	BnaA06T0273600ZY	0	+	0	0	3018	0.0000000
zheyou73v0_A06	34892088	34895106	BnaA06T0273600ZY.1	0	+	0	0	3018	0.0000000
zheyou73v0_A06	34904942	34905584	BnaA06T0273700ZY	0	+	0	0	642	0.0000000
zheyou73v0_A06	34907051	34909719	BnaA06T0273800ZY	0	-	0	0	2668	0.0000000
zheyou73v0_A06	34912306	34915554	BnaA06T0273900ZY	0	-	0	0	3248	0.0000000
zheyou73v0_A06	34930035	34933241	BnaA06T0274000ZY	0	-	0	0	3206	0.0000000
zheyou73v0_A06	34937259	34943325	BnaA06T0274100ZY	0	-	0	0	6066	0.0000000
zheyou73v0_A06	34950915	34952964	BnaA06T0274200ZY	0	-	0	0	2049	0.0000000
zheyou73v0_A06	34950915	34952964	BnaA06T0274200ZY.1	0	-	0	0	2049	0.0000000
zheyou73v0_A06	34952303	34952534	BnaA06T0274300ZY	0	+	0	0	231	0.0000000
zheyou73v0_A06	34957455	34958092	BnaA06T0274400ZY	0	+	0	0	637	0.0000000
zheyou73v0_A06	34958284	34958518	BnaA06T0274500ZY	0	-	0	0	234	0.0000000
zheyou73v0_A06	34973530	34976312	BnaA06T0274600ZY	0	+	0	0	2782	0.0000000
zheyou73v0_A06	34977723	34982802	BnaA06T0274700ZY	0	+	0	0	5079	0.0000000
zheyou73v0_A06	34985833	34986839	BnaA06T0274800ZY	0	-	0	0	1006	0.0000000
zheyou73v0_A06	34989061	34991406	BnaA06T0274900ZY	0	+	0	0	2345	0.0000000
zheyou73v0_A06	34992489	34994255	BnaA06T0275000ZY	0	+	0	0	1766	0.0000000
zheyou73v0_A06	34992816	34994255	BnaA06T0275000ZY.1	0	+	0	0	1439	0.0000000
zheyou73v0_A06	34995155	34995806	BnaA06T0275100ZY	0	-	0	0	651	0.0000000
zheyou73v0_A06	34996091	35000492	BnaA06T0275200ZY	0	-	0	0	4401	0.0000000
zheyou73v0_A06	34996091	35000492	BnaA06T0275200ZY.1	0	-	0	0	4401	0.0000000
zheyou73v0_A06	35005398	35006620	BnaA06T0275300ZY	0	+	0	0	1222	0.0000000
zheyou73v0_A06	35012751	35015498	BnaA06T0275400ZY	0	-	0	0	2747	0.0000000
zheyou73v0_A06	35017969	35021833	BnaA06T0275500ZY	0	+	0	0	3864	0.0000000
zheyou73v0_A06	35021953	35023061	BnaA06T0275600ZY	0	-	0	0	1108	0.0000000
zheyou73v0_A06	35026844	35028089	BnaA06T0275700ZY	0	-	0	0	1245	0.0000000
zheyou73v0_A06	35038853	35039616	BnaA06T0275800ZY	0	+	0	0	763	0.0000000
zheyou73v0_A06	35052101	35053271	BnaA06T0275900ZY	0	+	0	0	1170	0.0000000
zheyou73v0_A06	35064845	35065726	BnaA06T0276000ZY	0	-	0	0	881	0.0000000
zheyou73v0_A06	35067185	35070937	BnaA06T0276100ZY	0	+	0	0	3752	0.0000000
zheyou73v0_A06	35067411	35070937	BnaA06T0276100ZY.1	0	+	0	0	3526	0.0000000
zheyou73v0_A06	35072643	35073858	BnaA06T0276200ZY	0	+	0	0	1215	0.0000000
zheyou73v0_A06	35072643	35073858	BnaA06T0276200ZY.1	0	+	0	0	1215	0.0000000
zheyou73v0_A06	35076201	35077755	BnaA06T0276300ZY	0	+	0	0	1554	0.0000000
zheyou73v0_A06	35077872	35079694	BnaA06T0276400ZY	0	-	0	0	1822	0.0000000
zheyou73v0_A06	35077872	35079694	BnaA06T0276400ZY.1	0	-	0	0	1822	0.0000000
zheyou73v0_A06	35079938	35081799	BnaA06T0276500ZY	0	-	0	0	1861	0.0000000
zheyou73v0_A06	35095889	35096402	BnaA06T0276600ZY	0	-	0	0	513	0.0000000
zheyou73v0_A06	35099157	35099616	BnaA06T0276700ZY	0	+	0	0	459	0.0000000
zheyou73v0_A06	35107171	35108578	BnaA06T0276800ZY	0	-	0	0	1407	0.0000000
zheyou73v0_A06	35110228	35110795	BnaA06T0276900ZY	0	+	0	0	567	0.0000000
zheyou73v0_A06	35114054	35114408	BnaA06T0277000ZY	0	-	0	0	354	0.0000000
zheyou73v0_A06	35114639	35115801	BnaA06T0277100ZY	0	-	0	0	1162	0.0000000
zheyou73v0_A06	35123433	35125107	BnaA06T0277200ZY	0	-	0	0	1674	0.0000000
zheyou73v0_A06	35128340	35128517	BnaA06T0277300ZY	0	+	0	0	177	0.0000000
zheyou73v0_A06	35159694	35160288	BnaA06T0277400ZY	0	-	0	0	594	0.0000000
zheyou73v0_A06	35163186	35163759	BnaA06T0277500ZY	0	-	0	0	573	0.0000000
zheyou73v0_A06	35165347	35166778	BnaA06T0277600ZY	0	-	0	0	1431	0.0000000
zheyou73v0_A06	35170082	35171743	BnaA06T0277700ZY	0	+	0	0	1661	0.0000000
zheyou73v0_A06	35178138	35179334	BnaA06T0277800ZY	0	+	0	0	1196	0.0000000
zheyou73v0_A06	35179493	35180582	BnaA06T0277900ZY	0	-	0	0	1089	0.0000000
zheyou73v0_A06	35180853	35182113	BnaA06T0278000ZY	0	+	0	0	1260	0.0000000
zheyou73v0_A06	35182363	35183594	BnaA06T0278100ZY	0	-	0	0	1231	0.0000000
zheyou73v0_A06	35183922	35184377	BnaA06T0278200ZY	0	-	0	0	455	0.0000000
zheyou73v0_A06	35202382	35203579	BnaA06T0278300ZY	0	+	0	0	1197	0.0000000
zheyou73v0_A06	35222275	35222821	BnaA06T0278400ZY	0	-	0	0	546	0.0000000
zheyou73v0_A06	35229369	35231989	BnaA06T0278500ZY	0	-	0	0	2620	0.0000000
zheyou73v0_A06	35238579	35239232	BnaA06T0278600ZY	0	+	0	0	653	0.0000000
zheyou73v0_A06	35241141	35241918	BnaA06T0278700ZY	0	-	0	0	777	0.0000000
zheyou73v0_A06	35250134	35254060	BnaA06T0278800ZY	0	+	0	0	3926	0.0000000
zheyou73v0_A06	35259240	35260921	BnaA06T0278900ZY	0	+	0	0	1681	0.0000000
zheyou73v0_A06	35266759	35268673	BnaA06T0279000ZY	0	-	0	0	1914	0.0000000
zheyou73v0_A06	35277250	35279735	BnaA06T0279100ZY	0	+	0	0	2485	0.0000000
zheyou73v0_A06	35280003	35281973	BnaA06T0279200ZY	0	-	0	0	1970	0.0000000
zheyou73v0_A06	35285128	35288164	BnaA06T0279300ZY	0	+	0	0	3036	0.0000000
zheyou73v0_A06	35288210	35289566	BnaA06T0279400ZY	0	-	0	0	1356	0.0000000
zheyou73v0_A06	35289590	35292051	BnaA06T0279500ZY	0	-	0	0	2461	0.0000000
zheyou73v0_A06	35289590	35292051	BnaA06T0279500ZY.1	0	-	0	0	2461	0.0000000
zheyou73v0_A06	35292964	35293345	BnaA06T0279600ZY	0	-	0	0	381	0.0000000
zheyou73v0_A06	35301171	35304014	BnaA06T0279700ZY	0	+	0	0	2843	0.0000000
zheyou73v0_A06	35304507	35304933	BnaA06T0279800ZY	0	-	0	0	426	0.0000000
zheyou73v0_A06	35305755	35307288	BnaA06T0279900ZY	0	-	0	0	1533	0.0000000
zheyou73v0_A06	35316150	35317304	BnaA06T0280000ZY	0	-	0	0	1154	0.0000000
zheyou73v0_A06	35325672	35327656	BnaA06T0280100ZY	0	-	0	0	1984	0.0000000
zheyou73v0_A06	35327967	35329915	BnaA06T0280200ZY	0	-	0	0	1948	0.0000000
zheyou73v0_A06	35330189	35335175	BnaA06T0280300ZY	0	+	0	0	4986	0.0000000
zheyou73v0_A06	35342033	35343733	BnaA06T0280400ZY	0	-	0	0	1700	0.0000000
zheyou73v0_A06	35367895	35369354	BnaA06T0280500ZY	0	-	0	0	1459	0.0000000
zheyou73v0_A06	35369906	35371194	BnaA06T0280600ZY	0	+	0	0	1288	0.0000000
zheyou73v0_A06	35371079	35374370	BnaA06T0280700ZY	0	-	0	0	3291	0.0000000
zheyou73v0_A06	35371079	35374370	BnaA06T0280700ZY.1	0	-	0	0	3291	0.0000000
zheyou73v0_A06	35374989	35375495	BnaA06T0280800ZY	0	+	0	0	506	0.0000000
zheyou73v0_A06	35375753	35376936	BnaA06T0280900ZY	0	+	0	0	1183	0.0000000
zheyou73v0_A06	35376876	35379560	BnaA06T0281000ZY	0	-	0	0	2684	0.0000000
zheyou73v0_A06	35376876	35379301	BnaA06T0281000ZY.1	0	-	0	0	2425	0.0000000
zheyou73v0_A06	35386564	35388822	BnaA06T0281100ZY	0	+	0	0	2258	0.0000000
zheyou73v0_A06	35419061	35421835	BnaA06T0281200ZY	0	+	0	0	2774	0.0000000
zheyou73v0_A06	35424463	35426357	BnaA06T0281300ZY	0	+	0	0	1894	0.0000000
zheyou73v0_A06	35432063	35434190	BnaA06T0281400ZY	0	+	0	0	2127	0.0000000
zheyou73v0_A06	35436301	35440395	BnaA06T0281500ZY	0	+	0	0	4094	0.0000000
zheyou73v0_A06	35442282	35443539	BnaA06T0281600ZY	0	+	0	0	1257	0.0000000
zheyou73v0_A06	35443857	35444690	BnaA06T0281700ZY	0	+	0	0	833	0.0000000
zheyou73v0_A06	35449525	35451010	BnaA06T0281800ZY	0	-	0	0	1485	0.0000000
zheyou73v0_A06	35449525	35451010	BnaA06T0281800ZY.1	0	-	0	0	1485	0.0000000
zheyou73v0_A06	35472574	35474525	BnaA06T0281900ZY	0	-	0	0	1951	0.0000000
zheyou73v0_A06	35475142	35477960	BnaA06T0282000ZY	0	-	0	0	2818	0.0000000
zheyou73v0_A06	35479156	35481161	BnaA06T0282100ZY	0	+	0	0	2005	0.0000000
zheyou73v0_A06	35483794	35486777	BnaA06T0282200ZY	0	+	0	0	2983	0.0000000
zheyou73v0_A06	35483794	35486777	BnaA06T0282200ZY.1	0	+	0	0	2983	0.0000000
zheyou73v0_A06	35487188	35489121	BnaA06T0282300ZY	0	-	0	0	1933	0.0000000
zheyou73v0_A06	35490770	35492678	BnaA06T0282400ZY	0	-	0	0	1908	0.0000000
zheyou73v0_A06	35504330	35506581	BnaA06T0282500ZY	0	+	0	0	2251	0.0000000
zheyou73v0_A06	35507969	35508829	BnaA06T0282600ZY	0	-	0	0	860	0.0000000
zheyou73v0_A06	35514168	35517830	BnaA06T0282700ZY	0	+	0	0	3662	0.0000000
zheyou73v0_A06	35527317	35528879	BnaA06T0282800ZY	0	+	0	0	1562	0.0000000
zheyou73v0_A06	35529019	35530318	BnaA06T0282900ZY	0	-	0	0	1299	0.0000000
zheyou73v0_A06	35531768	35533379	BnaA06T0283000ZY	0	-	0	0	1611	0.0000000
zheyou73v0_A06	35537373	35537931	BnaA06T0283100ZY	0	-	0	0	558	0.0000000
zheyou73v0_A06	35542108	35545910	BnaA06T0283200ZY	0	+	0	0	3802	0.0000000
zheyou73v0_A06	35542108	35545910	BnaA06T0283200ZY.1	0	+	0	0	3802	0.0000000
zheyou73v0_A06	35547481	35550149	BnaA06T0283300ZY	0	+	0	0	2668	0.0000000
zheyou73v0_A06	35547481	35550149	BnaA06T0283300ZY.1	0	+	0	0	2668	0.0000000
zheyou73v0_A06	35547481	35550149	BnaA06T0283300ZY.2	0	+	0	0	2668	0.0000000
zheyou73v0_A06	35547481	35550149	BnaA06T0283300ZY.4	0	+	0	0	2668	0.0000000
zheyou73v0_A06	35548612	35550149	BnaA06T0283300ZY.3	0	+	0	0	1537	0.0000000
zheyou73v0_A06	35550150	35551317	BnaA06T0283400ZY	0	-	0	0	1167	0.0000000
zheyou73v0_A06	35556569	35562634	BnaA06T0283500ZY	0	+	0	0	6065	0.0000000
zheyou73v0_A06	35564002	35568229	BnaA06T0283600ZY	0	+	0	0	4227	0.0000000
zheyou73v0_A06	35567957	35569184	BnaA06T0283700ZY	0	-	0	0	1227	0.0000000
zheyou73v0_A06	35569515	35573651	BnaA06T0283800ZY	0	+	0	0	4136	0.0000000
zheyou73v0_A06	35575626	35578375	BnaA06T0283900ZY	0	+	0	0	2749	0.0000000
zheyou73v0_A06	35578979	35582851	BnaA06T0284000ZY	0	-	0	0	3872	0.0000000
zheyou73v0_A06	35585550	35586168	BnaA06T0284100ZY	0	-	0	0	618	0.0000000
zheyou73v0_A06	35586680	35587477	BnaA06T0284200ZY	0	-	0	0	797	0.0000000
zheyou73v0_A06	35594250	35595630	BnaA06T0284300ZY	0	+	0	0	1380	0.0000000
zheyou73v0_A06	35596039	35598692	BnaA06T0284400ZY	0	-	0	0	2653	0.0000000
zheyou73v0_A06	35608888	35610273	BnaA06T0284500ZY	0	+	0	0	1385	0.0000000
zheyou73v0_A06	35610280	35612663	BnaA06T0284600ZY	0	-	0	0	2383	0.0000000
zheyou73v0_A06	35613149	35613374	BnaA06T0284700ZY	0	+	0	0	225	0.0000000
zheyou73v0_A06	35615756	35619103	BnaA06T0284800ZY	0	+	0	0	3347	0.0000000
zheyou73v0_A06	35622611	35629317	BnaA06T0284900ZY	0	-	0	0	6706	0.0000000
zheyou73v0_A06	35629992	35631401	BnaA06T0285000ZY	0	-	0	0	1409	0.0000000
zheyou73v0_A06	35637771	35638653	BnaA06T0285100ZY	0	-	0	0	882	0.0000000
zheyou73v0_A06	35638747	35640862	BnaA06T0285200ZY	0	-	0	0	2115	0.0000000
zheyou73v0_A06	35644114	35651021	BnaA06T0285300ZY	0	+	0	0	6907	0.0000000
zheyou73v0_A06	35651300	35653156	BnaA06T0285400ZY	0	-	0	0	1856	0.0000000
zheyou73v0_A06	35653963	35655705	BnaA06T0285500ZY	0	+	0	0	1742	0.0000000
zheyou73v0_A06	35657060	35659430	BnaA06T0285600ZY	0	+	0	0	2370	0.0000000
zheyou73v0_A06	35659999	35661695	BnaA06T0285700ZY	0	+	0	0	1696	0.0000000
zheyou73v0_A06	35661729	35663383	BnaA06T0285800ZY	0	-	0	0	1654	0.0000000
zheyou73v0_A06	35666363	35667820	BnaA06T0285900ZY	0	-	0	0	1457	0.0000000
zheyou73v0_A06	35671336	35675196	BnaA06T0286000ZY	0	+	0	0	3860	0.0000000
zheyou73v0_A06	35675204	35676227	BnaA06T0286100ZY	0	-	0	0	1023	0.0000000
zheyou73v0_A06	35676592	35679709	BnaA06T0286200ZY	0	-	0	0	3117	0.0000000
zheyou73v0_A06	35681725	35684094	BnaA06T0286300ZY	0	-	0	0	2369	0.0000000
zheyou73v0_A06	35685484	35693115	BnaA06T0286400ZY	0	-	0	0	7631	0.0000000
zheyou73v0_A06	35693724	35695183	BnaA06T0286500ZY	0	-	0	0	1459	0.0000000
zheyou73v0_A06	35696092	35696734	BnaA06T0286600ZY	0	-	0	0	642	0.0000000
zheyou73v0_A06	35724792	35726286	BnaA06T0286700ZY	0	-	0	0	1494	0.0000000
zheyou73v0_A06	35727655	35729090	BnaA06T0286800ZY	0	-	0	0	1435	0.0000000
zheyou73v0_A06	35727913	35729090	BnaA06T0286800ZY.1	0	-	0	0	1177	0.0000000
zheyou73v0_A06	35729286	35730915	BnaA06T0286900ZY	0	+	0	0	1629	0.0000000
zheyou73v0_A06	35731010	35734109	BnaA06T0287000ZY	0	-	0	0	3099	0.0000000
zheyou73v0_A06	35735115	35736614	BnaA06T0287100ZY	0	+	0	0	1499	0.0000000
zheyou73v0_A06	35737908	35739984	BnaA06T0287200ZY	0	+	0	0	2076	0.0000000
zheyou73v0_A06	35739159	35742209	BnaA06T0287300ZY	0	-	0	0	3050	0.0000000
zheyou73v0_A06	35739159	35742173	BnaA06T0287300ZY.1	0	-	0	0	3014	0.0000000
zheyou73v0_A06	35743081	35744748	BnaA06T0287400ZY	0	+	0	0	1667	0.0000000
zheyou73v0_A06	35745130	35746753	BnaA06T0287500ZY	0	-	0	0	1623	0.0000000
zheyou73v0_A06	35757971	35759296	BnaA06T0287600ZY	0	+	0	0	1325	0.0000000
zheyou73v0_A06	35766127	35769865	BnaA06T0287700ZY	0	+	0	0	3738	0.0000000
zheyou73v0_A06	35770227	35772514	BnaA06T0287800ZY	0	-	0	0	2287	0.0000000
zheyou73v0_A06	35781950	35784893	BnaA06T0287900ZY	0	+	0	0	2943	0.0000000
zheyou73v0_A06	35797409	35798025	BnaA06T0288000ZY	0	+	0	0	616	0.0000000
zheyou73v0_A06	35801073	35804871	BnaA06T0288100ZY	0	+	0	0	3798	0.0000000
zheyou73v0_A06	35801073	35804871	BnaA06T0288100ZY.1	0	+	0	0	3798	0.0000000
zheyou73v0_A06	35805918	35806862	BnaA06T0288200ZY	0	-	0	0	944	0.0000000
zheyou73v0_A06	35806998	35808246	BnaA06T0288300ZY	0	-	0	0	1248	0.0000000
zheyou73v0_A06	35810573	35811612	BnaA06T0288400ZY	0	-	0	0	1039	0.0000000
zheyou73v0_A06	35812159	35814340	BnaA06T0288500ZY	0	-	0	0	2181	0.0000000
zheyou73v0_A06	35815442	35816804	BnaA06T0288600ZY	0	-	0	0	1362	0.0000000
zheyou73v0_A06	35817883	35819531	BnaA06T0288700ZY	0	+	0	0	1648	0.0000000
zheyou73v0_A06	35819792	35822014	BnaA06T0288800ZY	0	+	0	0	2222	0.0000000
zheyou73v0_A06	35823304	35824707	BnaA06T0288900ZY	0	+	0	0	1403	0.0000000
zheyou73v0_A06	35825084	35829995	BnaA06T0289000ZY	0	+	0	0	4911	0.0000000
zheyou73v0_A06	35825084	35829995	BnaA06T0289000ZY.1	0	+	0	0	4911	0.0000000
zheyou73v0_A06	35833105	35833460	BnaA06T0289100ZY	0	-	0	0	355	0.0000000
zheyou73v0_A06	35834322	35836661	BnaA06T0289200ZY	0	-	0	0	2339	0.0000000
zheyou73v0_A06	35844898	35867597	BnaA06T0289300ZY	0	+	0	0	22699	0.0000000
zheyou73v0_A06	35868461	35870935	BnaA06T0289400ZY	0	-	0	0	2474	0.0000000
zheyou73v0_A06	35868461	35870935	BnaA06T0289400ZY.1	0	-	0	0	2474	0.0000000
zheyou73v0_A06	35868461	35870935	BnaA06T0289400ZY.2	0	-	0	0	2474	0.0000000
zheyou73v0_A06	35871489	35873279	BnaA06T0289500ZY	0	+	0	0	1790	0.0000000
zheyou73v0_A06	35873407	35873968	BnaA06T0289600ZY	0	+	0	0	561	0.0000000
zheyou73v0_A06	35874746	35878049	BnaA06T0289700ZY	0	+	0	0	3303	0.0000000
zheyou73v0_A06	35874746	35878049	BnaA06T0289700ZY.1	0	+	0	0	3303	0.0000000
zheyou73v0_A06	35878710	35879961	BnaA06T0289800ZY	0	-	0	0	1251	0.0000000
zheyou73v0_A06	35880212	35882406	BnaA06T0289900ZY	0	+	0	0	2194	0.0000000
zheyou73v0_A06	35902149	35903929	BnaA06T0290000ZY	0	+	0	0	1780	0.0000000
zheyou73v0_A06	35905106	35907402	BnaA06T0290100ZY	0	-	0	0	2296	0.0000000
zheyou73v0_A06	35909594	35910257	BnaA06T0290200ZY	0	-	0	0	663	0.0000000
zheyou73v0_A06	35913590	35915887	BnaA06T0290300ZY	0	-	0	0	2297	0.0000000
zheyou73v0_A06	35924998	35926721	BnaA06T0290400ZY	0	-	0	0	1723	0.0000000
zheyou73v0_A06	35928875	35931916	BnaA06T0290500ZY	0	-	0	0	3041	0.0000000
zheyou73v0_A06	35935698	35939782	BnaA06T0290600ZY	0	-	0	0	4084	0.0000000
zheyou73v0_A06	35935698	35939782	BnaA06T0290600ZY.1	0	-	0	0	4084	0.0000000
zheyou73v0_A06	35948346	35949673	BnaA06T0290700ZY	0	-	0	0	1327	0.0000000
zheyou73v0_A06	35951649	35953514	BnaA06T0290800ZY	0	+	0	0	1865	0.0000000
zheyou73v0_A06	35954385	35955183	BnaA06T0290900ZY	0	+	0	0	798	0.0000000
zheyou73v0_A06	35956208	35959058	BnaA06T0291000ZY	0	+	0	0	2850	0.0000000
zheyou73v0_A06	35959610	35961599	BnaA06T0291100ZY	0	+	0	0	1989	0.0000000
zheyou73v0_A06	35961880	35968273	BnaA06T0291200ZY	0	-	0	0	6393	0.0000000
zheyou73v0_A06	35971244	35972826	BnaA06T0291300ZY	0	-	0	0	1582	0.0000000
zheyou73v0_A06	35994425	35994683	BnaA06T0291400ZY	0	+	0	0	258	0.0000000
zheyou73v0_A06	35996228	35997652	BnaA06T0291500ZY	0	-	0	0	1424	0.0000000
zheyou73v0_A06	36002965	36003925	BnaA06T0291600ZY	0	+	0	0	960	0.0000000
zheyou73v0_A06	36004283	36014200	BnaA06T0291700ZY	0	-	0	0	9917	0.0000000
zheyou73v0_A06	36017067	36018899	BnaA06T0291800ZY	0	+	0	0	1832	0.0000000
zheyou73v0_A06	36022199	36023113	BnaA06T0291900ZY	0	-	0	0	914	0.0000000
zheyou73v0_A06	36023276	36024864	BnaA06T0292000ZY	0	-	0	0	1588	0.0000000
zheyou73v0_A06	36024918	36025185	BnaA06T0292100ZY	0	-	0	0	267	0.0000000
zheyou73v0_A06	36039207	36044915	BnaA06T0292200ZY	0	+	0	0	5708	0.0000000
zheyou73v0_A06	36055340	36057735	BnaA06T0292300ZY	0	+	0	0	2395	0.0000000
zheyou73v0_A06	36061512	36062242	BnaA06T0292400ZY	0	-	0	0	730	0.0000000
zheyou73v0_A06	36064579	36065874	BnaA06T0292500ZY	0	-	0	0	1295	0.0000000
zheyou73v0_A06	36067750	36068547	BnaA06T0292600ZY	0	+	0	0	797	0.0000000
zheyou73v0_A06	36070235	36071750	BnaA06T0292700ZY	0	+	0	0	1515	0.0000000
zheyou73v0_A06	36070235	36071750	BnaA06T0292700ZY.1	0	+	0	0	1515	0.0000000
zheyou73v0_A06	36074727	36077151	BnaA06T0292800ZY	0	+	0	0	2424	0.0000000
zheyou73v0_A06	36077371	36078750	BnaA06T0292900ZY	0	-	0	0	1379	0.0000000
zheyou73v0_A06	36077640	36078027	BnaA06T0293000ZY	0	+	0	0	387	0.0000000
zheyou73v0_A06	36079086	36080541	BnaA06T0293100ZY	0	-	0	0	1455	0.0000000
zheyou73v0_A06	36081831	36083407	BnaA06T0293200ZY	0	+	0	0	1576	0.0000000
zheyou73v0_A06	36085916	36087763	BnaA06T0293300ZY	0	-	0	0	1847	0.0000000
zheyou73v0_A06	36090196	36091884	BnaA06T0293400ZY	0	+	0	0	1688	0.0000000
zheyou73v0_A06	36097987	36098856	BnaA06T0293500ZY	0	+	0	0	869	0.0000000
zheyou73v0_A06	36103437	36103892	BnaA06T0293600ZY	0	+	0	0	455	0.0000000
zheyou73v0_A06	36105292	36107759	BnaA06T0293700ZY.1	0	-	0	0	2467	0.0000000
zheyou73v0_A06	36105493	36107759	BnaA06T0293700ZY	0	-	0	0	2266	0.0000000
zheyou73v0_A06	36112692	36114132	BnaA06T0293800ZY	0	-	0	0	1440	0.0000000
zheyou73v0_A06	36115138	36119102	BnaA06T0293900ZY	0	+	0	0	3964	0.0000000
zheyou73v0_A06	36122364	36126774	BnaA06T0294000ZY	0	+	0	0	4410	0.0000000
zheyou73v0_A06	36130375	36130663	BnaA06T0294100ZY	0	-	0	0	288	0.0000000
zheyou73v0_A06	36132429	36134663	BnaA06T0294200ZY	0	+	0	0	2234	0.0000000
zheyou73v0_A06	36132429	36133888	BnaA06T0294200ZY.1	0	+	0	0	1459	0.0000000
zheyou73v0_A06	36135742	36137287	BnaA06T0294300ZY	0	-	0	0	1545	0.0000000
zheyou73v0_A06	36138441	36139575	BnaA06T0294400ZY	0	-	0	0	1134	0.0000000
zheyou73v0_A06	36146062	36148421	BnaA06T0294500ZY	0	-	0	0	2359	0.0000000
zheyou73v0_A06	36149086	36151974	BnaA06T0294600ZY	0	+	0	0	2888	0.0000000
zheyou73v0_A06	36154385	36156943	BnaA06T0294700ZY	0	+	0	0	2558	0.0000000
zheyou73v0_A06	36156341	36156944	BnaA06T0294800ZY	0	-	0	0	603	0.0000000
zheyou73v0_A06	36170133	36170599	BnaA06T0294900ZY	0	-	0	0	466	0.0000000
zheyou73v0_A06	36172972	36177306	BnaA06T0295000ZY	0	+	0	0	4334	0.0000000
zheyou73v0_A06	36172972	36176307	BnaA06T0295000ZY.2	0	+	0	0	3335	0.0000000
zheyou73v0_A06	36175422	36177306	BnaA06T0295000ZY.1	0	+	0	0	1884	0.0000000
zheyou73v0_A06	36180962	36185148	BnaA06T0295100ZY	0	+	0	0	4186	0.0000000
zheyou73v0_A06	36180962	36185148	BnaA06T0295100ZY.1	0	+	0	0	4186	0.0000000
zheyou73v0_A06	36185794	36188016	BnaA06T0295200ZY	0	-	0	0	2222	0.0000000
zheyou73v0_A06	36185794	36188016	BnaA06T0295200ZY.1	0	-	0	0	2222	0.0000000
zheyou73v0_A06	36188744	36191553	BnaA06T0295300ZY	0	+	0	0	2809	0.0000000
zheyou73v0_A06	36191701	36193159	BnaA06T0295400ZY	0	-	0	0	1458	0.0000000
zheyou73v0_A06	36194047	36197009	BnaA06T0295500ZY	0	-	0	0	2962	0.0000000
zheyou73v0_A06	36194047	36197009	BnaA06T0295500ZY.1	0	-	0	0	2962	0.0000000
zheyou73v0_A06	36197358	36199223	BnaA06T0295600ZY	0	+	0	0	1865	0.0000000
zheyou73v0_A06	36201132	36201802	BnaA06T0295700ZY	0	+	0	0	670	0.0000000
zheyou73v0_A06	36221170	36222019	BnaA06T0295800ZY	0	+	0	0	849	0.0000000
zheyou73v0_A06	36224129	36226602	BnaA06T0295900ZY	0	-	0	0	2473	0.0000000
zheyou73v0_A06	36224129	36226602	BnaA06T0295900ZY.1	0	-	0	0	2473	0.0000000
zheyou73v0_A06	36250370	36252912	BnaA06T0296000ZY	0	-	0	0	2542	0.0000000
zheyou73v0_A06	36267375	36267528	BnaA06T0296100ZY	0	+	0	0	153	0.0000000
zheyou73v0_A06	36270781	36272194	BnaA06T0296200ZY	0	+	0	0	1413	0.0000000
zheyou73v0_A06	36279024	36280033	BnaA06T0296300ZY	0	-	0	0	1009	0.0000000
zheyou73v0_A06	36302985	36306522	BnaA06T0296400ZY	0	+	0	0	3537	0.0000000
zheyou73v0_A06	36308111	36309041	BnaA06T0296500ZY	0	+	0	0	930	0.0000000
zheyou73v0_A06	36313352	36314553	BnaA06T0296600ZY	0	+	0	0	1201	0.0000000
zheyou73v0_A06	36314607	36321743	BnaA06T0296700ZY	0	-	0	0	7136	0.0000000
zheyou73v0_A06	36322230	36323753	BnaA06T0296800ZY	0	-	0	0	1523	0.0000000
zheyou73v0_A06	36323957	36327190	BnaA06T0296900ZY	0	-	0	0	3233	0.0000000
zheyou73v0_A06	36327561	36328336	BnaA06T0297000ZY	0	+	0	0	775	0.0000000
zheyou73v0_A06	36328464	36330433	BnaA06T0297100ZY	0	-	0	0	1969	0.0000000
zheyou73v0_A06	36336727	36341060	BnaA06T0297200ZY	0	+	0	0	4333	0.0000000
zheyou73v0_A06	36341107	36341895	BnaA06T0297300ZY	0	-	0	0	788	0.0000000
zheyou73v0_A06	36367647	36369381	BnaA06T0297400ZY	0	-	0	0	1734	0.0000000
zheyou73v0_A06	36370019	36370277	BnaA06T0297500ZY	0	-	0	0	258	0.0000000
zheyou73v0_A06	36372538	36373087	BnaA06T0297600ZY	0	+	0	0	549	0.0000000
zheyou73v0_A06	36386915	36387865	BnaA06T0297700ZY	0	+	0	0	950	0.0000000
zheyou73v0_A06	36397875	36406419	BnaA06T0297800ZY	0	-	0	0	8544	0.0000000
zheyou73v0_A06	36408974	36411930	BnaA06T0297900ZY	0	-	0	0	2956	0.0000000
zheyou73v0_A06	36416213	36419905	BnaA06T0298000ZY	0	-	0	0	3692	0.0000000
zheyou73v0_A06	36428573	36428765	BnaA06T0298100ZY	0	+	0	0	192	0.0000000
zheyou73v0_A06	36440816	36441710	BnaA06T0298200ZY	0	+	0	0	894	0.0000000
zheyou73v0_A06	36447157	36449310	BnaA06T0298300ZY	0	-	0	0	2153	0.0000000
zheyou73v0_A06	36451350	36453347	BnaA06T0298400ZY	0	-	0	0	1997	0.0000000
zheyou73v0_A06	36455235	36460034	BnaA06T0298500ZY	0	+	0	0	4799	0.0000000
zheyou73v0_A06	36465202	36468411	BnaA06T0298600ZY	0	+	0	0	3209	0.0000000
zheyou73v0_A06	36468599	36475024	BnaA06T0298700ZY	0	-	0	0	6425	0.0000000
zheyou73v0_A06	36481721	36484912	BnaA06T0298800ZY	0	+	0	0	3191	0.0000000
zheyou73v0_A06	36486323	36487322	BnaA06T0298900ZY	0	+	0	0	999	0.0000000
zheyou73v0_A06	36487286	36489953	BnaA06T0299000ZY	0	-	0	0	2667	0.0000000
zheyou73v0_A06	36493710	36495365	BnaA06T0299100ZY	0	-	0	0	1655	0.0000000
zheyou73v0_A06	36507053	36507526	BnaA06T0299200ZY	0	+	0	0	473	0.0000000
zheyou73v0_A06	36507572	36510484	BnaA06T0299300ZY	0	-	0	0	2912	0.0000000
zheyou73v0_A06	36523578	36526860	BnaA06T0299400ZY	0	+	0	0	3282	0.0000000
zheyou73v0_A06	36527195	36529886	BnaA06T0299500ZY	0	-	0	0	2691	0.0000000
zheyou73v0_A06	36532093	36534813	BnaA06T0299600ZY	0	+	0	0	2720	0.0000000
zheyou73v0_A06	36532093	36534813	BnaA06T0299600ZY.1	0	+	0	0	2720	0.0000000
zheyou73v0_A06	36534826	36538210	BnaA06T0299700ZY	0	-	0	0	3384	0.0000000
zheyou73v0_A06	36538390	36540566	BnaA06T0299800ZY	0	+	0	0	2176	0.0000000
zheyou73v0_A06	36544595	36545777	BnaA06T0299900ZY	0	-	0	0	1182	0.0000000
zheyou73v0_A06	36548771	36551003	BnaA06T0300000ZY	0	-	0	0	2232	0.0000000
zheyou73v0_A06	36553253	36553949	BnaA06T0300100ZY	0	-	0	0	696	0.0000000
zheyou73v0_A06	36554768	36558712	BnaA06T0300200ZY	0	+	0	0	3944	0.0000000
zheyou73v0_A06	36559077	36561135	BnaA06T0300300ZY	0	-	0	0	2058	0.0000000
zheyou73v0_A06	36591243	36593410	BnaA06T0300400ZY	0	+	0	0	2167	0.0000000
zheyou73v0_A06	36591243	36593410	BnaA06T0300400ZY.1	0	+	0	0	2167	0.0000000
zheyou73v0_A06	36591243	36593410	BnaA06T0300400ZY.2	0	+	0	0	2167	0.0000000
zheyou73v0_A06	36615282	36617230	BnaA06T0300500ZY	0	+	0	0	1948	0.0000000
zheyou73v0_A06	36619913	36620400	BnaA06T0300600ZY	0	+	0	0	487	0.0000000
zheyou73v0_A06	36629132	36632411	BnaA06T0300700ZY	0	+	0	0	3279	0.0000000
zheyou73v0_A06	36650115	36653358	BnaA06T0300800ZY	0	+	0	0	3243	0.0000000
zheyou73v0_A06	36655565	36658321	BnaA06T0300900ZY	0	-	0	0	2756	0.0000000
zheyou73v0_A06	36659412	36659668	BnaA06T0301000ZY	0	-	0	0	256	0.0000000
zheyou73v0_A06	36662643	36666479	BnaA06T0301100ZY	0	-	0	0	3836	0.0000000
zheyou73v0_A06	36670670	36673755	BnaA06T0301200ZY	0	+	0	0	3085	0.0000000
zheyou73v0_A06	36680509	36681846	BnaA06T0301300ZY	0	+	0	0	1337	0.0000000
zheyou73v0_A06	36683252	36684511	BnaA06T0301400ZY	0	+	0	0	1259	0.0000000
zheyou73v0_A06	36685895	36687565	BnaA06T0301500ZY	0	-	0	0	1670	0.0000000
zheyou73v0_A06	36687808	36692068	BnaA06T0301600ZY	0	+	0	0	4260	0.0000000
zheyou73v0_A06	36692530	36702197	BnaA06T0301700ZY	0	+	0	0	9667	0.0000000
zheyou73v0_A06	36708743	36710254	BnaA06T0301800ZY	0	+	0	0	1511	0.0000000
zheyou73v0_A06	36733933	36735550	BnaA06T0301900ZY	0	-	0	0	1617	0.0000000
zheyou73v0_A06	36740336	36741611	BnaA06T0302000ZY	0	-	0	0	1275	0.0000000
zheyou73v0_A06	36742292	36744182	BnaA06T0302100ZY	0	-	0	0	1890	0.0000000
zheyou73v0_A06	36745139	36746655	BnaA06T0302200ZY	0	-	0	0	1516	0.0000000
zheyou73v0_A06	36745139	36746682	BnaA06T0302200ZY.1	0	-	0	0	1543	0.0000000
zheyou73v0_A06	36750927	36764988	BnaA06T0302300ZY	0	-	0	0	14061	0.0000000
zheyou73v0_A06	36776079	36776694	BnaA06T0302400ZY	0	+	0	0	615	0.0000000
zheyou73v0_A06	36777702	36779115	BnaA06T0302500ZY	0	+	0	0	1413	0.0000000
zheyou73v0_A06	36785151	36787831	BnaA06T0302600ZY	0	+	0	0	2680	0.0000000
zheyou73v0_A06	36789155	36791874	BnaA06T0302700ZY	0	+	0	0	2719	0.0000000
zheyou73v0_A06	36792242	36793658	BnaA06T0302800ZY	0	-	0	0	1416	0.0000000
zheyou73v0_A06	36795997	36798763	BnaA06T0302900ZY	0	+	0	0	2766	0.0000000
zheyou73v0_A06	36800561	36802517	BnaA06T0303000ZY	0	+	0	0	1956	0.0000000
zheyou73v0_A06	36802919	36804565	BnaA06T0303100ZY	0	+	0	0	1646	0.0000000
zheyou73v0_A06	36805454	36806787	BnaA06T0303200ZY	0	+	0	0	1333	0.0000000
zheyou73v0_A06	36807768	36810425	BnaA06T0303300ZY	0	+	0	0	2657	0.0000000
zheyou73v0_A06	36807768	36809586	BnaA06T0303300ZY.1	0	+	0	0	1818	0.0000000
zheyou73v0_A06	36810859	36811676	BnaA06T0303400ZY	0	+	0	0	817	0.0000000
zheyou73v0_A06	36811825	36813069	BnaA06T0303500ZY	0	-	0	0	1244	0.0000000
zheyou73v0_A06	36814304	36815748	BnaA06T0303600ZY	0	+	0	0	1444	0.0000000
zheyou73v0_A06	36815688	36819164	BnaA06T0303700ZY	0	-	0	0	3476	0.0000000
zheyou73v0_A06	36819233	36821131	BnaA06T0303800ZY	0	-	0	0	1898	0.0000000
zheyou73v0_A06	36822283	36824133	BnaA06T0303900ZY	0	+	0	0	1850	0.0000000
zheyou73v0_A06	36828045	36830957	BnaA06T0304000ZY.1	0	-	0	0	2912	0.0000000
zheyou73v0_A06	36828184	36830957	BnaA06T0304000ZY	0	-	0	0	2773	0.0000000
zheyou73v0_A06	36831317	36832580	BnaA06T0304100ZY	0	-	0	0	1263	0.0000000
zheyou73v0_A06	36833304	36833699	BnaA06T0304200ZY	0	-	0	0	395	0.0000000
zheyou73v0_A06	36834111	36834800	BnaA06T0304300ZY	0	-	0	0	689	0.0000000
zheyou73v0_A06	36835202	36835529	BnaA06T0304400ZY	0	+	0	0	327	0.0000000
zheyou73v0_A06	36836595	36839123	BnaA06T0304500ZY	0	+	0	0	2528	0.0000000
zheyou73v0_A06	36836595	36839123	BnaA06T0304500ZY.1	0	+	0	0	2528	0.0000000
zheyou73v0_A06	36839543	36843191	BnaA06T0304600ZY	0	-	0	0	3648	0.0000000
zheyou73v0_A06	36839543	36843191	BnaA06T0304600ZY.1	0	-	0	0	3648	0.0000000
zheyou73v0_A06	36847600	36848326	BnaA06T0304700ZY	0	+	0	0	726	0.0000000
zheyou73v0_A06	36860053	36868048	BnaA06T0304800ZY	0	-	0	0	7995	0.0000000
zheyou73v0_A06	36900151	36902477	BnaA06T0304900ZY	0	+	0	0	2326	0.0000000
zheyou73v0_A06	36903256	36906848	BnaA06T0305000ZY	0	-	0	0	3592	0.0000000
zheyou73v0_A06	36915662	36922456	BnaA06T0305100ZY	0	-	0	0	6794	0.0000000
zheyou73v0_A06	36934297	36936522	BnaA06T0305200ZY	0	+	0	0	2225	0.0000000
zheyou73v0_A06	36938100	36940700	BnaA06T0305300ZY	0	+	0	0	2600	0.0000000
zheyou73v0_A06	36941026	36941973	BnaA06T0305400ZY	0	+	0	0	947	0.0000000
zheyou73v0_A06	36945183	36946564	BnaA06T0305500ZY	0	-	0	0	1381	0.0000000
zheyou73v0_A06	36951466	36954605	BnaA06T0305600ZY	0	-	0	0	3139	0.0000000
zheyou73v0_A06	36951466	36954605	BnaA06T0305600ZY.1	0	-	0	0	3139	0.0000000
zheyou73v0_A06	36956362	36958546	BnaA06T0305700ZY	0	-	0	0	2184	0.0000000
zheyou73v0_A06	36959125	36960097	BnaA06T0305800ZY	0	-	0	0	972	0.0000000
zheyou73v0_A06	36988252	36989662	BnaA06T0305900ZY	0	-	0	0	1410	0.0000000
zheyou73v0_A06	37016141	37018721	BnaA06T0306000ZY	0	+	0	0	2580	0.0000000
zheyou73v0_A06	37020127	37021400	BnaA06T0306100ZY	0	-	0	0	1273	0.0000000
zheyou73v0_A06	37021474	37022433	BnaA06T0306200ZY	0	-	0	0	959	0.0000000
zheyou73v0_A06	37034899	37036874	BnaA06T0306300ZY	0	-	0	0	1975	0.0000000
zheyou73v0_A06	37040168	37041748	BnaA06T0306400ZY	0	-	0	0	1580	0.0000000
zheyou73v0_A06	37040168	37041748	BnaA06T0306400ZY.1	0	-	0	0	1580	0.0000000
zheyou73v0_A06	37042033	37046100	BnaA06T0306500ZY	0	+	0	0	4067	0.0000000
zheyou73v0_A06	37047668	37049347	BnaA06T0306600ZY	0	+	0	0	1679	0.0000000
zheyou73v0_A06	37051297	37051606	BnaA06T0306700ZY	0	+	0	0	309	0.0000000
zheyou73v0_A06	37051948	37052938	BnaA06T0306800ZY	0	-	0	0	990	0.0000000
zheyou73v0_A06	37056684	37059193	BnaA06T0306900ZY	0	+	0	0	2509	0.0000000
zheyou73v0_A06	37059590	37060986	BnaA06T0307000ZY	0	-	0	0	1396	0.0000000
zheyou73v0_A06	37061202	37061589	BnaA06T0307100ZY	0	-	0	0	387	0.0000000
zheyou73v0_A06	37062201	37062785	BnaA06T0307200ZY	0	-	0	0	584	0.0000000
zheyou73v0_A06	37069436	37071862	BnaA06T0307300ZY	0	-	0	0	2426	0.0000000
zheyou73v0_A06	37080617	37082654	BnaA06T0307400ZY	0	+	0	0	2037	0.0000000
zheyou73v0_A06	37080617	37082654	BnaA06T0307400ZY.1	0	+	0	0	2037	0.0000000
zheyou73v0_A06	37080617	37082654	BnaA06T0307400ZY.2	0	+	0	0	2037	0.0000000
zheyou73v0_A06	37091615	37093354	BnaA06T0307500ZY	0	+	0	0	1739	0.0000000
zheyou73v0_A06	37094407	37095271	BnaA06T0307600ZY	0	-	0	0	864	0.0000000
zheyou73v0_A06	37105241	37106901	BnaA06T0307700ZY	0	+	0	0	1660	0.0000000
zheyou73v0_A06	37122450	37123576	BnaA06T0307800ZY	0	+	0	0	1126	0.0000000
zheyou73v0_A06	37141488	37143687	BnaA06T0307900ZY	0	+	0	0	2199	0.0000000
zheyou73v0_A06	37153698	37154598	BnaA06T0308000ZY	0	-	0	0	900	0.0000000
zheyou73v0_A06	37158066	37161337	BnaA06T0308100ZY	0	-	0	0	3271	0.0000000
zheyou73v0_A06	37161669	37162794	BnaA06T0308200ZY	0	-	0	0	1125	0.0000000
zheyou73v0_A06	37168009	37168336	BnaA06T0308300ZY	0	-	0	0	327	0.0000000
zheyou73v0_A06	37181163	37182751	BnaA06T0308400ZY	0	-	0	0	1588	0.0000000
zheyou73v0_A06	37183080	37185487	BnaA06T0308500ZY	0	-	0	0	2407	0.0000000
zheyou73v0_A06	37205816	37208053	BnaA06T0308600ZY	0	+	0	0	2237	0.0000000
zheyou73v0_A06	37217812	37234140	BnaA06T0308700ZY	0	+	0	0	16328	0.0000000
zheyou73v0_A06	37239302	37242260	BnaA06T0308800ZY	0	+	0	0	2958	0.0000000
zheyou73v0_A06	37259220	37259769	BnaA06T0308900ZY	0	+	0	0	549	0.0000000
zheyou73v0_A06	37261317	37262264	BnaA06T0309000ZY	0	+	0	0	947	0.0000000
zheyou73v0_A06	37261317	37262264	BnaA06T0309000ZY.1	0	+	0	0	947	0.0000000
zheyou73v0_A06	37261317	37262264	BnaA06T0309000ZY.2	0	+	0	0	947	0.0000000
zheyou73v0_A06	37265138	37267186	BnaA06T0309100ZY	0	+	0	0	2048	0.0000000
zheyou73v0_A06	37270609	37273264	BnaA06T0309200ZY	0	-	0	0	2655	0.0000000
zheyou73v0_A06	37270609	37273264	BnaA06T0309200ZY.1	0	-	0	0	2655	0.0000000
zheyou73v0_A06	37285641	37286316	BnaA06T0309300ZY	0	+	0	0	675	0.0000000
zheyou73v0_A06	37297479	37300609	BnaA06T0309400ZY	0	-	0	0	3130	0.0000000
zheyou73v0_A06	37305971	37306316	BnaA06T0309500ZY	0	-	0	0	345	0.0000000
zheyou73v0_A06	37306360	37306756	BnaA06T0309600ZY	0	-	0	0	396	0.0000000
zheyou73v0_A06	37306836	37307788	BnaA06T0309700ZY	0	-	0	0	952	0.0000000
zheyou73v0_A06	37313692	37314356	BnaA06T0309800ZY	0	+	0	0	664	0.0000000
zheyou73v0_A06	37320345	37320946	BnaA06T0309900ZY	0	+	0	0	601	0.0000000
zheyou73v0_A06	37333702	37334808	BnaA06T0310000ZY	0	+	0	0	1106	0.0000000
zheyou73v0_A06	37336954	37338598	BnaA06T0310100ZY	0	-	0	0	1644	0.0000000
zheyou73v0_A06	37342357	37344002	BnaA06T0310200ZY	0	-	0	0	1645	0.0000000
zheyou73v0_A06	37345894	37349182	BnaA06T0310300ZY	0	+	0	0	3288	0.0000000
zheyou73v0_A06	37345894	37349182	BnaA06T0310300ZY.1	0	+	0	0	3288	0.0000000
zheyou73v0_A06	37349698	37350851	BnaA06T0310400ZY	0	+	0	0	1153	0.0000000
zheyou73v0_A06	37362042	37362600	BnaA06T0310500ZY	0	-	0	0	558	0.0000000
zheyou73v0_A06	37366668	37369095	BnaA06T0310600ZY	0	+	0	0	2427	0.0000000
zheyou73v0_A06	37369156	37369408	BnaA06T0310700ZY	0	-	0	0	252	0.0000000
zheyou73v0_A06	37369538	37370489	BnaA06T0310800ZY	0	-	0	0	951	0.0000000
zheyou73v0_A06	37370807	37371373	BnaA06T0310900ZY	0	-	0	0	566	0.0000000
zheyou73v0_A06	37373352	37375519	BnaA06T0311000ZY	0	-	0	0	2167	0.0000000
zheyou73v0_A06	37377829	37379051	BnaA06T0311100ZY	0	-	0	0	1222	0.0000000
zheyou73v0_A06	37404873	37408123	BnaA06T0311200ZY	0	-	0	0	3250	0.0000000
zheyou73v0_A06	37409343	37409550	BnaA06T0311300ZY	0	-	0	0	207	0.0000000
zheyou73v0_A06	37409936	37411303	BnaA06T0311400ZY	0	-	0	0	1367	0.0000000
zheyou73v0_A06	37435381	37435753	BnaA06T0311500ZY	0	-	0	0	372	0.0000000
zheyou73v0_A06	37435774	37439164	BnaA06T0311600ZY	0	-	0	0	3390	0.0000000
zheyou73v0_A06	37438763	37440337	BnaA06T0311700ZY	0	+	0	0	1574	0.0000000
zheyou73v0_A06	37443835	37444286	BnaA06T0311800ZY	0	-	0	0	451	0.0000000
zheyou73v0_A06	37444641	37445983	BnaA06T0311900ZY	0	-	0	0	1342	0.0000000
zheyou73v0_A06	37447089	37450260	BnaA06T0312000ZY	0	-	0	0	3171	0.0000000
zheyou73v0_A06	37466808	37467372	BnaA06T0312100ZY	0	+	0	0	564	0.0000000
zheyou73v0_A06	37467505	37470400	BnaA06T0312200ZY	0	+	0	0	2895	0.0000000
zheyou73v0_A06	37470809	37472695	BnaA06T0312300ZY	0	-	0	0	1886	0.0000000
zheyou73v0_A06	37474446	37475209	BnaA06T0312400ZY	0	+	0	0	763	0.0000000
zheyou73v0_A06	37488477	37491292	BnaA06T0312500ZY	0	-	0	0	2815	0.0000000
zheyou73v0_A06	37491819	37501840	BnaA06T0312600ZY	0	+	0	0	10021	0.0000000
zheyou73v0_A06	37527179	37531948	BnaA06T0312700ZY	0	-	0	0	4769	0.0000000
zheyou73v0_A06	37534482	37534901	BnaA06T0312800ZY	0	+	0	0	419	0.0000000
zheyou73v0_A06	37534990	37535344	BnaA06T0312900ZY	0	+	0	0	354	0.0000000
zheyou73v0_A06	37535814	37538121	BnaA06T0313000ZY	0	+	0	0	2307	0.0000000
zheyou73v0_A06	37541220	37541472	BnaA06T0313100ZY	0	+	0	0	252	0.0000000
zheyou73v0_A06	37543398	37546194	BnaA06T0313200ZY	0	-	0	0	2796	0.0000000
zheyou73v0_A06	37546977	37549765	BnaA06T0313300ZY	0	-	0	0	2788	0.0000000
zheyou73v0_A06	37550902	37552024	BnaA06T0313400ZY	0	-	0	0	1122	0.0000000
zheyou73v0_A06	37553921	37554967	BnaA06T0313500ZY	0	-	0	0	1046	0.0000000
zheyou73v0_A06	37558525	37561625	BnaA06T0313600ZY	0	+	0	0	3100	0.0000000
zheyou73v0_A06	37576091	37580038	BnaA06T0313700ZY	0	+	0	0	3947	0.0000000
zheyou73v0_A06	37576091	37580038	BnaA06T0313700ZY.1	0	+	0	0	3947	0.0000000
zheyou73v0_A06	37582129	37583994	BnaA06T0313800ZY	0	-	0	0	1865	0.0000000
zheyou73v0_A06	37587364	37587643	BnaA06T0313900ZY	0	-	0	0	279	0.0000000
zheyou73v0_A06	37588456	37589015	BnaA06T0314000ZY	0	-	0	0	559	0.0000000
zheyou73v0_A06	37590343	37591659	BnaA06T0314100ZY	0	-	0	0	1316	0.0000000
zheyou73v0_A06	37594576	37595039	BnaA06T0314200ZY	0	-	0	0	463	0.0000000
zheyou73v0_A06	37608980	37611566	BnaA06T0314300ZY	0	+	0	0	2586	0.0000000
zheyou73v0_A06	37615626	37617242	BnaA06T0314400ZY	0	-	0	0	1616	0.0000000
zheyou73v0_A06	37632865	37633621	BnaA06T0314500ZY	0	+	0	0	756	0.0000000
zheyou73v0_A06	37636384	37637442	BnaA06T0314600ZY	0	+	0	0	1058	0.0000000
zheyou73v0_A06	37637777	37640116	BnaA06T0314700ZY	0	-	0	0	2339	0.0000000
zheyou73v0_A06	37640478	37642220	BnaA06T0314800ZY	0	+	0	0	1742	0.0000000
zheyou73v0_A06	37640478	37642220	BnaA06T0314800ZY.1	0	+	0	0	1742	0.0000000
zheyou73v0_A06	37645144	37646866	BnaA06T0314900ZY	0	+	0	0	1722	0.0000000
zheyou73v0_A06	37673124	37674107	BnaA06T0315000ZY	0	+	0	0	983	0.0000000
zheyou73v0_A06	37686103	37690052	BnaA06T0315100ZY	0	-	0	0	3949	0.0000000
zheyou73v0_A06	37690114	37691337	BnaA06T0315200ZY	0	-	0	0	1223	0.0000000
zheyou73v0_A06	37695625	37699198	BnaA06T0315300ZY.1	0	-	0	0	3573	0.0000000
zheyou73v0_A06	37695922	37697686	BnaA06T0315400ZY	0	+	0	0	1764	0.0000000
zheyou73v0_A06	37697945	37699198	BnaA06T0315300ZY	0	-	0	0	1253	0.0000000
zheyou73v0_A06	37707415	37713122	BnaA06T0315500ZY	0	-	0	0	5707	0.0000000
zheyou73v0_A06	37723490	37727338	BnaA06T0315600ZY	0	-	0	0	3848	0.0000000
zheyou73v0_A06	37723490	37727338	BnaA06T0315600ZY.1	0	-	0	0	3848	0.0000000
zheyou73v0_A06	37732501	37734255	BnaA06T0315700ZY	0	+	0	0	1754	0.0000000
zheyou73v0_A06	37745870	37751307	BnaA06T0315800ZY	0	+	0	0	5437	0.0000000
zheyou73v0_A06	37751514	37754250	BnaA06T0315900ZY	0	-	0	0	2736	0.0000000
zheyou73v0_A06	37756340	37757610	BnaA06T0316000ZY	0	-	0	0	1270	0.0000000
zheyou73v0_A06	37759739	37761531	BnaA06T0316100ZY	0	+	0	0	1792	0.0000000
zheyou73v0_A06	37761849	37763673	BnaA06T0316200ZY	0	+	0	0	1824	0.0000000
zheyou73v0_A06	37763821	37765651	BnaA06T0316300ZY	0	-	0	0	1830	0.0000000
zheyou73v0_A06	37769575	37771762	BnaA06T0316400ZY	0	+	0	0	2187	0.0000000
zheyou73v0_A06	37773265	37773631	BnaA06T0316500ZY	0	+	0	0	366	0.0000000
zheyou73v0_A06	37780674	37783860	BnaA06T0316600ZY	0	+	0	0	3186	0.0000000
zheyou73v0_A06	37784032	37786417	BnaA06T0316700ZY	0	-	0	0	2385	0.0000000
zheyou73v0_A06	37787290	37789378	BnaA06T0316800ZY	0	-	0	0	2088	0.0000000
zheyou73v0_A06	37789590	37792850	BnaA06T0316900ZY	0	-	0	0	3260	0.0000000
zheyou73v0_A06	37794950	37796338	BnaA06T0317000ZY	0	-	0	0	1388	0.0000000
zheyou73v0_A06	37798221	37800342	BnaA06T0317100ZY	0	-	0	0	2121	0.0000000
zheyou73v0_A06	37811274	37811985	BnaA06T0317200ZY	0	-	0	0	711	0.0000000
zheyou73v0_A06	37821788	37824751	BnaA06T0317300ZY	0	+	0	0	2963	0.0000000
zheyou73v0_A06	37825481	37829351	BnaA06T0317400ZY	0	+	0	0	3870	0.0000000
zheyou73v0_A06	37829434	37830136	BnaA06T0317500ZY	0	-	0	0	702	0.0000000
zheyou73v0_A06	37830804	37835500	BnaA06T0317600ZY	0	+	0	0	4696	0.0000000
zheyou73v0_A06	37835642	37837184	BnaA06T0317700ZY	0	-	0	0	1542	0.0000000
zheyou73v0_A06	37837259	37839025	BnaA06T0317800ZY	0	-	0	0	1766	0.0000000
zheyou73v0_A06	37840370	37841660	BnaA06T0317900ZY	0	-	0	0	1290	0.0000000
zheyou73v0_A06	37847024	37849830	BnaA06T0318000ZY	0	+	0	0	2806	0.0000000
zheyou73v0_A06	37851871	37854174	BnaA06T0318100ZY	0	+	0	0	2303	0.0000000
zheyou73v0_A06	37858926	37864453	BnaA06T0318200ZY	0	-	0	0	5527	0.0000000
zheyou73v0_A06	37858926	37864453	BnaA06T0318200ZY.1	0	-	0	0	5527	0.0000000
zheyou73v0_A06	37859370	37864453	BnaA06T0318200ZY.2	0	-	0	0	5083	0.0000000
zheyou73v0_A06	37869586	37874716	BnaA06T0318300ZY	0	+	0	0	5130	0.0000000
zheyou73v0_A06	37874930	37879317	BnaA06T0318400ZY	0	+	0	0	4387	0.0000000
zheyou73v0_A06	37874930	37879112	BnaA06T0318400ZY.1	0	+	0	0	4182	0.0000000
zheyou73v0_A06	37880994	37891799	BnaA06T0318500ZY	0	+	0	0	10805	0.0000000
zheyou73v0_A06	37892141	37893494	BnaA06T0318600ZY	0	-	0	0	1353	0.0000000
zheyou73v0_A06	37893909	37896803	BnaA06T0318700ZY	0	-	0	0	2894	0.0000000
zheyou73v0_A06	37908885	37911473	BnaA06T0318800ZY	0	+	0	0	2588	0.0000000
zheyou73v0_A06	37908885	37911473	BnaA06T0318800ZY.1	0	+	0	0	2588	0.0000000
zheyou73v0_A06	37914396	37915334	BnaA06T0318900ZY	0	-	0	0	938	0.0000000
zheyou73v0_A06	37921263	37923271	BnaA06T0319000ZY	0	-	0	0	2008	0.0000000
zheyou73v0_A06	37925752	37928533	BnaA06T0319100ZY	0	+	0	0	2781	0.0000000
zheyou73v0_A06	37928642	37934158	BnaA06T0319200ZY	0	+	0	0	5516	0.0000000
zheyou73v0_A06	37948463	37949684	BnaA06T0319300ZY	0	-	0	0	1221	0.0000000
zheyou73v0_A06	37949759	37950205	BnaA06T0319400ZY	0	-	0	0	446	0.0000000
zheyou73v0_A06	37951022	37962005	BnaA06T0319500ZY	0	-	0	0	10983	0.0000000
zheyou73v0_A06	37965504	37966047	BnaA06T0319600ZY	0	-	0	0	543	0.0000000
zheyou73v0_A06	37966646	37969959	BnaA06T0319700ZY	0	-	0	0	3313	0.0000000
zheyou73v0_A06	37972621	37974415	BnaA06T0319800ZY	0	-	0	0	1794	0.0000000
zheyou73v0_A06	37980868	37983389	BnaA06T0319900ZY	0	-	0	0	2521	0.0000000
zheyou73v0_A06	37984270	37986011	BnaA06T0320000ZY	0	+	0	0	1741	0.0000000
zheyou73v0_A06	37991641	37992448	BnaA06T0320100ZY	0	-	0	0	807	0.0000000
zheyou73v0_A06	37992649	37993560	BnaA06T0320200ZY	0	+	0	0	911	0.0000000
zheyou73v0_A06	37993808	37995312	BnaA06T0320300ZY	0	-	0	0	1504	0.0000000
zheyou73v0_A06	37996836	37999878	BnaA06T0320400ZY	0	-	0	0	3042	0.0000000
zheyou73v0_A06	37996993	37999878	BnaA06T0320400ZY.1	0	-	0	0	2885	0.0000000
zheyou73v0_A06	37996993	37999878	BnaA06T0320400ZY.2	0	-	0	0	2885	0.0000000
zheyou73v0_A06	38005221	38007030	BnaA06T0320500ZY	0	+	0	0	1809	0.0000000
zheyou73v0_A06	38007231	38011308	BnaA06T0320600ZY	0	-	0	0	4077	0.0000000
zheyou73v0_A06	38007231	38011308	BnaA06T0320600ZY.1	0	-	0	0	4077	0.0000000
zheyou73v0_A06	38014714	38017931	BnaA06T0320700ZY	0	-	0	0	3217	0.0000000
zheyou73v0_A06	38023608	38023963	BnaA06T0320800ZY	0	+	0	0	355	0.0000000
zheyou73v0_A06	38026121	38027581	BnaA06T0320900ZY	0	-	0	0	1460	0.0000000
zheyou73v0_A06	38030712	38039171	BnaA06T0321000ZY	0	+	0	0	8459	0.0000000
zheyou73v0_A06	38044796	38046815	BnaA06T0321100ZY	0	-	0	0	2019	0.0000000
zheyou73v0_A06	38049444	38050869	BnaA06T0321200ZY	0	-	0	0	1425	0.0000000
zheyou73v0_A06	38061489	38061843	BnaA06T0321300ZY	0	-	0	0	354	0.0000000
zheyou73v0_A06	38061892	38070716	BnaA06T0321400ZY	0	-	0	0	8824	0.0000000
zheyou73v0_A06	38074595	38077062	BnaA06T0321500ZY	0	-	0	0	2467	0.0000000
zheyou73v0_A06	38078624	38078927	BnaA06T0321600ZY	0	+	0	0	303	0.0000000
zheyou73v0_A06	38082865	38087024	BnaA06T0321700ZY	0	+	0	0	4159	0.0000000
zheyou73v0_A06	38087736	38090767	BnaA06T0321800ZY	0	+	0	0	3031	0.0000000
zheyou73v0_A06	38088817	38090527	BnaA06T0321800ZY.1	0	+	0	0	1710	0.0000000
zheyou73v0_A06	38093365	38093596	BnaA06T0321900ZY	0	-	0	0	231	0.0000000
zheyou73v0_A06	38093982	38095357	BnaA06T0322000ZY	0	+	0	0	1375	0.0000000
zheyou73v0_A06	38095855	38098988	BnaA06T0322100ZY	0	-	0	0	3133	0.0000000
zheyou73v0_A06	38106583	38108518	BnaA06T0322200ZY	0	-	0	0	1935	0.0000000
zheyou73v0_A06	38108887	38118399	BnaA06T0322300ZY	0	+	0	0	9512	0.0000000
zheyou73v0_A06	38122065	38125116	BnaA06T0322400ZY	0	+	0	0	3051	0.0000000
zheyou73v0_A06	38125868	38127218	BnaA06T0322500ZY	0	+	0	0	1350	0.0000000
zheyou73v0_A06	38128867	38131788	BnaA06T0322600ZY	0	+	0	0	2921	0.0000000
zheyou73v0_A06	38136719	38139405	BnaA06T0322700ZY	0	-	0	0	2686	0.0000000
zheyou73v0_A06	38140915	38142098	BnaA06T0322800ZY	0	-	0	0	1183	0.0000000
zheyou73v0_A06	38159245	38161748	BnaA06T0322900ZY	0	-	0	0	2503	0.0000000
zheyou73v0_A06	38180944	38185397	BnaA06T0323000ZY	0	-	0	0	4453	0.0000000
zheyou73v0_A06	38188428	38191138	BnaA06T0323100ZY	0	-	0	0	2710	0.0000000
zheyou73v0_A06	38191921	38193351	BnaA06T0323200ZY	0	+	0	0	1430	0.0000000
zheyou73v0_A06	38193550	38196319	BnaA06T0323300ZY	0	-	0	0	2769	0.0000000
zheyou73v0_A06	38199330	38201855	BnaA06T0323400ZY	0	+	0	0	2525	0.0000000
zheyou73v0_A06	38202239	38204013	BnaA06T0323500ZY	0	-	0	0	1774	0.0000000
zheyou73v0_A06	38215947	38221024	BnaA06T0323600ZY	0	+	0	0	5077	0.0000000
zheyou73v0_A06	38215947	38221024	BnaA06T0323600ZY.1	0	+	0	0	5077	0.0000000
zheyou73v0_A06	38221509	38222688	BnaA06T0323700ZY	0	+	0	0	1179	0.0000000
zheyou73v0_A06	38221509	38222688	BnaA06T0323700ZY.1	0	+	0	0	1179	0.0000000
zheyou73v0_A06	38233972	38234524	BnaA06T0323800ZY	0	-	0	0	552	0.0000000
zheyou73v0_A06	38238792	38240577	BnaA06T0323900ZY	0	-	0	0	1785	0.0000000
zheyou73v0_A06	38256647	38259260	BnaA06T0324000ZY	0	-	0	0	2613	0.0000000
zheyou73v0_A06	38263582	38265376	BnaA06T0324100ZY	0	-	0	0	1794	0.0000000
zheyou73v0_A06	38269608	38272338	BnaA06T0324200ZY	0	-	0	0	2730	0.0000000
zheyou73v0_A06	38277948	38278535	BnaA06T0324300ZY	0	+	0	0	587	0.0000000
zheyou73v0_A06	38279877	38280324	BnaA06T0324400ZY	0	+	0	0	447	0.0000000
zheyou73v0_A06	38281792	38283666	BnaA06T0324500ZY	0	+	0	0	1874	0.0000000
zheyou73v0_A06	38283459	38286900	BnaA06T0324600ZY	0	-	0	0	3441	0.0000000
zheyou73v0_A06	38283459	38286900	BnaA06T0324600ZY.1	0	-	0	0	3441	0.0000000
zheyou73v0_A06	38294261	38295765	BnaA06T0324700ZY	0	-	0	0	1504	0.0000000
zheyou73v0_A06	38297708	38300063	BnaA06T0324800ZY	0	-	0	0	2355	0.0000000
zheyou73v0_A06	38311482	38313221	BnaA06T0324900ZY	0	+	0	0	1739	0.0000000
zheyou73v0_A06	38311482	38313221	BnaA06T0324900ZY.1	0	+	0	0	1739	0.0000000
zheyou73v0_A06	38319830	38320007	BnaA06T0325000ZY	0	-	0	0	177	0.0000000
zheyou73v0_A06	38322066	38322635	BnaA06T0325100ZY	0	-	0	0	569	0.0000000
zheyou73v0_A06	38336241	38337945	BnaA06T0325200ZY	0	+	0	0	1704	0.0000000
zheyou73v0_A06	38338997	38339283	BnaA06T0325300ZY	0	-	0	0	286	0.0000000
zheyou73v0_A06	38352478	38353036	BnaA06T0325400ZY	0	-	0	0	558	0.0000000
zheyou73v0_A06	38354524	38358039	BnaA06T0325500ZY	0	+	0	0	3515	0.0000000
zheyou73v0_A06	38361758	38363528	BnaA06T0325600ZY	0	+	0	0	1770	0.0000000
zheyou73v0_A06	38361758	38363528	BnaA06T0325600ZY.1	0	+	0	0	1770	0.0000000
zheyou73v0_A06	38363548	38366457	BnaA06T0325700ZY	0	-	0	0	2909	0.0000000
zheyou73v0_A06	38366665	38375806	BnaA06T0325800ZY	0	-	0	0	9141	0.0000000
zheyou73v0_A06	38381154	38394908	BnaA06T0325900ZY	0	-	0	0	13754	0.0000000
zheyou73v0_A06	38402931	38404188	BnaA06T0326000ZY	0	+	0	0	1257	0.0000000
zheyou73v0_A06	38404992	38406179	BnaA06T0326100ZY	0	+	0	0	1187	0.0000000
zheyou73v0_A06	38406092	38411862	BnaA06T0326200ZY	0	-	0	0	5770	0.0000000
zheyou73v0_A06	38413456	38415302	BnaA06T0326300ZY	0	+	0	0	1846	0.0000000
zheyou73v0_A06	38422194	38424837	BnaA06T0326400ZY.1	0	+	0	0	2643	0.0000000
zheyou73v0_A06	38422391	38424837	BnaA06T0326400ZY	0	+	0	0	2446	0.0000000
zheyou73v0_A06	38425062	38429145	BnaA06T0326500ZY	0	-	0	0	4083	0.0000000
zheyou73v0_A06	38439144	38440676	BnaA06T0326600ZY	0	-	0	0	1532	0.0000000
zheyou73v0_A06	38439144	38440676	BnaA06T0326600ZY.1	0	-	0	0	1532	0.0000000
zheyou73v0_A06	38441593	38442151	BnaA06T0326700ZY	0	+	0	0	558	0.0000000
zheyou73v0_A06	38447385	38448744	BnaA06T0326800ZY	0	+	0	0	1359	0.0000000
zheyou73v0_A06	38450154	38453075	BnaA06T0326900ZY	0	-	0	0	2921	0.0000000
zheyou73v0_A06	38450154	38452184	BnaA06T0326900ZY.1	0	-	0	0	2030	0.0000000
zheyou73v0_A06	38457375	38458643	BnaA06T0327000ZY	0	+	0	0	1268	0.0000000
zheyou73v0_A06	38460425	38461463	BnaA06T0327100ZY	0	-	0	0	1038	0.0000000
zheyou73v0_A06	38467133	38470806	BnaA06T0327200ZY	0	-	0	0	3673	0.0000000
zheyou73v0_A06	38481927	38482489	BnaA06T0327300ZY	0	+	0	0	562	0.0000000
zheyou73v0_A06	38487113	38488931	BnaA06T0327400ZY	0	+	0	0	1818	0.0000000
zheyou73v0_A06	38491773	38496266	BnaA06T0327500ZY	0	-	0	0	4493	0.0000000
zheyou73v0_A06	38498532	38499526	BnaA06T0327600ZY	0	-	0	0	994	0.0000000
zheyou73v0_A06	38501845	38502927	BnaA06T0327700ZY	0	-	0	0	1082	0.0000000
zheyou73v0_A06	38510912	38512306	BnaA06T0327800ZY.1	0	-	0	0	1394	0.0000000
zheyou73v0_A06	38511225	38512306	BnaA06T0327800ZY	0	-	0	0	1081	0.0000000
zheyou73v0_A06	38512681	38512993	BnaA06T0327900ZY	0	+	0	0	312	0.0000000
zheyou73v0_A06	38513691	38514112	BnaA06T0328000ZY	0	-	0	0	421	0.0000000
zheyou73v0_A06	38519089	38521314	BnaA06T0328100ZY	0	+	0	0	2225	0.0000000
zheyou73v0_A06	38521477	38523994	BnaA06T0328200ZY	0	-	0	0	2517	0.0000000
zheyou73v0_A06	38533483	38535266	BnaA06T0328300ZY	0	+	0	0	1783	0.0000000
zheyou73v0_A06	38536976	38537631	BnaA06T0328400ZY	0	-	0	0	655	0.0000000
zheyou73v0_A06	38538341	38540552	BnaA06T0328500ZY	0	+	0	0	2211	0.0000000
zheyou73v0_A06	38545766	38547707	BnaA06T0328600ZY	0	-	0	0	1941	0.0000000
zheyou73v0_A06	38556539	38558634	BnaA06T0328700ZY	0	+	0	0	2095	0.0000000
zheyou73v0_A06	38562731	38563623	BnaA06T0328800ZY	0	-	0	0	892	0.0000000
zheyou73v0_A06	38570750	38572523	BnaA06T0328900ZY	0	+	0	0	1773	0.0000000
zheyou73v0_A06	38573073	38574630	BnaA06T0329000ZY	0	-	0	0	1557	0.0000000
zheyou73v0_A06	38590091	38590733	BnaA06T0329100ZY	0	+	0	0	642	0.0000000
zheyou73v0_A06	38593053	38593904	BnaA06T0329200ZY	0	+	0	0	851	0.0000000
zheyou73v0_A06	38598542	38599874	BnaA06T0329300ZY	0	+	0	0	1332	0.0000000
zheyou73v0_A06	38608804	38609798	BnaA06T0329400ZY	0	-	0	0	994	0.0000000
zheyou73v0_A06	38623111	38624409	BnaA06T0329500ZY	0	+	0	0	1298	0.0000000
zheyou73v0_A06	38635619	38638062	BnaA06T0329600ZY	0	+	0	0	2443	0.0000000
zheyou73v0_A06	38635619	38638062	BnaA06T0329600ZY.1	0	+	0	0	2443	0.0000000
zheyou73v0_A06	38638846	38643278	BnaA06T0329700ZY	0	-	0	0	4432	0.0000000
zheyou73v0_A06	38638846	38643278	BnaA06T0329700ZY.1	0	-	0	0	4432	0.0000000
zheyou73v0_A06	38656547	38657171	BnaA06T0329800ZY	0	+	0	0	624	0.0000000
zheyou73v0_A06	38657484	38657832	BnaA06T0329900ZY	0	+	0	0	348	0.0000000
zheyou73v0_A06	38661363	38666297	BnaA06T0330000ZY	0	+	0	0	4934	0.0000000
zheyou73v0_A06	38661363	38666297	BnaA06T0330000ZY.1	0	+	0	0	4934	0.0000000
zheyou73v0_A06	38667514	38669918	BnaA06T0330100ZY	0	+	0	0	2404	0.0000000
zheyou73v0_A06	38669923	38673690	BnaA06T0330200ZY	0	-	0	0	3767	0.0000000
zheyou73v0_A06	38669923	38672461	BnaA06T0330200ZY.1	0	-	0	0	2538	0.0000000
zheyou73v0_A06	38669923	38672461	BnaA06T0330200ZY.2	0	-	0	0	2538	0.0000000
zheyou73v0_A06	38678461	38679677	BnaA06T0330300ZY	0	+	0	0	1216	0.0000000
zheyou73v0_A06	38680350	38681509	BnaA06T0330400ZY	0	+	0	0	1159	0.0000000
zheyou73v0_A06	38682078	38683884	BnaA06T0330500ZY	0	-	0	0	1806	0.0000000
zheyou73v0_A06	38686148	38694897	BnaA06T0330600ZY	0	-	0	0	8749	0.0000000
zheyou73v0_A06	38705108	38706514	BnaA06T0330700ZY	0	+	0	0	1406	0.0000000
zheyou73v0_A06	38707628	38708833	BnaA06T0330800ZY	0	+	0	0	1205	0.0000000
zheyou73v0_A06	38711935	38714926	BnaA06T0330900ZY	0	-	0	0	2991	0.0000000
zheyou73v0_A06	38715900	38719282	BnaA06T0331000ZY	0	+	0	0	3382	0.0000000
zheyou73v0_A06	38721826	38722092	BnaA06T0331100ZY	0	+	0	0	266	0.0000000
zheyou73v0_A06	38723932	38725484	BnaA06T0331200ZY	0	-	0	0	1552	0.0000000
zheyou73v0_A06	38728399	38730839	BnaA06T0331300ZY	0	-	0	0	2440	0.0000000
zheyou73v0_A06	38728399	38730839	BnaA06T0331300ZY.1	0	-	0	0	2440	0.0000000
zheyou73v0_A06	38734937	38736342	BnaA06T0331400ZY	0	+	0	0	1405	0.0000000
zheyou73v0_A06	38750645	38751884	BnaA06T0331500ZY	0	+	0	0	1239	0.0000000
zheyou73v0_A06	38751659	38753654	BnaA06T0331600ZY	0	-	0	0	1995	0.0000000
zheyou73v0_A06	38754330	38759359	BnaA06T0331700ZY.1	0	+	0	0	5029	0.0000000
zheyou73v0_A06	38754330	38759359	BnaA06T0331700ZY.2	0	+	0	0	5029	0.0000000
zheyou73v0_A06	38754694	38759359	BnaA06T0331700ZY	0	+	0	0	4665	0.0000000
zheyou73v0_A06	38758919	38760054	BnaA06T0331800ZY	0	-	0	0	1135	0.0000000
zheyou73v0_A06	38760536	38762104	BnaA06T0331900ZY	0	-	0	0	1568	0.0000000
zheyou73v0_A06	38760536	38762104	BnaA06T0331900ZY.1	0	-	0	0	1568	0.0000000
zheyou73v0_A06	38760536	38762104	BnaA06T0331900ZY.2	0	-	0	0	1568	0.0000000
zheyou73v0_A06	38765229	38766831	BnaA06T0332000ZY	0	+	0	0	1602	0.0000000
zheyou73v0_A06	38767326	38768185	BnaA06T0332100ZY	0	+	0	0	859	0.0000000
zheyou73v0_A06	38768939	38771307	BnaA06T0332200ZY	0	+	0	0	2368	0.0000000
zheyou73v0_A06	38771696	38774641	BnaA06T0332300ZY	0	-	0	0	2945	0.0000000
zheyou73v0_A06	38777418	38779644	BnaA06T0332400ZY	0	-	0	0	2226	0.0000000
zheyou73v0_A06	38804332	38806971	BnaA06T0332500ZY	0	-	0	0	2639	0.0000000
zheyou73v0_A06	38816061	38817608	BnaA06T0332600ZY	0	+	0	0	1547	0.0000000
zheyou73v0_A06	38821138	38823567	BnaA06T0332700ZY	0	-	0	0	2429	0.0000000
zheyou73v0_A06	38821359	38823567	BnaA06T0332700ZY.1	0	-	0	0	2208	0.0000000
zheyou73v0_A06	38823671	38825005	BnaA06T0332800ZY.1	0	+	0	0	1334	0.0000000
zheyou73v0_A06	38823856	38825005	BnaA06T0332800ZY	0	+	0	0	1149	0.0000000
zheyou73v0_A06	38823856	38825005	BnaA06T0332800ZY.2	0	+	0	0	1149	0.0000000
zheyou73v0_A06	38825266	38827832	BnaA06T0332900ZY	0	-	0	0	2566	0.0000000
zheyou73v0_A06	38829653	38832608	BnaA06T0333000ZY	0	-	0	0	2955	0.0000000
zheyou73v0_A06	38835142	38844197	BnaA06T0333100ZY	0	+	0	0	9055	0.0000000
zheyou73v0_A06	38845174	38848769	BnaA06T0333200ZY	0	+	0	0	3595	0.0000000
zheyou73v0_A06	38853515	38855568	BnaA06T0333300ZY	0	-	0	0	2053	0.0000000
zheyou73v0_A06	38863243	38866362	BnaA06T0333400ZY	0	-	0	0	3119	0.0000000
zheyou73v0_A06	38871413	38872999	BnaA06T0333500ZY	0	-	0	0	1586	0.0000000
zheyou73v0_A06	38876683	38877479	BnaA06T0333600ZY	0	-	0	0	796	0.0000000
zheyou73v0_A06	38880113	38883700	BnaA06T0333700ZY	0	+	0	0	3587	0.0000000
zheyou73v0_A06	38887494	38888906	BnaA06T0333800ZY	0	+	0	0	1412	0.0000000
zheyou73v0_A06	38887494	38888906	BnaA06T0333800ZY.1	0	+	0	0	1412	0.0000000
zheyou73v0_A06	38889486	38891930	BnaA06T0333900ZY	0	+	0	0	2444	0.0000000
zheyou73v0_A06	38889486	38891930	BnaA06T0333900ZY.1	0	+	0	0	2444	0.0000000
zheyou73v0_A06	38896321	38899413	BnaA06T0334000ZY	0	+	0	0	3092	0.0000000
zheyou73v0_A06	38905747	38910400	BnaA06T0334100ZY	0	+	0	0	4653	0.0000000
zheyou73v0_A06	38922496	38924760	BnaA06T0334200ZY	0	-	0	0	2264	0.0000000
zheyou73v0_A06	38927979	38929438	BnaA06T0334300ZY	0	+	0	0	1459	0.0000000
zheyou73v0_A06	38929698	38931593	BnaA06T0334400ZY	0	-	0	0	1895	0.0000000
zheyou73v0_A06	38932672	38934626	BnaA06T0334500ZY	0	+	0	0	1954	0.0000000
zheyou73v0_A06	38935161	38937341	BnaA06T0334600ZY	0	-	0	0	2180	0.0000000
zheyou73v0_A06	38939574	38940048	BnaA06T0334700ZY	0	-	0	0	474	0.0000000
zheyou73v0_A06	38942326	38942944	BnaA06T0334800ZY	0	-	0	0	618	0.0000000
zheyou73v0_A06	38943518	38943896	BnaA06T0334900ZY	0	+	0	0	378	0.0000000
zheyou73v0_A06	38944549	38945134	BnaA06T0335000ZY	0	-	0	0	585	0.0000000
zheyou73v0_A06	38947143	38949987	BnaA06T0335100ZY	0	+	0	0	2844	0.0000000
zheyou73v0_A06	38956980	38959005	BnaA06T0335200ZY	0	-	0	0	2025	0.0000000
zheyou73v0_A06	38969608	38973118	BnaA06T0335300ZY	0	+	0	0	3510	0.0000000
zheyou73v0_A06	38969608	38973551	BnaA06T0335300ZY.1	0	+	0	0	3943	0.0000000
zheyou73v0_A06	38973749	38974638	BnaA06T0335400ZY	0	-	0	0	889	0.0000000
zheyou73v0_A06	38977421	38978539	BnaA06T0335500ZY	0	+	0	0	1118	0.0000000
zheyou73v0_A06	38978810	38980828	BnaA06T0335600ZY	0	-	0	0	2018	0.0000000
zheyou73v0_A06	38982793	38984563	BnaA06T0335700ZY	0	+	0	0	1770	0.0000000
zheyou73v0_A06	38987920	38989314	BnaA06T0335800ZY	0	+	0	0	1394	0.0000000
zheyou73v0_A06	38987920	38988941	BnaA06T0335800ZY.1	0	+	0	0	1021	0.0000000
zheyou73v0_A06	38987920	38988941	BnaA06T0335800ZY.2	0	+	0	0	1021	0.0000000
zheyou73v0_A06	38990039	38994315	BnaA06T0335900ZY	0	-	0	0	4276	0.0000000
zheyou73v0_A06	39014056	39015313	BnaA06T0336000ZY	0	-	0	0	1257	0.0000000
zheyou73v0_A06	39027346	39028433	BnaA06T0336100ZY	0	-	0	0	1087	0.0000000
zheyou73v0_A06	39035476	39040523	BnaA06T0336200ZY	0	+	0	0	5047	0.0000000
zheyou73v0_A06	39042061	39049440	BnaA06T0336300ZY	0	+	0	0	7379	0.0000000
zheyou73v0_A06	39050079	39050922	BnaA06T0336400ZY.2	0	+	0	0	843	0.0000000
zheyou73v0_A06	39050182	39050922	BnaA06T0336400ZY.1	0	+	0	0	740	0.0000000
zheyou73v0_A06	39050259	39050922	BnaA06T0336400ZY	0	+	0	0	663	0.0000000
zheyou73v0_A06	39066036	39067899	BnaA06T0336500ZY	0	+	0	0	1863	0.0000000
zheyou73v0_A06	39068436	39072032	BnaA06T0336600ZY	0	-	0	0	3596	0.0000000
zheyou73v0_A06	39068436	39071913	BnaA06T0336600ZY.1	0	-	0	0	3477	0.0000000
zheyou73v0_A06	39076955	39077460	BnaA06T0336700ZY	0	+	0	0	505	0.0000000
zheyou73v0_A06	39083938	39086625	BnaA06T0336800ZY	0	+	0	0	2687	0.0000000
zheyou73v0_A06	39083938	39086633	BnaA06T0336800ZY.1	0	+	0	0	2695	0.0000000
zheyou73v0_A06	39083938	39086078	BnaA06T0336800ZY.2	0	+	0	0	2140	0.0000000
zheyou73v0_A06	39087502	39091173	BnaA06T0336900ZY	0	-	0	0	3671	0.0000000
zheyou73v0_A06	39093850	39096077	BnaA06T0337000ZY	0	+	0	0	2227	0.0000000
zheyou73v0_A06	39104392	39104963	BnaA06T0337100ZY	0	+	0	0	571	0.0000000
zheyou73v0_A06	39106167	39109077	BnaA06T0337200ZY	0	+	0	0	2910	0.0000000
zheyou73v0_A06	39109584	39110235	BnaA06T0337300ZY	0	+	0	0	651	0.0000000
zheyou73v0_A06	39111577	39112076	BnaA06T0337400ZY	0	+	0	0	499	0.0000000
zheyou73v0_A06	39112514	39113933	BnaA06T0337500ZY	0	-	0	0	1419	0.0000000
zheyou73v0_A06	39115610	39116164	BnaA06T0337600ZY	0	+	0	0	554	0.0000000
zheyou73v0_A06	39116654	39120392	BnaA06T0337700ZY	0	-	0	0	3738	0.0000000
zheyou73v0_A06	39130400	39133200	BnaA06T0337800ZY	0	+	0	0	2800	0.0000000
zheyou73v0_A06	39139098	39140567	BnaA06T0337900ZY	0	-	0	0	1469	0.0000000
zheyou73v0_A06	39161671	39162766	BnaA06T0338000ZY	0	+	0	0	1095	0.0000000
zheyou73v0_A06	39167705	39168486	BnaA06T0338100ZY	0	+	0	0	781	0.0000000
zheyou73v0_A06	39168428	39169567	BnaA06T0338200ZY	0	-	0	0	1139	0.0000000
zheyou73v0_A06	39170812	39171588	BnaA06T0338300ZY	0	+	0	0	776	0.0000000
zheyou73v0_A06	39182484	39182745	BnaA06T0338400ZY	0	-	0	0	261	0.0000000
zheyou73v0_A06	39184066	39184782	BnaA06T0338500ZY	0	+	0	0	716	0.0000000
zheyou73v0_A06	39188042	39190553	BnaA06T0338600ZY	0	+	0	0	2511	0.0000000
zheyou73v0_A06	39191722	39193684	BnaA06T0338700ZY	0	+	0	0	1962	0.0000000
zheyou73v0_A06	39196492	39199187	BnaA06T0338800ZY	0	-	0	0	2695	0.0000000
zheyou73v0_A06	39200394	39202509	BnaA06T0338900ZY	0	-	0	0	2115	0.0000000
zheyou73v0_A06	39204532	39207041	BnaA06T0339000ZY	0	-	0	0	2509	0.0000000
zheyou73v0_A06	39204532	39207041	BnaA06T0339000ZY.1	0	-	0	0	2509	0.0000000
zheyou73v0_A06	39204532	39207041	BnaA06T0339000ZY.2	0	-	0	0	2509	0.0000000
zheyou73v0_A06	39216260	39216879	BnaA06T0339100ZY	0	+	0	0	619	0.0000000
zheyou73v0_A06	39217241	39218265	BnaA06T0339200ZY	0	+	0	0	1024	0.0000000
zheyou73v0_A06	39237307	39239127	BnaA06T0339300ZY	0	+	0	0	1820	0.0000000
zheyou73v0_A06	39239921	39244308	BnaA06T0339400ZY	0	+	0	0	4387	0.0000000
zheyou73v0_A06	39245295	39249654	BnaA06T0339500ZY	0	+	0	0	4359	0.0000000
zheyou73v0_A06	39250043	39255451	BnaA06T0339600ZY	0	+	0	0	5408	0.0000000
zheyou73v0_A06	39259202	39262704	BnaA06T0339700ZY	0	+	0	0	3502	0.0000000
zheyou73v0_A06	39259202	39262704	BnaA06T0339700ZY.1	0	+	0	0	3502	0.0000000
zheyou73v0_A06	39270779	39272612	BnaA06T0339800ZY	0	+	0	0	1833	0.0000000
zheyou73v0_A06	39271043	39272612	BnaA06T0339800ZY.1	0	+	0	0	1569	0.0000000
zheyou73v0_A06	39274013	39275851	BnaA06T0339900ZY	0	+	0	0	1838	0.0000000
zheyou73v0_A06	39280933	39286574	BnaA06T0340000ZY	0	+	0	0	5641	0.0000000
zheyou73v0_A06	39289956	39295165	BnaA06T0340100ZY	0	+	0	0	5209	0.0000000
zheyou73v0_A06	39295684	39302142	BnaA06T0340200ZY.1	0	-	0	0	6458	0.0000000
zheyou73v0_A06	39295823	39302142	BnaA06T0340200ZY	0	-	0	0	6319	0.0000000
zheyou73v0_A06	39305876	39308594	BnaA06T0340300ZY	0	+	0	0	2718	0.0000000
zheyou73v0_A06	39337352	39339066	BnaA06T0340400ZY	0	-	0	0	1714	0.0000000
zheyou73v0_A06	39352597	39353892	BnaA06T0340500ZY	0	-	0	0	1295	0.0000000
zheyou73v0_A06	39379263	39379569	BnaA06T0340600ZY	0	-	0	0	306	0.0000000
zheyou73v0_A06	39387026	39387881	BnaA06T0340700ZY	0	-	0	0	855	0.0000000
zheyou73v0_A06	39389798	39392459	BnaA06T0340800ZY	0	+	0	0	2661	0.0000000
zheyou73v0_A06	39395174	39396496	BnaA06T0340900ZY	0	+	0	0	1322	0.0000000
zheyou73v0_A06	39397362	39398539	BnaA06T0341000ZY	0	-	0	0	1177	0.0000000
zheyou73v0_A06	39406968	39408787	BnaA06T0341100ZY	0	+	0	0	1819	0.0000000
zheyou73v0_A06	39409380	39410764	BnaA06T0341200ZY	0	-	0	0	1384	0.0000000
zheyou73v0_A06	39411206	39412250	BnaA06T0341300ZY	0	-	0	0	1044	0.0000000
zheyou73v0_A06	39422469	39423299	BnaA06T0341400ZY	0	-	0	0	830	0.0000000
zheyou73v0_A06	39424471	39425697	BnaA06T0341500ZY	0	-	0	0	1226	0.0000000
zheyou73v0_A06	39426058	39429195	BnaA06T0341600ZY	0	-	0	0	3137	0.0000000
zheyou73v0_A06	39429899	39431137	BnaA06T0341700ZY	0	-	0	0	1238	0.0000000
zheyou73v0_A06	39431669	39432298	BnaA06T0341800ZY	0	+	0	0	629	0.0000000
zheyou73v0_A06	39432898	39437531	BnaA06T0341900ZY	0	+	0	0	4633	0.0000000
zheyou73v0_A06	39437869	39438427	BnaA06T0342000ZY	0	+	0	0	558	0.0000000
zheyou73v0_A06	39438931	39441832	BnaA06T0342100ZY	0	+	0	0	2901	0.0000000
zheyou73v0_A06	39441699	39444246	BnaA06T0342200ZY	0	-	0	0	2547	0.0000000
zheyou73v0_A06	39444422	39449226	BnaA06T0342300ZY	0	-	0	0	4804	0.0000000
zheyou73v0_A06	39444422	39449226	BnaA06T0342300ZY.1	0	-	0	0	4804	0.0000000
zheyou73v0_A06	39450763	39454942	BnaA06T0342400ZY	0	-	0	0	4179	0.0000000
zheyou73v0_A06	39455416	39459943	BnaA06T0342500ZY	0	-	0	0	4527	0.0000000
zheyou73v0_A06	39467356	39469339	BnaA06T0342600ZY	0	+	0	0	1983	0.0000000
zheyou73v0_A06	39469635	39471587	BnaA06T0342700ZY	0	-	0	0	1952	0.0000000
zheyou73v0_A06	39478118	39478836	BnaA06T0342800ZY	0	+	0	0	718	0.0000000
zheyou73v0_A06	39479105	39480014	BnaA06T0342900ZY	0	-	0	0	909	0.0000000
zheyou73v0_A06	39492035	39494102	BnaA06T0343000ZY	0	-	0	0	2067	0.0000000
zheyou73v0_A06	39494245	39495821	BnaA06T0343100ZY	0	-	0	0	1576	0.0000000
zheyou73v0_A06	39500913	39501312	BnaA06T0343200ZY	0	-	0	0	399	0.0000000
zheyou73v0_A06	39502141	39503056	BnaA06T0343300ZY	0	-	0	0	915	0.0000000
zheyou73v0_A06	39515271	39515939	BnaA06T0343400ZY	0	-	0	0	668	0.0000000
zheyou73v0_A06	39517997	39519237	BnaA06T0343500ZY	0	+	0	0	1240	0.0000000
zheyou73v0_A06	39527671	39528574	BnaA06T0343600ZY	0	-	0	0	903	0.0000000
zheyou73v0_A06	39536444	39539983	BnaA06T0343700ZY	0	-	0	0	3539	0.0000000
zheyou73v0_A06	39540799	39542879	BnaA06T0343800ZY	0	-	0	0	2080	0.0000000
zheyou73v0_A06	39543073	39544921	BnaA06T0343900ZY	0	+	0	0	1848	0.0000000
zheyou73v0_A06	39543073	39544921	BnaA06T0343900ZY.1	0	+	0	0	1848	0.0000000
zheyou73v0_A06	39545981	39548540	BnaA06T0344000ZY	0	+	0	0	2559	0.0000000
zheyou73v0_A06	39545981	39548540	BnaA06T0344000ZY.1	0	+	0	0	2559	0.0000000
zheyou73v0_A06	39548815	39551839	BnaA06T0344100ZY	0	+	0	0	3024	0.0000000
zheyou73v0_A06	39548815	39551839	BnaA06T0344100ZY.1	0	+	0	0	3024	0.0000000
zheyou73v0_A06	39559067	39564490	BnaA06T0344200ZY	0	-	0	0	5423	0.0000000
zheyou73v0_A06	39559067	39564490	BnaA06T0344200ZY.1	0	-	0	0	5423	0.0000000
zheyou73v0_A06	39573622	39575805	BnaA06T0344300ZY	0	+	0	0	2183	0.0000000
zheyou73v0_A06	39576496	39578997	BnaA06T0344400ZY	0	-	0	0	2501	0.0000000
zheyou73v0_A06	39583759	39588304	BnaA06T0344500ZY	0	-	0	0	4545	0.0000000
zheyou73v0_A06	39588866	39590773	BnaA06T0344600ZY	0	-	0	0	1907	0.0000000
zheyou73v0_A06	39595248	39597243	BnaA06T0344700ZY	0	-	0	0	1995	0.0000000
zheyou73v0_A06	39604639	39605326	BnaA06T0344800ZY	0	-	0	0	687	0.0000000
zheyou73v0_A06	39608019	39615025	BnaA06T0344900ZY	0	-	0	0	7006	0.0000000
zheyou73v0_A06	39615879	39618713	BnaA06T0345000ZY	0	-	0	0	2834	0.0000000
zheyou73v0_A06	39620408	39622647	BnaA06T0345100ZY	0	-	0	0	2239	0.0000000
zheyou73v0_A06	39626657	39629735	BnaA06T0345200ZY	0	+	0	0	3078	0.0000000
zheyou73v0_A06	39631941	39633797	BnaA06T0345300ZY	0	+	0	0	1856	0.0000000
zheyou73v0_A06	39631941	39633797	BnaA06T0345300ZY.1	0	+	0	0	1856	0.0000000
zheyou73v0_A06	39633919	39645164	BnaA06T0345400ZY	0	+	0	0	11245	0.0000000
zheyou73v0_A06	39645174	39646057	BnaA06T0345500ZY	0	-	0	0	883	0.0000000
zheyou73v0_A06	39646598	39647511	BnaA06T0345600ZY	0	+	0	0	913	0.0000000
zheyou73v0_A06	39647630	39649251	BnaA06T0345700ZY	0	-	0	0	1621	0.0000000
zheyou73v0_A06	39650263	39652998	BnaA06T0345800ZY	0	-	0	0	2735	0.0000000
zheyou73v0_A06	39656487	39657694	BnaA06T0345900ZY	0	-	0	0	1207	0.0000000
zheyou73v0_A06	39659942	39662245	BnaA06T0346000ZY	0	-	0	0	2303	0.0000000
zheyou73v0_A06	39659942	39662245	BnaA06T0346000ZY.1	0	-	0	0	2303	0.0000000
zheyou73v0_A06	39671210	39672592	BnaA06T0346100ZY	0	+	0	0	1382	0.0000000
zheyou73v0_A06	39673652	39675536	BnaA06T0346200ZY	0	+	0	0	1884	0.0000000
zheyou73v0_A06	39676813	39680195	BnaA06T0346300ZY	0	-	0	0	3382	0.0000000
zheyou73v0_A06	39684043	39686593	BnaA06T0346400ZY	0	-	0	0	2550	0.0000000
zheyou73v0_A06	39691435	39692062	BnaA06T0346500ZY	0	-	0	0	627	0.0000000
zheyou73v0_A06	39695684	39696742	BnaA06T0346600ZY	0	-	0	0	1058	0.0000000
zheyou73v0_A06	39705447	39708248	BnaA06T0346700ZY	0	+	0	0	2801	0.0000000
zheyou73v0_A06	39711026	39711605	BnaA06T0346800ZY	0	-	0	0	579	0.0000000
zheyou73v0_A06	39731850	39733484	BnaA06T0346900ZY	0	+	0	0	1634	0.0000000
zheyou73v0_A06	39733846	39736464	BnaA06T0347000ZY	0	-	0	0	2618	0.0000000
zheyou73v0_A06	39760205	39762153	BnaA06T0347100ZY	0	-	0	0	1948	0.0000000
zheyou73v0_A06	39768563	39769765	BnaA06T0347200ZY	0	-	0	0	1202	0.0000000
zheyou73v0_A06	39775812	39777459	BnaA06T0347300ZY	0	-	0	0	1647	0.0000000
zheyou73v0_A06	39783035	39786424	BnaA06T0347400ZY	0	-	0	0	3389	0.0000000
zheyou73v0_A06	39787128	39788284	BnaA06T0347500ZY	0	+	0	0	1156	0.0000000
zheyou73v0_A06	39790656	39791397	BnaA06T0347600ZY	0	+	0	0	741	0.0000000
zheyou73v0_A06	39791661	39792969	BnaA06T0347700ZY	0	-	0	0	1308	0.0000000
zheyou73v0_A06	39793537	39795628	BnaA06T0347800ZY	0	-	0	0	2091	0.0000000
zheyou73v0_A06	39798694	39801386	BnaA06T0347900ZY	0	-	0	0	2692	0.0000000
zheyou73v0_A06	39798694	39801386	BnaA06T0347900ZY.1	0	-	0	0	2692	0.0000000
zheyou73v0_A06	39806450	39810222	BnaA06T0348000ZY	0	+	0	0	3772	0.0000000
zheyou73v0_A06	39811111	39813875	BnaA06T0348100ZY	0	+	0	0	2764	0.0000000
zheyou73v0_A06	39826027	39826581	BnaA06T0348200ZY	0	+	0	0	554	0.0000000
zheyou73v0_A06	39829162	39832158	BnaA06T0348300ZY	0	-	0	0	2996	0.0000000
zheyou73v0_A06	39829162	39831976	BnaA06T0348300ZY.1	0	-	0	0	2814	0.0000000
zheyou73v0_A06	39829162	39831976	BnaA06T0348300ZY.2	0	-	0	0	2814	0.0000000
zheyou73v0_A06	39829162	39832158	BnaA06T0348300ZY.3	0	-	0	0	2996	0.0000000
zheyou73v0_A06	39829162	39832158	BnaA06T0348300ZY.4	0	-	0	0	2996	0.0000000
zheyou73v0_A06	39829162	39832158	BnaA06T0348300ZY.5	0	-	0	0	2996	0.0000000
zheyou73v0_A06	39853122	39854161	BnaA06T0348400ZY	0	+	0	0	1039	0.0000000
zheyou73v0_A06	39854562	39856882	BnaA06T0348500ZY	0	-	0	0	2320	0.0000000
zheyou73v0_A06	39868750	39876430	BnaA06T0348600ZY	0	+	0	0	7680	0.0000000
zheyou73v0_A06	39883879	39884472	BnaA06T0348700ZY	0	-	0	0	593	0.0000000
zheyou73v0_A06	39887331	39890108	BnaA06T0348800ZY	0	+	0	0	2777	0.0000000
zheyou73v0_A06	39890392	39896781	BnaA06T0348900ZY	0	-	0	0	6389	0.0000000
zheyou73v0_A06	39897891	39898938	BnaA06T0349000ZY	0	+	0	0	1047	0.0000000
zheyou73v0_A06	39900596	39904209	BnaA06T0349100ZY	0	+	0	0	3613	0.0000000
zheyou73v0_A06	39904608	39905173	BnaA06T0349200ZY	0	+	0	0	565	0.0000000
zheyou73v0_A06	39906724	39907895	BnaA06T0349300ZY	0	+	0	0	1171	0.0000000
zheyou73v0_A06	39907536	39911147	BnaA06T0349400ZY	0	-	0	0	3611	0.0000000
zheyou73v0_A06	39914928	39915437	BnaA06T0349500ZY	0	+	0	0	509	0.0000000
zheyou73v0_A06	39920316	39922842	BnaA06T0349600ZY	0	-	0	0	2526	0.0000000
zheyou73v0_A06	39930153	39931788	BnaA06T0349700ZY	0	-	0	0	1635	0.0000000
zheyou73v0_A06	39937913	39938935	BnaA06T0349800ZY	0	+	0	0	1022	0.0000000
zheyou73v0_A06	39939514	39940334	BnaA06T0349900ZY	0	+	0	0	820	0.0000000
zheyou73v0_A06	39942057	39950265	BnaA06T0350000ZY	0	+	0	0	8208	0.0000000
zheyou73v0_A06	39950390	39951988	BnaA06T0350100ZY	0	-	0	0	1598	0.0000000
zheyou73v0_A06	39967594	39971715	BnaA06T0350200ZY	0	+	0	0	4121	0.0000000
zheyou73v0_A06	39972891	39974222	BnaA06T0350300ZY	0	+	0	0	1331	0.0000000
zheyou73v0_A06	39977621	39980717	BnaA06T0350400ZY	0	+	0	0	3096	0.0000000
zheyou73v0_A06	39981656	39981960	BnaA06T0350500ZY	0	-	0	0	304	0.0000000
zheyou73v0_A06	39991051	39992837	BnaA06T0350600ZY	0	+	0	0	1786	0.0000000
zheyou73v0_A06	39993980	39994862	BnaA06T0350700ZY	0	+	0	0	882	0.0000000
zheyou73v0_A06	39993980	39994862	BnaA06T0350700ZY.1	0	+	0	0	882	0.0000000
zheyou73v0_A06	40001935	40002548	BnaA06T0350800ZY	0	+	0	0	613	0.0000000
zheyou73v0_A06	40011473	40011905	BnaA06T0350900ZY	0	+	0	0	432	0.0000000
zheyou73v0_A06	40019001	40019856	BnaA06T0351000ZY	0	-	0	0	855	0.0000000
zheyou73v0_A06	40024460	40027614	BnaA06T0351100ZY	0	-	0	0	3154	0.0000000
zheyou73v0_A06	40029274	40031677	BnaA06T0351200ZY	0	-	0	0	2403	0.0000000
zheyou73v0_A06	40034410	40036589	BnaA06T0351300ZY	0	-	0	0	2179	0.0000000
zheyou73v0_A06	40038059	40039660	BnaA06T0351400ZY	0	-	0	0	1601	0.0000000
zheyou73v0_A06	40042913	40044572	BnaA06T0351500ZY	0	-	0	0	1659	0.0000000
zheyou73v0_A06	40052424	40056420	BnaA06T0351600ZY	0	+	0	0	3996	0.0000000
zheyou73v0_A06	40057119	40058329	BnaA06T0351700ZY	0	+	0	0	1210	0.0000000
zheyou73v0_A06	40058962	40059823	BnaA06T0351800ZY	0	+	0	0	861	0.0000000
zheyou73v0_A06	40061991	40063754	BnaA06T0351900ZY	0	-	0	0	1763	0.0000000
zheyou73v0_A06	40068605	40069599	BnaA06T0352000ZY	0	+	0	0	994	0.0000000
zheyou73v0_A06	40074379	40076162	BnaA06T0352100ZY	0	+	0	0	1783	0.0000000
zheyou73v0_A06	40078823	40079903	BnaA06T0352200ZY	0	-	0	0	1080	0.0000000
zheyou73v0_A06	40080373	40087659	BnaA06T0352300ZY	0	+	0	0	7286	0.0000000
zheyou73v0_A06	40087928	40091133	BnaA06T0352400ZY	0	-	0	0	3205	0.0000000
zheyou73v0_A06	40091693	40092988	BnaA06T0352500ZY	0	-	0	0	1295	0.0000000
zheyou73v0_A06	40093874	40095376	BnaA06T0352600ZY	0	-	0	0	1502	0.0000000
zheyou73v0_A06	40093874	40095376	BnaA06T0352600ZY.1	0	-	0	0	1502	0.0000000
zheyou73v0_A06	40098421	40098748	BnaA06T0352700ZY	0	+	0	0	327	0.0000000
zheyou73v0_A06	40100348	40104597	BnaA06T0352800ZY	0	+	0	0	4249	0.0000000
zheyou73v0_A06	40102888	40105625	BnaA06T0352900ZY	0	-	0	0	2737	0.0000000
zheyou73v0_A06	40106260	40109890	BnaA06T0353000ZY	0	-	0	0	3630	0.0000000
zheyou73v0_A06	40110414	40111335	BnaA06T0353100ZY	0	-	0	0	921	0.0000000
zheyou73v0_A06	40115066	40115571	BnaA06T0353200ZY	0	+	0	0	505	0.0000000
zheyou73v0_A06	40116080	40116522	BnaA06T0353300ZY	0	+	0	0	442	0.0000000
zheyou73v0_A06	40119582	40120116	BnaA06T0353400ZY	0	+	0	0	534	0.0000000
zheyou73v0_A06	40122010	40122431	BnaA06T0353500ZY	0	+	0	0	421	0.0000000
zheyou73v0_A06	40127864	40129765	BnaA06T0353600ZY	0	-	0	0	1901	0.0000000
zheyou73v0_A06	40172855	40173104	BnaA06T0353700ZY	0	+	0	0	249	0.0000000
zheyou73v0_A06	40176239	40181721	BnaA06T0353800ZY	0	+	0	0	5482	0.0000000
zheyou73v0_A06	40196621	40202105	BnaA06T0353900ZY	0	+	0	0	5484	0.0000000
zheyou73v0_A06	40216967	40219141	BnaA06T0354000ZY	0	+	0	0	2174	0.0000000
zheyou73v0_A06	40219145	40219580	BnaA06T0354100ZY	0	-	0	0	435	0.0000000
zheyou73v0_A06	40222357	40222918	BnaA06T0354200ZY	0	-	0	0	561	0.0000000
zheyou73v0_A06	40228627	40230811	BnaA06T0354300ZY	0	+	0	0	2184	0.0000000
zheyou73v0_A06	40231656	40233261	BnaA06T0354400ZY	0	+	0	0	1605	0.0000000
zheyou73v0_A06	40234158	40236700	BnaA06T0354500ZY	0	+	0	0	2542	0.0000000
zheyou73v0_A06	40248778	40250731	BnaA06T0354600ZY	0	+	0	0	1953	0.0000000
zheyou73v0_A06	40255789	40257868	BnaA06T0354700ZY	0	+	0	0	2079	0.0000000
zheyou73v0_A06	40256603	40259029	BnaA06T0354800ZY	0	-	0	0	2426	0.0000000
zheyou73v0_A06	40259125	40260956	BnaA06T0354900ZY	0	+	0	0	1831	0.0000000
zheyou73v0_A06	40263042	40264311	BnaA06T0355000ZY	0	+	0	0	1269	0.0000000
zheyou73v0_A06	40265081	40269016	BnaA06T0355100ZY	0	+	0	0	3935	0.0000000
zheyou73v0_A06	40269192	40270890	BnaA06T0355200ZY	0	-	0	0	1698	0.0000000
zheyou73v0_A06	40271766	40274310	BnaA06T0355300ZY	0	-	0	0	2544	0.0000000
zheyou73v0_A06	40277264	40279784	BnaA06T0355400ZY	0	+	0	0	2520	0.0000000
zheyou73v0_A06	40280237	40281906	BnaA06T0355500ZY	0	+	0	0	1669	0.0000000
zheyou73v0_A06	40282474	40284194	BnaA06T0355600ZY	0	-	0	0	1720	0.0000000
zheyou73v0_A06	40287652	40289756	BnaA06T0355700ZY	0	+	0	0	2104	0.0000000
zheyou73v0_A06	40290360	40292011	BnaA06T0355800ZY	0	+	0	0	1651	0.0000000
zheyou73v0_A06	40290360	40292011	BnaA06T0355800ZY.1	0	+	0	0	1651	0.0000000
zheyou73v0_A06	40292745	40295452	BnaA06T0355900ZY	0	-	0	0	2707	0.0000000
zheyou73v0_A06	40296631	40298630	BnaA06T0356000ZY	0	+	0	0	1999	0.0000000
zheyou73v0_A06	40296631	40298630	BnaA06T0356000ZY.1	0	+	0	0	1999	0.0000000
zheyou73v0_A06	40296631	40298630	BnaA06T0356000ZY.2	0	+	0	0	1999	0.0000000
zheyou73v0_A06	40298928	40301699	BnaA06T0356100ZY	0	-	0	0	2771	0.0000000
zheyou73v0_A06	40303344	40305169	BnaA06T0356200ZY	0	-	0	0	1825	0.0000000
zheyou73v0_A06	40305452	40306872	BnaA06T0356300ZY	0	+	0	0	1420	0.0000000
zheyou73v0_A06	40308428	40311236	BnaA06T0356400ZY	0	+	0	0	2808	0.0000000
zheyou73v0_A06	40314318	40317709	BnaA06T0356500ZY	0	-	0	0	3391	0.0000000
zheyou73v0_A06	40314318	40317709	BnaA06T0356500ZY.1	0	-	0	0	3391	0.0000000
zheyou73v0_A06	40315787	40317709	BnaA06T0356500ZY.2	0	-	0	0	1922	0.0000000
zheyou73v0_A06	40319655	40320982	BnaA06T0356600ZY	0	-	0	0	1327	0.0000000
zheyou73v0_A06	40323570	40324814	BnaA06T0356700ZY	0	+	0	0	1244	0.0000000
zheyou73v0_A06	40326074	40327768	BnaA06T0356800ZY	0	+	0	0	1694	0.0000000
zheyou73v0_A06	40340262	40345577	BnaA06T0356900ZY	0	-	0	0	5315	0.0000000
zheyou73v0_A06	40353841	40355197	BnaA06T0357000ZY	0	-	0	0	1356	0.0000000
zheyou73v0_A06	40353841	40355197	BnaA06T0357000ZY.1	0	-	0	0	1356	0.0000000
zheyou73v0_A06	40353841	40355197	BnaA06T0357000ZY.2	0	-	0	0	1356	0.0000000
zheyou73v0_A06	40358625	40359296	BnaA06T0357100ZY	0	-	0	0	671	0.0000000
zheyou73v0_A06	40360235	40361208	BnaA06T0357200ZY	0	-	0	0	973	0.0000000
zheyou73v0_A06	40361616	40366361	BnaA06T0357300ZY	0	+	0	0	4745	0.0000000
zheyou73v0_A06	40368387	40371260	BnaA06T0357400ZY	0	-	0	0	2873	0.0000000
zheyou73v0_A06	40374519	40377790	BnaA06T0357500ZY	0	-	0	0	3271	0.0000000
zheyou73v0_A06	40379276	40381725	BnaA06T0357600ZY	0	-	0	0	2449	0.0000000
zheyou73v0_A06	40379276	40381725	BnaA06T0357600ZY.1	0	-	0	0	2449	0.0000000
zheyou73v0_A06	40383509	40386341	BnaA06T0357700ZY	0	+	0	0	2832	0.0000000
zheyou73v0_A06	40383509	40386341	BnaA06T0357700ZY.1	0	+	0	0	2832	0.0000000
zheyou73v0_A06	40386949	40389814	BnaA06T0357800ZY	0	-	0	0	2865	0.0000000
zheyou73v0_A06	40393699	40395425	BnaA06T0357900ZY	0	-	0	0	1726	0.0000000
zheyou73v0_A06	40396032	40398058	BnaA06T0358000ZY	0	-	0	0	2026	0.0000000
zheyou73v0_A06	40404803	40410202	BnaA06T0358100ZY	0	+	0	0	5399	0.0000000
zheyou73v0_A06	40412931	40415709	BnaA06T0358200ZY	0	-	0	0	2778	0.0000000
zheyou73v0_A06	40420213	40420858	BnaA06T0358300ZY	0	+	0	0	645	0.0000000
zheyou73v0_A06	40421223	40421816	BnaA06T0358400ZY	0	-	0	0	593	0.0000000
zheyou73v0_A06	40424582	40425554	BnaA06T0358500ZY	0	+	0	0	972	0.0000000
zheyou73v0_A06	40427154	40429277	BnaA06T0358600ZY	0	+	0	0	2123	0.0000000
zheyou73v0_A06	40429798	40431523	BnaA06T0358700ZY	0	-	0	0	1725	0.0000000
zheyou73v0_A06	40432176	40435446	BnaA06T0358800ZY	0	+	0	0	3270	0.0000000
zheyou73v0_A06	40435395	40441059	BnaA06T0358900ZY	0	-	0	0	5664	0.0000000
zheyou73v0_A06	40464181	40466051	BnaA06T0359000ZY	0	+	0	0	1870	0.0000000
zheyou73v0_A06	40468204	40470501	BnaA06T0359100ZY	0	+	0	0	2297	0.0000000
zheyou73v0_A06	40470580	40474709	BnaA06T0359200ZY	0	-	0	0	4129	0.0000000
zheyou73v0_A06	40475584	40478869	BnaA06T0359300ZY	0	-	0	0	3285	0.0000000
zheyou73v0_A06	40479882	40481296	BnaA06T0359400ZY	0	-	0	0	1414	0.0000000
zheyou73v0_A06	40482163	40485834	BnaA06T0359500ZY	0	+	0	0	3671	0.0000000
zheyou73v0_A06	40485953	40488213	BnaA06T0359600ZY	0	+	0	0	2260	0.0000000
zheyou73v0_A06	40485953	40488213	BnaA06T0359600ZY.1	0	+	0	0	2260	0.0000000
zheyou73v0_A06	40488296	40489355	BnaA06T0359700ZY	0	-	0	0	1059	0.0000000
zheyou73v0_A06	40491653	40493779	BnaA06T0359800ZY	0	+	0	0	2126	0.0000000
zheyou73v0_A06	40494130	40498420	BnaA06T0359900ZY	0	+	0	0	4290	0.0000000
zheyou73v0_A06	40500371	40501341	BnaA06T0360000ZY	0	+	0	0	970	0.0000000
zheyou73v0_A06	40512118	40516644	BnaA06T0360100ZY	0	-	0	0	4526	0.0000000
zheyou73v0_A06	40520022	40522693	BnaA06T0360200ZY	0	-	0	0	2671	0.0000000
zheyou73v0_A06	40523159	40524372	BnaA06T0360300ZY	0	-	0	0	1213	0.0000000
zheyou73v0_A06	40524804	40527311	BnaA06T0360400ZY	0	+	0	0	2507	0.0000000
zheyou73v0_A06	40527796	40528847	BnaA06T0360500ZY	0	+	0	0	1051	0.0000000
zheyou73v0_A06	40529052	40531331	BnaA06T0360600ZY	0	-	0	0	2279	0.0000000
zheyou73v0_A06	40532545	40534740	BnaA06T0360700ZY	0	-	0	0	2195	0.0000000
zheyou73v0_A06	40534943	40536681	BnaA06T0360800ZY	0	+	0	0	1738	0.0000000
zheyou73v0_A06	40536043	40542707	BnaA06T0360900ZY	0	-	0	0	6664	0.0000000
zheyou73v0_A06	40536043	40542328	BnaA06T0360900ZY.1	0	-	0	0	6285	0.0000000
zheyou73v0_A06	40548220	40551157	BnaA06T0361000ZY	0	+	0	0	2937	0.0000000
zheyou73v0_A06	40551541	40552662	BnaA06T0361100ZY	0	-	0	0	1121	0.0000000
zheyou73v0_A06	40552764	40555005	BnaA06T0361200ZY	0	-	0	0	2241	0.0000000
zheyou73v0_A06	40565320	40573537	BnaA06T0361300ZY	0	-	0	0	8217	0.0000000
zheyou73v0_A06	40578225	40584136	BnaA06T0361400ZY	0	+	0	0	5911	0.0000000
zheyou73v0_A06	40584168	40586893	BnaA06T0361500ZY.1	0	-	0	0	2725	0.0000000
zheyou73v0_A06	40584554	40586893	BnaA06T0361500ZY	0	-	0	0	2339	0.0000000
zheyou73v0_A06	40593521	40596147	BnaA06T0361600ZY	0	+	0	0	2626	0.0000000
zheyou73v0_A06	40600069	40600598	BnaA06T0361700ZY	0	-	0	0	529	0.0000000
zheyou73v0_A06	40607619	40608018	BnaA06T0361800ZY	0	+	0	0	399	0.0000000
zheyou73v0_A06	40611178	40612011	BnaA06T0361900ZY	0	-	0	0	833	0.0000000
zheyou73v0_A06	40621921	40622741	BnaA06T0362000ZY	0	+	0	0	820	0.0000000
zheyou73v0_A06	40623038	40624684	BnaA06T0362100ZY	0	+	0	0	1646	0.0000000
zheyou73v0_A06	40627352	40627929	BnaA06T0362200ZY	0	-	0	0	577	0.0000000
zheyou73v0_A06	40629985	40631034	BnaA06T0362300ZY	0	+	0	0	1049	0.0000000
zheyou73v0_A06	40631217	40632333	BnaA06T0362400ZY	0	+	0	0	1116	0.0000000
zheyou73v0_A06	40638542	40641113	BnaA06T0362500ZY	0	+	0	0	2571	0.0000000
zheyou73v0_A06	40640998	40643213	BnaA06T0362600ZY	0	-	0	0	2215	0.0000000
zheyou73v0_A06	40646751	40647433	BnaA06T0362700ZY	0	+	0	0	682	0.0000000
zheyou73v0_A06	40648288	40651760	BnaA06T0362800ZY	0	-	0	0	3472	0.0000000
zheyou73v0_A06	40658949	40662794	BnaA06T0362900ZY	0	+	0	0	3845	0.0000000
zheyou73v0_A06	40663247	40667418	BnaA06T0363000ZY	0	-	0	0	4171	0.0000000
zheyou73v0_A06	40683685	40687799	BnaA06T0363100ZY	0	-	0	0	4114	0.0000000
zheyou73v0_A06	40708521	40710133	BnaA06T0363200ZY	0	-	0	0	1612	0.0000000
zheyou73v0_A06	40717068	40719907	BnaA06T0363300ZY	0	-	0	0	2839	0.0000000
zheyou73v0_A06	40755095	40759532	BnaA06T0363400ZY	0	+	0	0	4437	0.0000000
zheyou73v0_A06	40760007	40761122	BnaA06T0363500ZY	0	-	0	0	1115	0.0000000
zheyou73v0_A06	40766586	40769653	BnaA06T0363600ZY	0	-	0	0	3067	0.0000000
zheyou73v0_A06	40771955	40773692	BnaA06T0363700ZY	0	-	0	0	1737	0.0000000
zheyou73v0_A06	40779302	40780673	BnaA06T0363800ZY	0	+	0	0	1371	0.0000000
zheyou73v0_A06	40786857	40788397	BnaA06T0363900ZY	0	+	0	0	1540	0.0000000
zheyou73v0_A06	40792221	40794358	BnaA06T0364000ZY	0	+	0	0	2137	0.0000000
zheyou73v0_A06	40796264	40797421	BnaA06T0364100ZY	0	+	0	0	1157	0.0000000
zheyou73v0_A06	40798512	40799881	BnaA06T0364200ZY	0	-	0	0	1369	0.0000000
zheyou73v0_A06	40806517	40808304	BnaA06T0364300ZY	0	+	0	0	1787	0.0000000
zheyou73v0_A06	40813177	40814021	BnaA06T0364400ZY	0	+	0	0	844	0.0000000
zheyou73v0_A06	40815903	40816893	BnaA06T0364500ZY	0	+	0	0	990	0.0000000
zheyou73v0_A06	40817588	40818560	BnaA06T0364600ZY	0	+	0	0	972	0.0000000
zheyou73v0_A06	40818793	40823377	BnaA06T0364700ZY	0	-	0	0	4584	0.0000000
zheyou73v0_A06	40824349	40825585	BnaA06T0364800ZY	0	+	0	0	1236	0.0000000
zheyou73v0_A06	40825853	40827295	BnaA06T0364900ZY	0	-	0	0	1442	0.0000000
zheyou73v0_A06	40828366	40829148	BnaA06T0365000ZY	0	-	0	0	782	0.0000000
zheyou73v0_A06	40829359	40831746	BnaA06T0365100ZY	0	-	0	0	2387	0.0000000
zheyou73v0_A06	40832029	40833372	BnaA06T0365200ZY	0	+	0	0	1343	0.0000000
zheyou73v0_A06	40833720	40834343	BnaA06T0365300ZY	0	-	0	0	623	0.0000000
zheyou73v0_A06	40835003	40836593	BnaA06T0365400ZY	0	-	0	0	1590	0.0000000
zheyou73v0_A06	40837618	40839315	BnaA06T0365500ZY	0	-	0	0	1697	0.0000000
zheyou73v0_A06	40840021	40842101	BnaA06T0365600ZY	0	-	0	0	2080	0.0000000
zheyou73v0_A06	40849541	40851437	BnaA06T0365700ZY	0	+	0	0	1896	0.0000000
zheyou73v0_A06	40851659	40853650	BnaA06T0365800ZY	0	+	0	0	1991	0.0000000
zheyou73v0_A06	40853661	40857100	BnaA06T0365900ZY	0	-	0	0	3439	0.0000000
zheyou73v0_A06	40853661	40856667	BnaA06T0365900ZY.1	0	-	0	0	3006	0.0000000
zheyou73v0_A06	40857362	40858868	BnaA06T0366000ZY	0	+	0	0	1506	0.0000000
zheyou73v0_A06	40865492	40868499	BnaA06T0366100ZY	0	+	0	0	3007	0.0000000
zheyou73v0_A06	40865492	40868499	BnaA06T0366100ZY.1	0	+	0	0	3007	0.0000000
zheyou73v0_A06	40872166	40872618	BnaA06T0366200ZY	0	+	0	0	452	0.0000000
zheyou73v0_A06	40873938	40874331	BnaA06T0366300ZY	0	+	0	0	393	0.0000000
zheyou73v0_A06	40875977	40877031	BnaA06T0366400ZY	0	+	0	0	1054	0.0000000
zheyou73v0_A06	40875977	40877031	BnaA06T0366400ZY.1	0	+	0	0	1054	0.0000000
zheyou73v0_A06	40877567	40879163	BnaA06T0366500ZY	0	-	0	0	1596	0.0000000
zheyou73v0_A06	40879804	40881174	BnaA06T0366600ZY	0	+	0	0	1370	0.0000000
zheyou73v0_A06	40882919	40884463	BnaA06T0366700ZY	0	-	0	0	1544	0.0000000
zheyou73v0_A06	40888904	40889369	BnaA06T0366800ZY	0	+	0	0	465	0.0000000
zheyou73v0_A06	40897582	40899677	BnaA06T0366900ZY	0	+	0	0	2095	0.0000000
zheyou73v0_A06	40906539	40909644	BnaA06T0367000ZY	0	-	0	0	3105	0.0000000
zheyou73v0_A06	40912227	40914537	BnaA06T0367100ZY	0	+	0	0	2310	0.0000000
zheyou73v0_A06	40912227	40914537	BnaA06T0367100ZY.1	0	+	0	0	2310	0.0000000
zheyou73v0_A06	40916643	40918061	BnaA06T0367200ZY	0	+	0	0	1418	0.0000000
zheyou73v0_A06	40924084	40932235	BnaA06T0367300ZY	0	+	0	0	8151	0.0000000
zheyou73v0_A06	40933008	40940479	BnaA06T0367400ZY	0	-	0	0	7471	0.0000000
zheyou73v0_A06	40945978	40947563	BnaA06T0367500ZY	0	+	0	0	1585	0.0000000
zheyou73v0_A06	40961960	40963051	BnaA06T0367600ZY	0	-	0	0	1091	0.0000000
zheyou73v0_A06	40976687	40978160	BnaA06T0367700ZY	0	-	0	0	1473	0.0000000
zheyou73v0_A06	40982748	40989624	BnaA06T0367800ZY	0	-	0	0	6876	0.0000000
zheyou73v0_A06	41004002	41010428	BnaA06T0367900ZY	0	+	0	0	6426	0.0000000
zheyou73v0_A06	41018884	41019838	BnaA06T0368000ZY	0	+	0	0	954	0.0000000
zheyou73v0_A06	41025920	41027245	BnaA06T0368100ZY	0	-	0	0	1325	0.0000000
zheyou73v0_A06	41031554	41035558	BnaA06T0368200ZY	0	-	0	0	4004	0.0000000
zheyou73v0_A06	41039470	41040766	BnaA06T0368300ZY	0	+	0	0	1296	0.0000000
zheyou73v0_A06	41041883	41044031	BnaA06T0368400ZY	0	+	0	0	2148	0.0000000
zheyou73v0_A06	41041883	41044031	BnaA06T0368400ZY.1	0	+	0	0	2148	0.0000000
zheyou73v0_A06	41041883	41044031	BnaA06T0368400ZY.2	0	+	0	0	2148	0.0000000
zheyou73v0_A06	41046676	41048298	BnaA06T0368500ZY	0	+	0	0	1622	0.0000000
zheyou73v0_A06	41048647	41051218	BnaA06T0368600ZY	0	+	0	0	2571	0.0000000
zheyou73v0_A06	41049768	41051218	BnaA06T0368600ZY.1	0	+	0	0	1450	0.0000000
zheyou73v0_A06	41050647	41055184	BnaA06T0368700ZY	0	-	0	0	4537	0.0000000
zheyou73v0_A06	41055817	41058208	BnaA06T0368800ZY	0	-	0	0	2391	0.0000000
zheyou73v0_A06	41062700	41068406	BnaA06T0368900ZY	0	-	0	0	5706	0.0000000
zheyou73v0_A06	41073352	41075927	BnaA06T0369000ZY	0	-	0	0	2575	0.0000000
zheyou73v0_A06	41076363	41078121	BnaA06T0369100ZY	0	+	0	0	1758	0.0000000
zheyou73v0_A06	41080078	41081749	BnaA06T0369200ZY	0	-	0	0	1671	0.0000000
zheyou73v0_A06	41084361	41085867	BnaA06T0369300ZY	0	-	0	0	1506	0.0000000
zheyou73v0_A06	41088268	41088538	BnaA06T0369400ZY	0	-	0	0	270	0.0000000
zheyou73v0_A06	41090800	41092276	BnaA06T0369500ZY	0	-	0	0	1476	0.0000000
zheyou73v0_A06	41100621	41102194	BnaA06T0369600ZY	0	+	0	0	1573	0.0000000
zheyou73v0_A06	41103663	41105265	BnaA06T0369700ZY	0	-	0	0	1602	0.0000000
zheyou73v0_A06	41111564	41112047	BnaA06T0369800ZY	0	-	0	0	483	0.0000000
zheyou73v0_A06	41113376	41115687	BnaA06T0369900ZY	0	+	0	0	2311	0.0000000
zheyou73v0_A06	41115791	41116992	BnaA06T0370000ZY	0	+	0	0	1201	0.0000000
zheyou73v0_A06	41117236	41119368	BnaA06T0370100ZY	0	+	0	0	2132	0.0000000
zheyou73v0_A06	41120635	41121420	BnaA06T0370200ZY	0	+	0	0	785	0.0000000
zheyou73v0_A06	41122076	41124066	BnaA06T0370300ZY	0	-	0	0	1990	0.0000000
zheyou73v0_A06	41125441	41127881	BnaA06T0370400ZY	0	+	0	0	2440	0.0000000
zheyou73v0_A06	41125441	41127604	BnaA06T0370400ZY.1	0	+	0	0	2163	0.0000000
zheyou73v0_A06	41129246	41129879	BnaA06T0370500ZY	0	+	0	0	633	0.0000000
zheyou73v0_A06	41133751	41144468	BnaA06T0370600ZY	0	-	0	0	10717	0.0000000
zheyou73v0_A06	41141312	41144468	BnaA06T0370600ZY.2	0	-	0	0	3156	0.0000000
zheyou73v0_A06	41141647	41144468	BnaA06T0370600ZY.1	0	-	0	0	2821	0.0000000
zheyou73v0_A06	41152123	41153740	BnaA06T0370700ZY	0	-	0	0	1617	0.0000000
zheyou73v0_A06	41175931	41177217	BnaA06T0370800ZY	0	+	0	0	1286	0.0000000
zheyou73v0_A06	41177875	41178773	BnaA06T0370900ZY	0	-	0	0	898	0.0000000
zheyou73v0_A06	41179294	41182766	BnaA06T0371000ZY	0	-	0	0	3472	0.0000000
zheyou73v0_A06	41205385	41207215	BnaA06T0371100ZY	0	+	0	0	1830	0.0000000
zheyou73v0_A06	41207363	41208751	BnaA06T0371200ZY	0	-	0	0	1388	0.0000000
zheyou73v0_A06	41209900	41212930	BnaA06T0371300ZY	0	-	0	0	3030	0.0000000
zheyou73v0_A06	41209900	41212930	BnaA06T0371300ZY.1	0	-	0	0	3030	0.0000000
zheyou73v0_A06	41214788	41219904	BnaA06T0371400ZY	0	-	0	0	5116	0.0000000
zheyou73v0_A06	41220311	41223739	BnaA06T0371500ZY	0	-	0	0	3428	0.0000000
zheyou73v0_A06	41227424	41234152	BnaA06T0371600ZY	0	-	0	0	6728	0.0000000
zheyou73v0_A06	41240759	41242949	BnaA06T0371700ZY	0	+	0	0	2190	0.0000000
zheyou73v0_A06	41244558	41245566	BnaA06T0371800ZY	0	-	0	0	1008	0.0000000
zheyou73v0_A06	41246066	41248509	BnaA06T0371900ZY	0	-	0	0	2443	0.0000000
zheyou73v0_A06	41258928	41261636	BnaA06T0372000ZY	0	+	0	0	2708	0.0000000
zheyou73v0_A06	41258928	41261636	BnaA06T0372000ZY.1	0	+	0	0	2708	0.0000000
zheyou73v0_A06	41271766	41273079	BnaA06T0372100ZY	0	+	0	0	1313	0.0000000
zheyou73v0_A06	41273441	41273687	BnaA06T0372200ZY	0	+	0	0	246	0.0000000
zheyou73v0_A06	41275953	41278754	BnaA06T0372300ZY	0	+	0	0	2801	0.0000000
zheyou73v0_A06	41279460	41281931	BnaA06T0372400ZY	0	+	0	0	2471	0.0000000
zheyou73v0_A06	41284026	41286227	BnaA06T0372500ZY	0	+	0	0	2201	0.0000000
zheyou73v0_A06	41290502	41291856	BnaA06T0372600ZY	0	+	0	0	1354	0.0000000
zheyou73v0_A06	41295380	41297007	BnaA06T0372700ZY	0	+	0	0	1627	0.0000000
zheyou73v0_A06	41299000	41300268	BnaA06T0372800ZY	0	-	0	0	1268	0.0000000
zheyou73v0_A06	41301635	41306229	BnaA06T0372900ZY	0	-	0	0	4594	0.0000000
zheyou73v0_A06	41310668	41312261	BnaA06T0373000ZY	0	-	0	0	1593	0.0000000
zheyou73v0_A06	41313244	41313859	BnaA06T0373100ZY	0	-	0	0	615	0.0000000
zheyou73v0_A06	41314797	41315559	BnaA06T0373200ZY	0	-	0	0	762	0.0000000
zheyou73v0_A06	41316631	41319523	BnaA06T0373300ZY	0	-	0	0	2892	0.0000000
zheyou73v0_A06	41330487	41335190	BnaA06T0373400ZY	0	-	0	0	4703	0.0000000
zheyou73v0_A06	41334710	41335043	BnaA06T0373500ZY	0	+	0	0	333	0.0000000
zheyou73v0_A06	41342098	41344214	BnaA06T0373600ZY	0	+	0	0	2116	0.0000000
zheyou73v0_A06	41346550	41350411	BnaA06T0373700ZY	0	+	0	0	3861	0.0000000
zheyou73v0_A06	41350449	41351595	BnaA06T0373800ZY	0	-	0	0	1146	0.0000000
zheyou73v0_A06	41355349	41363789	BnaA06T0373900ZY	0	-	0	0	8440	0.0000000
zheyou73v0_A06	41368440	41370721	BnaA06T0374000ZY	0	-	0	0	2281	0.0000000
zheyou73v0_A06	41376926	41379253	BnaA06T0374100ZY	0	-	0	0	2327	0.0000000
zheyou73v0_A06	41381017	41382478	BnaA06T0374200ZY	0	-	0	0	1461	0.0000000
zheyou73v0_A06	41405065	41416525	BnaA06T0374300ZY	0	+	0	0	11460	0.0000000
zheyou73v0_A06	41418657	41421122	BnaA06T0374400ZY	0	+	0	0	2465	0.0000000
zheyou73v0_A06	41422849	41425268	BnaA06T0374500ZY	0	+	0	0	2419	0.0000000
zheyou73v0_A06	41425549	41428148	BnaA06T0374600ZY	0	+	0	0	2599	0.0000000
zheyou73v0_A06	41428964	41431336	BnaA06T0374700ZY	0	-	0	0	2372	0.0000000
zheyou73v0_A06	41434543	41440189	BnaA06T0374800ZY	0	+	0	0	5646	0.0000000
zheyou73v0_A06	41440562	41441391	BnaA06T0374900ZY	0	-	0	0	829	0.0000000
zheyou73v0_A06	41456473	41466353	BnaA06T0375000ZY	0	-	0	0	9880	0.0000000
zheyou73v0_A06	41470703	41474182	BnaA06T0375100ZY	0	-	0	0	3479	0.0000000
zheyou73v0_A06	41475218	41482247	BnaA06T0375200ZY	0	+	0	0	7029	0.0000000
zheyou73v0_A06	41482312	41483333	BnaA06T0375300ZY	0	+	0	0	1021	0.0000000
zheyou73v0_A06	41484003	41487855	BnaA06T0375400ZY	0	-	0	0	3852	0.0000000
zheyou73v0_A06	41488748	41489123	BnaA06T0375500ZY	0	+	0	0	375	0.0000000
zheyou73v0_A06	41489632	41492423	BnaA06T0375600ZY	0	-	0	0	2791	0.0000000
zheyou73v0_A06	41494608	41498078	BnaA06T0375700ZY	0	+	0	0	3470	0.0000000
zheyou73v0_A06	41494711	41497731	BnaA06T0375700ZY.1	0	+	0	0	3020	0.0000000
zheyou73v0_A06	41501989	41503424	BnaA06T0375800ZY	0	+	0	0	1435	0.0000000
zheyou73v0_A06	41503549	41503848	BnaA06T0375900ZY	0	+	0	0	299	0.0000000
zheyou73v0_A06	41504254	41504767	BnaA06T0376000ZY	0	+	0	0	513	0.0000000
zheyou73v0_A06	41504830	41506818	BnaA06T0376100ZY	0	-	0	0	1988	0.0000000
zheyou73v0_A06	41512741	41514137	BnaA06T0376200ZY	0	-	0	0	1396	0.0000000
zheyou73v0_A06	41516988	41519100	BnaA06T0376300ZY	0	+	0	0	2112	0.0000000
zheyou73v0_A06	41520229	41520463	BnaA06T0376400ZY	0	+	0	0	234	0.0000000
zheyou73v0_A06	41521742	41521964	BnaA06T0376500ZY	0	+	0	0	222	0.0000000
zheyou73v0_A06	41522036	41528904	BnaA06T0376600ZY	0	-	0	0	6868	0.0000000
zheyou73v0_A06	41529974	41531698	BnaA06T0376700ZY	0	+	0	0	1724	0.0000000
zheyou73v0_A06	41532248	41536025	BnaA06T0376800ZY	0	+	0	0	3777	0.0000000
zheyou73v0_A06	41538174	41539664	BnaA06T0376900ZY	0	-	0	0	1490	0.0000000
zheyou73v0_A06	41541095	41545470	BnaA06T0377000ZY.1	0	-	0	0	4375	0.0000000
zheyou73v0_A06	41541095	41545470	BnaA06T0377000ZY.2	0	-	0	0	4375	0.0000000
zheyou73v0_A06	41541411	41545470	BnaA06T0377000ZY	0	-	0	0	4059	0.0000000
zheyou73v0_A06	41541411	41545470	BnaA06T0377000ZY.3	0	-	0	0	4059	0.0000000
zheyou73v0_A06	41547212	41547371	BnaA06T0377100ZY	0	-	0	0	159	0.0000000
zheyou73v0_A06	41594072	41594921	BnaA06T0377200ZY	0	-	0	0	849	0.0000000
zheyou73v0_A06	41599840	41602163	BnaA06T0377300ZY	0	+	0	0	2323	0.0000000
zheyou73v0_A06	41599840	41602163	BnaA06T0377300ZY.1	0	+	0	0	2323	0.0000000
zheyou73v0_A06	41599840	41602163	BnaA06T0377300ZY.2	0	+	0	0	2323	0.0000000
zheyou73v0_A06	41606557	41608664	BnaA06T0377400ZY	0	+	0	0	2107	0.0000000
zheyou73v0_A06	41609174	41609821	BnaA06T0377500ZY	0	+	0	0	647	0.0000000
zheyou73v0_A06	41618175	41621845	BnaA06T0377600ZY	0	+	0	0	3670	0.0000000
zheyou73v0_A06	41621925	41623962	BnaA06T0377700ZY	0	-	0	0	2037	0.0000000
zheyou73v0_A06	41624170	41627016	BnaA06T0377800ZY	0	+	0	0	2846	0.0000000
zheyou73v0_A06	41627302	41630262	BnaA06T0377900ZY	0	-	0	0	2960	0.0000000
zheyou73v0_A06	41627302	41630186	BnaA06T0377900ZY.1	0	-	0	0	2884	0.0000000
zheyou73v0_A06	41638900	41640480	BnaA06T0378000ZY	0	-	0	0	1580	0.0000000
zheyou73v0_A06	41643664	41644966	BnaA06T0378100ZY	0	+	0	0	1302	0.0000000
zheyou73v0_A06	41645834	41647559	BnaA06T0378200ZY	0	-	0	0	1725	0.0000000
zheyou73v0_A06	41647960	41648720	BnaA06T0378300ZY	0	+	0	0	760	0.0000000
zheyou73v0_A06	41648810	41651008	BnaA06T0378400ZY	0	-	0	0	2198	0.0000000
zheyou73v0_A06	41648810	41651008	BnaA06T0378400ZY.1	0	-	0	0	2198	0.0000000
zheyou73v0_A06	41648810	41651008	BnaA06T0378400ZY.2	0	-	0	0	2198	0.0000000
zheyou73v0_A06	41648810	41651008	BnaA06T0378400ZY.3	0	-	0	0	2198	0.0000000
zheyou73v0_A06	41660018	41661095	BnaA06T0378500ZY	0	+	0	0	1077	0.0000000
zheyou73v0_A06	41662975	41671375	BnaA06T0378600ZY	0	+	0	0	8400	0.0000000
zheyou73v0_A06	41671740	41671950	BnaA06T0378700ZY	0	-	0	0	210	0.0000000
zheyou73v0_A06	41672665	41674043	BnaA06T0378800ZY	0	-	0	0	1378	0.0000000
zheyou73v0_A06	41682139	41683637	BnaA06T0378900ZY	0	+	0	0	1498	0.0000000
zheyou73v0_A06	41684101	41686726	BnaA06T0379000ZY	0	+	0	0	2625	0.0000000
zheyou73v0_A06	41686918	41687517	BnaA06T0379100ZY	0	-	0	0	599	0.0000000
zheyou73v0_A06	41688113	41689725	BnaA06T0379200ZY	0	-	0	0	1612	0.0000000
zheyou73v0_A06	41690107	41692861	BnaA06T0379300ZY	0	-	0	0	2754	0.0000000
zheyou73v0_A06	41693528	41695765	BnaA06T0379400ZY	0	+	0	0	2237	0.0000000
zheyou73v0_A06	41697421	41699317	BnaA06T0379500ZY	0	+	0	0	1896	0.0000000
zheyou73v0_A06	41700027	41702577	BnaA06T0379600ZY	0	+	0	0	2550	0.0000000
zheyou73v0_A06	41702738	41704485	BnaA06T0379700ZY	0	-	0	0	1747	0.0000000
zheyou73v0_A06	41704652	41707741	BnaA06T0379800ZY	0	+	0	0	3089	0.0000000
zheyou73v0_A06	41708403	41711762	BnaA06T0379900ZY	0	+	0	0	3359	0.0000000
zheyou73v0_A06	41712840	41715314	BnaA06T0380000ZY	0	+	0	0	2474	0.0000000
zheyou73v0_A06	41746079	41747035	BnaA06T0380100ZY	0	+	0	0	956	0.0000000
zheyou73v0_A06	41750149	41752565	BnaA06T0380200ZY	0	-	0	0	2416	0.0000000
zheyou73v0_A06	41756666	41758490	BnaA06T0380300ZY	0	+	0	0	1824	0.0000000
zheyou73v0_A06	41761926	41763491	BnaA06T0380400ZY	0	-	0	0	1565	0.0000000
zheyou73v0_A06	41764615	41766100	BnaA06T0380500ZY	0	+	0	0	1485	0.0000000
zheyou73v0_A06	41777661	41779962	BnaA06T0380600ZY	0	+	0	0	2301	0.0000000
zheyou73v0_A06	41781127	41787371	BnaA06T0380700ZY	0	-	0	0	6244	0.0000000
zheyou73v0_A06	41788541	41789634	BnaA06T0380800ZY	0	-	0	0	1093	0.0000000
zheyou73v0_A06	41790493	41793073	BnaA06T0380900ZY	0	-	0	0	2580	0.0000000
zheyou73v0_A06	41790493	41793073	BnaA06T0380900ZY.1	0	-	0	0	2580	0.0000000
zheyou73v0_A06	41795211	41796322	BnaA06T0381000ZY	0	+	0	0	1111	0.0000000
zheyou73v0_A06	41796724	41799105	BnaA06T0381100ZY	0	-	0	0	2381	0.0000000
zheyou73v0_A06	41799744	41802989	BnaA06T0381200ZY	0	+	0	0	3245	0.0000000
zheyou73v0_A06	41802284	41803871	BnaA06T0381300ZY	0	-	0	0	1587	0.0000000
zheyou73v0_A06	41804609	41806179	BnaA06T0381400ZY	0	+	0	0	1570	0.0000000
zheyou73v0_A06	41806372	41806832	BnaA06T0381500ZY	0	-	0	0	460	0.0000000
zheyou73v0_A06	41808351	41812743	BnaA06T0381600ZY	0	-	0	0	4392	0.0000000
zheyou73v0_A06	41815362	41815644	BnaA06T0381700ZY	0	-	0	0	282	0.0000000
zheyou73v0_A06	41818941	41822957	BnaA06T0381800ZY	0	+	0	0	4016	0.0000000
zheyou73v0_A06	41823278	41824858	BnaA06T0381900ZY	0	-	0	0	1580	0.0000000
zheyou73v0_A06	41825841	41828391	BnaA06T0382000ZY	0	-	0	0	2550	0.0000000
zheyou73v0_A06	41831039	41835200	BnaA06T0382100ZY	0	+	0	0	4161	0.0000000
zheyou73v0_A06	41843328	41844410	BnaA06T0382200ZY	0	+	0	0	1082	0.0000000
zheyou73v0_A06	41863092	41863736	BnaA06T0382300ZY	0	+	0	0	644	0.0000000
zheyou73v0_A06	41864492	41865918	BnaA06T0382400ZY	0	+	0	0	1426	0.0000000
zheyou73v0_A06	41866444	41869121	BnaA06T0382500ZY	0	-	0	0	2677	0.0000000
zheyou73v0_A06	41876715	41879551	BnaA06T0382600ZY	0	-	0	0	2836	0.0000000
zheyou73v0_A06	41881018	41882514	BnaA06T0382700ZY	0	-	0	0	1496	0.0000000
zheyou73v0_A06	41883697	41885049	BnaA06T0382800ZY	0	-	0	0	1352	0.0000000
zheyou73v0_A06	41883697	41884915	BnaA06T0382800ZY.1	0	-	0	0	1218	0.0000000
zheyou73v0_A06	41885305	41887109	BnaA06T0382900ZY	0	+	0	0	1804	0.0000000
zheyou73v0_A06	41886758	41889968	BnaA06T0383000ZY	0	-	0	0	3210	0.0000000
zheyou73v0_A06	41892053	41895229	BnaA06T0383100ZY	0	-	0	0	3176	0.0000000
zheyou73v0_A06	41895731	41896527	BnaA06T0383200ZY	0	+	0	0	796	0.0000000
zheyou73v0_A06	41896989	41898157	BnaA06T0383300ZY	0	+	0	0	1168	0.0000000
zheyou73v0_A06	41922169	41923945	BnaA06T0383400ZY	0	+	0	0	1776	0.0000000
zheyou73v0_A06	41980668	41982388	BnaA06T0383500ZY	0	+	0	0	1720	0.0000000
zheyou73v0_A06	41983313	41985758	BnaA06T0383600ZY	0	+	0	0	2445	0.0000000
zheyou73v0_A06	41988656	41991270	BnaA06T0383700ZY	0	-	0	0	2614	0.0000000
zheyou73v0_A06	41993367	41995189	BnaA06T0383800ZY	0	-	0	0	1822	0.0000000
zheyou73v0_A06	41995839	41996133	BnaA06T0383900ZY	0	-	0	0	294	0.0000000
zheyou73v0_A06	41996618	41999593	BnaA06T0384000ZY	0	-	0	0	2975	0.0000000
zheyou73v0_A06	41996618	41999593	BnaA06T0384000ZY.1	0	-	0	0	2975	0.0000000
zheyou73v0_A06	41996618	41999593	BnaA06T0384000ZY.2	0	-	0	0	2975	0.0000000
zheyou73v0_A06	41996618	41999593	BnaA06T0384000ZY.3	0	-	0	0	2975	0.0000000
zheyou73v0_A06	41996618	41999593	BnaA06T0384000ZY.4	0	-	0	0	2975	0.0000000
zheyou73v0_A06	42001967	42005662	BnaA06T0384100ZY	0	-	0	0	3695	0.0000000
zheyou73v0_A06	42006071	42007481	BnaA06T0384200ZY	0	-	0	0	1410	0.0000000
zheyou73v0_A06	42008394	42010403	BnaA06T0384300ZY	0	-	0	0	2009	0.0000000
zheyou73v0_A06	42010701	42013588	BnaA06T0384400ZY	0	-	0	0	2887	0.0000000
zheyou73v0_A06	42010701	42013588	BnaA06T0384400ZY.1	0	-	0	0	2887	0.0000000
zheyou73v0_A06	42010701	42013588	BnaA06T0384400ZY.2	0	-	0	0	2887	0.0000000
zheyou73v0_A06	42017952	42019411	BnaA06T0384500ZY	0	+	0	0	1459	0.0000000
zheyou73v0_A06	42020714	42022219	BnaA06T0384600ZY	0	-	0	0	1505	0.0000000
zheyou73v0_A06	42024338	42025278	BnaA06T0384700ZY	0	-	0	0	940	0.0000000
zheyou73v0_A06	42027128	42028098	BnaA06T0384800ZY	0	+	0	0	970	0.0000000
zheyou73v0_A06	42030874	42031975	BnaA06T0384900ZY	0	+	0	0	1101	0.0000000
zheyou73v0_A06	42032159	42033116	BnaA06T0385000ZY	0	-	0	0	957	0.0000000
zheyou73v0_A06	42036109	42036516	BnaA06T0385100ZY	0	+	0	0	407	0.0000000
zheyou73v0_A06	42049593	42051483	BnaA06T0385200ZY	0	-	0	0	1890	0.0000000
zheyou73v0_A06	42057308	42058993	BnaA06T0385300ZY	0	-	0	0	1685	0.0000000
zheyou73v0_A06	42061576	42061840	BnaA06T0385400ZY	0	+	0	0	264	0.0000000
zheyou73v0_A06	42065112	42065723	BnaA06T0385500ZY	0	+	0	0	611	0.0000000
zheyou73v0_A06	42094177	42095289	BnaA06T0385600ZY	0	+	0	0	1112	0.0000000
zheyou73v0_A06	42095559	42097752	BnaA06T0385700ZY	0	-	0	0	2193	0.0000000
zheyou73v0_A06	42095559	42097752	BnaA06T0385700ZY.1	0	-	0	0	2193	0.0000000
zheyou73v0_A06	42098078	42098626	BnaA06T0385800ZY	0	+	0	0	548	0.0000000
zheyou73v0_A06	42100582	42105445	BnaA06T0385900ZY	0	+	0	0	4863	0.0000000
zheyou73v0_A06	42100582	42105445	BnaA06T0385900ZY.1	0	+	0	0	4863	0.0000000
zheyou73v0_A06	42100582	42105596	BnaA06T0385900ZY.2	0	+	0	0	5014	0.0000000
zheyou73v0_A06	42125581	42133061	BnaA06T0386000ZY	0	+	0	0	7480	0.0000000
zheyou73v0_A06	42140319	42146964	BnaA06T0386100ZY	0	+	0	0	6645	0.0000000
zheyou73v0_A06	42149485	42149872	BnaA06T0386200ZY	0	+	0	0	387	0.0000000
zheyou73v0_A06	42158857	42161254	BnaA06T0386300ZY	0	-	0	0	2397	0.0000000
zheyou73v0_A06	42164466	42168552	BnaA06T0386400ZY	0	-	0	0	4086	0.0000000
zheyou73v0_A06	42170802	42171684	BnaA06T0386500ZY	0	-	0	0	882	0.0000000
zheyou73v0_A06	42172797	42174503	BnaA06T0386600ZY	0	-	0	0	1706	0.0000000
zheyou73v0_A06	42174884	42176342	BnaA06T0386700ZY	0	-	0	0	1458	0.0000000
zheyou73v0_A06	42212538	42213908	BnaA06T0386800ZY	0	-	0	0	1370	0.0000000
zheyou73v0_A06	42231613	42233368	BnaA06T0386900ZY	0	-	0	0	1755	0.0000000
zheyou73v0_A06	42234172	42238962	BnaA06T0387000ZY	0	-	0	0	4790	0.0000000
zheyou73v0_A06	42240398	42241178	BnaA06T0387100ZY	0	-	0	0	780	0.0000000
zheyou73v0_A06	42245430	42247456	BnaA06T0387200ZY	0	+	0	0	2026	0.0000000
zheyou73v0_A06	42256799	42257072	BnaA06T0387300ZY	0	+	0	0	273	0.0000000
zheyou73v0_A06	42265418	42266426	BnaA06T0387400ZY	0	-	0	0	1008	0.0000000
zheyou73v0_A06	42292024	42294634	BnaA06T0387500ZY	0	+	0	0	2610	0.0000000
zheyou73v0_A06	42300087	42304000	BnaA06T0387600ZY	0	+	0	0	3913	0.0000000
zheyou73v0_A06	42307229	42308003	BnaA06T0387700ZY	0	-	0	0	774	0.0000000
zheyou73v0_A06	42309725	42310446	BnaA06T0387800ZY	0	-	0	0	721	0.0000000
zheyou73v0_A06	42313112	42314472	BnaA06T0387900ZY	0	-	0	0	1360	0.0000000
zheyou73v0_A06	42319759	42322699	BnaA06T0388000ZY	0	-	0	0	2940	0.0000000
zheyou73v0_A06	42331567	42332240	BnaA06T0388100ZY	0	-	0	0	673	0.0000000
zheyou73v0_A06	42342786	42346625	BnaA06T0388200ZY	0	+	0	0	3839	0.0000000
zheyou73v0_A06	42342786	42346625	BnaA06T0388200ZY.1	0	+	0	0	3839	0.0000000
zheyou73v0_A06	42352141	42352843	BnaA06T0388300ZY	0	-	0	0	702	0.0000000
zheyou73v0_A06	42359606	42362041	BnaA06T0388400ZY	0	-	0	0	2435	0.0000000
zheyou73v0_A06	42362371	42366152	BnaA06T0388500ZY	0	-	0	0	3781	0.0000000
zheyou73v0_A06	42367118	42369037	BnaA06T0388600ZY	0	-	0	0	1919	0.0000000
zheyou73v0_A06	42374468	42376412	BnaA06T0388700ZY	0	-	0	0	1944	0.0000000
zheyou73v0_A06	42379291	42381184	BnaA06T0388800ZY	0	-	0	0	1893	0.0000000
zheyou73v0_A06	42382312	42383183	BnaA06T0388900ZY	0	+	0	0	871	0.0000000
zheyou73v0_A06	42385002	42388772	BnaA06T0389000ZY	0	-	0	0	3770	0.0000000
zheyou73v0_A06	42390352	42393448	BnaA06T0389100ZY	0	-	0	0	3096	0.0000000
zheyou73v0_A06	42390352	42393448	BnaA06T0389100ZY.1	0	-	0	0	3096	0.0000000
zheyou73v0_A06	42398339	42400437	BnaA06T0389200ZY	0	-	0	0	2098	0.0000000
zheyou73v0_A06	42400717	42402972	BnaA06T0389300ZY	0	+	0	0	2255	0.0000000
zheyou73v0_A06	42403511	42404759	BnaA06T0389400ZY	0	-	0	0	1248	0.0000000
zheyou73v0_A06	42412929	42413641	BnaA06T0389500ZY	0	-	0	0	712	0.0000000
zheyou73v0_A06	42418216	42418549	BnaA06T0389600ZY	0	+	0	0	333	0.0000000
zheyou73v0_A06	42444237	42447759	BnaA06T0389700ZY	0	+	0	0	3522	0.0000000
zheyou73v0_A06	42450012	42451390	BnaA06T0389800ZY	0	+	0	0	1378	0.0000000
zheyou73v0_A06	42462252	42463208	BnaA06T0389900ZY	0	+	0	0	956	0.0000000
zheyou73v0_A06	42466449	42467237	BnaA06T0390000ZY	0	-	0	0	788	0.0000000
zheyou73v0_A06	42473869	42479428	BnaA06T0390100ZY	0	+	0	0	5559	0.0000000
zheyou73v0_A06	42479623	42480907	BnaA06T0390200ZY	0	+	0	0	1284	0.0000000
zheyou73v0_A06	42481887	42482988	BnaA06T0390300ZY	0	+	0	0	1101	0.0000000
zheyou73v0_A06	42483077	42485504	BnaA06T0390400ZY	0	-	0	0	2427	0.0000000
zheyou73v0_A06	42486370	42488813	BnaA06T0390500ZY	0	-	0	0	2443	0.0000000
zheyou73v0_A06	42489179	42492364	BnaA06T0390600ZY	0	+	0	0	3185	0.0000000
zheyou73v0_A06	42494773	42495214	BnaA06T0390700ZY	0	+	0	0	441	0.0000000
zheyou73v0_A06	42495532	42496410	BnaA06T0390800ZY	0	-	0	0	878	0.0000000
zheyou73v0_A06	42502268	42504554	BnaA06T0390900ZY	0	+	0	0	2286	0.0000000
zheyou73v0_A06	42504920	42506484	BnaA06T0391000ZY	0	+	0	0	1564	0.0000000
zheyou73v0_A06	42507307	42509164	BnaA06T0391100ZY	0	-	0	0	1857	0.0000000
zheyou73v0_A06	42510313	42512237	BnaA06T0391200ZY	0	-	0	0	1924	0.0000000
zheyou73v0_A06	42515617	42516735	BnaA06T0391300ZY	0	-	0	0	1118	0.0000000
zheyou73v0_A06	42531343	42531925	BnaA06T0391400ZY	0	-	0	0	582	0.0000000
zheyou73v0_A06	42533674	42538877	BnaA06T0391500ZY	0	-	0	0	5203	0.0000000
zheyou73v0_A06	42562796	42563621	BnaA06T0391600ZY	0	+	0	0	825	0.0000000
zheyou73v0_A06	42566627	42569535	BnaA06T0391700ZY	0	+	0	0	2908	0.0000000
zheyou73v0_A06	42566627	42569535	BnaA06T0391700ZY.1	0	+	0	0	2908	0.0000000
zheyou73v0_A06	42568651	42570730	BnaA06T0391800ZY	0	-	0	0	2079	0.0000000
zheyou73v0_A06	42571949	42574417	BnaA06T0391900ZY	0	+	0	0	2468	0.0000000
zheyou73v0_A06	42574966	42576695	BnaA06T0392000ZY	0	+	0	0	1729	0.0000000
zheyou73v0_A06	42578614	42580856	BnaA06T0392100ZY	0	+	0	0	2242	0.0000000
zheyou73v0_A06	42578614	42580856	BnaA06T0392100ZY.1	0	+	0	0	2242	0.0000000
zheyou73v0_A06	42581887	42583004	BnaA06T0392200ZY	0	-	0	0	1117	0.0000000
zheyou73v0_A06	42585794	42590150	BnaA06T0392300ZY	0	+	0	0	4356	0.0000000
zheyou73v0_A06	42607494	42612354	BnaA06T0392400ZY	0	+	0	0	4860	0.0000000
zheyou73v0_A06	42636745	42638887	BnaA06T0392500ZY	0	+	0	0	2142	0.0000000
zheyou73v0_A06	42638982	42640596	BnaA06T0392600ZY	0	+	0	0	1614	0.0000000
zheyou73v0_A06	42641460	42642921	BnaA06T0392700ZY	0	+	0	0	1461	0.0000000
zheyou73v0_A06	42647671	42649925	BnaA06T0392800ZY	0	-	0	0	2254	0.0000000
zheyou73v0_A06	42650777	42652864	BnaA06T0392900ZY	0	-	0	0	2087	0.0000000
zheyou73v0_A06	42650777	42652864	BnaA06T0392900ZY.1	0	-	0	0	2087	0.0000000
zheyou73v0_A06	42660168	42660909	BnaA06T0393000ZY	0	-	0	0	741	0.0000000
zheyou73v0_A06	42665450	42667028	BnaA06T0393100ZY	0	+	0	0	1578	0.0000000
zheyou73v0_A06	42665450	42667028	BnaA06T0393100ZY.1	0	+	0	0	1578	0.0000000
zheyou73v0_A06	42665783	42667028	BnaA06T0393100ZY.2	0	+	0	0	1245	0.0000000
zheyou73v0_A06	42669245	42670447	BnaA06T0393200ZY	0	-	0	0	1202	0.0000000
zheyou73v0_A06	42672526	42674554	BnaA06T0393300ZY	0	-	0	0	2028	0.0000000
zheyou73v0_A06	42675748	42678089	BnaA06T0393400ZY	0	+	0	0	2341	0.0000000
zheyou73v0_A06	42679627	42680841	BnaA06T0393500ZY	0	-	0	0	1214	0.0000000
zheyou73v0_A06	42683738	42686350	BnaA06T0393600ZY	0	+	0	0	2612	0.0000000
zheyou73v0_A06	42687461	42689380	BnaA06T0393700ZY	0	+	0	0	1919	0.0000000
zheyou73v0_A06	42694828	42699275	BnaA06T0393800ZY	0	-	0	0	4447	0.0000000
zheyou73v0_A06	42699677	42700417	BnaA06T0393900ZY	0	-	0	0	740	0.0000000
zheyou73v0_A06	42702420	42704465	BnaA06T0394000ZY	0	+	0	0	2045	0.0000000
zheyou73v0_A06	42716218	42718217	BnaA06T0394100ZY	0	-	0	0	1999	0.0000000
zheyou73v0_A06	42723089	42727387	BnaA06T0394200ZY	0	+	0	0	4298	0.0000000
zheyou73v0_A06	42729388	42730005	BnaA06T0394300ZY	0	+	0	0	617	0.0000000
zheyou73v0_A06	42740541	42743461	BnaA06T0394400ZY	0	+	0	0	2920	0.0000000
zheyou73v0_A06	42746065	42748214	BnaA06T0394500ZY	0	+	0	0	2149	0.0000000
zheyou73v0_A06	42748781	42750941	BnaA06T0394600ZY	0	-	0	0	2160	0.0000000
zheyou73v0_A06	42763109	42766587	BnaA06T0394700ZY	0	+	0	0	3478	0.0000000
zheyou73v0_A06	42765681	42767999	BnaA06T0394800ZY	0	-	0	0	2318	0.0000000
zheyou73v0_A06	42765681	42767999	BnaA06T0394800ZY.1	0	-	0	0	2318	0.0000000
zheyou73v0_A06	42765681	42767999	BnaA06T0394800ZY.2	0	-	0	0	2318	0.0000000
zheyou73v0_A06	42768387	42770047	BnaA06T0394900ZY	0	-	0	0	1660	0.0000000
zheyou73v0_A06	42772179	42774075	BnaA06T0395000ZY	0	+	0	0	1896	0.0000000
zheyou73v0_A06	42774386	42776459	BnaA06T0395100ZY	0	-	0	0	2073	0.0000000
zheyou73v0_A06	42779052	42781522	BnaA06T0395200ZY	0	+	0	0	2470	0.0000000
zheyou73v0_A06	42781887	42783249	BnaA06T0395300ZY	0	-	0	0	1362	0.0000000
zheyou73v0_A06	42783503	42786041	BnaA06T0395400ZY	0	+	0	0	2538	0.0000000
zheyou73v0_A06	42783503	42786041	BnaA06T0395400ZY.1	0	+	0	0	2538	0.0000000
zheyou73v0_A06	42783503	42786041	BnaA06T0395400ZY.2	0	+	0	0	2538	0.0000000
zheyou73v0_A06	42786306	42793791	BnaA06T0395500ZY	0	-	0	0	7485	0.0000000
zheyou73v0_A06	42794181	42794823	BnaA06T0395600ZY	0	-	0	0	642	0.0000000
zheyou73v0_A06	42801832	42806355	BnaA06T0395700ZY	0	-	0	0	4523	0.0000000
zheyou73v0_A06	42813824	42815667	BnaA06T0395800ZY	0	-	0	0	1843	0.0000000
zheyou73v0_A06	42817726	42820642	BnaA06T0395900ZY	0	-	0	0	2916	0.0000000
zheyou73v0_A06	42817726	42820066	BnaA06T0395900ZY.1	0	-	0	0	2340	0.0000000
zheyou73v0_A06	42845654	42847661	BnaA06T0396000ZY	0	-	0	0	2007	0.0000000
zheyou73v0_A06	42845654	42847661	BnaA06T0396000ZY.1	0	-	0	0	2007	0.0000000
zheyou73v0_A06	42848426	42850486	BnaA06T0396100ZY	0	-	0	0	2060	0.0000000
zheyou73v0_A06	42851343	42852553	BnaA06T0396200ZY	0	-	0	0	1210	0.0000000
zheyou73v0_A06	42881314	42884570	BnaA06T0396300ZY	0	+	0	0	3256	0.0000000
zheyou73v0_A06	42886223	42886913	BnaA06T0396400ZY	0	-	0	0	690	0.0000000
zheyou73v0_A06	42889913	42891667	BnaA06T0396500ZY	0	+	0	0	1754	0.0000000
zheyou73v0_A06	42908226	42911024	BnaA06T0396600ZY	0	+	0	0	2798	0.0000000
zheyou73v0_A06	42915781	42917471	BnaA06T0396700ZY	0	-	0	0	1690	0.0000000
zheyou73v0_A06	42920998	42921759	BnaA06T0396800ZY	0	-	0	0	761	0.0000000
zheyou73v0_A06	42928925	42931121	BnaA06T0396900ZY	0	+	0	0	2196	0.0000000
zheyou73v0_A06	42939085	42943771	BnaA06T0397000ZY	0	-	0	0	4686	0.0000000
zheyou73v0_A06	42948552	42950439	BnaA06T0397100ZY	0	-	0	0	1887	0.0000000
zheyou73v0_A06	42950902	42953410	BnaA06T0397200ZY	0	-	0	0	2508	0.0000000
zheyou73v0_A06	42958625	42961006	BnaA06T0397300ZY	0	-	0	0	2381	0.0000000
zheyou73v0_A06	42962078	42965000	BnaA06T0397400ZY	0	-	0	0	2922	0.0000000
zheyou73v0_A06	42973995	42977508	BnaA06T0397500ZY	0	+	0	0	3513	0.0000000
zheyou73v0_A06	42985529	42989401	BnaA06T0397600ZY	0	-	0	0	3872	0.0000000
zheyou73v0_A06	43001002	43001947	BnaA06T0397700ZY	0	-	0	0	945	0.0000000
zheyou73v0_A06	43005608	43006509	BnaA06T0397800ZY	0	+	0	0	901	0.0000000
zheyou73v0_A06	43008249	43010799	BnaA06T0397900ZY	0	-	0	0	2550	0.0000000
zheyou73v0_A06	43015590	43018371	BnaA06T0398000ZY	0	-	0	0	2781	0.0000000
zheyou73v0_A06	43020223	43022773	BnaA06T0398100ZY	0	+	0	0	2550	0.0000000
zheyou73v0_A06	43023551	43028440	BnaA06T0398200ZY	0	+	0	0	4889	0.0000000
zheyou73v0_A06	43028545	43029931	BnaA06T0398300ZY	0	-	0	0	1386	0.0000000
zheyou73v0_A06	43030753	43033104	BnaA06T0398400ZY	0	-	0	0	2351	0.0000000
zheyou73v0_A06	43047138	43052543	BnaA06T0398500ZY	0	+	0	0	5405	0.0000000
zheyou73v0_A06	43047138	43052543	BnaA06T0398500ZY.1	0	+	0	0	5405	0.0000000
zheyou73v0_A06	43068980	43072014	BnaA06T0398600ZY	0	-	0	0	3034	0.0000000
zheyou73v0_A06	43079120	43081881	BnaA06T0398700ZY	0	+	0	0	2761	0.0000000
zheyou73v0_A06	43082702	43084564	BnaA06T0398800ZY	0	+	0	0	1862	0.0000000
zheyou73v0_A06	43084586	43087329	BnaA06T0398900ZY	0	-	0	0	2743	0.0000000
zheyou73v0_A06	43090472	43091081	BnaA06T0399000ZY	0	+	0	0	609	0.0000000
zheyou73v0_A06	43091965	43093988	BnaA06T0399100ZY	0	-	0	0	2023	0.0000000
zheyou73v0_A06	43098110	43099777	BnaA06T0399200ZY	0	+	0	0	1667	0.0000000
zheyou73v0_A06	43098110	43099777	BnaA06T0399200ZY.1	0	+	0	0	1667	0.0000000
zheyou73v0_A06	43104041	43108055	BnaA06T0399300ZY	0	+	0	0	4014	0.0000000
zheyou73v0_A06	43108658	43109399	BnaA06T0399400ZY	0	-	0	0	741	0.0000000
zheyou73v0_A06	43114909	43117829	BnaA06T0399500ZY	0	-	0	0	2920	0.0000000
zheyou73v0_A06	43125407	43129635	BnaA06T0399600ZY	0	+	0	0	4228	0.0000000
zheyou73v0_A06	43133758	43136245	BnaA06T0399700ZY	0	-	0	0	2487	0.0000000
zheyou73v0_A06	43146318	43146741	BnaA06T0399800ZY	0	+	0	0	423	0.0000000
zheyou73v0_A06	43151105	43154520	BnaA06T0399900ZY	0	-	0	0	3415	0.0000000
zheyou73v0_A06	43162181	43162625	BnaA06T0400000ZY	0	+	0	0	444	0.0000000
zheyou73v0_A06	43167779	43168049	BnaA06T0400100ZY	0	-	0	0	270	0.0000000
zheyou73v0_A06	43172815	43174176	BnaA06T0400200ZY.1	0	+	0	0	1361	0.0000000
zheyou73v0_A06	43173124	43174176	BnaA06T0400200ZY	0	+	0	0	1052	0.0000000
zheyou73v0_A06	43176508	43179027	BnaA06T0400300ZY	0	+	0	0	2519	0.0000000
zheyou73v0_A06	43179836	43184429	BnaA06T0400400ZY	0	+	0	0	4593	0.0000000
zheyou73v0_A06	43184979	43187798	BnaA06T0400500ZY	0	-	0	0	2819	0.0000000
zheyou73v0_A06	43201773	43203435	BnaA06T0400600ZY	0	+	0	0	1662	0.0000000
zheyou73v0_A06	43201773	43203435	BnaA06T0400600ZY.1	0	+	0	0	1662	0.0000000
zheyou73v0_A06	43215727	43217537	BnaA06T0400700ZY	0	+	0	0	1810	0.0000000
zheyou73v0_A06	43221425	43222295	BnaA06T0400800ZY	0	-	0	0	870	0.0000000
zheyou73v0_A06	43223601	43224829	BnaA06T0400900ZY	0	-	0	0	1228	0.0000000
zheyou73v0_A06	43225583	43226423	BnaA06T0401000ZY	0	+	0	0	840	0.0000000
zheyou73v0_A06	43227469	43228525	BnaA06T0401100ZY	0	-	0	0	1056	0.0000000
zheyou73v0_A06	43229085	43232777	BnaA06T0401200ZY	0	-	0	0	3692	0.0000000
zheyou73v0_A06	43235323	43235887	BnaA06T0401300ZY	0	+	0	0	564	0.0000000
zheyou73v0_A06	43253113	43253987	BnaA06T0401400ZY	0	+	0	0	874	0.0000000
zheyou73v0_A06	43257498	43259711	BnaA06T0401500ZY	0	+	0	0	2213	0.0000000
zheyou73v0_A06	43267437	43267737	BnaA06T0401600ZY	0	-	0	0	300	0.0000000
zheyou73v0_A06	43268114	43268501	BnaA06T0401700ZY	0	-	0	0	387	0.0000000
zheyou73v0_A06	43269032	43270509	BnaA06T0401800ZY	0	+	0	0	1477	0.0000000
zheyou73v0_A06	43270515	43271703	BnaA06T0401900ZY	0	-	0	0	1188	0.0000000
zheyou73v0_A06	43283894	43285014	BnaA06T0402000ZY	0	+	0	0	1120	0.0000000
zheyou73v0_A06	43285212	43285850	BnaA06T0402100ZY	0	-	0	0	638	0.0000000
zheyou73v0_A06	43305266	43307248	BnaA06T0402200ZY	0	+	0	0	1982	0.0000000
zheyou73v0_A06	43308234	43309201	BnaA06T0402300ZY	0	+	0	0	967	0.0000000
zheyou73v0_A06	43322602	43326067	BnaA06T0402400ZY	0	-	0	0	3465	0.0000000
zheyou73v0_A06	43322602	43326067	BnaA06T0402400ZY.1	0	-	0	0	3465	0.0000000
zheyou73v0_A06	43328624	43332091	BnaA06T0402500ZY	0	-	0	0	3467	0.0000000
zheyou73v0_A06	43335332	43338352	BnaA06T0402600ZY	0	-	0	0	3020	0.0000000
zheyou73v0_A06	43341106	43342617	BnaA06T0402700ZY	0	+	0	0	1511	0.0000000
zheyou73v0_A06	43342745	43343299	BnaA06T0402800ZY	0	+	0	0	554	0.0000000
zheyou73v0_A06	43346454	43348758	BnaA06T0402900ZY	0	+	0	0	2304	0.0000000
zheyou73v0_A06	43349797	43354368	BnaA06T0403000ZY	0	+	0	0	4571	0.0000000
zheyou73v0_A06	43361628	43364452	BnaA06T0403100ZY	0	+	0	0	2824	0.0000000
zheyou73v0_A06	43367772	43369837	BnaA06T0403200ZY	0	-	0	0	2065	0.0000000
zheyou73v0_A06	43371362	43371946	BnaA06T0403300ZY	0	+	0	0	584	0.0000000
zheyou73v0_A06	43371983	43373350	BnaA06T0403400ZY	0	-	0	0	1367	0.0000000
zheyou73v0_A06	43381641	43381839	BnaA06T0403500ZY	0	+	0	0	198	0.0000000
zheyou73v0_A06	43386344	43386824	BnaA06T0403600ZY	0	+	0	0	480	0.0000000
zheyou73v0_A06	43388139	43388826	BnaA06T0403700ZY	0	+	0	0	687	0.0000000
zheyou73v0_A06	43390383	43392551	BnaA06T0403800ZY.1	0	+	0	0	2168	0.0000000
zheyou73v0_A06	43390717	43392551	BnaA06T0403800ZY	0	+	0	0	1834	0.0000000
zheyou73v0_A06	43395228	43397259	BnaA06T0403900ZY	0	+	0	0	2031	0.0000000
zheyou73v0_A06	43398155	43399528	BnaA06T0404000ZY	0	+	0	0	1373	0.0000000
zheyou73v0_A06	43399614	43402832	BnaA06T0404100ZY	0	-	0	0	3218	0.0000000
zheyou73v0_A06	43404343	43406904	BnaA06T0404200ZY	0	+	0	0	2561	0.0000000
zheyou73v0_A06	43406840	43407671	BnaA06T0404300ZY	0	-	0	0	831	0.0000000
zheyou73v0_A06	43408466	43411081	BnaA06T0404400ZY	0	-	0	0	2615	0.0000000
zheyou73v0_A06	43426161	43427713	BnaA06T0404500ZY	0	+	0	0	1552	0.0000000
zheyou73v0_A06	43428054	43430149	BnaA06T0404600ZY	0	+	0	0	2095	0.0000000
zheyou73v0_A06	43432475	43433027	BnaA06T0404700ZY	0	-	0	0	552	0.0000000
zheyou73v0_A06	43440815	43446467	BnaA06T0404800ZY	0	+	0	0	5652	0.0000000
zheyou73v0_A06	43447141	43449891	BnaA06T0404900ZY	0	-	0	0	2750	0.0000000
zheyou73v0_A06	43450260	43451593	BnaA06T0405000ZY	0	+	0	0	1333	0.0000000
zheyou73v0_A06	43452110	43452860	BnaA06T0405100ZY	0	-	0	0	750	0.0000000
zheyou73v0_A06	43453821	43455436	BnaA06T0405200ZY	0	-	0	0	1615	0.0000000
zheyou73v0_A06	43455450	43457869	BnaA06T0405300ZY	0	-	0	0	2419	0.0000000
zheyou73v0_A06	43462656	43464713	BnaA06T0405400ZY	0	+	0	0	2057	0.0000000
zheyou73v0_A06	43462844	43464713	BnaA06T0405400ZY.1	0	+	0	0	1869	0.0000000
zheyou73v0_A06	43464781	43467616	BnaA06T0405500ZY	0	-	0	0	2835	0.0000000
zheyou73v0_A06	43469351	43469900	BnaA06T0405600ZY	0	+	0	0	549	0.0000000
zheyou73v0_A06	43470728	43474648	BnaA06T0405700ZY	0	-	0	0	3920	0.0000000
zheyou73v0_A06	43470728	43474648	BnaA06T0405700ZY.1	0	-	0	0	3920	0.0000000
zheyou73v0_A06	43475801	43477705	BnaA06T0405800ZY	0	-	0	0	1904	0.0000000
zheyou73v0_A06	43478818	43480848	BnaA06T0405900ZY	0	+	0	0	2030	0.0000000
zheyou73v0_A06	43480841	43483421	BnaA06T0406000ZY	0	-	0	0	2580	0.0000000
zheyou73v0_A06	43480841	43483138	BnaA06T0406000ZY.1	0	-	0	0	2297	0.0000000
zheyou73v0_A06	43480841	43483421	BnaA06T0406000ZY.2	0	-	0	0	2580	0.0000000
zheyou73v0_A06	43483733	43485868	BnaA06T0406100ZY	0	-	0	0	2135	0.0000000
zheyou73v0_A06	43486372	43492924	BnaA06T0406200ZY	0	-	0	0	6552	0.0000000
zheyou73v0_A06	43496110	43498379	BnaA06T0406300ZY	0	+	0	0	2269	0.0000000
zheyou73v0_A06	43496383	43498379	BnaA06T0406300ZY.1	0	+	0	0	1996	0.0000000
zheyou73v0_A06	43498509	43499624	BnaA06T0406400ZY	0	-	0	0	1115	0.0000000
zheyou73v0_A06	43502716	43505057	BnaA06T0406500ZY	0	+	0	0	2341	0.0000000
zheyou73v0_A06	43504684	43506674	BnaA06T0406600ZY	0	-	0	0	1990	0.0000000
zheyou73v0_A06	43507252	43510471	BnaA06T0406700ZY	0	-	0	0	3219	0.0000000
zheyou73v0_A06	43510969	43520475	BnaA06T0406800ZY	0	-	0	0	9506	0.0000000
zheyou73v0_A06	43520886	43522148	BnaA06T0406900ZY	0	+	0	0	1262	0.0000000
zheyou73v0_A06	43522521	43524989	BnaA06T0407000ZY	0	-	0	0	2468	0.0000000
zheyou73v0_A06	43527438	43529842	BnaA06T0407100ZY	0	+	0	0	2404	0.0000000
zheyou73v0_A06	43533626	43534822	BnaA06T0407200ZY	0	-	0	0	1196	0.0000000
zheyou73v0_A06	43535953	43536989	BnaA06T0407300ZY	0	+	0	0	1036	0.0000000
zheyou73v0_A06	43537359	43537722	BnaA06T0407400ZY	0	-	0	0	363	0.0000000
zheyou73v0_A06	43540644	43542514	BnaA06T0407500ZY	0	+	0	0	1870	0.0000000
zheyou73v0_A06	43543120	43543940	BnaA06T0407600ZY	0	+	0	0	820	0.0000000
zheyou73v0_A06	43547611	43548431	BnaA06T0407700ZY	0	+	0	0	820	0.0000000
zheyou73v0_A06	43551634	43552183	BnaA06T0407800ZY	0	+	0	0	549	0.0000000
zheyou73v0_A06	43555009	43556313	BnaA06T0407900ZY	0	+	0	0	1304	0.0000000
zheyou73v0_A06	43561489	43564254	BnaA06T0408000ZY	0	+	0	0	2765	0.0000000
zheyou73v0_A06	43565359	43566140	BnaA06T0408100ZY	0	+	0	0	781	0.0000000
zheyou73v0_A06	43568071	43570435	BnaA06T0408200ZY	0	+	0	0	2364	0.0000000
zheyou73v0_A06	43568682	43570435	BnaA06T0408200ZY.1	0	+	0	0	1753	0.0000000
zheyou73v0_A06	43573018	43573225	BnaA06T0408300ZY	0	+	0	0	207	0.0000000
zheyou73v0_A06	43573461	43575848	BnaA06T0408400ZY	0	-	0	0	2387	0.0000000
zheyou73v0_A06	43579437	43581166	BnaA06T0408500ZY	0	+	0	0	1729	0.0000000
zheyou73v0_A06	43581363	43587702	BnaA06T0408600ZY	0	-	0	0	6339	0.0000000
zheyou73v0_A06	43588775	43589172	BnaA06T0408700ZY	0	-	0	0	397	0.0000000
zheyou73v0_A06	43589624	43591131	BnaA06T0408800ZY	0	-	0	0	1507	0.0000000
zheyou73v0_A06	43591615	43593043	BnaA06T0408900ZY.1	0	-	0	0	1428	0.0000000
zheyou73v0_A06	43591653	43593043	BnaA06T0408900ZY	0	-	0	0	1390	0.0000000
zheyou73v0_A06	43594325	43595933	BnaA06T0409000ZY	0	+	0	0	1608	0.0000000
zheyou73v0_A06	43596850	43598862	BnaA06T0409100ZY	0	+	0	0	2012	0.0000000
zheyou73v0_A06	43597949	43600106	BnaA06T0409200ZY	0	-	0	0	2157	0.0000000
zheyou73v0_A06	43602424	43605520	BnaA06T0409300ZY	0	-	0	0	3096	0.0000000
zheyou73v0_A06	43617959	43619545	BnaA06T0409400ZY	0	+	0	0	1586	0.0000000
zheyou73v0_A06	43627956	43628302	BnaA06T0409500ZY	0	+	0	0	346	0.0000000
zheyou73v0_A06	43628358	43629396	BnaA06T0409600ZY	0	+	0	0	1038	0.0000000
zheyou73v0_A06	43629528	43629943	BnaA06T0409700ZY	0	+	0	0	415	0.0000000
zheyou73v0_A06	43630237	43633901	BnaA06T0409800ZY	0	-	0	0	3664	0.0000000
zheyou73v0_A06	43636774	43638799	BnaA06T0409900ZY	0	-	0	0	2025	0.0000000
zheyou73v0_A06	43642115	43644266	BnaA06T0410000ZY	0	-	0	0	2151	0.0000000
zheyou73v0_A06	43642115	43644266	BnaA06T0410000ZY.1	0	-	0	0	2151	0.0000000
zheyou73v0_A06	43647996	43649006	BnaA06T0410100ZY	0	-	0	0	1010	0.0000000
zheyou73v0_A06	43658782	43659514	BnaA06T0410200ZY	0	+	0	0	732	0.0000000
zheyou73v0_A06	43660054	43661928	BnaA06T0410300ZY	0	+	0	0	1874	0.0000000
zheyou73v0_A06	43662832	43664830	BnaA06T0410400ZY	0	-	0	0	1998	0.0000000
zheyou73v0_A06	43668692	43670110	BnaA06T0410500ZY	0	+	0	0	1418	0.0000000
zheyou73v0_A06	43671538	43673070	BnaA06T0410600ZY	0	+	0	0	1532	0.0000000
zheyou73v0_A06	43673626	43674709	BnaA06T0410700ZY	0	-	0	0	1083	0.0000000
zheyou73v0_A06	43677523	43679272	BnaA06T0410800ZY	0	-	0	0	1749	0.0000000
zheyou73v0_A06	43677523	43679308	BnaA06T0410800ZY.1	0	-	0	0	1785	0.0000000
zheyou73v0_A06	43682295	43685315	BnaA06T0410900ZY	0	-	0	0	3020	0.0000000
zheyou73v0_A06	43692201	43692658	BnaA06T0411000ZY	0	-	0	0	457	0.0000000
zheyou73v0_A06	43693425	43698095	BnaA06T0411100ZY	0	+	0	0	4670	0.0000000
zheyou73v0_A06	43701888	43703584	BnaA06T0411200ZY	0	+	0	0	1696	0.0000000
zheyou73v0_A06	43705307	43706383	BnaA06T0411300ZY	0	-	0	0	1076	0.0000000
zheyou73v0_A06	43726138	43727561	BnaA06T0411400ZY	0	-	0	0	1423	0.0000000
zheyou73v0_A06	43735633	43741089	BnaA06T0411500ZY	0	+	0	0	5456	0.0000000
zheyou73v0_A06	43741441	43743015	BnaA06T0411600ZY	0	-	0	0	1574	0.0000000
zheyou73v0_A06	43743177	43744396	BnaA06T0411700ZY	0	+	0	0	1219	0.0000000
zheyou73v0_A06	43744413	43752162	BnaA06T0411800ZY	0	-	0	0	7749	0.0000000
zheyou73v0_A06	43757103	43757765	BnaA06T0411900ZY	0	+	0	0	662	0.0000000
zheyou73v0_A06	43760831	43761609	BnaA06T0412000ZY	0	+	0	0	778	0.0000000
zheyou73v0_A06	43763888	43764972	BnaA06T0412100ZY	0	+	0	0	1084	0.0000000
zheyou73v0_A06	43768507	43769274	BnaA06T0412200ZY	0	-	0	0	767	0.0000000
zheyou73v0_A06	43770147	43770696	BnaA06T0412300ZY	0	+	0	0	549	0.0000000
zheyou73v0_A06	43770368	43773430	BnaA06T0412400ZY	0	-	0	0	3062	0.0000000
zheyou73v0_A06	43775365	43776033	BnaA06T0412500ZY	0	-	0	0	668	0.0000000
zheyou73v0_A06	43795111	43799731	BnaA06T0412600ZY	0	-	0	0	4620	0.0000000
zheyou73v0_A06	43801686	43802527	BnaA06T0412700ZY	0	-	0	0	841	0.0000000
zheyou73v0_A06	43808103	43808896	BnaA06T0412800ZY	0	-	0	0	793	0.0000000
zheyou73v0_A06	43810784	43812726	BnaA06T0412900ZY	0	-	0	0	1942	0.0000000
zheyou73v0_A06	43814260	43815146	BnaA06T0413000ZY	0	-	0	0	886	0.0000000
zheyou73v0_A06	43820105	43821677	BnaA06T0413100ZY	0	+	0	0	1572	0.0000000
zheyou73v0_A06	43821371	43822916	BnaA06T0413200ZY	0	-	0	0	1545	0.0000000
zheyou73v0_A06	43827770	43829658	BnaA06T0413300ZY	0	-	0	0	1888	0.0000000
zheyou73v0_A06	43831950	43832766	BnaA06T0413400ZY	0	-	0	0	816	0.0000000
zheyou73v0_A06	43839519	43848650	BnaA06T0413500ZY	0	-	0	0	9131	0.0000000
zheyou73v0_A06	43855129	43856622	BnaA06T0413600ZY	0	+	0	0	1493	0.0000000
zheyou73v0_A06	43855129	43856622	BnaA06T0413600ZY.1	0	+	0	0	1493	0.0000000
zheyou73v0_A06	43857020	43859178	BnaA06T0413700ZY	0	+	0	0	2158	0.0000000
zheyou73v0_A06	43862659	43863515	BnaA06T0413800ZY	0	+	0	0	856	0.0000000
zheyou73v0_A06	43865728	43866885	BnaA06T0413900ZY	0	-	0	0	1157	0.0000000
zheyou73v0_A06	43871631	43872260	BnaA06T0414000ZY	0	+	0	0	629	0.0000000
zheyou73v0_A06	43875697	43877459	BnaA06T0414100ZY	0	-	0	0	1762	0.0000000
zheyou73v0_A06	43881023	43883144	BnaA06T0414200ZY	0	+	0	0	2121	0.0000000
zheyou73v0_A06	43881023	43883144	BnaA06T0414200ZY.1	0	+	0	0	2121	0.0000000
zheyou73v0_A06	43883553	43887794	BnaA06T0414300ZY	0	+	0	0	4241	0.0000000
zheyou73v0_A06	43887214	43888312	BnaA06T0414400ZY	0	-	0	0	1098	0.0000000
zheyou73v0_A06	43913510	43915014	BnaA06T0414500ZY	0	+	0	0	1504	0.0000000
zheyou73v0_A06	43915921	43916963	BnaA06T0414600ZY	0	-	0	0	1042	0.0000000
zheyou73v0_A06	43919544	43921370	BnaA06T0414700ZY	0	-	0	0	1826	0.0000000
zheyou73v0_A06	43945724	43946939	BnaA06T0414800ZY	0	-	0	0	1215	0.0000000
zheyou73v0_A06	43948208	43951447	BnaA06T0414900ZY	0	-	0	0	3239	0.0000000
zheyou73v0_A06	43952404	43953797	BnaA06T0415000ZY	0	+	0	0	1393	0.0000000
zheyou73v0_A06	43955529	43958230	BnaA06T0415100ZY	0	+	0	0	2701	0.0000000
zheyou73v0_A06	43959442	43960654	BnaA06T0415200ZY	0	-	0	0	1212	0.0000000
zheyou73v0_A06	43965361	43966038	BnaA06T0415300ZY	0	-	0	0	677	0.0000000
zheyou73v0_A06	43969398	43969785	BnaA06T0415400ZY	0	-	0	0	387	0.0000000
zheyou73v0_A06	43972452	43972702	BnaA06T0415500ZY	0	+	0	0	250	0.0000000
zheyou73v0_A06	43979664	43984731	BnaA06T0415600ZY	0	-	0	0	5067	0.0000000
zheyou73v0_A06	43979700	43981836	BnaA06T0415700ZY	0	+	0	0	2136	0.0000000
zheyou73v0_A06	43987846	43991429	BnaA06T0415800ZY	0	-	0	0	3583	0.0000000
zheyou73v0_A06	44007150	44009293	BnaA06T0415900ZY	0	-	0	0	2143	0.0000000
zheyou73v0_A06	44009679	44010561	BnaA06T0416000ZY	0	-	0	0	882	0.0000000
zheyou73v0_A06	44010985	44013929	BnaA06T0416100ZY	0	-	0	0	2944	0.0000000
zheyou73v0_A06	44014544	44018379	BnaA06T0416200ZY.1	0	-	0	0	3835	0.0000000
zheyou73v0_A06	44014544	44017600	BnaA06T0416200ZY.2	0	-	0	0	3056	0.0000000
zheyou73v0_A06	44014544	44018379	BnaA06T0416200ZY.3	0	-	0	0	3835	0.0000000
zheyou73v0_A06	44014544	44018379	BnaA06T0416200ZY.4	0	-	0	0	3835	0.0000000
zheyou73v0_A06	44014600	44017600	BnaA06T0416200ZY	0	-	0	0	3000	0.0000000
zheyou73v0_A06	44018542	44022837	BnaA06T0416300ZY	0	-	0	0	4295	0.0000000
zheyou73v0_A06	44028433	44031006	BnaA06T0416400ZY	0	+	0	0	2573	0.0000000
zheyou73v0_A06	44034543	44037917	BnaA06T0416500ZY	0	+	0	0	3374	0.0000000
zheyou73v0_A06	44034543	44037917	BnaA06T0416500ZY.1	0	+	0	0	3374	0.0000000
zheyou73v0_A06	44034543	44037917	BnaA06T0416500ZY.2	0	+	0	0	3374	0.0000000
zheyou73v0_A06	44038304	44040769	BnaA06T0416600ZY.1	0	-	0	0	2465	0.0000000
zheyou73v0_A06	44038335	44040769	BnaA06T0416600ZY	0	-	0	0	2434	0.0000000
zheyou73v0_A06	44042782	44042995	BnaA06T0416700ZY	0	+	0	0	213	0.0000000
zheyou73v0_A06	44046040	44049094	BnaA06T0416800ZY	0	+	0	0	3054	0.0000000
zheyou73v0_A06	44050677	44054522	BnaA06T0416900ZY	0	+	0	0	3845	0.0000000
zheyou73v0_A06	44055026	44057554	BnaA06T0417000ZY	0	-	0	0	2528	0.0000000
zheyou73v0_A06	44075799	44080091	BnaA06T0417100ZY.1	0	+	0	0	4292	0.0000000
zheyou73v0_A06	44076139	44080091	BnaA06T0417100ZY	0	+	0	0	3952	0.0000000
zheyou73v0_A06	44076139	44080091	BnaA06T0417100ZY.2	0	+	0	0	3952	0.0000000
zheyou73v0_A06	44083431	44084005	BnaA06T0417200ZY	0	+	0	0	574	0.0000000
zheyou73v0_A06	44088823	44093433	BnaA06T0417300ZY	0	-	0	0	4610	0.0000000
zheyou73v0_A06	44094296	44099389	BnaA06T0417400ZY	0	+	0	0	5093	0.0000000
zheyou73v0_A06	44100303	44103048	BnaA06T0417500ZY	0	+	0	0	2745	0.0000000
zheyou73v0_A06	44105097	44107638	BnaA06T0417600ZY	0	+	0	0	2541	0.0000000
zheyou73v0_A06	44105097	44107638	BnaA06T0417600ZY.1	0	+	0	0	2541	0.0000000
zheyou73v0_A06	44108827	44110708	BnaA06T0417700ZY	0	+	0	0	1881	0.0000000
zheyou73v0_A06	44112148	44113079	BnaA06T0417800ZY	0	+	0	0	931	0.0000000
zheyou73v0_A06	44118560	44119033	BnaA06T0417900ZY	0	-	0	0	473	0.0000000
zheyou73v0_A06	44122174	44122724	BnaA06T0418000ZY	0	+	0	0	550	0.0000000
zheyou73v0_A06	44122790	44125835	BnaA06T0418100ZY	0	-	0	0	3045	0.0000000
zheyou73v0_A06	44122790	44125835	BnaA06T0418100ZY.1	0	-	0	0	3045	0.0000000
zheyou73v0_A06	44122790	44125835	BnaA06T0418100ZY.2	0	-	0	0	3045	0.0000000
zheyou73v0_A06	44122790	44125835	BnaA06T0418100ZY.3	0	-	0	0	3045	0.0000000
zheyou73v0_A06	44130976	44133467	BnaA06T0418200ZY	0	+	0	0	2491	0.0000000
zheyou73v0_A06	44132468	44133122	BnaA06T0418300ZY	0	-	0	0	654	0.0000000
zheyou73v0_A06	44134765	44135491	BnaA06T0418400ZY	0	-	0	0	726	0.0000000
zheyou73v0_A06	44143141	44144396	BnaA06T0418500ZY	0	+	0	0	1255	0.0000000
zheyou73v0_A06	44147658	44152758	BnaA06T0418600ZY	0	-	0	0	5100	0.0000000
zheyou73v0_A06	44153608	44154223	BnaA06T0418700ZY	0	-	0	0	615	0.0000000
zheyou73v0_A06	44154906	44156685	BnaA06T0418800ZY	0	+	0	0	1779	0.0000000
zheyou73v0_A06	44154906	44156685	BnaA06T0418800ZY.1	0	+	0	0	1779	0.0000000
zheyou73v0_A06	44157822	44159801	BnaA06T0418900ZY	0	-	0	0	1979	0.0000000
zheyou73v0_A06	44158101	44159801	BnaA06T0418900ZY.1	0	-	0	0	1700	0.0000000
zheyou73v0_A06	44161192	44161510	BnaA06T0419000ZY	0	-	0	0	318	0.0000000
zheyou73v0_A06	44161667	44163360	BnaA06T0419100ZY	0	-	0	0	1693	0.0000000
zheyou73v0_A06	44166763	44167934	BnaA06T0419200ZY	0	+	0	0	1171	0.0000000
zheyou73v0_A06	44172418	44172907	BnaA06T0419300ZY	0	+	0	0	489	0.0000000
zheyou73v0_A06	44177018	44180104	BnaA06T0419400ZY	0	+	0	0	3086	0.0000000
zheyou73v0_A06	44184938	44186082	BnaA06T0419500ZY	0	+	0	0	1144	0.0000000
zheyou73v0_A06	44189497	44189920	BnaA06T0419600ZY	0	+	0	0	423	0.0000000
zheyou73v0_A06	44190499	44192141	BnaA06T0419700ZY	0	-	0	0	1642	0.0000000
zheyou73v0_A06	44197236	44200411	BnaA06T0419800ZY	0	+	0	0	3175	0.0000000
zheyou73v0_A06	44203065	44204778	BnaA06T0419900ZY	0	-	0	0	1713	0.0000000
zheyou73v0_A06	44204958	44209070	BnaA06T0420000ZY	0	-	0	0	4112	0.0000000
zheyou73v0_A06	44212959	44215739	BnaA06T0420100ZY	0	+	0	0	2780	0.0000000
zheyou73v0_A06	44216613	44218013	BnaA06T0420200ZY	0	-	0	0	1400	0.0000000
zheyou73v0_A06	44219797	44221307	BnaA06T0420300ZY	0	+	0	0	1510	0.0000000
zheyou73v0_A06	44230225	44230968	BnaA06T0420400ZY	0	+	0	0	743	0.0000000
zheyou73v0_A06	44232654	44233737	BnaA06T0420500ZY	0	-	0	0	1083	0.0000000
zheyou73v0_A06	44235683	44239213	BnaA06T0420600ZY	0	+	0	0	3530	0.0000000
zheyou73v0_A06	44256057	44257060	BnaA06T0420700ZY	0	-	0	0	1003	0.0000000
zheyou73v0_A06	44258986	44260211	BnaA06T0420800ZY	0	+	0	0	1225	0.0000000
zheyou73v0_A06	44262252	44264513	BnaA06T0420900ZY	0	-	0	0	2261	0.0000000
zheyou73v0_A06	44266280	44267348	BnaA06T0421000ZY	0	-	0	0	1068	0.0000000
zheyou73v0_A06	44268449	44270521	BnaA06T0421100ZY	0	-	0	0	2072	0.0000000
zheyou73v0_A06	44271612	44274959	BnaA06T0421200ZY	0	+	0	0	3347	0.0000000
zheyou73v0_A06	44275582	44276056	BnaA06T0421300ZY	0	-	0	0	474	0.0000000
zheyou73v0_A06	44277045	44278637	BnaA06T0421400ZY	0	-	0	0	1592	0.0000000
zheyou73v0_A06	44280059	44281555	BnaA06T0421500ZY	0	+	0	0	1496	0.0000000
zheyou73v0_A06	44289010	44290968	BnaA06T0421600ZY	0	+	0	0	1958	0.0000000
zheyou73v0_A06	44296891	44297279	BnaA06T0421700ZY	0	+	0	0	388	0.0000000
zheyou73v0_A06	44299383	44302539	BnaA06T0421800ZY	0	+	0	0	3156	0.0000000
zheyou73v0_A06	44304786	44308062	BnaA06T0421900ZY	0	+	0	0	3276	0.0000000
zheyou73v0_A06	44310124	44312960	BnaA06T0422000ZY	0	+	0	0	2836	0.0000000
zheyou73v0_A06	44313414	44315864	BnaA06T0422100ZY	0	-	0	0	2450	0.0000000
zheyou73v0_A06	44317910	44319200	BnaA06T0422200ZY	0	+	0	0	1290	0.0000000
zheyou73v0_A06	44320557	44322071	BnaA06T0422300ZY	0	-	0	0	1514	0.0000000
zheyou73v0_A06	44322355	44324359	BnaA06T0422400ZY	0	+	0	0	2004	0.0000000
zheyou73v0_A06	44328693	44331960	BnaA06T0422500ZY	0	+	0	0	3267	0.0000000
zheyou73v0_A06	44328693	44331960	BnaA06T0422500ZY.1	0	+	0	0	3267	0.0000000
zheyou73v0_A06	44328693	44331960	BnaA06T0422500ZY.2	0	+	0	0	3267	0.0000000
zheyou73v0_A06	44332913	44335279	BnaA06T0422600ZY	0	+	0	0	2366	0.0000000
zheyou73v0_A06	44341784	44343685	BnaA06T0422700ZY	0	+	0	0	1901	0.0000000
zheyou73v0_A06	44346098	44348042	BnaA06T0422800ZY	0	+	0	0	1944	0.0000000
zheyou73v0_A06	44352772	44354824	BnaA06T0422900ZY	0	+	0	0	2052	0.0000000
zheyou73v0_A06	44356898	44357998	BnaA06T0423000ZY	0	+	0	0	1100	0.0000000
zheyou73v0_A06	44360669	44363965	BnaA06T0423100ZY	0	+	0	0	3296	0.0000000
zheyou73v0_A06	44371049	44373767	BnaA06T0423200ZY	0	+	0	0	2718	0.0000000
zheyou73v0_A06	44374680	44377135	BnaA06T0423300ZY	0	+	0	0	2455	0.0000000
zheyou73v0_A06	44377556	44381531	BnaA06T0423400ZY	0	-	0	0	3975	0.0000000
zheyou73v0_A06	44383429	44393011	BnaA06T0423500ZY	0	+	0	0	9582	0.0000000
zheyou73v0_A06	44393306	44395026	BnaA06T0423600ZY	0	-	0	0	1720	0.0000000
zheyou73v0_A06	44395889	44397748	BnaA06T0423700ZY	0	+	0	0	1859	0.0000000
zheyou73v0_A06	44398546	44400871	BnaA06T0423800ZY	0	-	0	0	2325	0.0000000
zheyou73v0_A06	44398546	44400871	BnaA06T0423800ZY.1	0	-	0	0	2325	0.0000000
zheyou73v0_A06	44398546	44400871	BnaA06T0423800ZY.2	0	-	0	0	2325	0.0000000
zheyou73v0_A06	44404604	44405488	BnaA06T0423900ZY	0	+	0	0	884	0.0000000
zheyou73v0_A06	44405926	44407311	BnaA06T0424000ZY	0	-	0	0	1385	0.0000000
zheyou73v0_A06	44408831	44410543	BnaA06T0424100ZY	0	-	0	0	1712	0.0000000
zheyou73v0_A06	44410610	44410922	BnaA06T0424200ZY	0	-	0	0	312	0.0000000
zheyou73v0_A06	44412354	44413521	BnaA06T0424300ZY	0	+	0	0	1167	0.0000000
zheyou73v0_A06	44419545	44422538	BnaA06T0424400ZY	0	+	0	0	2993	0.0000000
zheyou73v0_A06	44434924	44436255	BnaA06T0424500ZY	0	+	0	0	1331	0.0000000
zheyou73v0_A06	44438239	44439989	BnaA06T0424600ZY	0	+	0	0	1750	0.0000000
zheyou73v0_A06	44443705	44447438	BnaA06T0424700ZY	0	+	0	0	3733	0.0000000
zheyou73v0_A06	44452731	44455469	BnaA06T0424800ZY	0	-	0	0	2738	0.0000000
zheyou73v0_A06	44457847	44460798	BnaA06T0424900ZY	0	+	0	0	2951	0.0000000
zheyou73v0_A06	44457847	44460798	BnaA06T0424900ZY.1	0	+	0	0	2951	0.0000000
zheyou73v0_A06	44463878	44466756	BnaA06T0425000ZY	0	-	0	0	2878	0.0000000
zheyou73v0_A06	44469943	44475761	BnaA06T0425100ZY	0	-	0	0	5818	0.0000000
zheyou73v0_A06	44476631	44480133	BnaA06T0425200ZY	0	+	0	0	3502	0.0000000
zheyou73v0_A06	44481634	44482537	BnaA06T0425300ZY	0	+	0	0	903	0.0000000
zheyou73v0_A06	44488050	44489631	BnaA06T0425400ZY	0	-	0	0	1581	0.0000000
zheyou73v0_A06	44489846	44491434	BnaA06T0425500ZY	0	-	0	0	1588	0.0000000
zheyou73v0_A06	44489846	44491800	BnaA06T0425500ZY.1	0	-	0	0	1954	0.0000000
zheyou73v0_A06	44494535	44497938	BnaA06T0425600ZY	0	+	0	0	3403	0.0000000
zheyou73v0_A06	44539190	44541681	BnaA06T0425700ZY	0	+	0	0	2491	0.0000000
zheyou73v0_A06	44543825	44545032	BnaA06T0425800ZY	0	-	0	0	1207	0.0000000
zheyou73v0_A06	44545285	44547755	BnaA06T0425900ZY	0	-	0	0	2470	0.0000000
zheyou73v0_A06	44548032	44552119	BnaA06T0426000ZY	0	+	0	0	4087	0.0000000
zheyou73v0_A06	44556269	44558968	BnaA06T0426100ZY	0	+	0	0	2699	0.0000000
zheyou73v0_A06	44564901	44566055	BnaA06T0426200ZY	0	+	0	0	1154	0.0000000
zheyou73v0_A06	44569257	44570902	BnaA06T0426300ZY	0	+	0	0	1645	0.0000000
zheyou73v0_A06	44571665	44573559	BnaA06T0426400ZY	0	-	0	0	1894	0.0000000
zheyou73v0_A06	44571665	44573422	BnaA06T0426400ZY.1	0	-	0	0	1757	0.0000000
zheyou73v0_A06	44575467	44577009	BnaA06T0426500ZY	0	+	0	0	1542	0.0000000
zheyou73v0_A06	44577373	44577724	BnaA06T0426600ZY	0	+	0	0	351	0.0000000
zheyou73v0_A06	44577731	44581152	BnaA06T0426700ZY	0	-	0	0	3421	0.0000000
zheyou73v0_A06	44584213	44584988	BnaA06T0426800ZY	0	+	0	0	775	0.0000000
zheyou73v0_A06	44588945	44590843	BnaA06T0426900ZY	0	+	0	0	1898	0.0000000
zheyou73v0_A06	44591352	44594956	BnaA06T0427000ZY	0	-	0	0	3604	0.0000000
zheyou73v0_A06	44606794	44607501	BnaA06T0427100ZY	0	-	0	0	707	0.0000000
zheyou73v0_A06	44609020	44611235	BnaA06T0427200ZY	0	+	0	0	2215	0.0000000
zheyou73v0_A06	44614135	44617800	BnaA06T0427300ZY	0	+	0	0	3665	0.0000000
zheyou73v0_A06	44622208	44624867	BnaA06T0427400ZY	0	+	0	0	2659	0.0000000
zheyou73v0_A06	44622208	44624867	BnaA06T0427400ZY.1	0	+	0	0	2659	0.0000000
zheyou73v0_A06	44627995	44629946	BnaA06T0427500ZY	0	+	0	0	1951	0.0000000
zheyou73v0_A06	44633177	44634862	BnaA06T0427600ZY	0	+	0	0	1685	0.0000000
zheyou73v0_A06	44636634	44639766	BnaA06T0427700ZY	0	+	0	0	3132	0.0000000
zheyou73v0_A06	44639809	44640199	BnaA06T0427800ZY	0	+	0	0	390	0.0000000
zheyou73v0_A06	44648215	44648639	BnaA06T0427900ZY	0	-	0	0	424	0.0000000
zheyou73v0_A06	44648716	44648992	BnaA06T0428000ZY	0	-	0	0	276	0.0000000
zheyou73v0_A06	44651922	44653991	BnaA06T0428100ZY	0	+	0	0	2069	0.0000000
zheyou73v0_A06	44653740	44655257	BnaA06T0428200ZY	0	-	0	0	1517	0.0000000
zheyou73v0_A06	44656945	44658948	BnaA06T0428300ZY	0	+	0	0	2003	0.0000000
zheyou73v0_A06	44659256	44660501	BnaA06T0428400ZY	0	-	0	0	1245	0.0000000
zheyou73v0_A06	44661679	44664259	BnaA06T0428500ZY	0	+	0	0	2580	0.0000000
zheyou73v0_A06	44664548	44664798	BnaA06T0428600ZY	0	-	0	0	250	0.0000000
zheyou73v0_A06	44670146	44673699	BnaA06T0428700ZY	0	-	0	0	3553	0.0000000
zheyou73v0_A06	44676071	44677875	BnaA06T0428800ZY	0	-	0	0	1804	0.0000000
zheyou73v0_A06	44683506	44684682	BnaA06T0428900ZY	0	+	0	0	1176	0.0000000
zheyou73v0_A06	44688205	44695000	BnaA06T0429000ZY	0	-	0	0	6795	0.0000000
zheyou73v0_A06	44696015	44698059	BnaA06T0429100ZY	0	+	0	0	2044	0.0000000
zheyou73v0_A06	44696015	44698059	BnaA06T0429100ZY.1	0	+	0	0	2044	0.0000000
zheyou73v0_A06	44699650	44701659	BnaA06T0429200ZY	0	-	0	0	2009	0.0000000
zheyou73v0_A06	44710286	44717234	BnaA06T0429300ZY	0	-	0	0	6948	0.0000000
zheyou73v0_A06	44723202	44725168	BnaA06T0429400ZY	0	-	0	0	1966	0.0000000
zheyou73v0_A06	44732540	44733373	BnaA06T0429500ZY	0	-	0	0	833	0.0000000
zheyou73v0_A06	44738632	44740592	BnaA06T0429600ZY	0	+	0	0	1960	0.0000000
zheyou73v0_A06	44740620	44743010	BnaA06T0429700ZY	0	-	0	0	2390	0.0000000
zheyou73v0_A06	44744559	44745788	BnaA06T0429800ZY	0	+	0	0	1229	0.0000000
zheyou73v0_A06	44746451	44749095	BnaA06T0429900ZY	0	-	0	0	2644	0.0000000
zheyou73v0_A06	44752629	44753252	BnaA06T0430000ZY	0	-	0	0	623	0.0000000
zheyou73v0_A06	44757097	44758468	BnaA06T0430100ZY	0	+	0	0	1371	0.0000000
zheyou73v0_A06	44758747	44763057	BnaA06T0430200ZY	0	-	0	0	4310	0.0000000
zheyou73v0_A06	44763424	44765487	BnaA06T0430300ZY	0	-	0	0	2063	0.0000000
zheyou73v0_A06	44771112	44771718	BnaA06T0430400ZY	0	+	0	0	606	0.0000000
zheyou73v0_A06	44774398	44774961	BnaA06T0430500ZY	0	+	0	0	563	0.0000000
zheyou73v0_A06	44776402	44778074	BnaA06T0430600ZY	0	+	0	0	1672	0.0000000
zheyou73v0_A06	44778524	44781563	BnaA06T0430700ZY	0	-	0	0	3039	0.0000000
zheyou73v0_A06	44783681	44785683	BnaA06T0430800ZY	0	+	0	0	2002	0.0000000
zheyou73v0_A06	44787781	44788075	BnaA06T0430900ZY	0	-	0	0	294	0.0000000
zheyou73v0_A06	44789597	44791982	BnaA06T0431000ZY	0	+	0	0	2385	0.0000000
zheyou73v0_A06	44792002	44794300	BnaA06T0431100ZY	0	-	0	0	2298	0.0000000
zheyou73v0_A06	44800663	44804682	BnaA06T0431200ZY	0	+	0	0	4019	0.0000000
zheyou73v0_A06	44800663	44804682	BnaA06T0431200ZY.1	0	+	0	0	4019	0.0000000
zheyou73v0_A06	44805105	44815110	BnaA06T0431300ZY	0	+	0	0	10005	0.0000000
zheyou73v0_A06	44822458	44835589	BnaA06T0431400ZY	0	+	0	0	13131	0.0000000
zheyou73v0_A06	44836097	44836815	BnaA06T0431500ZY	0	+	0	0	718	0.0000000
zheyou73v0_A06	44843016	44846155	BnaA06T0431600ZY	0	+	0	0	3139	0.0000000
zheyou73v0_A06	44847180	44847612	BnaA06T0431700ZY	0	+	0	0	432	0.0000000
zheyou73v0_A06	44848596	44849629	BnaA06T0431800ZY	0	-	0	0	1033	0.0000000
zheyou73v0_A06	44849825	44851442	BnaA06T0431900ZY	0	-	0	0	1617	0.0000000
zheyou73v0_A06	44852283	44856652	BnaA06T0432000ZY	0	-	0	0	4369	0.0000000
zheyou73v0_A06	44872159	44873643	BnaA06T0432100ZY	0	+	0	0	1484	0.0000000
zheyou73v0_A06	44873979	44876057	BnaA06T0432200ZY	0	+	0	0	2078	0.0000000
zheyou73v0_A06	44876142	44876706	BnaA06T0432300ZY	0	-	0	0	564	0.0000000
zheyou73v0_A06	44876957	44880202	BnaA06T0432400ZY	0	-	0	0	3245	0.0000000
zheyou73v0_A06	44890945	44893093	BnaA06T0432500ZY	0	+	0	0	2148	0.0000000
zheyou73v0_A06	44893281	44894832	BnaA06T0432600ZY	0	-	0	0	1551	0.0000000
zheyou73v0_A06	44895060	44897897	BnaA06T0432700ZY	0	-	0	0	2837	0.0000000
zheyou73v0_A06	44900521	44904120	BnaA06T0432800ZY	0	+	0	0	3599	0.0000000
zheyou73v0_A06	44907162	44909789	BnaA06T0432900ZY	0	-	0	0	2627	0.0000000
zheyou73v0_A06	44915436	44918299	BnaA06T0433000ZY	0	-	0	0	2863	0.0000000
zheyou73v0_A06	44920473	44921600	BnaA06T0433100ZY	0	-	0	0	1127	0.0000000
zheyou73v0_A06	44924392	44928524	BnaA06T0433200ZY	0	-	0	0	4132	0.0000000
zheyou73v0_A06	44935322	44935985	BnaA06T0433300ZY	0	-	0	0	663	0.0000000
zheyou73v0_A06	44938395	44943104	BnaA06T0433400ZY	0	-	0	0	4709	0.0000000
zheyou73v0_A06	44945437	44946841	BnaA06T0433500ZY	0	-	0	0	1404	0.0000000
zheyou73v0_A06	44949446	44950544	BnaA06T0433600ZY	0	-	0	0	1098	0.0000000
zheyou73v0_A06	44956931	44958914	BnaA06T0433700ZY	0	+	0	0	1983	0.0000000
zheyou73v0_A06	44959737	44962113	BnaA06T0433800ZY	0	+	0	0	2376	0.0000000
zheyou73v0_A06	44959737	44962113	BnaA06T0433800ZY.1	0	+	0	0	2376	0.0000000
zheyou73v0_A06	44959737	44961150	BnaA06T0433800ZY.2	0	+	0	0	1413	0.0000000
zheyou73v0_A06	44981175	44986251	BnaA06T0433900ZY	0	+	0	0	5076	0.0000000
zheyou73v0_A06	44981175	44986251	BnaA06T0433900ZY.1	0	+	0	0	5076	0.0000000
zheyou73v0_A06	44986612	44989982	BnaA06T0434000ZY	0	+	0	0	3370	0.0000000
zheyou73v0_A06	44987331	44990230	BnaA06T0434000ZY.1	0	+	0	0	2899	0.0000000
zheyou73v0_A06	44987991	44990230	BnaA06T0434000ZY.2	0	+	0	0	2239	0.0000000
zheyou73v0_A06	44990516	44996066	BnaA06T0434100ZY	0	-	0	0	5550	0.0000000
zheyou73v0_A06	45000412	45000709	BnaA06T0434200ZY	0	+	0	0	297	0.0000000
zheyou73v0_A06	45001987	45002988	BnaA06T0434300ZY	0	+	0	0	1001	0.0000000
zheyou73v0_A06	45003907	45004274	BnaA06T0434400ZY	0	+	0	0	367	0.0000000
zheyou73v0_A06	45005835	45007116	BnaA06T0434500ZY	0	+	0	0	1281	0.0000000
zheyou73v0_A06	45008992	45009550	BnaA06T0434600ZY	0	+	0	0	558	0.0000000
zheyou73v0_A06	45009926	45011013	BnaA06T0434700ZY	0	-	0	0	1087	0.0000000
zheyou73v0_A06	45012774	45013516	BnaA06T0434800ZY	0	-	0	0	742	0.0000000
zheyou73v0_A06	45015954	45017283	BnaA06T0434900ZY	0	-	0	0	1329	0.0000000
zheyou73v0_A06	45018349	45022964	BnaA06T0435000ZY	0	+	0	0	4615	0.0000000
zheyou73v0_A06	45024610	45026708	BnaA06T0435100ZY	0	-	0	0	2098	0.0000000
zheyou73v0_A06	45028088	45031495	BnaA06T0435200ZY	0	-	0	0	3407	0.0000000
zheyou73v0_A06	45032799	45035137	BnaA06T0435300ZY	0	-	0	0	2338	0.0000000
zheyou73v0_A06	45036907	45038715	BnaA06T0435400ZY	0	-	0	0	1808	0.0000000
zheyou73v0_A06	45042388	45044466	BnaA06T0435500ZY	0	+	0	0	2078	0.0000000
zheyou73v0_A06	45047158	45049901	BnaA06T0435600ZY	0	+	0	0	2743	0.0000000
zheyou73v0_A06	45051690	45054179	BnaA06T0435700ZY	0	+	0	0	2489	0.0000000
zheyou73v0_A06	45051690	45054179	BnaA06T0435700ZY.1	0	+	0	0	2489	0.0000000
zheyou73v0_A06	45056005	45058520	BnaA06T0435800ZY	0	+	0	0	2515	0.0000000
zheyou73v0_A06	45058913	45059975	BnaA06T0435900ZY	0	-	0	0	1062	0.0000000
zheyou73v0_A06	45063227	45065438	BnaA06T0436000ZY	0	+	0	0	2211	0.0000000
zheyou73v0_A06	45072114	45077144	BnaA06T0436100ZY	0	+	0	0	5030	0.0000000
zheyou73v0_A06	45078572	45081822	BnaA06T0436200ZY	0	+	0	0	3250	0.0000000
zheyou73v0_A06	45082514	45084185	BnaA06T0436300ZY	0	-	0	0	1671	0.0000000
zheyou73v0_A06	45086010	45087434	BnaA06T0436400ZY	0	-	0	0	1424	0.0000000
zheyou73v0_A06	45086010	45087434	BnaA06T0436400ZY.1	0	-	0	0	1424	0.0000000
zheyou73v0_A06	45086010	45087434	BnaA06T0436400ZY.2	0	-	0	0	1424	0.0000000
zheyou73v0_A06	45098379	45101035	BnaA06T0436500ZY	0	-	0	0	2656	0.0000000
zheyou73v0_A06	45102475	45105842	BnaA06T0436600ZY	0	+	0	0	3367	0.0000000
zheyou73v0_A06	45108584	45109446	BnaA06T0436700ZY	0	+	0	0	862	0.0000000
zheyou73v0_A06	45110606	45112237	BnaA06T0436800ZY.2	0	-	0	0	1631	0.0000000
zheyou73v0_A06	45110705	45112237	BnaA06T0436800ZY	0	-	0	0	1532	0.0000000
zheyou73v0_A06	45110705	45112237	BnaA06T0436800ZY.1	0	-	0	0	1532	0.0000000
zheyou73v0_A06	45113695	45115022	BnaA06T0436900ZY	0	-	0	0	1327	0.0000000
zheyou73v0_A06	45116394	45118244	BnaA06T0437000ZY	0	-	0	0	1850	0.0000000
zheyou73v0_A06	45119278	45122106	BnaA06T0437100ZY	0	-	0	0	2828	0.0000000
zheyou73v0_A06	45123436	45127896	BnaA06T0437200ZY	0	-	0	0	4460	0.0000000
zheyou73v0_A06	45131544	45133485	BnaA06T0437300ZY	0	-	0	0	1941	0.0000000
zheyou73v0_A06	45134246	45140959	BnaA06T0437400ZY	0	-	0	0	6713	0.0000000
zheyou73v0_A06	45142157	45145315	BnaA06T0437500ZY	0	-	0	0	3158	0.0000000
zheyou73v0_A06	45142157	45145315	BnaA06T0437500ZY.1	0	-	0	0	3158	0.0000000
zheyou73v0_A06	45142903	45145315	BnaA06T0437500ZY.2	0	-	0	0	2412	0.0000000
zheyou73v0_A06	45146132	45148617	BnaA06T0437600ZY	0	-	0	0	2485	0.0000000
zheyou73v0_A06	45160284	45164008	BnaA06T0437700ZY	0	+	0	0	3724	0.0000000
zheyou73v0_A06	45171019	45171896	BnaA06T0437800ZY	0	-	0	0	877	0.0000000
zheyou73v0_A06	45173224	45180366	BnaA06T0437900ZY	0	-	0	0	7142	0.0000000
zheyou73v0_A06	45182690	45186912	BnaA06T0438000ZY	0	-	0	0	4222	0.0000000
zheyou73v0_A06	45187522	45188712	BnaA06T0438100ZY	0	-	0	0	1190	0.0000000
zheyou73v0_A06	45189816	45194575	BnaA06T0438200ZY	0	-	0	0	4759	0.0000000
zheyou73v0_A06	45196516	45200979	BnaA06T0438300ZY	0	+	0	0	4463	0.0000000
zheyou73v0_A06	45201293	45204076	BnaA06T0438400ZY	0	+	0	0	2783	0.0000000
zheyou73v0_A06	45204715	45206362	BnaA06T0438500ZY	0	+	0	0	1647	0.0000000
zheyou73v0_A06	45223369	45225247	BnaA06T0438600ZY	0	-	0	0	1878	0.0000000
zheyou73v0_A06	45227349	45228996	BnaA06T0438700ZY	0	-	0	0	1647	0.0000000
zheyou73v0_A06	45230333	45231906	BnaA06T0438800ZY	0	+	0	0	1573	0.0000000
zheyou73v0_A06	45230333	45231906	BnaA06T0438800ZY.1	0	+	0	0	1573	0.0000000
zheyou73v0_A06	45236436	45241478	BnaA06T0438900ZY	0	+	0	0	5042	0.0000000
zheyou73v0_A06	45251018	45252765	BnaA06T0439000ZY	0	+	0	0	1747	0.0000000
zheyou73v0_A06	45287436	45289086	BnaA06T0439100ZY	0	+	0	0	1650	0.0000000
zheyou73v0_A06	45292556	45293321	BnaA06T0439200ZY	0	-	0	0	765	0.0000000
zheyou73v0_A06	45293662	45294768	BnaA06T0439300ZY	0	-	0	0	1106	0.0000000
zheyou73v0_A06	45295012	45297954	BnaA06T0439400ZY	0	-	0	0	2942	0.0000000
zheyou73v0_A06	45302427	45302730	BnaA06T0439500ZY	0	-	0	0	303	0.0000000
zheyou73v0_A06	45304380	45305511	BnaA06T0439600ZY	0	+	0	0	1131	0.0000000
zheyou73v0_A06	45306993	45307170	BnaA06T0439700ZY	0	+	0	0	177	0.0000000
zheyou73v0_A06	45307570	45308421	BnaA06T0439800ZY	0	-	0	0	851	0.0000000
zheyou73v0_A06	45307570	45308421	BnaA06T0439800ZY.1	0	-	0	0	851	0.0000000
zheyou73v0_A06	45308944	45312794	BnaA06T0439900ZY	0	-	0	0	3850	0.0000000
zheyou73v0_A06	45317148	45318496	BnaA06T0440000ZY	0	+	0	0	1348	0.0000000
zheyou73v0_A06	45318949	45319992	BnaA06T0440100ZY	0	+	0	0	1043	0.0000000
zheyou73v0_A06	45320311	45323031	BnaA06T0440200ZY	0	-	0	0	2720	0.0000000
zheyou73v0_A06	45324861	45326461	BnaA06T0440300ZY	0	+	0	0	1600	0.0000000
zheyou73v0_A06	45327401	45329535	BnaA06T0440400ZY	0	+	0	0	2134	0.0000000
zheyou73v0_A06	45329616	45330305	BnaA06T0440500ZY	0	+	0	0	689	0.0000000
zheyou73v0_A06	45345734	45352159	BnaA06T0440600ZY	0	-	0	0	6425	0.0000000
zheyou73v0_A06	45354311	45355580	BnaA06T0440700ZY	0	+	0	0	1269	0.0000000
zheyou73v0_A06	45354311	45355580	BnaA06T0440700ZY.1	0	+	0	0	1269	0.0000000
zheyou73v0_A06	45356915	45357689	BnaA06T0440800ZY	0	+	0	0	774	0.0000000
zheyou73v0_A06	45359397	45361260	BnaA06T0440900ZY	0	+	0	0	1863	0.0000000
zheyou73v0_A06	45361863	45362433	BnaA06T0441000ZY	0	-	0	0	570	0.0000000
zheyou73v0_A06	45364516	45366753	BnaA06T0441100ZY	0	+	0	0	2237	0.0000000
zheyou73v0_A06	45367632	45370369	BnaA06T0441200ZY	0	+	0	0	2737	0.0000000
zheyou73v0_A06	45367632	45370369	BnaA06T0441200ZY.1	0	+	0	0	2737	0.0000000
zheyou73v0_A06	45370885	45373356	BnaA06T0441300ZY	0	+	0	0	2471	0.0000000
zheyou73v0_A06	45373382	45375275	BnaA06T0441400ZY	0	-	0	0	1893	0.0000000
zheyou73v0_A06	45377448	45383708	BnaA06T0441500ZY	0	+	0	0	6260	0.0000000
zheyou73v0_A06	45386320	45387670	BnaA06T0441600ZY	0	-	0	0	1350	0.0000000
zheyou73v0_A06	45388585	45389640	BnaA06T0441700ZY	0	+	0	0	1055	0.0000000
zheyou73v0_A06	45392513	45394524	BnaA06T0441800ZY.1	0	+	0	0	2011	0.0000000
zheyou73v0_A06	45392564	45394524	BnaA06T0441800ZY	0	+	0	0	1960	0.0000000
zheyou73v0_A06	45397150	45397465	BnaA06T0441900ZY	0	-	0	0	315	0.0000000
zheyou73v0_A06	45403491	45404442	BnaA06T0442000ZY	0	+	0	0	951	0.0000000
zheyou73v0_A06	45404016	45404448	BnaA06T0442100ZY	0	-	0	0	432	0.0000000
zheyou73v0_A06	45405573	45406747	BnaA06T0442200ZY	0	-	0	0	1174	0.0000000
zheyou73v0_A06	45409605	45413221	BnaA06T0442300ZY	0	+	0	0	3616	0.0000000
zheyou73v0_A06	45409605	45412470	BnaA06T0442300ZY.2	0	+	0	0	2865	0.0000000
zheyou73v0_A06	45411108	45413221	BnaA06T0442300ZY.1	0	+	0	0	2113	0.0000000
zheyou73v0_A06	45414097	45424234	BnaA06T0442400ZY	0	+	0	0	10137	0.0000000
zheyou73v0_A06	45424904	45425423	BnaA06T0442500ZY	0	+	0	0	519	0.0000000
zheyou73v0_A06	45425918	45427963	BnaA06T0442600ZY	0	+	0	0	2045	0.0000000
zheyou73v0_A06	45425918	45427963	BnaA06T0442600ZY.1	0	+	0	0	2045	0.0000000
zheyou73v0_A06	45430395	45431764	BnaA06T0442700ZY	0	-	0	0	1369	0.0000000
zheyou73v0_A06	45442343	45446726	BnaA06T0442800ZY	0	-	0	0	4383	0.0000000
zheyou73v0_A06	45459052	45461047	BnaA06T0442900ZY	0	-	0	0	1995	0.0000000
zheyou73v0_A06	45461648	45462482	BnaA06T0443000ZY	0	+	0	0	834	0.0000000
zheyou73v0_A06	45462637	45464200	BnaA06T0443100ZY	0	-	0	0	1563	0.0000000
zheyou73v0_A06	45464350	45466688	BnaA06T0443200ZY.1	0	-	0	0	2338	0.0000000
zheyou73v0_A06	45464509	45466685	BnaA06T0443200ZY	0	-	0	0	2176	0.0000000
zheyou73v0_A06	45509398	45510827	BnaA06T0443300ZY	0	+	0	0	1429	0.0000000
zheyou73v0_A06	45512442	45514486	BnaA06T0443400ZY	0	-	0	0	2044	0.0000000
zheyou73v0_A06	45515255	45517768	BnaA06T0443500ZY	0	-	0	0	2513	0.0000000
zheyou73v0_A06	45523294	45524249	BnaA06T0443600ZY	0	+	0	0	955	0.0000000
zheyou73v0_A06	45524541	45526956	BnaA06T0443700ZY	0	-	0	0	2415	0.0000000
zheyou73v0_A06	45529237	45531556	BnaA06T0443800ZY	0	-	0	0	2319	0.0000000
zheyou73v0_A06	45533329	45535931	BnaA06T0443900ZY	0	-	0	0	2602	0.0000000
zheyou73v0_A06	45544056	45546602	BnaA06T0444000ZY	0	-	0	0	2546	0.0000000
zheyou73v0_A06	45546585	45547940	BnaA06T0444100ZY	0	+	0	0	1355	0.0000000
zheyou73v0_A06	45548137	45549475	BnaA06T0444200ZY	0	-	0	0	1338	0.0000000
zheyou73v0_A06	45549746	45553225	BnaA06T0444300ZY	0	+	0	0	3479	0.0000000
zheyou73v0_A06	45555400	45555637	BnaA06T0444400ZY	0	+	0	0	237	0.0000000
zheyou73v0_A06	45556102	45557749	BnaA06T0444500ZY	0	-	0	0	1647	0.0000000
zheyou73v0_A06	45558338	45565548	BnaA06T0444600ZY	0	-	0	0	7210	0.0000000
zheyou73v0_A06	45568365	45571599	BnaA06T0444700ZY	0	+	0	0	3234	0.0000000
zheyou73v0_A07	1559	1899	BnaA07T0000100ZY	0	+	0	0	340	0.0000000
zheyou73v0_A07	3613	4499	BnaA07T0000200ZY	0	+	0	0	886	0.0000000
zheyou73v0_A07	50417	52417	BnaA07T0000300ZY	0	+	0	0	2000	0.0000000
zheyou73v0_A07	366679	369287	BnaA07T0000400ZY	0	+	0	0	2608	0.0000000
zheyou73v0_A07	369293	374479	BnaA07T0000500ZY	0	-	0	0	5186	0.0000000
zheyou73v0_A07	387298	396066	BnaA07T0000600ZY	0	+	0	0	8768	0.0000000
zheyou73v0_A07	396167	396501	BnaA07T0000700ZY	0	+	0	0	334	0.0000000
zheyou73v0_A07	401893	402296	BnaA07T0000800ZY	0	-	0	0	403	0.0000000
zheyou73v0_A07	724630	725367	BnaA07T0000900ZY	0	-	0	0	737	0.0000000
zheyou73v0_A07	781549	783251	BnaA07T0001000ZY	0	+	0	0	1702	0.0000000
zheyou73v0_A07	789017	790429	BnaA07T0001100ZY	0	-	0	0	1412	0.0000000
zheyou73v0_A07	789017	790429	BnaA07T0001100ZY.1	0	-	0	0	1412	0.0000000
zheyou73v0_A07	794001	794358	BnaA07T0001200ZY	0	-	0	0	357	0.0000000
zheyou73v0_A07	795882	797225	BnaA07T0001300ZY	0	+	0	0	1343	0.0000000
zheyou73v0_A07	795882	797225	BnaA07T0001300ZY.1	0	+	0	0	1343	0.0000000
zheyou73v0_A07	805759	807368	BnaA07T0001400ZY	0	-	0	0	1609	0.0000000
zheyou73v0_A07	817309	818532	BnaA07T0001500ZY	0	-	0	0	1223	0.0000000
zheyou73v0_A07	831664	832169	BnaA07T0001600ZY	0	-	0	0	505	0.0000000
zheyou73v0_A07	897052	899179	BnaA07T0001700ZY	0	+	0	0	2127	0.0000000
zheyou73v0_A07	910686	912877	BnaA07T0001800ZY	0	-	0	0	2191	0.0000000
zheyou73v0_A07	910686	912877	BnaA07T0001800ZY.1	0	-	0	0	2191	0.0000000
zheyou73v0_A07	924871	926519	BnaA07T0001900ZY	0	-	0	0	1648	0.0000000
zheyou73v0_A07	947375	947798	BnaA07T0002000ZY	0	-	0	0	423	0.0000000
zheyou73v0_A07	951851	953273	BnaA07T0002100ZY	0	+	0	0	1422	0.0000000
zheyou73v0_A07	965351	966267	BnaA07T0002200ZY	0	-	0	0	916	0.0000000
zheyou73v0_A07	966914	967211	BnaA07T0002300ZY	0	+	0	0	297	0.0000000
zheyou73v0_A07	977542	978443	BnaA07T0002400ZY	0	-	0	0	901	0.0000000
zheyou73v0_A07	1008685	1011417	BnaA07T0002500ZY	0	-	0	0	2732	0.0000000
zheyou73v0_A07	1054147	1057331	BnaA07T0002600ZY	0	+	0	0	3184	0.0000000
zheyou73v0_A07	1062375	1065833	BnaA07T0002700ZY	0	-	0	0	3458	0.0000000
zheyou73v0_A07	1085638	1088525	BnaA07T0002800ZY	0	+	0	0	2887	0.0000000
zheyou73v0_A07	1092357	1094726	BnaA07T0002900ZY	0	+	0	0	2369	0.0000000
zheyou73v0_A07	1121701	1122882	BnaA07T0003000ZY	0	+	0	0	1181	0.0000000
zheyou73v0_A07	1126547	1126811	BnaA07T0003100ZY	0	-	0	0	264	0.0000000
zheyou73v0_A07	1128174	1133407	BnaA07T0003200ZY	0	-	0	0	5233	0.0000000
zheyou73v0_A07	1148057	1148990	BnaA07T0003300ZY	0	-	0	0	933	0.0000000
zheyou73v0_A07	1324635	1324797	BnaA07T0003400ZY	0	+	0	0	162	0.0000000
zheyou73v0_A07	1330839	1333243	BnaA07T0003500ZY	0	+	0	0	2404	0.0000000
zheyou73v0_A07	1337750	1342771	BnaA07T0003600ZY	0	+	0	0	5021	0.0000000
zheyou73v0_A07	1403250	1404022	BnaA07T0003700ZY	0	-	0	0	772	0.0000000
zheyou73v0_A07	1421173	1423775	BnaA07T0003800ZY	0	+	0	0	2602	0.0000000
zheyou73v0_A07	1521637	1521805	BnaA07T0003900ZY	0	+	0	0	168	0.0000000
zheyou73v0_A07	1683454	1684249	BnaA07T0004000ZY	0	-	0	0	795	0.0000000
zheyou73v0_A07	1707288	1708941	BnaA07T0004100ZY	0	+	0	0	1653	0.0000000
zheyou73v0_A07	1716071	1716230	BnaA07T0004200ZY	0	+	0	0	159	0.0000000
zheyou73v0_A07	1719596	1719773	BnaA07T0004300ZY	0	-	0	0	177	0.0000000
zheyou73v0_A07	1728769	1730121	BnaA07T0004400ZY	0	-	0	0	1352	0.0000000
zheyou73v0_A07	1730207	1732331	BnaA07T0004500ZY	0	+	0	0	2124	0.0000000
zheyou73v0_A07	1753467	1764708	BnaA07T0004600ZY	0	-	0	0	11241	0.0000000
zheyou73v0_A07	1782722	1786629	BnaA07T0004700ZY	0	-	0	0	3907	0.0000000
zheyou73v0_A07	1787074	1787878	BnaA07T0004800ZY	0	+	0	0	804	0.0000000
zheyou73v0_A07	1790126	1790649	BnaA07T0004900ZY	0	-	0	0	523	0.0000000
zheyou73v0_A07	1791540	1791973	BnaA07T0005000ZY	0	-	0	0	433	0.0000000
zheyou73v0_A07	1871388	1871628	BnaA07T0005100ZY	0	+	0	0	240	0.0000000
zheyou73v0_A07	1875603	1877163	BnaA07T0005200ZY	0	+	0	0	1560	0.0000000
zheyou73v0_A07	1877451	1877658	BnaA07T0005300ZY	0	-	0	0	207	0.0000000
zheyou73v0_A07	1878400	1880990	BnaA07T0005400ZY	0	-	0	0	2590	0.0000000
zheyou73v0_A07	1891237	1893231	BnaA07T0005500ZY	0	+	0	0	1994	0.0000000
zheyou73v0_A07	2051343	2052027	BnaA07T0005600ZY	0	-	0	0	684	0.0000000
zheyou73v0_A07	2053673	2078182	BnaA07T0005700ZY	0	+	0	0	24509	0.0000000
zheyou73v0_A07	2080261	2080582	BnaA07T0005800ZY	0	+	0	0	321	0.0000000
zheyou73v0_A07	2114905	2115979	BnaA07T0005900ZY	0	+	0	0	1074	0.0000000
zheyou73v0_A07	2135311	2137793	BnaA07T0006000ZY	0	-	0	0	2482	0.0000000
zheyou73v0_A07	2370887	2379026	BnaA07T0006100ZY	0	+	0	0	8139	0.0000000
zheyou73v0_A07	2381934	2383711	BnaA07T0006200ZY	0	-	0	0	1777	0.0000000
zheyou73v0_A07	2405460	2406044	BnaA07T0006300ZY	0	+	0	0	584	0.0000000
zheyou73v0_A07	2450231	2457925	BnaA07T0006400ZY	0	-	0	0	7694	0.0000000
zheyou73v0_A07	2479424	2479655	BnaA07T0006500ZY	0	-	0	0	231	0.0000000
zheyou73v0_A07	2498359	2499856	BnaA07T0006600ZY	0	+	0	0	1497	0.0000000
zheyou73v0_A07	2739783	2740581	BnaA07T0006700ZY	0	-	0	0	798	0.0000000
zheyou73v0_A07	4066693	4066996	BnaA07T0006800ZY	0	+	0	0	303	0.0000000
zheyou73v0_A07	4075066	4075468	BnaA07T0006900ZY	0	+	0	0	402	0.0000000
zheyou73v0_A07	4076216	4076414	BnaA07T0007000ZY	0	-	0	0	198	0.0000000
zheyou73v0_A07	4076811	4077355	BnaA07T0007100ZY	0	-	0	0	544	0.0000000
zheyou73v0_A07	4290269	4290559	BnaA07T0007200ZY	0	+	0	0	290	0.0000000
zheyou73v0_A07	4293428	4294639	BnaA07T0007300ZY	0	+	0	0	1211	0.0000000
zheyou73v0_A07	4295175	4312773	BnaA07T0007400ZY	0	+	0	0	17598	0.0000000
zheyou73v0_A07	4326159	4328338	BnaA07T0007500ZY	0	-	0	0	2179	0.0000000
zheyou73v0_A07	4329461	4330145	BnaA07T0007600ZY	0	-	0	0	684	0.0000000
zheyou73v0_A07	4330811	4332871	BnaA07T0007700ZY	0	+	0	0	2060	0.0000000
zheyou73v0_A07	4333025	4333942	BnaA07T0007800ZY	0	+	0	0	917	0.0000000
zheyou73v0_A07	4336031	4336316	BnaA07T0007900ZY	0	-	0	0	285	0.0000000
zheyou73v0_A07	5081222	5081447	BnaA07T0008000ZY	0	+	0	0	225	0.0000000
zheyou73v0_A07	5208502	5208679	BnaA07T0008100ZY	0	+	0	0	177	0.0000000
zheyou73v0_A07	5211445	5211622	BnaA07T0008200ZY	0	-	0	0	177	0.0000000
zheyou73v0_A07	6277591	6279959	BnaA07T0008300ZY	0	+	0	0	2368	0.0000000
zheyou73v0_A07	6349186	6349364	BnaA07T0008400ZY	0	+	0	0	178	0.0000000
zheyou73v0_A07	6357668	6359260	BnaA07T0008500ZY	0	+	0	0	1592	0.0000000
zheyou73v0_A07	6367460	6367802	BnaA07T0008600ZY	0	-	0	0	342	0.0000000
zheyou73v0_A07	6368094	6370143	BnaA07T0008700ZY	0	-	0	0	2049	0.0000000
zheyou73v0_A07	6375563	6377329	BnaA07T0008800ZY	0	+	0	0	1766	0.0000000
zheyou73v0_A07	6393552	6394511	BnaA07T0008900ZY	0	+	0	0	959	0.0000000
zheyou73v0_A07	6413880	6419744	BnaA07T0009000ZY	0	-	0	0	5864	0.0000000
zheyou73v0_A07	6425907	6428132	BnaA07T0009100ZY	0	+	0	0	2225	0.0000000
zheyou73v0_A07	6429048	6430923	BnaA07T0009200ZY	0	-	0	0	1875	0.0000000
zheyou73v0_A07	6429048	6430923	BnaA07T0009200ZY.1	0	-	0	0	1875	0.0000000
zheyou73v0_A07	6437225	6437819	BnaA07T0009300ZY	0	-	0	0	594	0.0000000
zheyou73v0_A07	6439141	6450312	BnaA07T0009400ZY	0	+	0	0	11171	0.0000000
zheyou73v0_A07	6451557	6452038	BnaA07T0009500ZY	0	-	0	0	481	0.0000000
zheyou73v0_A07	6466552	6471075	BnaA07T0009600ZY	0	-	0	0	4523	0.0000000
zheyou73v0_A07	6475465	6478049	BnaA07T0009700ZY	0	+	0	0	2584	0.0000000
zheyou73v0_A07	6491981	6494053	BnaA07T0009800ZY	0	-	0	0	2072	0.0000000
zheyou73v0_A07	6537879	6539814	BnaA07T0009900ZY	0	+	0	0	1935	0.0000000
zheyou73v0_A07	6575000	6577822	BnaA07T0010000ZY	0	+	0	0	2822	0.0000000
zheyou73v0_A07	6578657	6578916	BnaA07T0010100ZY	0	-	0	0	259	0.0000000
zheyou73v0_A07	6579087	6579450	BnaA07T0010200ZY	0	-	0	0	363	0.0000000
zheyou73v0_A07	6581336	6583272	BnaA07T0010300ZY	0	+	0	0	1936	0.0000000
zheyou73v0_A07	6583361	6585206	BnaA07T0010400ZY	0	-	0	0	1845	0.0000000
zheyou73v0_A07	6589781	6592697	BnaA07T0010500ZY	0	-	0	0	2916	0.0000000
zheyou73v0_A07	6620415	6621422	BnaA07T0010600ZY	0	-	0	0	1007	0.0000000
zheyou73v0_A07	6625969	6627446	BnaA07T0010700ZY	0	-	0	0	1477	0.0000000
zheyou73v0_A07	6639719	6640726	BnaA07T0010800ZY	0	-	0	0	1007	0.0000000
zheyou73v0_A07	6645271	6647663	BnaA07T0010900ZY	0	-	0	0	2392	0.0000000
zheyou73v0_A07	6664947	6669617	BnaA07T0011000ZY	0	-	0	0	4670	0.0000000
zheyou73v0_A07	6679088	6679577	BnaA07T0011100ZY	0	-	0	0	489	0.0000000
zheyou73v0_A07	6680797	6686386	BnaA07T0011200ZY	0	-	0	0	5589	0.0000000
zheyou73v0_A07	6738401	6739785	BnaA07T0011300ZY	0	+	0	0	1384	0.0000000
zheyou73v0_A07	6785346	6787295	BnaA07T0011400ZY	0	+	0	0	1949	0.0000000
zheyou73v0_A07	6794698	6795751	BnaA07T0011500ZY	0	-	0	0	1053	0.0000000
zheyou73v0_A07	6799492	6801684	BnaA07T0011600ZY	0	+	0	0	2192	0.0000000
zheyou73v0_A07	6840293	6842378	BnaA07T0011700ZY	0	+	0	0	2085	0.0000000
zheyou73v0_A07	6844075	6844599	BnaA07T0011800ZY	0	-	0	0	524	0.0000000
zheyou73v0_A07	6845473	6845915	BnaA07T0011900ZY	0	-	0	0	442	0.0000000
zheyou73v0_A07	6851746	6855362	BnaA07T0012000ZY	0	+	0	0	3616	0.0000000
zheyou73v0_A07	6851746	6855362	BnaA07T0012000ZY.1	0	+	0	0	3616	0.0000000
zheyou73v0_A07	6927074	6929197	BnaA07T0012100ZY	0	-	0	0	2123	0.0000000
zheyou73v0_A07	6935136	6935596	BnaA07T0012200ZY	0	-	0	0	460	0.0000000
zheyou73v0_A07	6939741	6940325	BnaA07T0012300ZY	0	-	0	0	584	0.0000000
zheyou73v0_A07	6952631	6953982	BnaA07T0012400ZY	0	-	0	0	1351	0.0000000
zheyou73v0_A07	6955266	6956291	BnaA07T0012500ZY	0	+	0	0	1025	0.0000000
zheyou73v0_A07	6960966	6962294	BnaA07T0012600ZY	0	-	0	0	1328	0.0000000
zheyou73v0_A07	6974732	6976743	BnaA07T0012700ZY	0	+	0	0	2011	0.0000000
zheyou73v0_A07	6977369	6978860	BnaA07T0012800ZY	0	-	0	0	1491	0.0000000
zheyou73v0_A07	6988578	6989777	BnaA07T0012900ZY	0	+	0	0	1199	0.0000000
zheyou73v0_A07	7009198	7009744	BnaA07T0013000ZY	0	+	0	0	546	0.0000000
zheyou73v0_A07	7022594	7023693	BnaA07T0013100ZY	0	-	0	0	1099	0.0000000
zheyou73v0_A07	7024199	7024388	BnaA07T0013200ZY	0	+	0	0	189	0.0000000
zheyou73v0_A07	7028969	7029218	BnaA07T0013300ZY	0	+	0	0	249	0.0000000
zheyou73v0_A07	7053552	7055123	BnaA07T0013400ZY	0	+	0	0	1571	0.0000000
zheyou73v0_A07	7055646	7057160	BnaA07T0013500ZY	0	-	0	0	1514	0.0000000
zheyou73v0_A07	7070140	7072387	BnaA07T0013600ZY	0	+	0	0	2247	0.0000000
zheyou73v0_A07	7075060	7081974	BnaA07T0013700ZY	0	-	0	0	6914	0.0000000
zheyou73v0_A07	7075183	7076869	BnaA07T0013800ZY	0	+	0	0	1686	0.0000000
zheyou73v0_A07	7088339	7089996	BnaA07T0013900ZY	0	+	0	0	1657	0.0000000
zheyou73v0_A07	7090447	7095439	BnaA07T0014000ZY	0	-	0	0	4992	0.0000000
zheyou73v0_A07	7101965	7103514	BnaA07T0014100ZY	0	-	0	0	1549	0.0000000
zheyou73v0_A07	7105322	7106061	BnaA07T0014200ZY	0	-	0	0	739	0.0000000
zheyou73v0_A07	7161940	7164458	BnaA07T0014300ZY	0	+	0	0	2518	0.0000000
zheyou73v0_A07	7172821	7176758	BnaA07T0014400ZY	0	+	0	0	3937	0.0000000
zheyou73v0_A07	7205570	7206550	BnaA07T0014500ZY	0	-	0	0	980	0.0000000
zheyou73v0_A07	7219528	7220460	BnaA07T0014600ZY	0	-	0	0	932	0.0000000
zheyou73v0_A07	7227428	7229399	BnaA07T0014700ZY	0	+	0	0	1971	0.0000000
zheyou73v0_A07	7230957	7231530	BnaA07T0014800ZY	0	+	0	0	573	0.0000000
zheyou73v0_A07	7235699	7241683	BnaA07T0014900ZY	0	-	0	0	5984	0.0000000
zheyou73v0_A07	7246157	7248013	BnaA07T0015000ZY	0	-	0	0	1856	0.0000000
zheyou73v0_A07	7250148	7252749	BnaA07T0015100ZY	0	-	0	0	2601	0.0000000
zheyou73v0_A07	7263849	7264958	BnaA07T0015200ZY	0	+	0	0	1109	0.0000000
zheyou73v0_A07	7265133	7268391	BnaA07T0015300ZY	0	-	0	0	3258	0.0000000
zheyou73v0_A07	7274519	7276403	BnaA07T0015400ZY	0	+	0	0	1884	0.0000000
zheyou73v0_A07	7277205	7278372	BnaA07T0015500ZY	0	-	0	0	1167	0.0000000
zheyou73v0_A07	7283059	7283801	BnaA07T0015600ZY	0	+	0	0	742	0.0000000
zheyou73v0_A07	7292101	7293464	BnaA07T0015700ZY	0	-	0	0	1363	0.0000000
zheyou73v0_A07	7295779	7297501	BnaA07T0015800ZY	0	-	0	0	1722	0.0000000
zheyou73v0_A07	7322608	7330709	BnaA07T0015900ZY	0	+	0	0	8101	0.0000000
zheyou73v0_A07	7331141	7332044	BnaA07T0016000ZY	0	+	0	0	903	0.0000000
zheyou73v0_A07	7337977	7339584	BnaA07T0016100ZY	0	-	0	0	1607	0.0000000
zheyou73v0_A07	7360621	7361077	BnaA07T0016200ZY	0	+	0	0	456	0.0000000
zheyou73v0_A07	7362695	7363209	BnaA07T0016300ZY	0	+	0	0	514	0.0000000
zheyou73v0_A07	7376083	7377813	BnaA07T0016400ZY	0	+	0	0	1730	0.0000000
zheyou73v0_A07	7443825	7446041	BnaA07T0016500ZY	0	-	0	0	2216	0.0000000
zheyou73v0_A07	7446696	7447415	BnaA07T0016600ZY	0	-	0	0	719	0.0000000
zheyou73v0_A07	7457000	7458626	BnaA07T0016700ZY	0	+	0	0	1626	0.0000000
zheyou73v0_A07	7465958	7467539	BnaA07T0016800ZY	0	+	0	0	1581	0.0000000
zheyou73v0_A07	7470700	7472469	BnaA07T0016900ZY	0	-	0	0	1769	0.0000000
zheyou73v0_A07	7481577	7484249	BnaA07T0017000ZY	0	+	0	0	2672	0.0000000
zheyou73v0_A07	7481577	7484249	BnaA07T0017000ZY.1	0	+	0	0	2672	0.0000000
zheyou73v0_A07	7484560	7486420	BnaA07T0017100ZY	0	-	0	0	1860	0.0000000
zheyou73v0_A07	7489435	7490954	BnaA07T0017200ZY	0	-	0	0	1519	0.0000000
zheyou73v0_A07	7505393	7506740	BnaA07T0017300ZY	0	+	0	0	1347	0.0000000
zheyou73v0_A07	7512968	7514714	BnaA07T0017400ZY	0	+	0	0	1746	0.0000000
zheyou73v0_A07	7515081	7516985	BnaA07T0017500ZY	0	-	0	0	1904	0.0000000
zheyou73v0_A07	7523465	7523814	BnaA07T0017600ZY	0	+	0	0	349	0.0000000
zheyou73v0_A07	7526490	7529546	BnaA07T0017700ZY	0	-	0	0	3056	0.0000000
zheyou73v0_A07	7539993	7540835	BnaA07T0017800ZY	0	-	0	0	842	0.0000000
zheyou73v0_A07	7540847	7541072	BnaA07T0017900ZY	0	-	0	0	225	0.0000000
zheyou73v0_A07	7542969	7546106	BnaA07T0018000ZY	0	+	0	0	3137	0.0000000
zheyou73v0_A07	7542969	7546106	BnaA07T0018000ZY.1	0	+	0	0	3137	0.0000000
zheyou73v0_A07	7542969	7546106	BnaA07T0018000ZY.2	0	+	0	0	3137	0.0000000
zheyou73v0_A07	7546456	7550591	BnaA07T0018100ZY	0	-	0	0	4135	0.0000000
zheyou73v0_A07	7557573	7558374	BnaA07T0018200ZY	0	-	0	0	801	0.0000000
zheyou73v0_A07	7576997	7587505	BnaA07T0018300ZY	0	+	0	0	10508	0.0000000
zheyou73v0_A07	7586593	7587463	BnaA07T0018400ZY	0	-	0	0	870	0.0000000
zheyou73v0_A07	7587821	7589184	BnaA07T0018500ZY	0	+	0	0	1363	0.0000000
zheyou73v0_A07	7591590	7597364	BnaA07T0018600ZY	0	-	0	0	5774	0.0000000
zheyou73v0_A07	7591590	7594978	BnaA07T0018600ZY.1	0	-	0	0	3388	0.0000000
zheyou73v0_A07	7591590	7594978	BnaA07T0018600ZY.2	0	-	0	0	3388	0.0000000
zheyou73v0_A07	7602010	7603632	BnaA07T0018700ZY	0	-	0	0	1622	0.0000000
zheyou73v0_A07	7603809	7605042	BnaA07T0018800ZY	0	+	0	0	1233	0.0000000
zheyou73v0_A07	7605588	7607596	BnaA07T0018900ZY	0	-	0	0	2008	0.0000000
zheyou73v0_A07	7634967	7635709	BnaA07T0019000ZY	0	+	0	0	742	0.0000000
zheyou73v0_A07	7645042	7645495	BnaA07T0019100ZY	0	+	0	0	453	0.0000000
zheyou73v0_A07	7650511	7650910	BnaA07T0019200ZY	0	+	0	0	399	0.0000000
zheyou73v0_A07	7662143	7663188	BnaA07T0019300ZY	0	-	0	0	1045	0.0000000
zheyou73v0_A07	7665318	7665615	BnaA07T0019400ZY	0	-	0	0	297	0.0000000
zheyou73v0_A07	7676670	7678390	BnaA07T0019500ZY.1	0	-	0	0	1720	0.0000000
zheyou73v0_A07	7676709	7678390	BnaA07T0019500ZY	0	-	0	0	1681	0.0000000
zheyou73v0_A07	7682637	7684405	BnaA07T0019600ZY	0	-	0	0	1768	0.0000000
zheyou73v0_A07	7687933	7688254	BnaA07T0019700ZY	0	+	0	0	321	0.0000000
zheyou73v0_A07	7692127	7694597	BnaA07T0019800ZY.1	0	-	0	0	2470	0.0000000
zheyou73v0_A07	7692127	7694597	BnaA07T0019800ZY.3	0	-	0	0	2470	0.0000000
zheyou73v0_A07	7692189	7694597	BnaA07T0019800ZY.2	0	-	0	0	2408	0.0000000
zheyou73v0_A07	7692459	7694597	BnaA07T0019800ZY	0	-	0	0	2138	0.0000000
zheyou73v0_A07	7700501	7702075	BnaA07T0019900ZY	0	+	0	0	1574	0.0000000
zheyou73v0_A07	7726413	7730224	BnaA07T0020000ZY	0	+	0	0	3811	0.0000000
zheyou73v0_A07	7754692	7757762	BnaA07T0020100ZY	0	-	0	0	3070	0.0000000
zheyou73v0_A07	7755454	7757242	BnaA07T0020100ZY.1	0	-	0	0	1788	0.0000000
zheyou73v0_A07	7764603	7766942	BnaA07T0020200ZY	0	+	0	0	2339	0.0000000
zheyou73v0_A07	7781230	7782828	BnaA07T0020300ZY	0	-	0	0	1598	0.0000000
zheyou73v0_A07	7785449	7787170	BnaA07T0020400ZY.1	0	+	0	0	1721	0.0000000
zheyou73v0_A07	7785584	7787170	BnaA07T0020400ZY	0	+	0	0	1586	0.0000000
zheyou73v0_A07	7795667	7796156	BnaA07T0020500ZY	0	-	0	0	489	0.0000000
zheyou73v0_A07	7821711	7823320	BnaA07T0020600ZY	0	+	0	0	1609	0.0000000
zheyou73v0_A07	7823636	7824636	BnaA07T0020700ZY	0	+	0	0	1000	0.0000000
zheyou73v0_A07	7824803	7826028	BnaA07T0020800ZY	0	-	0	0	1225	0.0000000
zheyou73v0_A07	7829551	7834633	BnaA07T0020900ZY	0	-	0	0	5082	0.0000000
zheyou73v0_A07	7841835	7843794	BnaA07T0021000ZY	0	+	0	0	1959	0.0000000
zheyou73v0_A07	7845836	7847279	BnaA07T0021100ZY	0	-	0	0	1443	0.0000000
zheyou73v0_A07	7852450	7852657	BnaA07T0021200ZY	0	+	0	0	207	0.0000000
zheyou73v0_A07	7855520	7857948	BnaA07T0021300ZY.1	0	-	0	0	2428	0.0000000
zheyou73v0_A07	7855696	7858521	BnaA07T0021300ZY	0	-	0	0	2825	0.0000000
zheyou73v0_A07	7861541	7864450	BnaA07T0021400ZY	0	-	0	0	2909	0.0000000
zheyou73v0_A07	7883318	7885693	BnaA07T0021500ZY	0	+	0	0	2375	0.0000000
zheyou73v0_A07	7883318	7885693	BnaA07T0021500ZY.1	0	+	0	0	2375	0.0000000
zheyou73v0_A07	7897318	7897660	BnaA07T0021600ZY	0	+	0	0	342	0.0000000
zheyou73v0_A07	7899284	7899545	BnaA07T0021700ZY	0	-	0	0	261	0.0000000
zheyou73v0_A07	7903913	7905336	BnaA07T0021800ZY	0	-	0	0	1423	0.0000000
zheyou73v0_A07	7910640	7914992	BnaA07T0021900ZY	0	-	0	0	4352	0.0000000
zheyou73v0_A07	7917684	7919341	BnaA07T0022000ZY	0	-	0	0	1657	0.0000000
zheyou73v0_A07	7924947	7927613	BnaA07T0022100ZY	0	-	0	0	2666	0.0000000
zheyou73v0_A07	7939583	7939959	BnaA07T0022200ZY	0	-	0	0	376	0.0000000
zheyou73v0_A07	7945369	7945951	BnaA07T0022300ZY	0	-	0	0	582	0.0000000
zheyou73v0_A07	7985849	7987028	BnaA07T0022400ZY	0	+	0	0	1179	0.0000000
zheyou73v0_A07	7990156	7992464	BnaA07T0022500ZY	0	+	0	0	2308	0.0000000
zheyou73v0_A07	8006051	8008328	BnaA07T0022600ZY	0	+	0	0	2277	0.0000000
zheyou73v0_A07	8015312	8015969	BnaA07T0022700ZY	0	-	0	0	657	0.0000000
zheyou73v0_A07	8017227	8018111	BnaA07T0022800ZY	0	+	0	0	884	0.0000000
zheyou73v0_A07	8019489	8021489	BnaA07T0022900ZY	0	-	0	0	2000	0.0000000
zheyou73v0_A07	8024858	8028162	BnaA07T0023000ZY	0	+	0	0	3304	0.0000000
zheyou73v0_A07	8028293	8029778	BnaA07T0023100ZY	0	-	0	0	1485	0.0000000
zheyou73v0_A07	8037746	8043558	BnaA07T0023200ZY	0	+	0	0	5812	0.0000000
zheyou73v0_A07	8045300	8047604	BnaA07T0023300ZY	0	+	0	0	2304	0.0000000
zheyou73v0_A07	8047748	8067434	BnaA07T0023400ZY	0	-	0	0	19686	0.0000000
zheyou73v0_A07	8073582	8074875	BnaA07T0023500ZY	0	+	0	0	1293	0.0000000
zheyou73v0_A07	8101486	8103001	BnaA07T0023600ZY	0	+	0	0	1515	0.0000000
zheyou73v0_A07	8117220	8122148	BnaA07T0023700ZY	0	-	0	0	4928	0.0000000
zheyou73v0_A07	8124610	8125865	BnaA07T0023800ZY	0	+	0	0	1255	0.0000000
zheyou73v0_A07	8127828	8128940	BnaA07T0023900ZY	0	-	0	0	1112	0.0000000
zheyou73v0_A07	8153883	8156641	BnaA07T0024000ZY	0	+	0	0	2758	0.0000000
zheyou73v0_A07	8161108	8161414	BnaA07T0024100ZY	0	+	0	0	306	0.0000000
zheyou73v0_A07	8163158	8164288	BnaA07T0024200ZY	0	+	0	0	1130	0.0000000
zheyou73v0_A07	8166736	8169800	BnaA07T0024300ZY	0	+	0	0	3064	0.0000000
zheyou73v0_A07	8170265	8170792	BnaA07T0024400ZY	0	-	0	0	527	0.0000000
zheyou73v0_A07	8195406	8196899	BnaA07T0024500ZY.1	0	+	0	0	1493	0.0000000
zheyou73v0_A07	8196152	8196899	BnaA07T0024500ZY	0	+	0	0	747	0.0000000
zheyou73v0_A07	8200687	8201110	BnaA07T0024600ZY	0	+	0	0	423	0.0000000
zheyou73v0_A07	8202673	8204442	BnaA07T0024700ZY	0	-	0	0	1769	0.0000000
zheyou73v0_A07	8230424	8233166	BnaA07T0024800ZY	0	-	0	0	2742	0.0000000
zheyou73v0_A07	8234661	8236614	BnaA07T0024900ZY	0	-	0	0	1953	0.0000000
zheyou73v0_A07	8234661	8236614	BnaA07T0024900ZY.1	0	-	0	0	1953	0.0000000
zheyou73v0_A07	8237351	8239128	BnaA07T0025000ZY	0	-	0	0	1777	0.0000000
zheyou73v0_A07	8237351	8239128	BnaA07T0025000ZY.1	0	-	0	0	1777	0.0000000
zheyou73v0_A07	8239491	8241393	BnaA07T0025100ZY	0	-	0	0	1902	0.0000000
zheyou73v0_A07	8239660	8240398	BnaA07T0025200ZY	0	+	0	0	738	0.0000000
zheyou73v0_A07	8242333	8244255	BnaA07T0025300ZY	0	-	0	0	1922	0.0000000
zheyou73v0_A07	8244710	8247809	BnaA07T0025400ZY	0	-	0	0	3099	0.0000000
zheyou73v0_A07	8248089	8249032	BnaA07T0025500ZY	0	-	0	0	943	0.0000000
zheyou73v0_A07	8258450	8260682	BnaA07T0025600ZY	0	-	0	0	2232	0.0000000
zheyou73v0_A07	8264449	8265556	BnaA07T0025700ZY	0	-	0	0	1107	0.0000000
zheyou73v0_A07	8265956	8267651	BnaA07T0025800ZY	0	-	0	0	1695	0.0000000
zheyou73v0_A07	8298955	8301876	BnaA07T0025900ZY	0	-	0	0	2921	0.0000000
zheyou73v0_A07	8349813	8351569	BnaA07T0026000ZY	0	-	0	0	1756	0.0000000
zheyou73v0_A07	8352883	8355558	BnaA07T0026100ZY	0	+	0	0	2675	0.0000000
zheyou73v0_A07	8355987	8356272	BnaA07T0026200ZY	0	-	0	0	285	0.0000000
zheyou73v0_A07	8360432	8364544	BnaA07T0026300ZY	0	-	0	0	4112	0.0000000
zheyou73v0_A07	8365561	8369662	BnaA07T0026400ZY	0	+	0	0	4101	0.0000000
zheyou73v0_A07	8370211	8375818	BnaA07T0026500ZY	0	-	0	0	5607	0.0000000
zheyou73v0_A07	8390584	8392342	BnaA07T0026600ZY	0	+	0	0	1758	0.0000000
zheyou73v0_A07	8407723	8409891	BnaA07T0026700ZY	0	+	0	0	2168	0.0000000
zheyou73v0_A07	8414643	8414945	BnaA07T0026800ZY	0	+	0	0	302	0.0000000
zheyou73v0_A07	8425665	8428020	BnaA07T0026900ZY	0	+	0	0	2355	0.0000000
zheyou73v0_A07	8431499	8432374	BnaA07T0027000ZY	0	-	0	0	875	0.0000000
zheyou73v0_A07	8432461	8433601	BnaA07T0027100ZY	0	-	0	0	1140	0.0000000
zheyou73v0_A07	8439954	8443562	BnaA07T0027200ZY	0	+	0	0	3608	0.0000000
zheyou73v0_A07	8446472	8448645	BnaA07T0027300ZY	0	-	0	0	2173	0.0000000
zheyou73v0_A07	8455129	8457725	BnaA07T0027400ZY	0	-	0	0	2596	0.0000000
zheyou73v0_A07	8461237	8465790	BnaA07T0027500ZY	0	+	0	0	4553	0.0000000
zheyou73v0_A07	8464648	8468516	BnaA07T0027600ZY	0	-	0	0	3868	0.0000000
zheyou73v0_A07	8464648	8467922	BnaA07T0027600ZY.1	0	-	0	0	3274	0.0000000
zheyou73v0_A07	8464648	8468516	BnaA07T0027600ZY.2	0	-	0	0	3868	0.0000000
zheyou73v0_A07	8464648	8467922	BnaA07T0027600ZY.3	0	-	0	0	3274	0.0000000
zheyou73v0_A07	8464648	8468516	BnaA07T0027600ZY.4	0	-	0	0	3868	0.0000000
zheyou73v0_A07	8464648	8468516	BnaA07T0027600ZY.5	0	-	0	0	3868	0.0000000
zheyou73v0_A07	8483937	8486856	BnaA07T0027700ZY	0	+	0	0	2919	0.0000000
zheyou73v0_A07	8486920	8487481	BnaA07T0027800ZY	0	+	0	0	561	0.0000000
zheyou73v0_A07	8487769	8491049	BnaA07T0027900ZY	0	-	0	0	3280	0.0000000
zheyou73v0_A07	8493862	8495224	BnaA07T0028000ZY	0	-	0	0	1362	0.0000000
zheyou73v0_A07	8531677	8533487	BnaA07T0028100ZY	0	+	0	0	1810	0.0000000
zheyou73v0_A07	8536364	8539266	BnaA07T0028200ZY	0	+	0	0	2902	0.0000000
zheyou73v0_A07	8539343	8540112	BnaA07T0028300ZY	0	-	0	0	769	0.0000000
zheyou73v0_A07	8543908	8544348	BnaA07T0028400ZY	0	+	0	0	440	0.0000000
zheyou73v0_A07	8543908	8544348	BnaA07T0028400ZY.1	0	+	0	0	440	0.0000000
zheyou73v0_A07	8552487	8554632	BnaA07T0028500ZY	0	-	0	0	2145	0.0000000
zheyou73v0_A07	8569519	8571150	BnaA07T0028600ZY	0	-	0	0	1631	0.0000000
zheyou73v0_A07	8571940	8574077	BnaA07T0028700ZY	0	+	0	0	2137	0.0000000
zheyou73v0_A07	8575628	8578557	BnaA07T0028800ZY	0	-	0	0	2929	0.0000000
zheyou73v0_A07	8591311	8594051	BnaA07T0028900ZY	0	+	0	0	2740	0.0000000
zheyou73v0_A07	8594945	8596066	BnaA07T0029000ZY	0	-	0	0	1121	0.0000000
zheyou73v0_A07	8614798	8617264	BnaA07T0029100ZY	0	+	0	0	2466	0.0000000
zheyou73v0_A07	8617647	8619794	BnaA07T0029200ZY	0	+	0	0	2147	0.0000000
zheyou73v0_A07	8620964	8621120	BnaA07T0029300ZY	0	+	0	0	156	0.0000000
zheyou73v0_A07	8629498	8630417	BnaA07T0029400ZY	0	+	0	0	919	0.0000000
zheyou73v0_A07	8643516	8644430	BnaA07T0029500ZY	0	+	0	0	914	0.0000000
zheyou73v0_A07	8646780	8652683	BnaA07T0029600ZY	0	-	0	0	5903	0.0000000
zheyou73v0_A07	8717488	8718700	BnaA07T0029700ZY	0	-	0	0	1212	0.0000000
zheyou73v0_A07	8746782	8748542	BnaA07T0029800ZY	0	-	0	0	1760	0.0000000
zheyou73v0_A07	8751595	8753098	BnaA07T0029900ZY	0	-	0	0	1503	0.0000000
zheyou73v0_A07	8754357	8756016	BnaA07T0030000ZY	0	-	0	0	1659	0.0000000
zheyou73v0_A07	8756821	8762940	BnaA07T0030100ZY	0	-	0	0	6119	0.0000000
zheyou73v0_A07	8756821	8762940	BnaA07T0030100ZY.1	0	-	0	0	6119	0.0000000
zheyou73v0_A07	8764138	8768120	BnaA07T0030200ZY	0	-	0	0	3982	0.0000000
zheyou73v0_A07	8769028	8769518	BnaA07T0030300ZY	0	-	0	0	490	0.0000000
zheyou73v0_A07	8782119	8784700	BnaA07T0030400ZY	0	-	0	0	2581	0.0000000
zheyou73v0_A07	8782119	8784762	BnaA07T0030400ZY.1	0	-	0	0	2643	0.0000000
zheyou73v0_A07	8782119	8784700	BnaA07T0030400ZY.2	0	-	0	0	2581	0.0000000
zheyou73v0_A07	8785021	8786770	BnaA07T0030500ZY	0	+	0	0	1749	0.0000000
zheyou73v0_A07	8787051	8789756	BnaA07T0030600ZY	0	-	0	0	2705	0.0000000
zheyou73v0_A07	8799097	8799903	BnaA07T0030700ZY	0	-	0	0	806	0.0000000
zheyou73v0_A07	8802479	8808310	BnaA07T0030800ZY	0	-	0	0	5831	0.0000000
zheyou73v0_A07	8802479	8807775	BnaA07T0030800ZY.1	0	-	0	0	5296	0.0000000
zheyou73v0_A07	8827098	8828924	BnaA07T0030900ZY	0	+	0	0	1826	0.0000000
zheyou73v0_A07	8833511	8836010	BnaA07T0031000ZY	0	+	0	0	2499	0.0000000
zheyou73v0_A07	8836907	8837979	BnaA07T0031100ZY	0	-	0	0	1072	0.0000000
zheyou73v0_A07	8849904	8852114	BnaA07T0031200ZY	0	-	0	0	2210	0.0000000
zheyou73v0_A07	8864044	8868963	BnaA07T0031300ZY	0	+	0	0	4919	0.0000000
zheyou73v0_A07	8869391	8879063	BnaA07T0031400ZY	0	-	0	0	9672	0.0000000
zheyou73v0_A07	8882274	8886686	BnaA07T0031500ZY	0	-	0	0	4412	0.0000000
zheyou73v0_A07	8896596	8896827	BnaA07T0031600ZY	0	+	0	0	231	0.0000000
zheyou73v0_A07	8931581	8937311	BnaA07T0031700ZY	0	+	0	0	5730	0.0000000
zheyou73v0_A07	8937758	8941333	BnaA07T0031800ZY	0	-	0	0	3575	0.0000000
zheyou73v0_A07	8963430	8964879	BnaA07T0031900ZY	0	+	0	0	1449	0.0000000
zheyou73v0_A07	8965102	8966487	BnaA07T0032000ZY	0	-	0	0	1385	0.0000000
zheyou73v0_A07	8968302	8969195	BnaA07T0032100ZY	0	-	0	0	893	0.0000000
zheyou73v0_A07	8972320	8974838	BnaA07T0032200ZY	0	-	0	0	2518	0.0000000
zheyou73v0_A07	8977903	8979338	BnaA07T0032300ZY	0	+	0	0	1435	0.0000000
zheyou73v0_A07	8979414	8980991	BnaA07T0032400ZY	0	-	0	0	1577	0.0000000
zheyou73v0_A07	8981626	8982008	BnaA07T0032500ZY	0	-	0	0	382	0.0000000
zheyou73v0_A07	8988368	8988764	BnaA07T0032600ZY	0	+	0	0	396	0.0000000
zheyou73v0_A07	8992098	8992519	BnaA07T0032700ZY	0	-	0	0	421	0.0000000
zheyou73v0_A07	9009888	9012030	BnaA07T0032800ZY	0	-	0	0	2142	0.0000000
zheyou73v0_A07	9012346	9013487	BnaA07T0032900ZY	0	-	0	0	1141	0.0000000
zheyou73v0_A07	9014925	9015669	BnaA07T0033000ZY	0	+	0	0	744	0.0000000
zheyou73v0_A07	9016200	9018849	BnaA07T0033100ZY	0	-	0	0	2649	0.0000000
zheyou73v0_A07	9018908	9019659	BnaA07T0033200ZY	0	-	0	0	751	0.0000000
zheyou73v0_A07	9027549	9030130	BnaA07T0033300ZY	0	-	0	0	2581	0.0000000
zheyou73v0_A07	9034933	9036531	BnaA07T0033400ZY	0	-	0	0	1598	0.0000000
zheyou73v0_A07	9046542	9049184	BnaA07T0033500ZY	0	-	0	0	2642	0.0000000
zheyou73v0_A07	9062913	9064082	BnaA07T0033600ZY	0	+	0	0	1169	0.0000000
zheyou73v0_A07	9067535	9069837	BnaA07T0033700ZY	0	-	0	0	2302	0.0000000
zheyou73v0_A07	9070552	9076610	BnaA07T0033800ZY	0	-	0	0	6058	0.0000000
zheyou73v0_A07	9084750	9085636	BnaA07T0033900ZY	0	+	0	0	886	0.0000000
zheyou73v0_A07	9089845	9091182	BnaA07T0034000ZY	0	-	0	0	1337	0.0000000
zheyou73v0_A07	9109055	9109527	BnaA07T0034100ZY	0	+	0	0	472	0.0000000
zheyou73v0_A07	9155438	9155914	BnaA07T0034200ZY	0	+	0	0	476	0.0000000
zheyou73v0_A07	9157351	9157768	BnaA07T0034300ZY	0	-	0	0	417	0.0000000
zheyou73v0_A07	9161964	9163674	BnaA07T0034400ZY	0	+	0	0	1710	0.0000000
zheyou73v0_A07	9164351	9165657	BnaA07T0034500ZY	0	-	0	0	1306	0.0000000
zheyou73v0_A07	9184324	9197616	BnaA07T0034600ZY	0	+	0	0	13292	0.0000000
zheyou73v0_A07	9198015	9201622	BnaA07T0034700ZY	0	-	0	0	3607	0.0000000
zheyou73v0_A07	9202789	9204148	BnaA07T0034800ZY	0	+	0	0	1359	0.0000000
zheyou73v0_A07	9207153	9208234	BnaA07T0034900ZY	0	+	0	0	1081	0.0000000
zheyou73v0_A07	9220462	9222599	BnaA07T0035000ZY	0	+	0	0	2137	0.0000000
zheyou73v0_A07	9228155	9228461	BnaA07T0035100ZY	0	+	0	0	306	0.0000000
zheyou73v0_A07	9229252	9236680	BnaA07T0035200ZY	0	-	0	0	7428	0.0000000
zheyou73v0_A07	9229252	9236680	BnaA07T0035200ZY.1	0	-	0	0	7428	0.0000000
zheyou73v0_A07	9243007	9245781	BnaA07T0035300ZY	0	+	0	0	2774	0.0000000
zheyou73v0_A07	9247132	9249122	BnaA07T0035400ZY	0	+	0	0	1990	0.0000000
zheyou73v0_A07	9253389	9253608	BnaA07T0035500ZY	0	+	0	0	219	0.0000000
zheyou73v0_A07	9254879	9255635	BnaA07T0035600ZY	0	+	0	0	756	0.0000000
zheyou73v0_A07	9264420	9265787	BnaA07T0035700ZY	0	-	0	0	1367	0.0000000
zheyou73v0_A07	9315339	9316765	BnaA07T0035800ZY	0	+	0	0	1426	0.0000000
zheyou73v0_A07	9327764	9329344	BnaA07T0035900ZY	0	-	0	0	1580	0.0000000
zheyou73v0_A07	9333891	9335196	BnaA07T0036000ZY	0	+	0	0	1305	0.0000000
zheyou73v0_A07	9341484	9342875	BnaA07T0036100ZY	0	+	0	0	1391	0.0000000
zheyou73v0_A07	9360432	9376079	BnaA07T0036200ZY	0	+	0	0	15647	0.0000000
zheyou73v0_A07	9394806	9398040	BnaA07T0036300ZY	0	+	0	0	3234	0.0000000
zheyou73v0_A07	9413161	9424854	BnaA07T0036400ZY	0	-	0	0	11693	0.0000000
zheyou73v0_A07	9428785	9430631	BnaA07T0036500ZY	0	+	0	0	1846	0.0000000
zheyou73v0_A07	9434960	9437818	BnaA07T0036600ZY	0	-	0	0	2858	0.0000000
zheyou73v0_A07	9439676	9440286	BnaA07T0036700ZY	0	+	0	0	610	0.0000000
zheyou73v0_A07	9440475	9453171	BnaA07T0036800ZY	0	-	0	0	12696	0.0000000
zheyou73v0_A07	9456224	9456986	BnaA07T0036900ZY	0	-	0	0	762	0.0000000
zheyou73v0_A07	9469531	9471756	BnaA07T0037000ZY	0	-	0	0	2225	0.0000000
zheyou73v0_A07	9496871	9497063	BnaA07T0037100ZY	0	+	0	0	192	0.0000000
zheyou73v0_A07	9538651	9543377	BnaA07T0037200ZY	0	+	0	0	4726	0.0000000
zheyou73v0_A07	9550869	9552557	BnaA07T0037300ZY	0	+	0	0	1688	0.0000000
zheyou73v0_A07	9554289	9554481	BnaA07T0037400ZY	0	+	0	0	192	0.0000000
zheyou73v0_A07	9554841	9557562	BnaA07T0037500ZY	0	-	0	0	2721	0.0000000
zheyou73v0_A07	9567959	9568757	BnaA07T0037600ZY	0	+	0	0	798	0.0000000
zheyou73v0_A07	9585190	9586881	BnaA07T0037700ZY	0	-	0	0	1691	0.0000000
zheyou73v0_A07	9588403	9589999	BnaA07T0037800ZY	0	-	0	0	1596	0.0000000
zheyou73v0_A07	9595803	9596669	BnaA07T0037900ZY	0	-	0	0	866	0.0000000
zheyou73v0_A07	9597460	9598902	BnaA07T0038000ZY	0	+	0	0	1442	0.0000000
zheyou73v0_A07	9601068	9602918	BnaA07T0038100ZY	0	-	0	0	1850	0.0000000
zheyou73v0_A07	9628288	9630809	BnaA07T0038200ZY	0	-	0	0	2521	0.0000000
zheyou73v0_A07	9644481	9647639	BnaA07T0038300ZY	0	+	0	0	3158	0.0000000
zheyou73v0_A07	9648108	9648677	BnaA07T0038400ZY	0	+	0	0	569	0.0000000
zheyou73v0_A07	9651974	9653006	BnaA07T0038500ZY	0	+	0	0	1032	0.0000000
zheyou73v0_A07	9653238	9654845	BnaA07T0038600ZY	0	-	0	0	1607	0.0000000
zheyou73v0_A07	9653238	9654845	BnaA07T0038600ZY.1	0	-	0	0	1607	0.0000000
zheyou73v0_A07	9653238	9654845	BnaA07T0038600ZY.2	0	-	0	0	1607	0.0000000
zheyou73v0_A07	9653238	9654845	BnaA07T0038600ZY.3	0	-	0	0	1607	0.0000000
zheyou73v0_A07	9653238	9654845	BnaA07T0038600ZY.4	0	-	0	0	1607	0.0000000
zheyou73v0_A07	9653238	9654845	BnaA07T0038600ZY.5	0	-	0	0	1607	0.0000000
zheyou73v0_A07	9655672	9655987	BnaA07T0038700ZY	0	-	0	0	315	0.0000000
zheyou73v0_A07	9679854	9681097	BnaA07T0038800ZY	0	+	0	0	1243	0.0000000
zheyou73v0_A07	9681542	9687867	BnaA07T0038900ZY	0	-	0	0	6325	0.0000000
zheyou73v0_A07	9690190	9694474	BnaA07T0039000ZY	0	+	0	0	4284	0.0000000
zheyou73v0_A07	9694775	9698394	BnaA07T0039100ZY	0	-	0	0	3619	0.0000000
zheyou73v0_A07	9707966	9715150	BnaA07T0039200ZY	0	-	0	0	7184	0.0000000
zheyou73v0_A07	9717916	9719191	BnaA07T0039300ZY	0	-	0	0	1275	0.0000000
zheyou73v0_A07	9725441	9727187	BnaA07T0039400ZY	0	+	0	0	1746	0.0000000
zheyou73v0_A07	9742671	9743689	BnaA07T0039500ZY	0	+	0	0	1018	0.0000000
zheyou73v0_A07	9752881	9755025	BnaA07T0039600ZY	0	+	0	0	2144	0.0000000
zheyou73v0_A07	9752881	9755025	BnaA07T0039600ZY.1	0	+	0	0	2144	0.0000000
zheyou73v0_A07	9756891	9757623	BnaA07T0039700ZY	0	-	0	0	732	0.0000000
zheyou73v0_A07	9758599	9759019	BnaA07T0039800ZY	0	-	0	0	420	0.0000000
zheyou73v0_A07	9760567	9762444	BnaA07T0039900ZY	0	-	0	0	1877	0.0000000
zheyou73v0_A07	9766306	9769055	BnaA07T0040000ZY	0	-	0	0	2749	0.0000000
zheyou73v0_A07	9779505	9780005	BnaA07T0040100ZY	0	-	0	0	500	0.0000000
zheyou73v0_A07	9784464	9784767	BnaA07T0040200ZY	0	+	0	0	303	0.0000000
zheyou73v0_A07	9805562	9806664	BnaA07T0040300ZY	0	-	0	0	1102	0.0000000
zheyou73v0_A07	9811532	9813465	BnaA07T0040400ZY	0	-	0	0	1933	0.0000000
zheyou73v0_A07	9849559	9851857	BnaA07T0040500ZY	0	-	0	0	2298	0.0000000
zheyou73v0_A07	9856780	9858609	BnaA07T0040600ZY	0	+	0	0	1829	0.0000000
zheyou73v0_A07	9920526	9921461	BnaA07T0040700ZY	0	-	0	0	935	0.0000000
zheyou73v0_A07	9925638	9928444	BnaA07T0040800ZY	0	-	0	0	2806	0.0000000
zheyou73v0_A07	9946633	9953784	BnaA07T0040900ZY	0	+	0	0	7151	0.0000000
zheyou73v0_A07	9953905	9954752	BnaA07T0041000ZY	0	-	0	0	847	0.0000000
zheyou73v0_A07	9957168	9958015	BnaA07T0041100ZY	0	+	0	0	847	0.0000000
zheyou73v0_A07	9958375	9959178	BnaA07T0041200ZY	0	-	0	0	803	0.0000000
zheyou73v0_A07	9961847	9965221	BnaA07T0041300ZY	0	+	0	0	3374	0.0000000
zheyou73v0_A07	9966727	9968172	BnaA07T0041400ZY	0	-	0	0	1445	0.0000000
zheyou73v0_A07	9973782	9978430	BnaA07T0041500ZY	0	-	0	0	4648	0.0000000
zheyou73v0_A07	9979966	9987053	BnaA07T0041600ZY	0	-	0	0	7087	0.0000000
zheyou73v0_A07	9995838	9996254	BnaA07T0041700ZY	0	+	0	0	416	0.0000000
zheyou73v0_A07	9997232	9997961	BnaA07T0041800ZY	0	-	0	0	729	0.0000000
zheyou73v0_A07	9999340	10000132	BnaA07T0041900ZY	0	-	0	0	792	0.0000000
zheyou73v0_A07	10004957	10010179	BnaA07T0042000ZY	0	+	0	0	5222	0.0000000
zheyou73v0_A07	10018659	10023872	BnaA07T0042100ZY	0	+	0	0	5213	0.0000000
zheyou73v0_A07	10030659	10042034	BnaA07T0042200ZY	0	+	0	0	11375	0.0000000
zheyou73v0_A07	10043698	10055390	BnaA07T0042300ZY	0	+	0	0	11692	0.0000000
zheyou73v0_A07	10070819	10071146	BnaA07T0042400ZY	0	+	0	0	327	0.0000000
zheyou73v0_A07	10152876	10153518	BnaA07T0042500ZY	0	-	0	0	642	0.0000000
zheyou73v0_A07	10159392	10159759	BnaA07T0042600ZY	0	+	0	0	367	0.0000000
zheyou73v0_A07	10165367	10167709	BnaA07T0042700ZY	0	+	0	0	2342	0.0000000
zheyou73v0_A07	10176020	10177731	BnaA07T0042800ZY	0	-	0	0	1711	0.0000000
zheyou73v0_A07	10181725	10183711	BnaA07T0042900ZY	0	-	0	0	1986	0.0000000
zheyou73v0_A07	10201982	10202841	BnaA07T0043000ZY	0	+	0	0	859	0.0000000
zheyou73v0_A07	10210297	10213761	BnaA07T0043100ZY	0	-	0	0	3464	0.0000000
zheyou73v0_A07	10215555	10217058	BnaA07T0043200ZY	0	-	0	0	1503	0.0000000
zheyou73v0_A07	10234943	10237094	BnaA07T0043300ZY	0	-	0	0	2151	0.0000000
zheyou73v0_A07	10245425	10247729	BnaA07T0043400ZY	0	-	0	0	2304	0.0000000
zheyou73v0_A07	10259178	10259802	BnaA07T0043500ZY	0	-	0	0	624	0.0000000
zheyou73v0_A07	10265812	10266101	BnaA07T0043600ZY	0	+	0	0	289	0.0000000
zheyou73v0_A07	10266674	10267088	BnaA07T0043700ZY	0	-	0	0	414	0.0000000
zheyou73v0_A07	10269438	10270862	BnaA07T0043800ZY	0	+	0	0	1424	0.0000000
zheyou73v0_A07	10269438	10270862	BnaA07T0043800ZY.1	0	+	0	0	1424	0.0000000
zheyou73v0_A07	10271866	10272906	BnaA07T0043900ZY	0	-	0	0	1040	0.0000000
zheyou73v0_A07	10276119	10277238	BnaA07T0044000ZY	0	-	0	0	1119	0.0000000
zheyou73v0_A07	10279608	10280347	BnaA07T0044100ZY	0	+	0	0	739	0.0000000
zheyou73v0_A07	10288306	10288790	BnaA07T0044200ZY	0	-	0	0	484	0.0000000
zheyou73v0_A07	10289157	10294587	BnaA07T0044300ZY	0	+	0	0	5430	0.0000000
zheyou73v0_A07	10293052	10294597	BnaA07T0044400ZY	0	-	0	0	1545	0.0000000
zheyou73v0_A07	10295100	10295514	BnaA07T0044500ZY	0	+	0	0	414	0.0000000
zheyou73v0_A07	10295669	10300892	BnaA07T0044600ZY	0	-	0	0	5223	0.0000000
zheyou73v0_A07	10295669	10300892	BnaA07T0044600ZY.1	0	-	0	0	5223	0.0000000
zheyou73v0_A07	10307254	10307983	BnaA07T0044700ZY	0	+	0	0	729	0.0000000
zheyou73v0_A07	10310904	10311976	BnaA07T0044800ZY	0	+	0	0	1072	0.0000000
zheyou73v0_A07	10314746	10315818	BnaA07T0044900ZY	0	+	0	0	1072	0.0000000
zheyou73v0_A07	10323688	10327146	BnaA07T0045000ZY	0	+	0	0	3458	0.0000000
zheyou73v0_A07	10328348	10332909	BnaA07T0045100ZY	0	+	0	0	4561	0.0000000
zheyou73v0_A07	10338734	10339126	BnaA07T0045200ZY	0	-	0	0	392	0.0000000
zheyou73v0_A07	10345844	10346451	BnaA07T0045300ZY	0	-	0	0	607	0.0000000
zheyou73v0_A07	10353510	10354381	BnaA07T0045400ZY	0	-	0	0	871	0.0000000
zheyou73v0_A07	10356939	10357358	BnaA07T0045500ZY	0	-	0	0	419	0.0000000
zheyou73v0_A07	10373569	10379909	BnaA07T0045600ZY	0	+	0	0	6340	0.0000000
zheyou73v0_A07	10401818	10404340	BnaA07T0045700ZY	0	+	0	0	2522	0.0000000
zheyou73v0_A07	10410083	10412694	BnaA07T0045800ZY	0	-	0	0	2611	0.0000000
zheyou73v0_A07	10419753	10420244	BnaA07T0045900ZY	0	-	0	0	491	0.0000000
zheyou73v0_A07	10424094	10424585	BnaA07T0046000ZY	0	-	0	0	491	0.0000000
zheyou73v0_A07	10427404	10428778	BnaA07T0046100ZY	0	-	0	0	1374	0.0000000
zheyou73v0_A07	10434085	10435800	BnaA07T0046200ZY	0	-	0	0	1715	0.0000000
zheyou73v0_A07	10440011	10440692	BnaA07T0046300ZY	0	-	0	0	681	0.0000000
zheyou73v0_A07	10461536	10462566	BnaA07T0046400ZY	0	+	0	0	1030	0.0000000
zheyou73v0_A07	10465376	10466531	BnaA07T0046500ZY	0	-	0	0	1155	0.0000000
zheyou73v0_A07	10466556	10466859	BnaA07T0046600ZY	0	-	0	0	303	0.0000000
zheyou73v0_A07	10470895	10472051	BnaA07T0046700ZY	0	-	0	0	1156	0.0000000
zheyou73v0_A07	10473727	10477585	BnaA07T0046800ZY	0	-	0	0	3858	0.0000000
zheyou73v0_A07	10473727	10477585	BnaA07T0046800ZY.1	0	-	0	0	3858	0.0000000
zheyou73v0_A07	10494376	10495218	BnaA07T0046900ZY	0	-	0	0	842	0.0000000
zheyou73v0_A07	10504747	10506048	BnaA07T0047000ZY	0	-	0	0	1301	0.0000000
zheyou73v0_A07	10514977	10518027	BnaA07T0047100ZY	0	+	0	0	3050	0.0000000
zheyou73v0_A07	10518206	10518974	BnaA07T0047200ZY	0	-	0	0	768	0.0000000
zheyou73v0_A07	10521716	10522936	BnaA07T0047300ZY	0	-	0	0	1220	0.0000000
zheyou73v0_A07	10521716	10522936	BnaA07T0047300ZY.1	0	-	0	0	1220	0.0000000
zheyou73v0_A07	10527478	10529018	BnaA07T0047400ZY	0	-	0	0	1540	0.0000000
zheyou73v0_A07	10552800	10555205	BnaA07T0047500ZY	0	+	0	0	2405	0.0000000
zheyou73v0_A07	10555966	10562165	BnaA07T0047600ZY	0	+	0	0	6199	0.0000000
zheyou73v0_A07	10572812	10581957	BnaA07T0047700ZY	0	+	0	0	9145	0.0000000
zheyou73v0_A07	10593367	10594142	BnaA07T0047800ZY	0	-	0	0	775	0.0000000
zheyou73v0_A07	10594769	10596100	BnaA07T0047900ZY	0	+	0	0	1331	0.0000000
zheyou73v0_A07	10596776	10597587	BnaA07T0048000ZY	0	+	0	0	811	0.0000000
zheyou73v0_A07	10599254	10601450	BnaA07T0048100ZY	0	+	0	0	2196	0.0000000
zheyou73v0_A07	10602214	10604505	BnaA07T0048200ZY	0	+	0	0	2291	0.0000000
zheyou73v0_A07	10604956	10605690	BnaA07T0048300ZY	0	+	0	0	734	0.0000000
zheyou73v0_A07	10605837	10606562	BnaA07T0048400ZY	0	-	0	0	725	0.0000000
zheyou73v0_A07	10609484	10610471	BnaA07T0048500ZY	0	-	0	0	987	0.0000000
zheyou73v0_A07	10610787	10612135	BnaA07T0048600ZY	0	-	0	0	1348	0.0000000
zheyou73v0_A07	10615304	10615967	BnaA07T0048700ZY	0	+	0	0	663	0.0000000
zheyou73v0_A07	10636452	10637192	BnaA07T0048800ZY	0	+	0	0	740	0.0000000
zheyou73v0_A07	10637980	10639909	BnaA07T0048900ZY	0	-	0	0	1929	0.0000000
zheyou73v0_A07	10650369	10653759	BnaA07T0049000ZY	0	-	0	0	3390	0.0000000
zheyou73v0_A07	10665637	10667155	BnaA07T0049100ZY	0	-	0	0	1518	0.0000000
zheyou73v0_A07	10670287	10672592	BnaA07T0049200ZY	0	+	0	0	2305	0.0000000
zheyou73v0_A07	10670287	10672592	BnaA07T0049200ZY.1	0	+	0	0	2305	0.0000000
zheyou73v0_A07	10670287	10672592	BnaA07T0049200ZY.2	0	+	0	0	2305	0.0000000
zheyou73v0_A07	10670287	10672592	BnaA07T0049200ZY.3	0	+	0	0	2305	0.0000000
zheyou73v0_A07	10680221	10680431	BnaA07T0049300ZY	0	-	0	0	210	0.0000000
zheyou73v0_A07	10684630	10685473	BnaA07T0049400ZY	0	+	0	0	843	0.0000000
zheyou73v0_A07	10688494	10689031	BnaA07T0049500ZY	0	-	0	0	537	0.0000000
zheyou73v0_A07	10706353	10710924	BnaA07T0049600ZY	0	-	0	0	4571	0.0000000
zheyou73v0_A07	10714552	10715594	BnaA07T0049700ZY	0	+	0	0	1042	0.0000000
zheyou73v0_A07	10742149	10743307	BnaA07T0049800ZY	0	+	0	0	1158	0.0000000
zheyou73v0_A07	10743921	10746723	BnaA07T0049900ZY	0	+	0	0	2802	0.0000000
zheyou73v0_A07	10750871	10754162	BnaA07T0050000ZY	0	+	0	0	3291	0.0000000
zheyou73v0_A07	10780839	10782563	BnaA07T0050100ZY	0	+	0	0	1724	0.0000000
zheyou73v0_A07	10788470	10789470	BnaA07T0050200ZY	0	+	0	0	1000	0.0000000
zheyou73v0_A07	10798049	10799470	BnaA07T0050300ZY	0	-	0	0	1421	0.0000000
zheyou73v0_A07	10800704	10801007	BnaA07T0050400ZY	0	-	0	0	303	0.0000000
zheyou73v0_A07	10810897	10814298	BnaA07T0050500ZY	0	+	0	0	3401	0.0000000
zheyou73v0_A07	10818240	10819371	BnaA07T0050600ZY	0	+	0	0	1131	0.0000000
zheyou73v0_A07	10820521	10822452	BnaA07T0050700ZY	0	-	0	0	1931	0.0000000
zheyou73v0_A07	10825418	10825703	BnaA07T0050800ZY	0	+	0	0	285	0.0000000
zheyou73v0_A07	10828332	10829052	BnaA07T0050900ZY	0	-	0	0	720	0.0000000
zheyou73v0_A07	10834253	10835028	BnaA07T0051000ZY	0	+	0	0	775	0.0000000
zheyou73v0_A07	10848989	10851901	BnaA07T0051100ZY	0	-	0	0	2912	0.0000000
zheyou73v0_A07	10872295	10873559	BnaA07T0051200ZY	0	+	0	0	1264	0.0000000
zheyou73v0_A07	10874115	10875982	BnaA07T0051300ZY	0	-	0	0	1867	0.0000000
zheyou73v0_A07	10884179	10886602	BnaA07T0051400ZY	0	-	0	0	2423	0.0000000
zheyou73v0_A07	10889064	10890946	BnaA07T0051500ZY	0	+	0	0	1882	0.0000000
zheyou73v0_A07	10891634	10892187	BnaA07T0051600ZY	0	-	0	0	553	0.0000000
zheyou73v0_A07	10894287	10894558	BnaA07T0051700ZY	0	+	0	0	271	0.0000000
zheyou73v0_A07	10898821	10900352	BnaA07T0051800ZY	0	-	0	0	1531	0.0000000
zheyou73v0_A07	10903391	10904664	BnaA07T0051900ZY	0	+	0	0	1273	0.0000000
zheyou73v0_A07	10906576	10911649	BnaA07T0052000ZY	0	-	0	0	5073	0.0000000
zheyou73v0_A07	10911864	10913990	BnaA07T0052100ZY	0	-	0	0	2126	0.0000000
zheyou73v0_A07	10917969	10918868	BnaA07T0052200ZY	0	-	0	0	899	0.0000000
zheyou73v0_A07	10919161	10920213	BnaA07T0052300ZY	0	-	0	0	1052	0.0000000
zheyou73v0_A07	10922997	10924326	BnaA07T0052400ZY	0	-	0	0	1329	0.0000000
zheyou73v0_A07	10944171	10944503	BnaA07T0052500ZY	0	+	0	0	332	0.0000000
zheyou73v0_A07	10957996	10961851	BnaA07T0052600ZY	0	-	0	0	3855	0.0000000
zheyou73v0_A07	10965125	10969921	BnaA07T0052700ZY	0	+	0	0	4796	0.0000000
zheyou73v0_A07	10965125	10969921	BnaA07T0052700ZY.1	0	+	0	0	4796	0.0000000
zheyou73v0_A07	10965125	10969921	BnaA07T0052700ZY.2	0	+	0	0	4796	0.0000000
zheyou73v0_A07	10970082	10970637	BnaA07T0052800ZY	0	-	0	0	555	0.0000000
zheyou73v0_A07	10971919	10973249	BnaA07T0052900ZY	0	+	0	0	1330	0.0000000
zheyou73v0_A07	10971919	10973249	BnaA07T0052900ZY.1	0	+	0	0	1330	0.0000000
zheyou73v0_A07	10971919	10973249	BnaA07T0052900ZY.2	0	+	0	0	1330	0.0000000
zheyou73v0_A07	10971919	10973249	BnaA07T0052900ZY.3	0	+	0	0	1330	0.0000000
zheyou73v0_A07	10979460	10981366	BnaA07T0053000ZY	0	-	0	0	1906	0.0000000
zheyou73v0_A07	10986248	10987142	BnaA07T0053100ZY	0	-	0	0	894	0.0000000
zheyou73v0_A07	10995291	10998260	BnaA07T0053200ZY	0	-	0	0	2969	0.0000000
zheyou73v0_A07	10995291	10997425	BnaA07T0053200ZY.1	0	-	0	0	2134	0.0000000
zheyou73v0_A07	10995291	10997425	BnaA07T0053200ZY.2	0	-	0	0	2134	0.0000000
zheyou73v0_A07	11004735	11007077	BnaA07T0053300ZY	0	+	0	0	2342	0.0000000
zheyou73v0_A07	11008208	11009573	BnaA07T0053400ZY	0	+	0	0	1365	0.0000000
zheyou73v0_A07	11011731	11014189	BnaA07T0053500ZY	0	-	0	0	2458	0.0000000
zheyou73v0_A07	11015859	11017573	BnaA07T0053600ZY	0	+	0	0	1714	0.0000000
zheyou73v0_A07	11018983	11019608	BnaA07T0053700ZY	0	+	0	0	625	0.0000000
zheyou73v0_A07	11049345	11052845	BnaA07T0053800ZY	0	-	0	0	3500	0.0000000
zheyou73v0_A07	11053010	11054534	BnaA07T0053900ZY	0	-	0	0	1524	0.0000000
zheyou73v0_A07	11054782	11056000	BnaA07T0054000ZY	0	+	0	0	1218	0.0000000
zheyou73v0_A07	11056364	11057962	BnaA07T0054100ZY	0	+	0	0	1598	0.0000000
zheyou73v0_A07	11058043	11060098	BnaA07T0054200ZY	0	+	0	0	2055	0.0000000
zheyou73v0_A07	11058043	11059816	BnaA07T0054200ZY.1	0	+	0	0	1773	0.0000000
zheyou73v0_A07	11060309	11061857	BnaA07T0054300ZY	0	+	0	0	1548	0.0000000
zheyou73v0_A07	11065037	11066595	BnaA07T0054400ZY	0	+	0	0	1558	0.0000000
zheyou73v0_A07	11065037	11066595	BnaA07T0054400ZY.1	0	+	0	0	1558	0.0000000
zheyou73v0_A07	11066941	11069758	BnaA07T0054500ZY	0	-	0	0	2817	0.0000000
zheyou73v0_A07	11066941	11069314	BnaA07T0054500ZY.1	0	-	0	0	2373	0.0000000
zheyou73v0_A07	11066941	11069314	BnaA07T0054500ZY.2	0	-	0	0	2373	0.0000000
zheyou73v0_A07	11070101	11074596	BnaA07T0054600ZY	0	+	0	0	4495	0.0000000
zheyou73v0_A07	11074693	11076773	BnaA07T0054700ZY	0	-	0	0	2080	0.0000000
zheyou73v0_A07	11080250	11088046	BnaA07T0054800ZY	0	-	0	0	7796	0.0000000
zheyou73v0_A07	11089335	11091087	BnaA07T0054900ZY	0	-	0	0	1752	0.0000000
zheyou73v0_A07	11092464	11093200	BnaA07T0055000ZY	0	+	0	0	736	0.0000000
zheyou73v0_A07	11093124	11094905	BnaA07T0055100ZY	0	-	0	0	1781	0.0000000
zheyou73v0_A07	11095014	11096047	BnaA07T0055200ZY	0	-	0	0	1033	0.0000000
zheyou73v0_A07	11099289	11101465	BnaA07T0055300ZY	0	-	0	0	2176	0.0000000
zheyou73v0_A07	11099289	11101465	BnaA07T0055300ZY.1	0	-	0	0	2176	0.0000000
zheyou73v0_A07	11099289	11101465	BnaA07T0055300ZY.2	0	-	0	0	2176	0.0000000
zheyou73v0_A07	11099289	11101465	BnaA07T0055300ZY.3	0	-	0	0	2176	0.0000000
zheyou73v0_A07	11107387	11108373	BnaA07T0055400ZY	0	-	0	0	986	0.0000000
zheyou73v0_A07	11111398	11113887	BnaA07T0055500ZY	0	+	0	0	2489	0.0000000
zheyou73v0_A07	11114134	11115694	BnaA07T0055600ZY	0	-	0	0	1560	0.0000000
zheyou73v0_A07	11117113	11121890	BnaA07T0055700ZY	0	-	0	0	4777	0.0000000
zheyou73v0_A07	11123159	11126454	BnaA07T0055800ZY	0	+	0	0	3295	0.0000000
zheyou73v0_A07	11127550	11130490	BnaA07T0055900ZY	0	+	0	0	2940	0.0000000
zheyou73v0_A07	11130713	11131686	BnaA07T0056000ZY	0	-	0	0	973	0.0000000
zheyou73v0_A07	11132208	11134719	BnaA07T0056100ZY	0	+	0	0	2511	0.0000000
zheyou73v0_A07	11135131	11137521	BnaA07T0056200ZY	0	-	0	0	2390	0.0000000
zheyou73v0_A07	11135131	11137521	BnaA07T0056200ZY.1	0	-	0	0	2390	0.0000000
zheyou73v0_A07	11144417	11146075	BnaA07T0056300ZY	0	+	0	0	1658	0.0000000
zheyou73v0_A07	11150387	11159297	BnaA07T0056400ZY	0	+	0	0	8910	0.0000000
zheyou73v0_A07	11150387	11157706	BnaA07T0056400ZY.1	0	+	0	0	7319	0.0000000
zheyou73v0_A07	11160307	11161237	BnaA07T0056500ZY	0	-	0	0	930	0.0000000
zheyou73v0_A07	11161670	11162128	BnaA07T0056600ZY	0	+	0	0	458	0.0000000
zheyou73v0_A07	11168071	11170536	BnaA07T0056700ZY	0	+	0	0	2465	0.0000000
zheyou73v0_A07	11170727	11173183	BnaA07T0056800ZY	0	-	0	0	2456	0.0000000
zheyou73v0_A07	11170727	11173183	BnaA07T0056800ZY.1	0	-	0	0	2456	0.0000000
zheyou73v0_A07	11173562	11176201	BnaA07T0056900ZY	0	+	0	0	2639	0.0000000
zheyou73v0_A07	11176880	11179491	BnaA07T0057000ZY	0	-	0	0	2611	0.0000000
zheyou73v0_A07	11182043	11182403	BnaA07T0057100ZY	0	+	0	0	360	0.0000000
zheyou73v0_A07	11184875	11186309	BnaA07T0057200ZY	0	+	0	0	1434	0.0000000
zheyou73v0_A07	11201435	11204746	BnaA07T0057300ZY	0	-	0	0	3311	0.0000000
zheyou73v0_A07	11205145	11206692	BnaA07T0057400ZY	0	+	0	0	1547	0.0000000
zheyou73v0_A07	11218182	11220306	BnaA07T0057500ZY	0	+	0	0	2124	0.0000000
zheyou73v0_A07	11221769	11222349	BnaA07T0057600ZY	0	-	0	0	580	0.0000000
zheyou73v0_A07	11227037	11227925	BnaA07T0057700ZY	0	-	0	0	888	0.0000000
zheyou73v0_A07	11244261	11244785	BnaA07T0057800ZY	0	+	0	0	524	0.0000000
zheyou73v0_A07	11245352	11245907	BnaA07T0057900ZY	0	-	0	0	555	0.0000000
zheyou73v0_A07	11249332	11250600	BnaA07T0058000ZY	0	-	0	0	1268	0.0000000
zheyou73v0_A07	11260881	11263774	BnaA07T0058100ZY	0	+	0	0	2893	0.0000000
zheyou73v0_A07	11271517	11273406	BnaA07T0058200ZY	0	+	0	0	1889	0.0000000
zheyou73v0_A07	11274047	11278780	BnaA07T0058300ZY	0	-	0	0	4733	0.0000000
zheyou73v0_A07	11292450	11299806	BnaA07T0058400ZY	0	-	0	0	7356	0.0000000
zheyou73v0_A07	11299908	11301621	BnaA07T0058500ZY	0	-	0	0	1713	0.0000000
zheyou73v0_A07	11303487	11304704	BnaA07T0058600ZY	0	+	0	0	1217	0.0000000
zheyou73v0_A07	11304882	11306387	BnaA07T0058700ZY	0	-	0	0	1505	0.0000000
zheyou73v0_A07	11306943	11308300	BnaA07T0058800ZY	0	-	0	0	1357	0.0000000
zheyou73v0_A07	11310123	11310809	BnaA07T0058900ZY	0	-	0	0	686	0.0000000
zheyou73v0_A07	11320547	11323184	BnaA07T0059000ZY	0	+	0	0	2637	0.0000000
zheyou73v0_A07	11324340	11325279	BnaA07T0059100ZY	0	+	0	0	939	0.0000000
zheyou73v0_A07	11324340	11325279	BnaA07T0059100ZY.1	0	+	0	0	939	0.0000000
zheyou73v0_A07	11326384	11329163	BnaA07T0059200ZY	0	+	0	0	2779	0.0000000
zheyou73v0_A07	11338752	11339414	BnaA07T0059300ZY	0	+	0	0	662	0.0000000
zheyou73v0_A07	11355951	11357307	BnaA07T0059400ZY	0	-	0	0	1356	0.0000000
zheyou73v0_A07	11363267	11364496	BnaA07T0059500ZY	0	-	0	0	1229	0.0000000
zheyou73v0_A07	11363267	11364496	BnaA07T0059500ZY.1	0	-	0	0	1229	0.0000000
zheyou73v0_A07	11368147	11370245	BnaA07T0059600ZY	0	-	0	0	2098	0.0000000
zheyou73v0_A07	11374416	11375499	BnaA07T0059700ZY	0	-	0	0	1083	0.0000000
zheyou73v0_A07	11378299	11380387	BnaA07T0059800ZY	0	+	0	0	2088	0.0000000
zheyou73v0_A07	11383722	11384281	BnaA07T0059900ZY	0	+	0	0	559	0.0000000
zheyou73v0_A07	11392543	11393028	BnaA07T0060000ZY	0	+	0	0	485	0.0000000
zheyou73v0_A07	11400669	11402412	BnaA07T0060100ZY	0	-	0	0	1743	0.0000000
zheyou73v0_A07	11405895	11409414	BnaA07T0060200ZY	0	+	0	0	3519	0.0000000
zheyou73v0_A07	11406086	11409414	BnaA07T0060200ZY.1	0	+	0	0	3328	0.0000000
zheyou73v0_A07	11414627	11416157	BnaA07T0060300ZY	0	-	0	0	1530	0.0000000
zheyou73v0_A07	11420231	11423010	BnaA07T0060400ZY	0	+	0	0	2779	0.0000000
zheyou73v0_A07	11424862	11426277	BnaA07T0060500ZY	0	+	0	0	1415	0.0000000
zheyou73v0_A07	11429758	11434862	BnaA07T0060600ZY	0	-	0	0	5104	0.0000000
zheyou73v0_A07	11435211	11438089	BnaA07T0060700ZY	0	-	0	0	2878	0.0000000
zheyou73v0_A07	11435211	11438089	BnaA07T0060700ZY.1	0	-	0	0	2878	0.0000000
zheyou73v0_A07	11445434	11450506	BnaA07T0060800ZY	0	+	0	0	5072	0.0000000
zheyou73v0_A07	11454817	11455605	BnaA07T0060900ZY	0	+	0	0	788	0.0000000
zheyou73v0_A07	11474645	11475124	BnaA07T0061000ZY	0	+	0	0	479	0.0000000
zheyou73v0_A07	11475526	11482280	BnaA07T0061100ZY	0	-	0	0	6754	0.0000000
zheyou73v0_A07	11482569	11486105	BnaA07T0061200ZY	0	-	0	0	3536	0.0000000
zheyou73v0_A07	11498775	11499365	BnaA07T0061300ZY	0	-	0	0	590	0.0000000
zheyou73v0_A07	11499403	11499847	BnaA07T0061400ZY	0	-	0	0	444	0.0000000
zheyou73v0_A07	11503216	11503645	BnaA07T0061500ZY	0	+	0	0	429	0.0000000
zheyou73v0_A07	11506167	11509924	BnaA07T0061600ZY	0	-	0	0	3757	0.0000000
zheyou73v0_A07	11506167	11509924	BnaA07T0061600ZY.1	0	-	0	0	3757	0.0000000
zheyou73v0_A07	11506167	11509924	BnaA07T0061600ZY.2	0	-	0	0	3757	0.0000000
zheyou73v0_A07	11506334	11506580	BnaA07T0061700ZY	0	+	0	0	246	0.0000000
zheyou73v0_A07	11510582	11517729	BnaA07T0061800ZY	0	+	0	0	7147	0.0000000
zheyou73v0_A07	11518164	11518929	BnaA07T0061900ZY	0	-	0	0	765	0.0000000
zheyou73v0_A07	11533835	11536004	BnaA07T0062000ZY	0	+	0	0	2169	0.0000000
zheyou73v0_A07	11535182	11536921	BnaA07T0062100ZY	0	-	0	0	1739	0.0000000
zheyou73v0_A07	11535182	11536921	BnaA07T0062100ZY.1	0	-	0	0	1739	0.0000000
zheyou73v0_A07	11556974	11558207	BnaA07T0062200ZY	0	-	0	0	1233	0.0000000
zheyou73v0_A07	11564618	11564916	BnaA07T0062300ZY	0	+	0	0	298	0.0000000
zheyou73v0_A07	11565838	11566611	BnaA07T0062400ZY	0	+	0	0	773	0.0000000
zheyou73v0_A07	11566753	11568262	BnaA07T0062500ZY	0	-	0	0	1509	0.0000000
zheyou73v0_A07	11572520	11573239	BnaA07T0062600ZY	0	+	0	0	719	0.0000000
zheyou73v0_A07	11574928	11576105	BnaA07T0062700ZY	0	-	0	0	1177	0.0000000
zheyou73v0_A07	11576785	11577692	BnaA07T0062800ZY	0	+	0	0	907	0.0000000
zheyou73v0_A07	11579076	11580187	BnaA07T0062900ZY	0	+	0	0	1111	0.0000000
zheyou73v0_A07	11580649	11580997	BnaA07T0063000ZY	0	+	0	0	348	0.0000000
zheyou73v0_A07	11582440	11583706	BnaA07T0063100ZY	0	+	0	0	1266	0.0000000
zheyou73v0_A07	11584360	11587922	BnaA07T0063200ZY	0	-	0	0	3562	0.0000000
zheyou73v0_A07	11591286	11597007	BnaA07T0063300ZY	0	+	0	0	5721	0.0000000
zheyou73v0_A07	11597510	11598855	BnaA07T0063400ZY	0	+	0	0	1345	0.0000000
zheyou73v0_A07	11617134	11618273	BnaA07T0063500ZY	0	-	0	0	1139	0.0000000
zheyou73v0_A07	11618576	11620197	BnaA07T0063600ZY	0	+	0	0	1621	0.0000000
zheyou73v0_A07	11624387	11624729	BnaA07T0063700ZY	0	+	0	0	342	0.0000000
zheyou73v0_A07	11644139	11645061	BnaA07T0063800ZY	0	-	0	0	922	0.0000000
zheyou73v0_A07	11645232	11648185	BnaA07T0063900ZY	0	-	0	0	2953	0.0000000
zheyou73v0_A07	11651394	11652668	BnaA07T0064000ZY	0	-	0	0	1274	0.0000000
zheyou73v0_A07	11651394	11652668	BnaA07T0064000ZY.1	0	-	0	0	1274	0.0000000
zheyou73v0_A07	11657886	11660863	BnaA07T0064100ZY	0	-	0	0	2977	0.0000000
zheyou73v0_A07	11657886	11660863	BnaA07T0064100ZY.1	0	-	0	0	2977	0.0000000
zheyou73v0_A07	11691902	11692841	BnaA07T0064200ZY	0	+	0	0	939	0.0000000
zheyou73v0_A07	11696726	11701789	BnaA07T0064300ZY	0	+	0	0	5063	0.0000000
zheyou73v0_A07	11720680	11721781	BnaA07T0064400ZY	0	+	0	0	1101	0.0000000
zheyou73v0_A07	11722381	11723152	BnaA07T0064500ZY	0	+	0	0	771	0.0000000
zheyou73v0_A07	11728331	11736167	BnaA07T0064600ZY	0	+	0	0	7836	0.0000000
zheyou73v0_A07	11747004	11752571	BnaA07T0064700ZY	0	+	0	0	5567	0.0000000
zheyou73v0_A07	11755875	11758794	BnaA07T0064800ZY	0	-	0	0	2919	0.0000000
zheyou73v0_A07	11761361	11762262	BnaA07T0064900ZY	0	+	0	0	901	0.0000000
zheyou73v0_A07	11773413	11776475	BnaA07T0065000ZY	0	+	0	0	3062	0.0000000
zheyou73v0_A07	11776759	11779298	BnaA07T0065100ZY	0	-	0	0	2539	0.0000000
zheyou73v0_A07	11797533	11799337	BnaA07T0065200ZY	0	-	0	0	1804	0.0000000
zheyou73v0_A07	11801720	11804610	BnaA07T0065300ZY	0	-	0	0	2890	0.0000000
zheyou73v0_A07	11807871	11810240	BnaA07T0065400ZY	0	+	0	0	2369	0.0000000
zheyou73v0_A07	11811519	11812941	BnaA07T0065500ZY	0	+	0	0	1422	0.0000000
zheyou73v0_A07	11818978	11822153	BnaA07T0065600ZY	0	+	0	0	3175	0.0000000
zheyou73v0_A07	11818978	11822153	BnaA07T0065600ZY.1	0	+	0	0	3175	0.0000000
zheyou73v0_A07	11818978	11822153	BnaA07T0065600ZY.2	0	+	0	0	3175	0.0000000
zheyou73v0_A07	11822465	11823801	BnaA07T0065700ZY	0	+	0	0	1336	0.0000000
zheyou73v0_A07	11823878	11826319	BnaA07T0065800ZY	0	+	0	0	2441	0.0000000
zheyou73v0_A07	11828382	11829034	BnaA07T0065900ZY	0	+	0	0	652	0.0000000
zheyou73v0_A07	11829870	11832320	BnaA07T0066000ZY	0	+	0	0	2450	0.0000000
zheyou73v0_A07	11838685	11840061	BnaA07T0066100ZY	0	+	0	0	1376	0.0000000
zheyou73v0_A07	11843199	11846499	BnaA07T0066200ZY	0	+	0	0	3300	0.0000000
zheyou73v0_A07	11846782	11848172	BnaA07T0066300ZY	0	-	0	0	1390	0.0000000
zheyou73v0_A07	11850477	11851080	BnaA07T0066400ZY	0	+	0	0	603	0.0000000
zheyou73v0_A07	11855833	11856262	BnaA07T0066500ZY	0	+	0	0	429	0.0000000
zheyou73v0_A07	11878376	11879661	BnaA07T0066600ZY	0	+	0	0	1285	0.0000000
zheyou73v0_A07	11879910	11882458	BnaA07T0066700ZY	0	-	0	0	2548	0.0000000
zheyou73v0_A07	11884538	11884916	BnaA07T0066800ZY	0	-	0	0	378	0.0000000
zheyou73v0_A07	11884999	11886582	BnaA07T0066900ZY	0	-	0	0	1583	0.0000000
zheyou73v0_A07	11895530	11896945	BnaA07T0067000ZY	0	-	0	0	1415	0.0000000
zheyou73v0_A07	11898016	11900591	BnaA07T0067100ZY	0	-	0	0	2575	0.0000000
zheyou73v0_A07	11900896	11901855	BnaA07T0067200ZY	0	+	0	0	959	0.0000000
zheyou73v0_A07	11904710	11906135	BnaA07T0067300ZY	0	+	0	0	1425	0.0000000
zheyou73v0_A07	11909063	11909462	BnaA07T0067400ZY	0	+	0	0	399	0.0000000
zheyou73v0_A07	11915513	11916502	BnaA07T0067500ZY	0	+	0	0	989	0.0000000
zheyou73v0_A07	11917562	11918095	BnaA07T0067600ZY	0	-	0	0	533	0.0000000
zheyou73v0_A07	11927300	11927643	BnaA07T0067700ZY	0	-	0	0	343	0.0000000
zheyou73v0_A07	11927748	11928271	BnaA07T0067800ZY	0	+	0	0	523	0.0000000
zheyou73v0_A07	11928755	11937947	BnaA07T0067900ZY	0	+	0	0	9192	0.0000000
zheyou73v0_A07	11942269	11945877	BnaA07T0068000ZY	0	+	0	0	3608	0.0000000
zheyou73v0_A07	11956563	11959485	BnaA07T0068100ZY	0	-	0	0	2922	0.0000000
zheyou73v0_A07	11964760	11969952	BnaA07T0068200ZY	0	-	0	0	5192	0.0000000
zheyou73v0_A07	11970391	11972107	BnaA07T0068300ZY	0	+	0	0	1716	0.0000000
zheyou73v0_A07	12064643	12065676	BnaA07T0068400ZY	0	+	0	0	1033	0.0000000
zheyou73v0_A07	12072527	12072811	BnaA07T0068500ZY	0	+	0	0	284	0.0000000
zheyou73v0_A07	12075986	12077204	BnaA07T0068600ZY	0	+	0	0	1218	0.0000000
zheyou73v0_A07	12088968	12090641	BnaA07T0068700ZY	0	+	0	0	1673	0.0000000
zheyou73v0_A07	12092309	12093885	BnaA07T0068800ZY	0	+	0	0	1576	0.0000000
zheyou73v0_A07	12097618	12103315	BnaA07T0068900ZY	0	-	0	0	5697	0.0000000
zheyou73v0_A07	12106624	12107307	BnaA07T0069000ZY	0	+	0	0	683	0.0000000
zheyou73v0_A07	12108162	12109121	BnaA07T0069100ZY	0	+	0	0	959	0.0000000
zheyou73v0_A07	12117488	12118717	BnaA07T0069200ZY	0	+	0	0	1229	0.0000000
zheyou73v0_A07	12130418	12131516	BnaA07T0069300ZY	0	+	0	0	1098	0.0000000
zheyou73v0_A07	12131293	12134765	BnaA07T0069400ZY	0	-	0	0	3472	0.0000000
zheyou73v0_A07	12136977	12139500	BnaA07T0069500ZY	0	-	0	0	2523	0.0000000
zheyou73v0_A07	12140470	12142291	BnaA07T0069600ZY	0	+	0	0	1821	0.0000000
zheyou73v0_A07	12142374	12143293	BnaA07T0069700ZY	0	-	0	0	919	0.0000000
zheyou73v0_A07	12144099	12146015	BnaA07T0069800ZY	0	-	0	0	1916	0.0000000
zheyou73v0_A07	12150878	12158309	BnaA07T0069900ZY	0	+	0	0	7431	0.0000000
zheyou73v0_A07	12159242	12160699	BnaA07T0070000ZY	0	+	0	0	1457	0.0000000
zheyou73v0_A07	12161606	12170475	BnaA07T0070100ZY	0	+	0	0	8869	0.0000000
zheyou73v0_A07	12172847	12174547	BnaA07T0070200ZY	0	-	0	0	1700	0.0000000
zheyou73v0_A07	12172847	12174626	BnaA07T0070200ZY.1	0	-	0	0	1779	0.0000000
zheyou73v0_A07	12172847	12174626	BnaA07T0070200ZY.2	0	-	0	0	1779	0.0000000
zheyou73v0_A07	12172847	12174626	BnaA07T0070200ZY.3	0	-	0	0	1779	0.0000000
zheyou73v0_A07	12177124	12177676	BnaA07T0070300ZY	0	-	0	0	552	0.0000000
zheyou73v0_A07	12178764	12180421	BnaA07T0070400ZY	0	-	0	0	1657	0.0000000
zheyou73v0_A07	12183756	12185410	BnaA07T0070500ZY	0	-	0	0	1654	0.0000000
zheyou73v0_A07	12187869	12189643	BnaA07T0070600ZY	0	-	0	0	1774	0.0000000
zheyou73v0_A07	12190326	12192279	BnaA07T0070700ZY	0	-	0	0	1953	0.0000000
zheyou73v0_A07	12193198	12194808	BnaA07T0070800ZY	0	-	0	0	1610	0.0000000
zheyou73v0_A07	12197141	12199071	BnaA07T0070900ZY	0	-	0	0	1930	0.0000000
zheyou73v0_A07	12197839	12199071	BnaA07T0070900ZY.1	0	-	0	0	1232	0.0000000
zheyou73v0_A07	12207424	12207922	BnaA07T0071000ZY	0	+	0	0	498	0.0000000
zheyou73v0_A07	12209478	12212006	BnaA07T0071100ZY	0	+	0	0	2528	0.0000000
zheyou73v0_A07	12214491	12217903	BnaA07T0071200ZY	0	+	0	0	3412	0.0000000
zheyou73v0_A07	12218039	12226336	BnaA07T0071300ZY	0	-	0	0	8297	0.0000000
zheyou73v0_A07	12226561	12228447	BnaA07T0071400ZY	0	-	0	0	1886	0.0000000
zheyou73v0_A07	12232839	12233604	BnaA07T0071500ZY	0	+	0	0	765	0.0000000
zheyou73v0_A07	12245589	12248573	BnaA07T0071600ZY	0	-	0	0	2984	0.0000000
zheyou73v0_A07	12255627	12259690	BnaA07T0071700ZY	0	-	0	0	4063	0.0000000
zheyou73v0_A07	12265201	12266376	BnaA07T0071800ZY	0	-	0	0	1175	0.0000000
zheyou73v0_A07	12276640	12277353	BnaA07T0071900ZY	0	-	0	0	713	0.0000000
zheyou73v0_A07	12280476	12281367	BnaA07T0072000ZY	0	-	0	0	891	0.0000000
zheyou73v0_A07	12284534	12284902	BnaA07T0072100ZY	0	+	0	0	368	0.0000000
zheyou73v0_A07	12284944	12288044	BnaA07T0072200ZY	0	+	0	0	3100	0.0000000
zheyou73v0_A07	12288854	12289206	BnaA07T0072300ZY	0	+	0	0	352	0.0000000
zheyou73v0_A07	12302626	12308540	BnaA07T0072400ZY	0	+	0	0	5914	0.0000000
zheyou73v0_A07	12302626	12308540	BnaA07T0072400ZY.1	0	+	0	0	5914	0.0000000
zheyou73v0_A07	12302626	12308540	BnaA07T0072400ZY.2	0	+	0	0	5914	0.0000000
zheyou73v0_A07	12311401	12314020	BnaA07T0072500ZY	0	+	0	0	2619	0.0000000
zheyou73v0_A07	12330409	12331565	BnaA07T0072600ZY	0	+	0	0	1156	0.0000000
zheyou73v0_A07	12337733	12338635	BnaA07T0072700ZY	0	-	0	0	902	0.0000000
zheyou73v0_A07	12340995	12343122	BnaA07T0072800ZY	0	-	0	0	2127	0.0000000
zheyou73v0_A07	12351892	12353176	BnaA07T0072900ZY	0	-	0	0	1284	0.0000000
zheyou73v0_A07	12366046	12367060	BnaA07T0073000ZY	0	-	0	0	1014	0.0000000
zheyou73v0_A07	12370896	12371574	BnaA07T0073100ZY	0	+	0	0	678	0.0000000
zheyou73v0_A07	12377140	12379462	BnaA07T0073200ZY	0	+	0	0	2322	0.0000000
zheyou73v0_A07	12379828	12382828	BnaA07T0073300ZY	0	-	0	0	3000	0.0000000
zheyou73v0_A07	12379828	12382828	BnaA07T0073300ZY.1	0	-	0	0	3000	0.0000000
zheyou73v0_A07	12404078	12405740	BnaA07T0073400ZY	0	+	0	0	1662	0.0000000
zheyou73v0_A07	12406069	12407082	BnaA07T0073500ZY	0	-	0	0	1013	0.0000000
zheyou73v0_A07	12408240	12408696	BnaA07T0073600ZY	0	+	0	0	456	0.0000000
zheyou73v0_A07	12409166	12410006	BnaA07T0073700ZY	0	-	0	0	840	0.0000000
zheyou73v0_A07	12416178	12418943	BnaA07T0073800ZY	0	+	0	0	2765	0.0000000
zheyou73v0_A07	12416178	12418943	BnaA07T0073800ZY.1	0	+	0	0	2765	0.0000000
zheyou73v0_A07	12416652	12418943	BnaA07T0073800ZY.2	0	+	0	0	2291	0.0000000
zheyou73v0_A07	12418273	12418957	BnaA07T0073900ZY	0	-	0	0	684	0.0000000
zheyou73v0_A07	12439543	12441924	BnaA07T0074000ZY	0	+	0	0	2381	0.0000000
zheyou73v0_A07	12447587	12448867	BnaA07T0074100ZY	0	+	0	0	1280	0.0000000
zheyou73v0_A07	12449467	12452918	BnaA07T0074200ZY	0	-	0	0	3451	0.0000000
zheyou73v0_A07	12461753	12463026	BnaA07T0074300ZY	0	-	0	0	1273	0.0000000
zheyou73v0_A07	12471619	12472205	BnaA07T0074400ZY	0	-	0	0	586	0.0000000
zheyou73v0_A07	12473113	12478303	BnaA07T0074500ZY	0	+	0	0	5190	0.0000000
zheyou73v0_A07	12473113	12477045	BnaA07T0074500ZY.1	0	+	0	0	3932	0.0000000
zheyou73v0_A07	12478763	12480009	BnaA07T0074600ZY	0	+	0	0	1246	0.0000000
zheyou73v0_A07	12480363	12480852	BnaA07T0074700ZY	0	-	0	0	489	0.0000000
zheyou73v0_A07	12506819	12509116	BnaA07T0074800ZY	0	+	0	0	2297	0.0000000
zheyou73v0_A07	12512901	12513084	BnaA07T0074900ZY	0	+	0	0	183	0.0000000
zheyou73v0_A07	12515268	12516344	BnaA07T0075000ZY	0	+	0	0	1076	0.0000000
zheyou73v0_A07	12517057	12518582	BnaA07T0075100ZY	0	+	0	0	1525	0.0000000
zheyou73v0_A07	12518685	12519720	BnaA07T0075200ZY	0	-	0	0	1035	0.0000000
zheyou73v0_A07	12551921	12554246	BnaA07T0075300ZY	0	+	0	0	2325	0.0000000
zheyou73v0_A07	12555336	12558587	BnaA07T0075400ZY	0	-	0	0	3251	0.0000000
zheyou73v0_A07	12578283	12578442	BnaA07T0075500ZY	0	+	0	0	159	0.0000000
zheyou73v0_A07	12589891	12591661	BnaA07T0075600ZY	0	-	0	0	1770	0.0000000
zheyou73v0_A07	12592827	12597049	BnaA07T0075700ZY	0	-	0	0	4222	0.0000000
zheyou73v0_A07	12610244	12610607	BnaA07T0075800ZY	0	+	0	0	363	0.0000000
zheyou73v0_A07	12615613	12617263	BnaA07T0075900ZY	0	+	0	0	1650	0.0000000
zheyou73v0_A07	12617673	12619060	BnaA07T0076000ZY	0	-	0	0	1387	0.0000000
zheyou73v0_A07	12630991	12634738	BnaA07T0076100ZY	0	+	0	0	3747	0.0000000
zheyou73v0_A07	12635392	12637201	BnaA07T0076200ZY	0	+	0	0	1809	0.0000000
zheyou73v0_A07	12639890	12642723	BnaA07T0076300ZY	0	+	0	0	2833	0.0000000
zheyou73v0_A07	12645723	12648687	BnaA07T0076400ZY	0	-	0	0	2964	0.0000000
zheyou73v0_A07	12660363	12661834	BnaA07T0076500ZY	0	+	0	0	1471	0.0000000
zheyou73v0_A07	12662365	12663913	BnaA07T0076600ZY	0	+	0	0	1548	0.0000000
zheyou73v0_A07	12664424	12666370	BnaA07T0076700ZY	0	-	0	0	1946	0.0000000
zheyou73v0_A07	12664424	12666247	BnaA07T0076700ZY.1	0	-	0	0	1823	0.0000000
zheyou73v0_A07	12669336	12669910	BnaA07T0076800ZY	0	+	0	0	574	0.0000000
zheyou73v0_A07	12670873	12671724	BnaA07T0076900ZY	0	-	0	0	851	0.0000000
zheyou73v0_A07	12675161	12677338	BnaA07T0077000ZY	0	-	0	0	2177	0.0000000
zheyou73v0_A07	12701991	12702837	BnaA07T0077100ZY	0	-	0	0	846	0.0000000
zheyou73v0_A07	12705573	12706907	BnaA07T0077200ZY	0	+	0	0	1334	0.0000000
zheyou73v0_A07	12713471	12714428	BnaA07T0077300ZY	0	-	0	0	957	0.0000000
zheyou73v0_A07	12717215	12718893	BnaA07T0077400ZY	0	-	0	0	1678	0.0000000
zheyou73v0_A07	12721501	12723795	BnaA07T0077500ZY	0	+	0	0	2294	0.0000000
zheyou73v0_A07	12735173	12736477	BnaA07T0077600ZY	0	+	0	0	1304	0.0000000
zheyou73v0_A07	12736842	12738557	BnaA07T0077700ZY	0	-	0	0	1715	0.0000000
zheyou73v0_A07	12740929	12741827	BnaA07T0077800ZY	0	-	0	0	898	0.0000000
zheyou73v0_A07	12745671	12748527	BnaA07T0077900ZY	0	+	0	0	2856	0.0000000
zheyou73v0_A07	12757768	12760904	BnaA07T0078000ZY	0	+	0	0	3136	0.0000000
zheyou73v0_A07	12767345	12768218	BnaA07T0078100ZY	0	+	0	0	873	0.0000000
zheyou73v0_A07	12783300	12784191	BnaA07T0078200ZY	0	-	0	0	891	0.0000000
zheyou73v0_A07	12786921	12788322	BnaA07T0078300ZY	0	-	0	0	1401	0.0000000
zheyou73v0_A07	12790542	12792300	BnaA07T0078400ZY	0	+	0	0	1758	0.0000000
zheyou73v0_A07	12793081	12793522	BnaA07T0078500ZY	0	+	0	0	441	0.0000000
zheyou73v0_A07	12799043	12801312	BnaA07T0078600ZY	0	+	0	0	2269	0.0000000
zheyou73v0_A07	12808156	12810018	BnaA07T0078700ZY	0	+	0	0	1862	0.0000000
zheyou73v0_A07	12817014	12818802	BnaA07T0078800ZY	0	+	0	0	1788	0.0000000
zheyou73v0_A07	12830304	12830973	BnaA07T0078900ZY	0	-	0	0	669	0.0000000
zheyou73v0_A07	12890722	12891271	BnaA07T0079000ZY	0	+	0	0	549	0.0000000
zheyou73v0_A07	12891849	12893744	BnaA07T0079100ZY	0	+	0	0	1895	0.0000000
zheyou73v0_A07	12891849	12893744	BnaA07T0079100ZY.1	0	+	0	0	1895	0.0000000
zheyou73v0_A07	12891849	12893744	BnaA07T0079100ZY.2	0	+	0	0	1895	0.0000000
zheyou73v0_A07	12891849	12893744	BnaA07T0079100ZY.3	0	+	0	0	1895	0.0000000
zheyou73v0_A07	12896232	12898976	BnaA07T0079200ZY	0	-	0	0	2744	0.0000000
zheyou73v0_A07	12896232	12898976	BnaA07T0079200ZY.1	0	-	0	0	2744	0.0000000
zheyou73v0_A07	12899380	12900053	BnaA07T0079300ZY	0	-	0	0	673	0.0000000
zheyou73v0_A07	12900414	12902074	BnaA07T0079400ZY	0	-	0	0	1660	0.0000000
zheyou73v0_A07	12903731	12904580	BnaA07T0079500ZY	0	-	0	0	849	0.0000000
zheyou73v0_A07	12907403	12909986	BnaA07T0079600ZY	0	-	0	0	2583	0.0000000
zheyou73v0_A07	12910730	12912152	BnaA07T0079700ZY	0	-	0	0	1422	0.0000000
zheyou73v0_A07	12910730	12912152	BnaA07T0079700ZY.1	0	-	0	0	1422	0.0000000
zheyou73v0_A07	12913121	12918906	BnaA07T0079800ZY	0	-	0	0	5785	0.0000000
zheyou73v0_A07	12921665	12921932	BnaA07T0079900ZY	0	-	0	0	267	0.0000000
zheyou73v0_A07	12928694	12931159	BnaA07T0080000ZY	0	-	0	0	2465	0.0000000
zheyou73v0_A07	12931868	12932284	BnaA07T0080100ZY	0	+	0	0	416	0.0000000
zheyou73v0_A07	12939311	12940452	BnaA07T0080200ZY	0	-	0	0	1141	0.0000000
zheyou73v0_A07	12942716	12943174	BnaA07T0080300ZY	0	-	0	0	458	0.0000000
zheyou73v0_A07	12954760	12955319	BnaA07T0080400ZY	0	+	0	0	559	0.0000000
zheyou73v0_A07	12963092	12963302	BnaA07T0080500ZY	0	+	0	0	210	0.0000000
zheyou73v0_A07	12976775	12976943	BnaA07T0080600ZY	0	+	0	0	168	0.0000000
zheyou73v0_A07	12990538	12991251	BnaA07T0080700ZY	0	+	0	0	713	0.0000000
zheyou73v0_A07	13011977	13014046	BnaA07T0080800ZY	0	-	0	0	2069	0.0000000
zheyou73v0_A07	13021469	13024038	BnaA07T0080900ZY	0	+	0	0	2569	0.0000000
zheyou73v0_A07	13027983	13030594	BnaA07T0081000ZY	0	-	0	0	2611	0.0000000
zheyou73v0_A07	13045775	13046561	BnaA07T0081100ZY	0	-	0	0	786	0.0000000
zheyou73v0_A07	13050494	13050758	BnaA07T0081200ZY	0	+	0	0	264	0.0000000
zheyou73v0_A07	13059898	13060603	BnaA07T0081300ZY	0	+	0	0	705	0.0000000
zheyou73v0_A07	13062065	13063708	BnaA07T0081400ZY	0	+	0	0	1643	0.0000000
zheyou73v0_A07	13062065	13063708	BnaA07T0081400ZY.1	0	+	0	0	1643	0.0000000
zheyou73v0_A07	13109526	13110949	BnaA07T0081500ZY	0	+	0	0	1423	0.0000000
zheyou73v0_A07	13112610	13114013	BnaA07T0081600ZY	0	+	0	0	1403	0.0000000
zheyou73v0_A07	13116534	13117816	BnaA07T0081700ZY	0	+	0	0	1282	0.0000000
zheyou73v0_A07	13118492	13119968	BnaA07T0081800ZY	0	-	0	0	1476	0.0000000
zheyou73v0_A07	13120313	13123504	BnaA07T0081900ZY	0	+	0	0	3191	0.0000000
zheyou73v0_A07	13129225	13130125	BnaA07T0082000ZY	0	-	0	0	900	0.0000000
zheyou73v0_A07	13140009	13140969	BnaA07T0082100ZY	0	-	0	0	960	0.0000000
zheyou73v0_A07	13147920	13148973	BnaA07T0082200ZY	0	-	0	0	1053	0.0000000
zheyou73v0_A07	13164185	13165770	BnaA07T0082300ZY	0	+	0	0	1585	0.0000000
zheyou73v0_A07	13192624	13194158	BnaA07T0082400ZY	0	+	0	0	1534	0.0000000
zheyou73v0_A07	13202269	13205332	BnaA07T0082500ZY	0	+	0	0	3063	0.0000000
zheyou73v0_A07	13207729	13208662	BnaA07T0082600ZY	0	-	0	0	933	0.0000000
zheyou73v0_A07	13219741	13220494	BnaA07T0082700ZY	0	+	0	0	753	0.0000000
zheyou73v0_A07	13221853	13224049	BnaA07T0082800ZY	0	+	0	0	2196	0.0000000
zheyou73v0_A07	13226357	13228388	BnaA07T0082900ZY	0	+	0	0	2031	0.0000000
zheyou73v0_A07	13228747	13230210	BnaA07T0083000ZY	0	-	0	0	1463	0.0000000
zheyou73v0_A07	13234413	13235198	BnaA07T0083100ZY	0	-	0	0	785	0.0000000
zheyou73v0_A07	13242155	13246282	BnaA07T0083200ZY	0	-	0	0	4127	0.0000000
zheyou73v0_A07	13242155	13246282	BnaA07T0083200ZY.1	0	-	0	0	4127	0.0000000
zheyou73v0_A07	13246552	13248614	BnaA07T0083300ZY	0	+	0	0	2062	0.0000000
zheyou73v0_A07	13246552	13248614	BnaA07T0083300ZY.1	0	+	0	0	2062	0.0000000
zheyou73v0_A07	13248234	13253024	BnaA07T0083400ZY	0	-	0	0	4790	0.0000000
zheyou73v0_A07	13248234	13253024	BnaA07T0083400ZY.1	0	-	0	0	4790	0.0000000
zheyou73v0_A07	13259866	13261898	BnaA07T0083500ZY	0	-	0	0	2032	0.0000000
zheyou73v0_A07	13262948	13264817	BnaA07T0083600ZY	0	-	0	0	1869	0.0000000
zheyou73v0_A07	13272298	13275385	BnaA07T0083700ZY	0	+	0	0	3087	0.0000000
zheyou73v0_A07	13275615	13276835	BnaA07T0083800ZY	0	+	0	0	1220	0.0000000
zheyou73v0_A07	13282448	13283798	BnaA07T0083900ZY	0	+	0	0	1350	0.0000000
zheyou73v0_A07	13284115	13287126	BnaA07T0084000ZY	0	-	0	0	3011	0.0000000
zheyou73v0_A07	13291144	13292068	BnaA07T0084100ZY	0	+	0	0	924	0.0000000
zheyou73v0_A07	13293733	13303090	BnaA07T0084200ZY	0	-	0	0	9357	0.0000000
zheyou73v0_A07	13311848	13312889	BnaA07T0084300ZY	0	+	0	0	1041	0.0000000
zheyou73v0_A07	13313290	13313786	BnaA07T0084400ZY	0	-	0	0	496	0.0000000
zheyou73v0_A07	13314057	13315629	BnaA07T0084500ZY	0	+	0	0	1572	0.0000000
zheyou73v0_A07	13317294	13317537	BnaA07T0084600ZY	0	+	0	0	243	0.0000000
zheyou73v0_A07	13321915	13324657	BnaA07T0084700ZY	0	+	0	0	2742	0.0000000
zheyou73v0_A07	13327338	13330215	BnaA07T0084800ZY	0	+	0	0	2877	0.0000000
zheyou73v0_A07	13331330	13331883	BnaA07T0084900ZY	0	-	0	0	553	0.0000000
zheyou73v0_A07	13333957	13334161	BnaA07T0085000ZY	0	-	0	0	204	0.0000000
zheyou73v0_A07	13336981	13337861	BnaA07T0085100ZY	0	+	0	0	880	0.0000000
zheyou73v0_A07	13340619	13341442	BnaA07T0085200ZY	0	+	0	0	823	0.0000000
zheyou73v0_A07	13341940	13354647	BnaA07T0085300ZY	0	+	0	0	12707	0.0000000
zheyou73v0_A07	13363492	13364862	BnaA07T0085400ZY	0	+	0	0	1370	0.0000000
zheyou73v0_A07	13365728	13366662	BnaA07T0085500ZY	0	+	0	0	934	0.0000000
zheyou73v0_A07	13367343	13368558	BnaA07T0085600ZY	0	-	0	0	1215	0.0000000
zheyou73v0_A07	13369540	13371219	BnaA07T0085700ZY	0	+	0	0	1679	0.0000000
zheyou73v0_A07	13371555	13378294	BnaA07T0085800ZY	0	-	0	0	6739	0.0000000
zheyou73v0_A07	13379455	13384162	BnaA07T0085900ZY	0	+	0	0	4707	0.0000000
zheyou73v0_A07	13396335	13406514	BnaA07T0086000ZY	0	+	0	0	10179	0.0000000
zheyou73v0_A07	13407639	13407899	BnaA07T0086100ZY	0	+	0	0	260	0.0000000
zheyou73v0_A07	13408430	13412674	BnaA07T0086200ZY	0	+	0	0	4244	0.0000000
zheyou73v0_A07	13412776	13413337	BnaA07T0086300ZY	0	-	0	0	561	0.0000000
zheyou73v0_A07	13416098	13416585	BnaA07T0086400ZY	0	+	0	0	487	0.0000000
zheyou73v0_A07	13416999	13417356	BnaA07T0086500ZY	0	+	0	0	357	0.0000000
zheyou73v0_A07	13417455	13418025	BnaA07T0086600ZY	0	-	0	0	570	0.0000000
zheyou73v0_A07	13418680	13420729	BnaA07T0086700ZY	0	+	0	0	2049	0.0000000
zheyou73v0_A07	13420830	13421380	BnaA07T0086800ZY	0	-	0	0	550	0.0000000
zheyou73v0_A07	13429996	13431423	BnaA07T0086900ZY	0	-	0	0	1427	0.0000000
zheyou73v0_A07	13440335	13443646	BnaA07T0087000ZY	0	-	0	0	3311	0.0000000
zheyou73v0_A07	13458262	13459294	BnaA07T0087100ZY	0	+	0	0	1032	0.0000000
zheyou73v0_A07	13465962	13467053	BnaA07T0087200ZY	0	-	0	0	1091	0.0000000
zheyou73v0_A07	13468141	13470535	BnaA07T0087300ZY	0	+	0	0	2394	0.0000000
zheyou73v0_A07	13479127	13479459	BnaA07T0087400ZY	0	-	0	0	332	0.0000000
zheyou73v0_A07	13484494	13486203	BnaA07T0087500ZY	0	+	0	0	1709	0.0000000
zheyou73v0_A07	13487760	13490429	BnaA07T0087600ZY	0	+	0	0	2669	0.0000000
zheyou73v0_A07	13490642	13491642	BnaA07T0087700ZY	0	-	0	0	1000	0.0000000
zheyou73v0_A07	13507772	13509517	BnaA07T0087800ZY	0	+	0	0	1745	0.0000000
zheyou73v0_A07	13513586	13515257	BnaA07T0087900ZY	0	+	0	0	1671	0.0000000
zheyou73v0_A07	13520712	13524081	BnaA07T0088000ZY	0	+	0	0	3369	0.0000000
zheyou73v0_A07	13530377	13534238	BnaA07T0088100ZY	0	-	0	0	3861	0.0000000
zheyou73v0_A07	13562581	13563458	BnaA07T0088200ZY	0	+	0	0	877	0.0000000
zheyou73v0_A07	13570248	13570611	BnaA07T0088300ZY	0	-	0	0	363	0.0000000
zheyou73v0_A07	13578601	13579512	BnaA07T0088400ZY	0	+	0	0	911	0.0000000
zheyou73v0_A07	13604951	13607379	BnaA07T0088500ZY	0	+	0	0	2428	0.0000000
zheyou73v0_A07	13615884	13617142	BnaA07T0088600ZY	0	+	0	0	1258	0.0000000
zheyou73v0_A07	13621971	13622662	BnaA07T0088700ZY	0	-	0	0	691	0.0000000
zheyou73v0_A07	13632073	13640841	BnaA07T0088800ZY	0	+	0	0	8768	0.0000000
zheyou73v0_A07	13643692	13651097	BnaA07T0088900ZY	0	+	0	0	7405	0.0000000
zheyou73v0_A07	13643692	13650679	BnaA07T0088900ZY.1	0	+	0	0	6987	0.0000000
zheyou73v0_A07	13654164	13655569	BnaA07T0089000ZY	0	-	0	0	1405	0.0000000
zheyou73v0_A07	13657025	13659999	BnaA07T0089100ZY	0	-	0	0	2974	0.0000000
zheyou73v0_A07	13670750	13675275	BnaA07T0089200ZY	0	+	0	0	4525	0.0000000
zheyou73v0_A07	13676301	13677600	BnaA07T0089300ZY	0	-	0	0	1299	0.0000000
zheyou73v0_A07	13678143	13679847	BnaA07T0089400ZY	0	+	0	0	1704	0.0000000
zheyou73v0_A07	13680752	13686118	BnaA07T0089500ZY	0	+	0	0	5366	0.0000000
zheyou73v0_A07	13696261	13697713	BnaA07T0089600ZY	0	+	0	0	1452	0.0000000
zheyou73v0_A07	13699261	13703609	BnaA07T0089700ZY	0	-	0	0	4348	0.0000000
zheyou73v0_A07	13706106	13707174	BnaA07T0089800ZY	0	-	0	0	1068	0.0000000
zheyou73v0_A07	13708639	13711883	BnaA07T0089900ZY	0	-	0	0	3244	0.0000000
zheyou73v0_A07	13708639	13711883	BnaA07T0089900ZY.2	0	-	0	0	3244	0.0000000
zheyou73v0_A07	13709184	13711883	BnaA07T0089900ZY.1	0	-	0	0	2699	0.0000000
zheyou73v0_A07	13726822	13729438	BnaA07T0090000ZY	0	+	0	0	2616	0.0000000
zheyou73v0_A07	13736826	13738393	BnaA07T0090100ZY	0	-	0	0	1567	0.0000000
zheyou73v0_A07	13742465	13743746	BnaA07T0090200ZY	0	+	0	0	1281	0.0000000
zheyou73v0_A07	13745827	13747061	BnaA07T0090300ZY	0	+	0	0	1234	0.0000000
zheyou73v0_A07	13758249	13758887	BnaA07T0090400ZY	0	+	0	0	638	0.0000000
zheyou73v0_A07	13763756	13764358	BnaA07T0090500ZY	0	+	0	0	602	0.0000000
zheyou73v0_A07	13765021	13767847	BnaA07T0090600ZY	0	-	0	0	2826	0.0000000
zheyou73v0_A07	13787381	13788494	BnaA07T0090700ZY	0	+	0	0	1113	0.0000000
zheyou73v0_A07	13789584	13792555	BnaA07T0090800ZY	0	-	0	0	2971	0.0000000
zheyou73v0_A07	13792957	13795389	BnaA07T0090900ZY	0	-	0	0	2432	0.0000000
zheyou73v0_A07	13810035	13824206	BnaA07T0091000ZY	0	+	0	0	14171	0.0000000
zheyou73v0_A07	13829288	13830939	BnaA07T0091100ZY	0	+	0	0	1651	0.0000000
zheyou73v0_A07	13833142	13834781	BnaA07T0091200ZY	0	+	0	0	1639	0.0000000
zheyou73v0_A07	13836937	13838614	BnaA07T0091300ZY	0	+	0	0	1677	0.0000000
zheyou73v0_A07	13838764	13839655	BnaA07T0091400ZY	0	-	0	0	891	0.0000000
zheyou73v0_A07	13862194	13867016	BnaA07T0091500ZY	0	+	0	0	4822	0.0000000
zheyou73v0_A07	13867264	13867744	BnaA07T0091600ZY	0	+	0	0	480	0.0000000
zheyou73v0_A07	13871148	13872578	BnaA07T0091700ZY	0	-	0	0	1430	0.0000000
zheyou73v0_A07	13878395	13880297	BnaA07T0091800ZY	0	+	0	0	1902	0.0000000
zheyou73v0_A07	13880934	13894623	BnaA07T0091900ZY	0	+	0	0	13689	0.0000000
zheyou73v0_A07	13896416	13897994	BnaA07T0092000ZY	0	-	0	0	1578	0.0000000
zheyou73v0_A07	13898626	13900554	BnaA07T0092100ZY	0	+	0	0	1928	0.0000000
zheyou73v0_A07	13900976	13901994	BnaA07T0092200ZY	0	-	0	0	1018	0.0000000
zheyou73v0_A07	13912743	13915656	BnaA07T0092300ZY	0	+	0	0	2913	0.0000000
zheyou73v0_A07	13924550	13925358	BnaA07T0092400ZY	0	+	0	0	808	0.0000000
zheyou73v0_A07	13935474	13938139	BnaA07T0092500ZY	0	+	0	0	2665	0.0000000
zheyou73v0_A07	13935474	13938139	BnaA07T0092500ZY.1	0	+	0	0	2665	0.0000000
zheyou73v0_A07	13938727	13940445	BnaA07T0092600ZY	0	+	0	0	1718	0.0000000
zheyou73v0_A07	13940479	13942134	BnaA07T0092700ZY	0	+	0	0	1655	0.0000000
zheyou73v0_A07	13942782	13944129	BnaA07T0092800ZY	0	+	0	0	1347	0.0000000
zheyou73v0_A07	13944123	13946329	BnaA07T0092900ZY	0	-	0	0	2206	0.0000000
zheyou73v0_A07	13950696	13951910	BnaA07T0093000ZY	0	+	0	0	1214	0.0000000
zheyou73v0_A07	13952486	13953489	BnaA07T0093100ZY	0	+	0	0	1003	0.0000000
zheyou73v0_A07	13953692	13954241	BnaA07T0093200ZY	0	-	0	0	549	0.0000000
zheyou73v0_A07	13962314	13963589	BnaA07T0093300ZY	0	-	0	0	1275	0.0000000
zheyou73v0_A07	13970973	13971816	BnaA07T0093400ZY	0	-	0	0	843	0.0000000
zheyou73v0_A07	13974897	13975557	BnaA07T0093500ZY	0	-	0	0	660	0.0000000
zheyou73v0_A07	13988398	13991669	BnaA07T0093600ZY	0	+	0	0	3271	0.0000000
zheyou73v0_A07	13993811	13995303	BnaA07T0093700ZY	0	-	0	0	1492	0.0000000
zheyou73v0_A07	14003687	14004237	BnaA07T0093800ZY	0	+	0	0	550	0.0000000
zheyou73v0_A07	14005497	14006604	BnaA07T0093900ZY	0	+	0	0	1107	0.0000000
zheyou73v0_A07	14007012	14007608	BnaA07T0094000ZY	0	-	0	0	596	0.0000000
zheyou73v0_A07	14008390	14009623	BnaA07T0094100ZY	0	-	0	0	1233	0.0000000
zheyou73v0_A07	14015621	14016284	BnaA07T0094200ZY	0	+	0	0	663	0.0000000
zheyou73v0_A07	14016650	14018234	BnaA07T0094300ZY	0	-	0	0	1584	0.0000000
zheyou73v0_A07	14018903	14021451	BnaA07T0094400ZY	0	-	0	0	2548	0.0000000
zheyou73v0_A07	14024822	14028461	BnaA07T0094500ZY	0	+	0	0	3639	0.0000000
zheyou73v0_A07	14029884	14030415	BnaA07T0094600ZY	0	+	0	0	531	0.0000000
zheyou73v0_A07	14030426	14032826	BnaA07T0094700ZY	0	+	0	0	2400	0.0000000
zheyou73v0_A07	14033227	14035342	BnaA07T0094800ZY	0	-	0	0	2115	0.0000000
zheyou73v0_A07	14033227	14035342	BnaA07T0094800ZY.1	0	-	0	0	2115	0.0000000
zheyou73v0_A07	14033227	14035342	BnaA07T0094800ZY.2	0	-	0	0	2115	0.0000000
zheyou73v0_A07	14037832	14040364	BnaA07T0094900ZY	0	-	0	0	2532	0.0000000
zheyou73v0_A07	14046197	14047749	BnaA07T0095000ZY	0	+	0	0	1552	0.0000000
zheyou73v0_A07	14046197	14047173	BnaA07T0095000ZY.1	0	+	0	0	976	0.0000000
zheyou73v0_A07	14048152	14051323	BnaA07T0095100ZY	0	+	0	0	3171	0.0000000
zheyou73v0_A07	14052028	14052313	BnaA07T0095200ZY	0	+	0	0	285	0.0000000
zheyou73v0_A07	14052637	14054939	BnaA07T0095300ZY	0	-	0	0	2302	0.0000000
zheyou73v0_A07	14061216	14061630	BnaA07T0095400ZY	0	-	0	0	414	0.0000000
zheyou73v0_A07	14064962	14065494	BnaA07T0095500ZY	0	-	0	0	532	0.0000000
zheyou73v0_A07	14071767	14072073	BnaA07T0095600ZY	0	-	0	0	306	0.0000000
zheyou73v0_A07	14079773	14080076	BnaA07T0095700ZY	0	-	0	0	303	0.0000000
zheyou73v0_A07	14081504	14084921	BnaA07T0095800ZY	0	-	0	0	3417	0.0000000
zheyou73v0_A07	14082236	14084921	BnaA07T0095800ZY.1	0	-	0	0	2685	0.0000000
zheyou73v0_A07	14088752	14089595	BnaA07T0095900ZY	0	-	0	0	843	0.0000000
zheyou73v0_A07	14100412	14103180	BnaA07T0096000ZY	0	-	0	0	2768	0.0000000
zheyou73v0_A07	14103793	14104534	BnaA07T0096100ZY	0	-	0	0	741	0.0000000
zheyou73v0_A07	14105422	14107751	BnaA07T0096200ZY	0	-	0	0	2329	0.0000000
zheyou73v0_A07	14117983	14118289	BnaA07T0096300ZY	0	+	0	0	306	0.0000000
zheyou73v0_A07	14120432	14123858	BnaA07T0096400ZY	0	-	0	0	3426	0.0000000
zheyou73v0_A07	14124829	14128649	BnaA07T0096500ZY	0	-	0	0	3820	0.0000000
zheyou73v0_A07	14129710	14130973	BnaA07T0096600ZY	0	-	0	0	1263	0.0000000
zheyou73v0_A07	14131224	14133212	BnaA07T0096700ZY	0	-	0	0	1988	0.0000000
zheyou73v0_A07	14134091	14135520	BnaA07T0096800ZY	0	-	0	0	1429	0.0000000
zheyou73v0_A07	14136623	14138082	BnaA07T0096900ZY	0	+	0	0	1459	0.0000000
zheyou73v0_A07	14138319	14139973	BnaA07T0097000ZY	0	-	0	0	1654	0.0000000
zheyou73v0_A07	14142769	14146364	BnaA07T0097100ZY	0	-	0	0	3595	0.0000000
zheyou73v0_A07	14154397	14154927	BnaA07T0097200ZY	0	-	0	0	530	0.0000000
zheyou73v0_A07	14173423	14175051	BnaA07T0097300ZY	0	-	0	0	1628	0.0000000
zheyou73v0_A07	14179383	14181898	BnaA07T0097400ZY	0	+	0	0	2515	0.0000000
zheyou73v0_A07	14183132	14184305	BnaA07T0097500ZY	0	+	0	0	1173	0.0000000
zheyou73v0_A07	14192139	14192807	BnaA07T0097600ZY	0	+	0	0	668	0.0000000
zheyou73v0_A07	14193486	14198672	BnaA07T0097700ZY	0	-	0	0	5186	0.0000000
zheyou73v0_A07	14200518	14202969	BnaA07T0097800ZY	0	+	0	0	2451	0.0000000
zheyou73v0_A07	14214998	14219590	BnaA07T0097900ZY	0	+	0	0	4592	0.0000000
zheyou73v0_A07	14215804	14219590	BnaA07T0097900ZY.1	0	+	0	0	3786	0.0000000
zheyou73v0_A07	14217063	14219671	BnaA07T0097900ZY.2	0	+	0	0	2608	0.0000000
zheyou73v0_A07	14220489	14220948	BnaA07T0098000ZY	0	-	0	0	459	0.0000000
zheyou73v0_A07	14223398	14224868	BnaA07T0098100ZY	0	-	0	0	1470	0.0000000
zheyou73v0_A07	14227659	14230527	BnaA07T0098200ZY	0	-	0	0	2868	0.0000000
zheyou73v0_A07	14233037	14234629	BnaA07T0098300ZY	0	+	0	0	1592	0.0000000
zheyou73v0_A07	14235314	14236659	BnaA07T0098400ZY	0	-	0	0	1345	0.0000000
zheyou73v0_A07	14235314	14236659	BnaA07T0098400ZY.1	0	-	0	0	1345	0.0000000
zheyou73v0_A07	14235314	14236659	BnaA07T0098400ZY.2	0	-	0	0	1345	0.0000000
zheyou73v0_A07	14235314	14236659	BnaA07T0098400ZY.3	0	-	0	0	1345	0.0000000
zheyou73v0_A07	14239998	14240818	BnaA07T0098500ZY	0	+	0	0	820	0.0000000
zheyou73v0_A07	14241886	14244635	BnaA07T0098600ZY	0	+	0	0	2749	0.0000000
zheyou73v0_A07	14245420	14248772	BnaA07T0098700ZY	0	+	0	0	3352	0.0000000
zheyou73v0_A07	14247252	14249118	BnaA07T0098800ZY	0	-	0	0	1866	0.0000000
zheyou73v0_A07	14251280	14253030	BnaA07T0098900ZY	0	+	0	0	1750	0.0000000
zheyou73v0_A07	14253086	14255503	BnaA07T0099000ZY	0	+	0	0	2417	0.0000000
zheyou73v0_A07	14256239	14258438	BnaA07T0099100ZY	0	+	0	0	2199	0.0000000
zheyou73v0_A07	14259371	14263675	BnaA07T0099200ZY	0	+	0	0	4304	0.0000000
zheyou73v0_A07	14267065	14268131	BnaA07T0099300ZY	0	-	0	0	1066	0.0000000
zheyou73v0_A07	14276327	14277096	BnaA07T0099400ZY	0	+	0	0	769	0.0000000
zheyou73v0_A07	14283421	14286613	BnaA07T0099500ZY	0	+	0	0	3192	0.0000000
zheyou73v0_A07	14283421	14286613	BnaA07T0099500ZY.1	0	+	0	0	3192	0.0000000
zheyou73v0_A07	14286875	14291711	BnaA07T0099600ZY	0	-	0	0	4836	0.0000000
zheyou73v0_A07	14296081	14297188	BnaA07T0099700ZY	0	+	0	0	1107	0.0000000
zheyou73v0_A07	14297235	14298572	BnaA07T0099800ZY	0	-	0	0	1337	0.0000000
zheyou73v0_A07	14298917	14299679	BnaA07T0099900ZY	0	-	0	0	762	0.0000000
zheyou73v0_A07	14303536	14307985	BnaA07T0100000ZY	0	-	0	0	4449	0.0000000
zheyou73v0_A07	14303536	14307985	BnaA07T0100000ZY.1	0	-	0	0	4449	0.0000000
zheyou73v0_A07	14319892	14321877	BnaA07T0100100ZY	0	-	0	0	1985	0.0000000
zheyou73v0_A07	14335293	14337165	BnaA07T0100200ZY	0	+	0	0	1872	0.0000000
zheyou73v0_A07	14337802	14341077	BnaA07T0100300ZY	0	+	0	0	3275	0.0000000
zheyou73v0_A07	14347686	14348046	BnaA07T0100400ZY	0	+	0	0	360	0.0000000
zheyou73v0_A07	14350667	14354053	BnaA07T0100500ZY	0	+	0	0	3386	0.0000000
zheyou73v0_A07	14356562	14357742	BnaA07T0100600ZY	0	-	0	0	1180	0.0000000
zheyou73v0_A07	14356562	14357742	BnaA07T0100600ZY.1	0	-	0	0	1180	0.0000000
zheyou73v0_A07	14358171	14360134	BnaA07T0100700ZY	0	-	0	0	1963	0.0000000
zheyou73v0_A07	14365445	14366851	BnaA07T0100800ZY	0	+	0	0	1406	0.0000000
zheyou73v0_A07	14370126	14382742	BnaA07T0100900ZY	0	-	0	0	12616	0.0000000
zheyou73v0_A07	14387312	14393326	BnaA07T0101000ZY	0	-	0	0	6014	0.0000000
zheyou73v0_A07	14401350	14401740	BnaA07T0101100ZY	0	-	0	0	390	0.0000000
zheyou73v0_A07	14432587	14435086	BnaA07T0101200ZY	0	+	0	0	2499	0.0000000
zheyou73v0_A07	14453305	14454797	BnaA07T0101300ZY	0	+	0	0	1492	0.0000000
zheyou73v0_A07	14485012	14489339	BnaA07T0101400ZY	0	+	0	0	4327	0.0000000
zheyou73v0_A07	14493087	14496377	BnaA07T0101500ZY	0	+	0	0	3290	0.0000000
zheyou73v0_A07	14506429	14509128	BnaA07T0101600ZY	0	-	0	0	2699	0.0000000
zheyou73v0_A07	14516257	14518666	BnaA07T0101700ZY	0	-	0	0	2409	0.0000000
zheyou73v0_A07	14520032	14522308	BnaA07T0101800ZY	0	-	0	0	2276	0.0000000
zheyou73v0_A07	14523458	14534567	BnaA07T0101900ZY	0	-	0	0	11109	0.0000000
zheyou73v0_A07	14535749	14538037	BnaA07T0102000ZY	0	-	0	0	2288	0.0000000
zheyou73v0_A07	14551854	14552643	BnaA07T0102100ZY	0	-	0	0	789	0.0000000
zheyou73v0_A07	14554859	14556163	BnaA07T0102200ZY	0	-	0	0	1304	0.0000000
zheyou73v0_A07	14556675	14559101	BnaA07T0102300ZY	0	-	0	0	2426	0.0000000
zheyou73v0_A07	14556675	14559101	BnaA07T0102300ZY.1	0	-	0	0	2426	0.0000000
zheyou73v0_A07	14559893	14561843	BnaA07T0102400ZY	0	-	0	0	1950	0.0000000
zheyou73v0_A07	14563978	14567464	BnaA07T0102500ZY	0	-	0	0	3486	0.0000000
zheyou73v0_A07	14574265	14577759	BnaA07T0102600ZY	0	+	0	0	3494	0.0000000
zheyou73v0_A07	14578167	14582247	BnaA07T0102700ZY	0	-	0	0	4080	0.0000000
zheyou73v0_A07	14584330	14587830	BnaA07T0102800ZY	0	+	0	0	3500	0.0000000
zheyou73v0_A07	14589362	14591937	BnaA07T0102900ZY	0	+	0	0	2575	0.0000000
zheyou73v0_A07	14592661	14592817	BnaA07T0103000ZY	0	+	0	0	156	0.0000000
zheyou73v0_A07	14594543	14595459	BnaA07T0103100ZY	0	+	0	0	916	0.0000000
zheyou73v0_A07	14601098	14603277	BnaA07T0103200ZY	0	+	0	0	2179	0.0000000
zheyou73v0_A07	14620131	14622735	BnaA07T0103300ZY	0	+	0	0	2604	0.0000000
zheyou73v0_A07	14628067	14629632	BnaA07T0103400ZY	0	+	0	0	1565	0.0000000
zheyou73v0_A07	14630863	14634033	BnaA07T0103500ZY	0	+	0	0	3170	0.0000000
zheyou73v0_A07	14630863	14634033	BnaA07T0103500ZY.1	0	+	0	0	3170	0.0000000
zheyou73v0_A07	14641750	14642885	BnaA07T0103600ZY	0	+	0	0	1135	0.0000000
zheyou73v0_A07	14645261	14646024	BnaA07T0103700ZY	0	+	0	0	763	0.0000000
zheyou73v0_A07	14652098	14653540	BnaA07T0103800ZY	0	-	0	0	1442	0.0000000
zheyou73v0_A07	14656752	14659088	BnaA07T0103900ZY	0	-	0	0	2336	0.0000000
zheyou73v0_A07	14664347	14665276	BnaA07T0104000ZY	0	-	0	0	929	0.0000000
zheyou73v0_A07	14666964	14668823	BnaA07T0104100ZY	0	-	0	0	1859	0.0000000
zheyou73v0_A07	14675708	14680123	BnaA07T0104200ZY	0	-	0	0	4415	0.0000000
zheyou73v0_A07	14681829	14682180	BnaA07T0104300ZY	0	+	0	0	351	0.0000000
zheyou73v0_A07	14682631	14683193	BnaA07T0104400ZY	0	-	0	0	562	0.0000000
zheyou73v0_A07	14687423	14691993	BnaA07T0104500ZY	0	+	0	0	4570	0.0000000
zheyou73v0_A07	14691298	14692770	BnaA07T0104600ZY	0	-	0	0	1472	0.0000000
zheyou73v0_A07	14695497	14697519	BnaA07T0104700ZY	0	-	0	0	2022	0.0000000
zheyou73v0_A07	14698653	14699707	BnaA07T0104800ZY	0	-	0	0	1054	0.0000000
zheyou73v0_A07	14705474	14706689	BnaA07T0104900ZY	0	-	0	0	1215	0.0000000
zheyou73v0_A07	14715162	14716393	BnaA07T0105000ZY	0	-	0	0	1231	0.0000000
zheyou73v0_A07	14719377	14721070	BnaA07T0105100ZY.1	0	+	0	0	1693	0.0000000
zheyou73v0_A07	14719528	14721070	BnaA07T0105100ZY	0	+	0	0	1542	0.0000000
zheyou73v0_A07	14719579	14721070	BnaA07T0105100ZY.2	0	+	0	0	1491	0.0000000
zheyou73v0_A07	14727340	14728939	BnaA07T0105200ZY	0	+	0	0	1599	0.0000000
zheyou73v0_A07	14730908	14733437	BnaA07T0105300ZY	0	+	0	0	2529	0.0000000
zheyou73v0_A07	14735171	14737515	BnaA07T0105400ZY	0	-	0	0	2344	0.0000000
zheyou73v0_A07	14752105	14753799	BnaA07T0105500ZY	0	-	0	0	1694	0.0000000
zheyou73v0_A07	14760120	14762603	BnaA07T0105600ZY	0	-	0	0	2483	0.0000000
zheyou73v0_A07	14763697	14764797	BnaA07T0105700ZY	0	+	0	0	1100	0.0000000
zheyou73v0_A07	14763697	14764797	BnaA07T0105700ZY.1	0	+	0	0	1100	0.0000000
zheyou73v0_A07	14764991	14765918	BnaA07T0105800ZY	0	-	0	0	927	0.0000000
zheyou73v0_A07	14768763	14769787	BnaA07T0105900ZY	0	+	0	0	1024	0.0000000
zheyou73v0_A07	14770479	14771404	BnaA07T0106000ZY	0	-	0	0	925	0.0000000
zheyou73v0_A07	14771963	14773513	BnaA07T0106100ZY	0	-	0	0	1550	0.0000000
zheyou73v0_A07	14774394	14775831	BnaA07T0106200ZY	0	+	0	0	1437	0.0000000
zheyou73v0_A07	14778258	14779509	BnaA07T0106300ZY	0	-	0	0	1251	0.0000000
zheyou73v0_A07	14780975	14784124	BnaA07T0106400ZY	0	+	0	0	3149	0.0000000
zheyou73v0_A07	14796162	14797581	BnaA07T0106500ZY	0	+	0	0	1419	0.0000000
zheyou73v0_A07	14801172	14805841	BnaA07T0106600ZY	0	+	0	0	4669	0.0000000
zheyou73v0_A07	14810777	14812024	BnaA07T0106700ZY	0	+	0	0	1247	0.0000000
zheyou73v0_A07	14814871	14815578	BnaA07T0106800ZY	0	+	0	0	707	0.0000000
zheyou73v0_A07	14815583	14819701	BnaA07T0106900ZY	0	-	0	0	4118	0.0000000
zheyou73v0_A07	14827601	14833471	BnaA07T0107000ZY	0	-	0	0	5870	0.0000000
zheyou73v0_A07	14848032	14855792	BnaA07T0107100ZY	0	-	0	0	7760	0.0000000
zheyou73v0_A07	14882193	14883835	BnaA07T0107200ZY	0	-	0	0	1642	0.0000000
zheyou73v0_A07	14882193	14883835	BnaA07T0107200ZY.1	0	-	0	0	1642	0.0000000
zheyou73v0_A07	14887039	14890381	BnaA07T0107300ZY	0	+	0	0	3342	0.0000000
zheyou73v0_A07	14892811	14895319	BnaA07T0107400ZY	0	-	0	0	2508	0.0000000
zheyou73v0_A07	14897969	14898338	BnaA07T0107500ZY	0	+	0	0	369	0.0000000
zheyou73v0_A07	14900102	14900848	BnaA07T0107600ZY	0	+	0	0	746	0.0000000
zheyou73v0_A07	14910911	14912111	BnaA07T0107700ZY	0	+	0	0	1200	0.0000000
zheyou73v0_A07	14912156	14915174	BnaA07T0107800ZY	0	+	0	0	3018	0.0000000
zheyou73v0_A07	14915534	14916033	BnaA07T0107900ZY	0	-	0	0	499	0.0000000
zheyou73v0_A07	14918515	14920164	BnaA07T0108000ZY	0	-	0	0	1649	0.0000000
zheyou73v0_A07	14922801	14924705	BnaA07T0108100ZY	0	-	0	0	1904	0.0000000
zheyou73v0_A07	14928397	14930116	BnaA07T0108200ZY	0	+	0	0	1719	0.0000000
zheyou73v0_A07	14941743	14944255	BnaA07T0108300ZY	0	-	0	0	2512	0.0000000
zheyou73v0_A07	14945801	14948138	BnaA07T0108400ZY	0	+	0	0	2337	0.0000000
zheyou73v0_A07	14951388	14952451	BnaA07T0108500ZY	0	+	0	0	1063	0.0000000
zheyou73v0_A07	14956075	14958208	BnaA07T0108600ZY	0	+	0	0	2133	0.0000000
zheyou73v0_A07	14962750	14965696	BnaA07T0108700ZY	0	+	0	0	2946	0.0000000
zheyou73v0_A07	14967528	14969141	BnaA07T0108800ZY	0	-	0	0	1613	0.0000000
zheyou73v0_A07	14970936	14971484	BnaA07T0108900ZY	0	+	0	0	548	0.0000000
zheyou73v0_A07	14977286	14979010	BnaA07T0109000ZY	0	+	0	0	1724	0.0000000
zheyou73v0_A07	14987309	14989986	BnaA07T0109100ZY	0	+	0	0	2677	0.0000000
zheyou73v0_A07	15004552	15005893	BnaA07T0109200ZY	0	+	0	0	1341	0.0000000
zheyou73v0_A07	15015930	15017777	BnaA07T0109300ZY	0	+	0	0	1847	0.0000000
zheyou73v0_A07	15019826	15021539	BnaA07T0109400ZY	0	-	0	0	1713	0.0000000
zheyou73v0_A07	15022028	15023936	BnaA07T0109500ZY	0	+	0	0	1908	0.0000000
zheyou73v0_A07	15026038	15028511	BnaA07T0109600ZY	0	+	0	0	2473	0.0000000
zheyou73v0_A07	15039600	15042744	BnaA07T0109700ZY	0	+	0	0	3144	0.0000000
zheyou73v0_A07	15054979	15058828	BnaA07T0109800ZY	0	+	0	0	3849	0.0000000
zheyou73v0_A07	15070732	15073419	BnaA07T0109900ZY	0	+	0	0	2687	0.0000000
zheyou73v0_A07	15070732	15073419	BnaA07T0109900ZY.1	0	+	0	0	2687	0.0000000
zheyou73v0_A07	15074215	15075893	BnaA07T0110000ZY	0	+	0	0	1678	0.0000000
zheyou73v0_A07	15084354	15088435	BnaA07T0110100ZY	0	+	0	0	4081	0.0000000
zheyou73v0_A07	15089053	15089643	BnaA07T0110200ZY	0	-	0	0	590	0.0000000
zheyou73v0_A07	15092251	15092647	BnaA07T0110300ZY	0	-	0	0	396	0.0000000
zheyou73v0_A07	15100224	15102556	BnaA07T0110400ZY	0	+	0	0	2332	0.0000000
zheyou73v0_A07	15130715	15133097	BnaA07T0110500ZY	0	+	0	0	2382	0.0000000
zheyou73v0_A07	15147664	15148805	BnaA07T0110600ZY	0	+	0	0	1141	0.0000000
zheyou73v0_A07	15149189	15150632	BnaA07T0110700ZY	0	-	0	0	1443	0.0000000
zheyou73v0_A07	15156900	15160154	BnaA07T0110800ZY	0	-	0	0	3254	0.0000000
zheyou73v0_A07	15161209	15161575	BnaA07T0110900ZY	0	-	0	0	366	0.0000000
zheyou73v0_A07	15165556	15165904	BnaA07T0111000ZY	0	+	0	0	348	0.0000000
zheyou73v0_A07	15166423	15166981	BnaA07T0111100ZY	0	+	0	0	558	0.0000000
zheyou73v0_A07	15167795	15170015	BnaA07T0111200ZY	0	-	0	0	2220	0.0000000
zheyou73v0_A07	15170123	15170890	BnaA07T0111300ZY	0	+	0	0	767	0.0000000
zheyou73v0_A07	15170876	15174654	BnaA07T0111400ZY	0	-	0	0	3778	0.0000000
zheyou73v0_A07	15175043	15179992	BnaA07T0111500ZY	0	-	0	0	4949	0.0000000
zheyou73v0_A07	15186827	15187485	BnaA07T0111600ZY	0	-	0	0	658	0.0000000
zheyou73v0_A07	15194874	15196861	BnaA07T0111700ZY	0	-	0	0	1987	0.0000000
zheyou73v0_A07	15207302	15208977	BnaA07T0111800ZY	0	-	0	0	1675	0.0000000
zheyou73v0_A07	15235403	15241921	BnaA07T0111900ZY	0	+	0	0	6518	0.0000000
zheyou73v0_A07	15247931	15250998	BnaA07T0112000ZY	0	+	0	0	3067	0.0000000
zheyou73v0_A07	15253600	15255907	BnaA07T0112100ZY	0	-	0	0	2307	0.0000000
zheyou73v0_A07	15282142	15283749	BnaA07T0112200ZY	0	+	0	0	1607	0.0000000
zheyou73v0_A07	15287184	15289003	BnaA07T0112300ZY	0	-	0	0	1819	0.0000000
zheyou73v0_A07	15296371	15298351	BnaA07T0112400ZY	0	-	0	0	1980	0.0000000
zheyou73v0_A07	15304965	15306739	BnaA07T0112500ZY	0	-	0	0	1774	0.0000000
zheyou73v0_A07	15321702	15323038	BnaA07T0112600ZY	0	-	0	0	1336	0.0000000
zheyou73v0_A07	15324047	15325349	BnaA07T0112700ZY	0	-	0	0	1302	0.0000000
zheyou73v0_A07	15329897	15331566	BnaA07T0112800ZY	0	-	0	0	1669	0.0000000
zheyou73v0_A07	15368609	15369062	BnaA07T0112900ZY	0	+	0	0	453	0.0000000
zheyou73v0_A07	15375740	15376416	BnaA07T0113000ZY	0	+	0	0	676	0.0000000
zheyou73v0_A07	15377776	15378256	BnaA07T0113100ZY	0	-	0	0	480	0.0000000
zheyou73v0_A07	15379404	15381392	BnaA07T0113200ZY	0	-	0	0	1988	0.0000000
zheyou73v0_A07	15386472	15387479	BnaA07T0113300ZY	0	-	0	0	1007	0.0000000
zheyou73v0_A07	15389977	15395620	BnaA07T0113400ZY	0	-	0	0	5643	0.0000000
zheyou73v0_A07	15413707	15414723	BnaA07T0113500ZY	0	-	0	0	1016	0.0000000
zheyou73v0_A07	15416408	15416901	BnaA07T0113600ZY	0	-	0	0	493	0.0000000
zheyou73v0_A07	15428383	15430704	BnaA07T0113700ZY	0	+	0	0	2321	0.0000000
zheyou73v0_A07	15439855	15440302	BnaA07T0113800ZY	0	-	0	0	447	0.0000000
zheyou73v0_A07	15446571	15447228	BnaA07T0113900ZY	0	-	0	0	657	0.0000000
zheyou73v0_A07	15451771	15456065	BnaA07T0114000ZY	0	-	0	0	4294	0.0000000
zheyou73v0_A07	15467163	15469773	BnaA07T0114100ZY	0	-	0	0	2610	0.0000000
zheyou73v0_A07	15489178	15490510	BnaA07T0114200ZY	0	-	0	0	1332	0.0000000
zheyou73v0_A07	15490723	15492190	BnaA07T0114300ZY	0	-	0	0	1467	0.0000000
zheyou73v0_A07	15494115	15494545	BnaA07T0114400ZY	0	+	0	0	430	0.0000000
zheyou73v0_A07	15495537	15495906	BnaA07T0114500ZY	0	+	0	0	369	0.0000000
zheyou73v0_A07	15499350	15501845	BnaA07T0114600ZY	0	+	0	0	2495	0.0000000
zheyou73v0_A07	15502478	15504394	BnaA07T0114700ZY	0	-	0	0	1916	0.0000000
zheyou73v0_A07	15507335	15509797	BnaA07T0114800ZY	0	-	0	0	2462	0.0000000
zheyou73v0_A07	15515540	15519308	BnaA07T0114900ZY	0	+	0	0	3768	0.0000000
zheyou73v0_A07	15520185	15521584	BnaA07T0115000ZY	0	+	0	0	1399	0.0000000
zheyou73v0_A07	15522413	15525042	BnaA07T0115100ZY	0	-	0	0	2629	0.0000000
zheyou73v0_A07	15532034	15534312	BnaA07T0115200ZY	0	+	0	0	2278	0.0000000
zheyou73v0_A07	15536355	15538377	BnaA07T0115300ZY	0	+	0	0	2022	0.0000000
zheyou73v0_A07	15539048	15542579	BnaA07T0115400ZY	0	-	0	0	3531	0.0000000
zheyou73v0_A07	15543619	15548087	BnaA07T0115500ZY	0	-	0	0	4468	0.0000000
zheyou73v0_A07	15548458	15549778	BnaA07T0115600ZY	0	+	0	0	1320	0.0000000
zheyou73v0_A07	15552217	15553507	BnaA07T0115700ZY	0	-	0	0	1290	0.0000000
zheyou73v0_A07	15564429	15569430	BnaA07T0115800ZY	0	+	0	0	5001	0.0000000
zheyou73v0_A07	15569733	15570931	BnaA07T0115900ZY	0	+	0	0	1198	0.0000000
zheyou73v0_A07	15577490	15579010	BnaA07T0116000ZY	0	-	0	0	1520	0.0000000
zheyou73v0_A07	15587759	15589929	BnaA07T0116100ZY	0	+	0	0	2170	0.0000000
zheyou73v0_A07	15598596	15600572	BnaA07T0116200ZY	0	+	0	0	1976	0.0000000
zheyou73v0_A07	15605430	15607546	BnaA07T0116300ZY	0	-	0	0	2116	0.0000000
zheyou73v0_A07	15611779	15613751	BnaA07T0116400ZY	0	-	0	0	1972	0.0000000
zheyou73v0_A07	15619991	15621562	BnaA07T0116500ZY	0	+	0	0	1571	0.0000000
zheyou73v0_A07	15621774	15623393	BnaA07T0116600ZY	0	-	0	0	1619	0.0000000
zheyou73v0_A07	15635589	15638338	BnaA07T0116700ZY	0	+	0	0	2749	0.0000000
zheyou73v0_A07	15640041	15641449	BnaA07T0116800ZY	0	+	0	0	1408	0.0000000
zheyou73v0_A07	15642208	15644006	BnaA07T0116900ZY	0	-	0	0	1798	0.0000000
zheyou73v0_A07	15645490	15647381	BnaA07T0117000ZY	0	+	0	0	1891	0.0000000
zheyou73v0_A07	15650428	15653344	BnaA07T0117100ZY	0	-	0	0	2916	0.0000000
zheyou73v0_A07	15656716	15658998	BnaA07T0117200ZY	0	+	0	0	2282	0.0000000
zheyou73v0_A07	15695110	15698012	BnaA07T0117300ZY	0	+	0	0	2902	0.0000000
zheyou73v0_A07	15698974	15699929	BnaA07T0117400ZY	0	-	0	0	955	0.0000000
zheyou73v0_A07	15703427	15705108	BnaA07T0117500ZY	0	-	0	0	1681	0.0000000
zheyou73v0_A07	15706982	15709362	BnaA07T0117600ZY	0	+	0	0	2380	0.0000000
zheyou73v0_A07	15711386	15712952	BnaA07T0117700ZY	0	+	0	0	1566	0.0000000
zheyou73v0_A07	15713499	15715649	BnaA07T0117800ZY	0	-	0	0	2150	0.0000000
zheyou73v0_A07	15713499	15715649	BnaA07T0117800ZY.1	0	-	0	0	2150	0.0000000
zheyou73v0_A07	15716616	15717169	BnaA07T0117900ZY	0	+	0	0	553	0.0000000
zheyou73v0_A07	15717770	15719559	BnaA07T0118000ZY	0	-	0	0	1789	0.0000000
zheyou73v0_A07	15717770	15719559	BnaA07T0118000ZY.1	0	-	0	0	1789	0.0000000
zheyou73v0_A07	15717770	15719640	BnaA07T0118000ZY.2	0	-	0	0	1870	0.0000000
zheyou73v0_A07	15721422	15722484	BnaA07T0118100ZY	0	+	0	0	1062	0.0000000
zheyou73v0_A07	15731604	15734361	BnaA07T0118200ZY	0	+	0	0	2757	0.0000000
zheyou73v0_A07	15742513	15744223	BnaA07T0118300ZY	0	+	0	0	1710	0.0000000
zheyou73v0_A07	15746917	15748297	BnaA07T0118400ZY	0	-	0	0	1380	0.0000000
zheyou73v0_A07	15749247	15752120	BnaA07T0118500ZY	0	+	0	0	2873	0.0000000
zheyou73v0_A07	15756708	15757445	BnaA07T0118600ZY	0	+	0	0	737	0.0000000
zheyou73v0_A07	15758505	15761276	BnaA07T0118700ZY	0	+	0	0	2771	0.0000000
zheyou73v0_A07	15763258	15764948	BnaA07T0118800ZY	0	-	0	0	1690	0.0000000
zheyou73v0_A07	15767026	15769334	BnaA07T0118900ZY	0	+	0	0	2308	0.0000000
zheyou73v0_A07	15772362	15775350	BnaA07T0119000ZY	0	+	0	0	2988	0.0000000
zheyou73v0_A07	15772362	15775350	BnaA07T0119000ZY.1	0	+	0	0	2988	0.0000000
zheyou73v0_A07	15782287	15786037	BnaA07T0119100ZY	0	+	0	0	3750	0.0000000
zheyou73v0_A07	15786378	15791070	BnaA07T0119200ZY	0	+	0	0	4692	0.0000000
zheyou73v0_A07	15791245	15793527	BnaA07T0119300ZY	0	+	0	0	2282	0.0000000
zheyou73v0_A07	15794667	15798236	BnaA07T0119400ZY	0	+	0	0	3569	0.0000000
zheyou73v0_A07	15802202	15804047	BnaA07T0119500ZY	0	+	0	0	1845	0.0000000
zheyou73v0_A07	15809033	15810719	BnaA07T0119600ZY	0	+	0	0	1686	0.0000000
zheyou73v0_A07	15816800	15817124	BnaA07T0119700ZY	0	+	0	0	324	0.0000000
zheyou73v0_A07	15817372	15819536	BnaA07T0119800ZY	0	-	0	0	2164	0.0000000
zheyou73v0_A07	15824015	15824879	BnaA07T0119900ZY	0	+	0	0	864	0.0000000
zheyou73v0_A07	15828623	15829810	BnaA07T0120000ZY	0	-	0	0	1187	0.0000000
zheyou73v0_A07	15839766	15841878	BnaA07T0120100ZY	0	+	0	0	2112	0.0000000
zheyou73v0_A07	15857657	15858854	BnaA07T0120200ZY	0	+	0	0	1197	0.0000000
zheyou73v0_A07	15862691	15865200	BnaA07T0120300ZY	0	-	0	0	2509	0.0000000
zheyou73v0_A07	15867092	15868196	BnaA07T0120400ZY	0	-	0	0	1104	0.0000000
zheyou73v0_A07	15868543	15869340	BnaA07T0120500ZY	0	-	0	0	797	0.0000000
zheyou73v0_A07	15876199	15879143	BnaA07T0120600ZY	0	+	0	0	2944	0.0000000
zheyou73v0_A07	15883596	15885883	BnaA07T0120700ZY	0	+	0	0	2287	0.0000000
zheyou73v0_A07	15888500	15890696	BnaA07T0120800ZY	0	+	0	0	2196	0.0000000
zheyou73v0_A07	15892105	15893974	BnaA07T0120900ZY	0	-	0	0	1869	0.0000000
zheyou73v0_A07	15894148	15900340	BnaA07T0121000ZY	0	-	0	0	6192	0.0000000
zheyou73v0_A07	15894148	15900340	BnaA07T0121000ZY.1	0	-	0	0	6192	0.0000000
zheyou73v0_A07	15900732	15902320	BnaA07T0121100ZY	0	-	0	0	1588	0.0000000
zheyou73v0_A07	15903392	15904607	BnaA07T0121200ZY	0	+	0	0	1215	0.0000000
zheyou73v0_A07	15905108	15906382	BnaA07T0121300ZY	0	-	0	0	1274	0.0000000
zheyou73v0_A07	15909343	15912452	BnaA07T0121400ZY	0	-	0	0	3109	0.0000000
zheyou73v0_A07	15912803	15926629	BnaA07T0121500ZY	0	+	0	0	13826	0.0000000
zheyou73v0_A07	15928383	15930188	BnaA07T0121600ZY	0	+	0	0	1805	0.0000000
zheyou73v0_A07	15930470	15931645	BnaA07T0121700ZY	0	-	0	0	1175	0.0000000
zheyou73v0_A07	15936519	15946702	BnaA07T0121800ZY	0	-	0	0	10183	0.0000000
zheyou73v0_A07	15953850	15954484	BnaA07T0121900ZY	0	+	0	0	634	0.0000000
zheyou73v0_A07	15963857	15974032	BnaA07T0122000ZY	0	+	0	0	10175	0.0000000
zheyou73v0_A07	15963857	15974032	BnaA07T0122000ZY.1	0	+	0	0	10175	0.0000000
zheyou73v0_A07	15974485	15975589	BnaA07T0122100ZY	0	+	0	0	1104	0.0000000
zheyou73v0_A07	15977808	15980374	BnaA07T0122200ZY	0	+	0	0	2566	0.0000000
zheyou73v0_A07	15991428	15992183	BnaA07T0122300ZY	0	+	0	0	755	0.0000000
zheyou73v0_A07	15993413	15994271	BnaA07T0122400ZY	0	-	0	0	858	0.0000000
zheyou73v0_A07	15995294	15997438	BnaA07T0122500ZY	0	-	0	0	2144	0.0000000
zheyou73v0_A07	16002033	16002793	BnaA07T0122600ZY	0	+	0	0	760	0.0000000
zheyou73v0_A07	16005567	16008390	BnaA07T0122700ZY	0	+	0	0	2823	0.0000000
zheyou73v0_A07	16008694	16009007	BnaA07T0122800ZY	0	-	0	0	313	0.0000000
zheyou73v0_A07	16009890	16010920	BnaA07T0122900ZY	0	+	0	0	1030	0.0000000
zheyou73v0_A07	16021728	16023519	BnaA07T0123000ZY	0	-	0	0	1791	0.0000000
zheyou73v0_A07	16030589	16032318	BnaA07T0123100ZY	0	+	0	0	1729	0.0000000
zheyou73v0_A07	16037077	16040308	BnaA07T0123200ZY	0	-	0	0	3231	0.0000000
zheyou73v0_A07	16050165	16053508	BnaA07T0123300ZY	0	+	0	0	3343	0.0000000
zheyou73v0_A07	16055193	16056692	BnaA07T0123400ZY	0	-	0	0	1499	0.0000000
zheyou73v0_A07	16074089	16078156	BnaA07T0123500ZY	0	+	0	0	4067	0.0000000
zheyou73v0_A07	16079222	16080069	BnaA07T0123600ZY	0	-	0	0	847	0.0000000
zheyou73v0_A07	16080751	16081588	BnaA07T0123700ZY	0	-	0	0	837	0.0000000
zheyou73v0_A07	16086871	16089947	BnaA07T0123800ZY	0	-	0	0	3076	0.0000000
zheyou73v0_A07	16097168	16098587	BnaA07T0123900ZY	0	+	0	0	1419	0.0000000
zheyou73v0_A07	16101955	16102406	BnaA07T0124000ZY	0	+	0	0	451	0.0000000
zheyou73v0_A07	16108247	16108698	BnaA07T0124100ZY	0	+	0	0	451	0.0000000
zheyou73v0_A07	16110039	16110450	BnaA07T0124200ZY	0	+	0	0	411	0.0000000
zheyou73v0_A07	16110468	16110936	BnaA07T0124300ZY	0	-	0	0	468	0.0000000
zheyou73v0_A07	16111035	16111761	BnaA07T0124400ZY	0	+	0	0	726	0.0000000
zheyou73v0_A07	16117588	16119263	BnaA07T0124500ZY	0	+	0	0	1675	0.0000000
zheyou73v0_A07	16119270	16120391	BnaA07T0124600ZY	0	-	0	0	1121	0.0000000
zheyou73v0_A07	16123020	16127008	BnaA07T0124700ZY	0	+	0	0	3988	0.0000000
zheyou73v0_A07	16128491	16130421	BnaA07T0124800ZY	0	+	0	0	1930	0.0000000
zheyou73v0_A07	16133427	16134393	BnaA07T0124900ZY	0	+	0	0	966	0.0000000
zheyou73v0_A07	16135953	16138840	BnaA07T0125000ZY	0	+	0	0	2887	0.0000000
zheyou73v0_A07	16145162	16148321	BnaA07T0125100ZY	0	+	0	0	3159	0.0000000
zheyou73v0_A07	16151688	16153797	BnaA07T0125200ZY	0	-	0	0	2109	0.0000000
zheyou73v0_A07	16155269	16156770	BnaA07T0125300ZY	0	-	0	0	1501	0.0000000
zheyou73v0_A07	16158577	16160292	BnaA07T0125400ZY	0	-	0	0	1715	0.0000000
zheyou73v0_A07	16162150	16164098	BnaA07T0125500ZY	0	-	0	0	1948	0.0000000
zheyou73v0_A07	16162150	16164098	BnaA07T0125500ZY.1	0	-	0	0	1948	0.0000000
zheyou73v0_A07	16164461	16173527	BnaA07T0125600ZY	0	-	0	0	9066	0.0000000
zheyou73v0_A07	16176276	16180287	BnaA07T0125700ZY	0	+	0	0	4011	0.0000000
zheyou73v0_A07	16181586	16183201	BnaA07T0125800ZY	0	+	0	0	1615	0.0000000
zheyou73v0_A07	16189953	16191362	BnaA07T0125900ZY	0	-	0	0	1409	0.0000000
zheyou73v0_A07	16202481	16210086	BnaA07T0126000ZY	0	-	0	0	7605	0.0000000
zheyou73v0_A07	16224644	16225364	BnaA07T0126100ZY	0	-	0	0	720	0.0000000
zheyou73v0_A07	16230463	16234196	BnaA07T0126200ZY	0	-	0	0	3733	0.0000000
zheyou73v0_A07	16256583	16257005	BnaA07T0126300ZY	0	-	0	0	422	0.0000000
zheyou73v0_A07	16258348	16259408	BnaA07T0126400ZY	0	+	0	0	1060	0.0000000
zheyou73v0_A07	16263021	16264546	BnaA07T0126500ZY	0	-	0	0	1525	0.0000000
zheyou73v0_A07	16263021	16264546	BnaA07T0126500ZY.1	0	-	0	0	1525	0.0000000
zheyou73v0_A07	16271100	16275885	BnaA07T0126600ZY	0	+	0	0	4785	0.0000000
zheyou73v0_A07	16277345	16280706	BnaA07T0126700ZY	0	+	0	0	3361	0.0000000
zheyou73v0_A07	16281427	16284324	BnaA07T0126800ZY	0	+	0	0	2897	0.0000000
zheyou73v0_A07	16285186	16291845	BnaA07T0126900ZY	0	+	0	0	6659	0.0000000
zheyou73v0_A07	16299244	16301994	BnaA07T0127000ZY	0	+	0	0	2750	0.0000000
zheyou73v0_A07	16305822	16307848	BnaA07T0127100ZY	0	+	0	0	2026	0.0000000
zheyou73v0_A07	16317491	16318613	BnaA07T0127200ZY	0	-	0	0	1122	0.0000000
zheyou73v0_A07	16319748	16322521	BnaA07T0127300ZY	0	-	0	0	2773	0.0000000
zheyou73v0_A07	16319875	16320469	BnaA07T0127400ZY	0	+	0	0	594	0.0000000
zheyou73v0_A07	16322577	16325373	BnaA07T0127500ZY	0	+	0	0	2796	0.0000000
zheyou73v0_A07	16325417	16328007	BnaA07T0127600ZY	0	+	0	0	2590	0.0000000
zheyou73v0_A07	16328236	16331006	BnaA07T0127700ZY	0	-	0	0	2770	0.0000000
zheyou73v0_A07	16332986	16337957	BnaA07T0127800ZY	0	+	0	0	4971	0.0000000
zheyou73v0_A07	16345238	16348092	BnaA07T0127900ZY	0	+	0	0	2854	0.0000000
zheyou73v0_A07	16350885	16354131	BnaA07T0128000ZY	0	+	0	0	3246	0.0000000
zheyou73v0_A07	16355402	16358681	BnaA07T0128100ZY	0	+	0	0	3279	0.0000000
zheyou73v0_A07	16359696	16362475	BnaA07T0128200ZY	0	-	0	0	2779	0.0000000
zheyou73v0_A07	16364209	16365838	BnaA07T0128300ZY	0	+	0	0	1629	0.0000000
zheyou73v0_A07	16364209	16365838	BnaA07T0128300ZY.1	0	+	0	0	1629	0.0000000
zheyou73v0_A07	16367407	16369842	BnaA07T0128400ZY	0	+	0	0	2435	0.0000000
zheyou73v0_A07	16373864	16375871	BnaA07T0128500ZY	0	-	0	0	2007	0.0000000
zheyou73v0_A07	16381896	16383680	BnaA07T0128600ZY	0	-	0	0	1784	0.0000000
zheyou73v0_A07	16386393	16388052	BnaA07T0128700ZY	0	+	0	0	1659	0.0000000
zheyou73v0_A07	16389895	16393893	BnaA07T0128800ZY	0	-	0	0	3998	0.0000000
zheyou73v0_A07	16401317	16403104	BnaA07T0128900ZY	0	-	0	0	1787	0.0000000
zheyou73v0_A07	16403528	16404319	BnaA07T0129000ZY	0	-	0	0	791	0.0000000
zheyou73v0_A07	16406563	16408108	BnaA07T0129100ZY	0	-	0	0	1545	0.0000000
zheyou73v0_A07	16406563	16408108	BnaA07T0129100ZY.1	0	-	0	0	1545	0.0000000
zheyou73v0_A07	16406563	16407523	BnaA07T0129100ZY.2	0	-	0	0	960	0.0000000
zheyou73v0_A07	16413483	16415740	BnaA07T0129200ZY	0	-	0	0	2257	0.0000000
zheyou73v0_A07	16422116	16434759	BnaA07T0129300ZY	0	+	0	0	12643	0.0000000
zheyou73v0_A07	16436275	16436488	BnaA07T0129400ZY	0	-	0	0	213	0.0000000
zheyou73v0_A07	16439708	16440808	BnaA07T0129500ZY	0	+	0	0	1100	0.0000000
zheyou73v0_A07	16447853	16451961	BnaA07T0129600ZY	0	-	0	0	4108	0.0000000
zheyou73v0_A07	16457810	16461681	BnaA07T0129700ZY	0	+	0	0	3871	0.0000000
zheyou73v0_A07	16461984	16462258	BnaA07T0129800ZY	0	-	0	0	274	0.0000000
zheyou73v0_A07	16462944	16466084	BnaA07T0129900ZY	0	-	0	0	3140	0.0000000
zheyou73v0_A07	16485680	16487084	BnaA07T0130000ZY	0	+	0	0	1404	0.0000000
zheyou73v0_A07	16488079	16489936	BnaA07T0130100ZY	0	-	0	0	1857	0.0000000
zheyou73v0_A07	16490906	16493675	BnaA07T0130200ZY	0	-	0	0	2769	0.0000000
zheyou73v0_A07	16494973	16496638	BnaA07T0130300ZY	0	+	0	0	1665	0.0000000
zheyou73v0_A07	16505365	16509172	BnaA07T0130400ZY	0	+	0	0	3807	0.0000000
zheyou73v0_A07	16505365	16509172	BnaA07T0130400ZY.1	0	+	0	0	3807	0.0000000
zheyou73v0_A07	16509739	16510919	BnaA07T0130500ZY	0	-	0	0	1180	0.0000000
zheyou73v0_A07	16511676	16514075	BnaA07T0130600ZY	0	+	0	0	2399	0.0000000
zheyou73v0_A07	16514150	16514698	BnaA07T0130700ZY	0	-	0	0	548	0.0000000
zheyou73v0_A07	16518648	16522236	BnaA07T0130800ZY	0	+	0	0	3588	0.0000000
zheyou73v0_A07	16523135	16527247	BnaA07T0130900ZY	0	+	0	0	4112	0.0000000
zheyou73v0_A07	16528566	16531837	BnaA07T0131000ZY	0	+	0	0	3271	0.0000000
zheyou73v0_A07	16532733	16533787	BnaA07T0131100ZY	0	-	0	0	1054	0.0000000
zheyou73v0_A07	16537107	16537816	BnaA07T0131200ZY	0	+	0	0	709	0.0000000
zheyou73v0_A07	16540046	16544038	BnaA07T0131300ZY	0	+	0	0	3992	0.0000000
zheyou73v0_A07	16554008	16559275	BnaA07T0131400ZY	0	+	0	0	5267	0.0000000
zheyou73v0_A07	16561613	16562009	BnaA07T0131500ZY	0	+	0	0	396	0.0000000
zheyou73v0_A07	16562509	16565357	BnaA07T0131600ZY	0	-	0	0	2848	0.0000000
zheyou73v0_A07	16570085	16571683	BnaA07T0131700ZY	0	-	0	0	1598	0.0000000
zheyou73v0_A07	16595676	16597411	BnaA07T0131800ZY	0	-	0	0	1735	0.0000000
zheyou73v0_A07	16597685	16599281	BnaA07T0131900ZY	0	-	0	0	1596	0.0000000
zheyou73v0_A07	16599457	16600390	BnaA07T0132000ZY	0	-	0	0	933	0.0000000
zheyou73v0_A07	16600817	16602150	BnaA07T0132100ZY	0	-	0	0	1333	0.0000000
zheyou73v0_A07	16606151	16606975	BnaA07T0132200ZY	0	-	0	0	824	0.0000000
zheyou73v0_A07	16609437	16612063	BnaA07T0132300ZY	0	-	0	0	2626	0.0000000
zheyou73v0_A07	16618488	16620401	BnaA07T0132400ZY	0	-	0	0	1913	0.0000000
zheyou73v0_A07	16618871	16620401	BnaA07T0132400ZY.1	0	-	0	0	1530	0.0000000
zheyou73v0_A07	16624467	16630950	BnaA07T0132500ZY	0	+	0	0	6483	0.0000000
zheyou73v0_A07	16631952	16633331	BnaA07T0132600ZY	0	+	0	0	1379	0.0000000
zheyou73v0_A07	16633430	16635688	BnaA07T0132700ZY	0	-	0	0	2258	0.0000000
zheyou73v0_A07	16633430	16635688	BnaA07T0132700ZY.1	0	-	0	0	2258	0.0000000
zheyou73v0_A07	16636445	16637063	BnaA07T0132800ZY	0	+	0	0	618	0.0000000
zheyou73v0_A07	16637639	16637870	BnaA07T0132900ZY	0	-	0	0	231	0.0000000
zheyou73v0_A07	16638604	16640096	BnaA07T0133000ZY	0	+	0	0	1492	0.0000000
zheyou73v0_A07	16640218	16643916	BnaA07T0133100ZY	0	-	0	0	3698	0.0000000
zheyou73v0_A07	16658939	16659938	BnaA07T0133200ZY	0	-	0	0	999	0.0000000
zheyou73v0_A07	16660435	16662911	BnaA07T0133300ZY	0	-	0	0	2476	0.0000000
zheyou73v0_A07	16663472	16665608	BnaA07T0133400ZY	0	+	0	0	2136	0.0000000
zheyou73v0_A07	16668261	16668768	BnaA07T0133500ZY	0	+	0	0	507	0.0000000
zheyou73v0_A07	16668802	16671338	BnaA07T0133600ZY	0	-	0	0	2536	0.0000000
zheyou73v0_A07	16674416	16676191	BnaA07T0133700ZY	0	+	0	0	1775	0.0000000
zheyou73v0_A07	16676432	16679502	BnaA07T0133800ZY	0	-	0	0	3070	0.0000000
zheyou73v0_A07	16691428	16692463	BnaA07T0133900ZY	0	-	0	0	1035	0.0000000
zheyou73v0_A07	16693315	16694559	BnaA07T0134000ZY	0	+	0	0	1244	0.0000000
zheyou73v0_A07	16696743	16697370	BnaA07T0134100ZY	0	-	0	0	627	0.0000000
zheyou73v0_A07	16697998	16698667	BnaA07T0134200ZY	0	-	0	0	669	0.0000000
zheyou73v0_A07	16699283	16701830	BnaA07T0134300ZY	0	-	0	0	2547	0.0000000
zheyou73v0_A07	16702948	16704921	BnaA07T0134400ZY	0	+	0	0	1973	0.0000000
zheyou73v0_A07	16705154	16709302	BnaA07T0134500ZY	0	-	0	0	4148	0.0000000
zheyou73v0_A07	16715995	16717560	BnaA07T0134600ZY	0	+	0	0	1565	0.0000000
zheyou73v0_A07	16719993	16721258	BnaA07T0134700ZY	0	+	0	0	1265	0.0000000
zheyou73v0_A07	16724336	16725821	BnaA07T0134800ZY	0	-	0	0	1485	0.0000000
zheyou73v0_A07	16724336	16725821	BnaA07T0134800ZY.1	0	-	0	0	1485	0.0000000
zheyou73v0_A07	16739364	16740915	BnaA07T0134900ZY	0	+	0	0	1551	0.0000000
zheyou73v0_A07	16745775	16749652	BnaA07T0135000ZY	0	+	0	0	3877	0.0000000
zheyou73v0_A07	16752990	16754419	BnaA07T0135100ZY	0	+	0	0	1429	0.0000000
zheyou73v0_A07	16755049	16756997	BnaA07T0135200ZY	0	-	0	0	1948	0.0000000
zheyou73v0_A07	16759203	16761297	BnaA07T0135300ZY	0	-	0	0	2094	0.0000000
zheyou73v0_A07	16762370	16763686	BnaA07T0135400ZY	0	+	0	0	1316	0.0000000
zheyou73v0_A07	16766535	16768504	BnaA07T0135500ZY	0	+	0	0	1969	0.0000000
zheyou73v0_A07	16768736	16769615	BnaA07T0135600ZY	0	-	0	0	879	0.0000000
zheyou73v0_A07	16771980	16773747	BnaA07T0135700ZY	0	+	0	0	1767	0.0000000
zheyou73v0_A07	16771980	16773747	BnaA07T0135700ZY.1	0	+	0	0	1767	0.0000000
zheyou73v0_A07	16780685	16786368	BnaA07T0135800ZY	0	+	0	0	5683	0.0000000
zheyou73v0_A07	16787741	16790557	BnaA07T0135900ZY	0	+	0	0	2816	0.0000000
zheyou73v0_A07	16787741	16790557	BnaA07T0135900ZY.1	0	+	0	0	2816	0.0000000
zheyou73v0_A07	16792761	16793962	BnaA07T0136000ZY	0	+	0	0	1201	0.0000000
zheyou73v0_A07	16794389	16795457	BnaA07T0136100ZY	0	-	0	0	1068	0.0000000
zheyou73v0_A07	16797111	16799219	BnaA07T0136200ZY	0	-	0	0	2108	0.0000000
zheyou73v0_A07	16797111	16799219	BnaA07T0136200ZY.1	0	-	0	0	2108	0.0000000
zheyou73v0_A07	16812155	16816312	BnaA07T0136300ZY	0	+	0	0	4157	0.0000000
zheyou73v0_A07	16817584	16820585	BnaA07T0136400ZY	0	-	0	0	3001	0.0000000
zheyou73v0_A07	16821491	16824110	BnaA07T0136500ZY	0	-	0	0	2619	0.0000000
zheyou73v0_A07	16824547	16826832	BnaA07T0136600ZY	0	-	0	0	2285	0.0000000
zheyou73v0_A07	16827124	16828400	BnaA07T0136700ZY	0	+	0	0	1276	0.0000000
zheyou73v0_A07	16831888	16832407	BnaA07T0136800ZY	0	+	0	0	519	0.0000000
zheyou73v0_A07	16832465	16834575	BnaA07T0136900ZY	0	-	0	0	2110	0.0000000
zheyou73v0_A07	16835328	16839088	BnaA07T0137000ZY.1	0	-	0	0	3760	0.0000000
zheyou73v0_A07	16835328	16839088	BnaA07T0137000ZY.2	0	-	0	0	3760	0.0000000
zheyou73v0_A07	16835359	16839088	BnaA07T0137000ZY	0	-	0	0	3729	0.0000000
zheyou73v0_A07	16842960	16844282	BnaA07T0137100ZY	0	+	0	0	1322	0.0000000
zheyou73v0_A07	16844449	16847367	BnaA07T0137200ZY	0	-	0	0	2918	0.0000000
zheyou73v0_A07	16849827	16850535	BnaA07T0137300ZY	0	-	0	0	708	0.0000000
zheyou73v0_A07	16854400	16857690	BnaA07T0137400ZY	0	+	0	0	3290	0.0000000
zheyou73v0_A07	16857870	16861948	BnaA07T0137500ZY	0	-	0	0	4078	0.0000000
zheyou73v0_A07	16864764	16866198	BnaA07T0137600ZY	0	+	0	0	1434	0.0000000
zheyou73v0_A07	16866782	16868673	BnaA07T0137700ZY	0	+	0	0	1891	0.0000000
zheyou73v0_A07	16872250	16873832	BnaA07T0137800ZY	0	+	0	0	1582	0.0000000
zheyou73v0_A07	16872250	16873832	BnaA07T0137800ZY.1	0	+	0	0	1582	0.0000000
zheyou73v0_A07	16872250	16873832	BnaA07T0137800ZY.2	0	+	0	0	1582	0.0000000
zheyou73v0_A07	16874871	16878903	BnaA07T0137900ZY	0	+	0	0	4032	0.0000000
zheyou73v0_A07	16888598	16889988	BnaA07T0138000ZY	0	+	0	0	1390	0.0000000
zheyou73v0_A07	16896396	16903458	BnaA07T0138100ZY	0	+	0	0	7062	0.0000000
zheyou73v0_A07	16906752	16908978	BnaA07T0138200ZY	0	-	0	0	2226	0.0000000
zheyou73v0_A07	16916904	16919624	BnaA07T0138300ZY	0	+	0	0	2720	0.0000000
zheyou73v0_A07	16920052	16920986	BnaA07T0138400ZY	0	+	0	0	934	0.0000000
zheyou73v0_A07	16920052	16920986	BnaA07T0138400ZY.1	0	+	0	0	934	0.0000000
zheyou73v0_A07	16922818	16924304	BnaA07T0138500ZY	0	-	0	0	1486	0.0000000
zheyou73v0_A07	16925214	16926249	BnaA07T0138600ZY	0	-	0	0	1035	0.0000000
zheyou73v0_A07	16927188	16927467	BnaA07T0138700ZY	0	+	0	0	279	0.0000000
zheyou73v0_A07	16927731	16931116	BnaA07T0138800ZY	0	+	0	0	3385	0.0000000
zheyou73v0_A07	16933113	16934661	BnaA07T0138900ZY	0	-	0	0	1548	0.0000000
zheyou73v0_A07	16934788	16939013	BnaA07T0139000ZY	0	-	0	0	4225	0.0000000
zheyou73v0_A07	16943906	16944209	BnaA07T0139100ZY	0	-	0	0	303	0.0000000
zheyou73v0_A07	16949370	16951213	BnaA07T0139200ZY	0	-	0	0	1843	0.0000000
zheyou73v0_A07	16962679	16964751	BnaA07T0139300ZY	0	+	0	0	2072	0.0000000
zheyou73v0_A07	16965777	16967736	BnaA07T0139400ZY	0	+	0	0	1959	0.0000000
zheyou73v0_A07	16969434	16970778	BnaA07T0139500ZY	0	+	0	0	1344	0.0000000
zheyou73v0_A07	16970868	16974666	BnaA07T0139600ZY	0	-	0	0	3798	0.0000000
zheyou73v0_A07	16979065	16979239	BnaA07T0139700ZY	0	-	0	0	174	0.0000000
zheyou73v0_A07	16981737	16984299	BnaA07T0139800ZY	0	-	0	0	2562	0.0000000
zheyou73v0_A07	16995103	16996806	BnaA07T0139900ZY	0	-	0	0	1703	0.0000000
zheyou73v0_A07	17000675	17002293	BnaA07T0140000ZY	0	+	0	0	1618	0.0000000
zheyou73v0_A07	17000675	17002293	BnaA07T0140000ZY.1	0	+	0	0	1618	0.0000000
zheyou73v0_A07	17003596	17007618	BnaA07T0140100ZY	0	+	0	0	4022	0.0000000
zheyou73v0_A07	17008732	17010996	BnaA07T0140200ZY	0	-	0	0	2264	0.0000000
zheyou73v0_A07	17016812	17024929	BnaA07T0140300ZY	0	-	0	0	8117	0.0000000
zheyou73v0_A07	17032008	17033193	BnaA07T0140400ZY	0	+	0	0	1185	0.0000000
zheyou73v0_A07	17035486	17037557	BnaA07T0140500ZY	0	+	0	0	2071	0.0000000
zheyou73v0_A07	17038050	17040102	BnaA07T0140600ZY	0	-	0	0	2052	0.0000000
zheyou73v0_A07	17041644	17042864	BnaA07T0140700ZY	0	-	0	0	1220	0.0000000
zheyou73v0_A07	17044110	17045386	BnaA07T0140800ZY	0	+	0	0	1276	0.0000000
zheyou73v0_A07	17050983	17053658	BnaA07T0140900ZY	0	+	0	0	2675	0.0000000
zheyou73v0_A07	17058503	17059028	BnaA07T0141000ZY	0	+	0	0	525	0.0000000
zheyou73v0_A07	17063091	17064336	BnaA07T0141100ZY	0	+	0	0	1245	0.0000000
zheyou73v0_A07	17065641	17066163	BnaA07T0141200ZY	0	+	0	0	522	0.0000000
zheyou73v0_A07	17067986	17068817	BnaA07T0141300ZY	0	+	0	0	831	0.0000000
zheyou73v0_A07	17089709	17091231	BnaA07T0141400ZY	0	+	0	0	1522	0.0000000
zheyou73v0_A07	17112803	17114802	BnaA07T0141500ZY	0	+	0	0	1999	0.0000000
zheyou73v0_A07	17118789	17119590	BnaA07T0141600ZY	0	+	0	0	801	0.0000000
zheyou73v0_A07	17122574	17123847	BnaA07T0141700ZY	0	+	0	0	1273	0.0000000
zheyou73v0_A07	17125584	17127229	BnaA07T0141800ZY	0	-	0	0	1645	0.0000000
zheyou73v0_A07	17125584	17127229	BnaA07T0141800ZY.1	0	-	0	0	1645	0.0000000
zheyou73v0_A07	17132817	17135365	BnaA07T0141900ZY	0	+	0	0	2548	0.0000000
zheyou73v0_A07	17136201	17137966	BnaA07T0142000ZY	0	-	0	0	1765	0.0000000
zheyou73v0_A07	17139493	17141903	BnaA07T0142100ZY	0	-	0	0	2410	0.0000000
zheyou73v0_A07	17144136	17145173	BnaA07T0142200ZY	0	-	0	0	1037	0.0000000
zheyou73v0_A07	17148711	17150486	BnaA07T0142300ZY	0	+	0	0	1775	0.0000000
zheyou73v0_A07	17154829	17157797	BnaA07T0142400ZY	0	+	0	0	2968	0.0000000
zheyou73v0_A07	17159235	17160036	BnaA07T0142500ZY	0	+	0	0	801	0.0000000
zheyou73v0_A07	17160310	17162234	BnaA07T0142600ZY	0	-	0	0	1924	0.0000000
zheyou73v0_A07	17171816	17173208	BnaA07T0142700ZY	0	+	0	0	1392	0.0000000
zheyou73v0_A07	17174643	17178168	BnaA07T0142800ZY	0	-	0	0	3525	0.0000000
zheyou73v0_A07	17179670	17180692	BnaA07T0142900ZY	0	-	0	0	1022	0.0000000
zheyou73v0_A07	17192838	17195420	BnaA07T0143000ZY	0	+	0	0	2582	0.0000000
zheyou73v0_A07	17192838	17195420	BnaA07T0143000ZY.1	0	+	0	0	2582	0.0000000
zheyou73v0_A07	17194882	17195290	BnaA07T0143100ZY	0	-	0	0	408	0.0000000
zheyou73v0_A07	17198236	17199202	BnaA07T0143200ZY	0	-	0	0	966	0.0000000
zheyou73v0_A07	17200990	17217283	BnaA07T0143300ZY	0	-	0	0	16293	0.0000000
zheyou73v0_A07	17217821	17218973	BnaA07T0143400ZY	0	-	0	0	1152	0.0000000
zheyou73v0_A07	17223900	17225762	BnaA07T0143500ZY	0	-	0	0	1862	0.0000000
zheyou73v0_A07	17235403	17240217	BnaA07T0143600ZY	0	-	0	0	4814	0.0000000
zheyou73v0_A07	17240873	17242155	BnaA07T0143700ZY	0	-	0	0	1282	0.0000000
zheyou73v0_A07	17242363	17244280	BnaA07T0143800ZY	0	-	0	0	1917	0.0000000
zheyou73v0_A07	17242363	17244280	BnaA07T0143800ZY.1	0	-	0	0	1917	0.0000000
zheyou73v0_A07	17244743	17248120	BnaA07T0143900ZY	0	-	0	0	3377	0.0000000
zheyou73v0_A07	17252153	17253193	BnaA07T0144000ZY	0	+	0	0	1040	0.0000000
zheyou73v0_A07	17256851	17258544	BnaA07T0144100ZY	0	+	0	0	1693	0.0000000
zheyou73v0_A07	17262090	17264047	BnaA07T0144200ZY	0	-	0	0	1957	0.0000000
zheyou73v0_A07	17275838	17277582	BnaA07T0144300ZY	0	+	0	0	1744	0.0000000
zheyou73v0_A07	17279100	17281147	BnaA07T0144400ZY	0	-	0	0	2047	0.0000000
zheyou73v0_A07	17283284	17285666	BnaA07T0144500ZY	0	-	0	0	2382	0.0000000
zheyou73v0_A07	17292674	17294468	BnaA07T0144600ZY	0	-	0	0	1794	0.0000000
zheyou73v0_A07	17294544	17296300	BnaA07T0144700ZY	0	-	0	0	1756	0.0000000
zheyou73v0_A07	17297703	17299521	BnaA07T0144800ZY	0	-	0	0	1818	0.0000000
zheyou73v0_A07	17304114	17305226	BnaA07T0144900ZY	0	-	0	0	1112	0.0000000
zheyou73v0_A07	17305746	17309072	BnaA07T0145000ZY	0	+	0	0	3326	0.0000000
zheyou73v0_A07	17309080	17310364	BnaA07T0145100ZY	0	-	0	0	1284	0.0000000
zheyou73v0_A07	17309578	17310421	BnaA07T0145100ZY.1	0	-	0	0	843	0.0000000
zheyou73v0_A07	17314227	17326717	BnaA07T0145200ZY	0	+	0	0	12490	0.0000000
zheyou73v0_A07	17314227	17326717	BnaA07T0145200ZY.1	0	+	0	0	12490	0.0000000
zheyou73v0_A07	17326628	17328471	BnaA07T0145300ZY	0	-	0	0	1843	0.0000000
zheyou73v0_A07	17330598	17334312	BnaA07T0145400ZY	0	+	0	0	3714	0.0000000
zheyou73v0_A07	17341284	17344998	BnaA07T0145500ZY	0	+	0	0	3714	0.0000000
zheyou73v0_A07	17353893	17355434	BnaA07T0145600ZY	0	+	0	0	1541	0.0000000
zheyou73v0_A07	17375840	17379458	BnaA07T0145700ZY	0	-	0	0	3618	0.0000000
zheyou73v0_A07	17375840	17378596	BnaA07T0145700ZY.1	0	-	0	0	2756	0.0000000
zheyou73v0_A07	17387226	17389150	BnaA07T0145800ZY	0	-	0	0	1924	0.0000000
zheyou73v0_A07	17391572	17392986	BnaA07T0145900ZY	0	+	0	0	1414	0.0000000
zheyou73v0_A07	17394675	17397053	BnaA07T0146000ZY	0	+	0	0	2378	0.0000000
zheyou73v0_A07	17398055	17399582	BnaA07T0146100ZY	0	+	0	0	1527	0.0000000
zheyou73v0_A07	17413338	17415536	BnaA07T0146200ZY	0	+	0	0	2198	0.0000000
zheyou73v0_A07	17416299	17419598	BnaA07T0146300ZY	0	-	0	0	3299	0.0000000
zheyou73v0_A07	17420351	17422392	BnaA07T0146400ZY	0	-	0	0	2041	0.0000000
zheyou73v0_A07	17432592	17433560	BnaA07T0146500ZY	0	-	0	0	968	0.0000000
zheyou73v0_A07	17447515	17448729	BnaA07T0146600ZY	0	+	0	0	1214	0.0000000
zheyou73v0_A07	17449496	17450138	BnaA07T0146700ZY	0	+	0	0	642	0.0000000
zheyou73v0_A07	17450848	17456257	BnaA07T0146800ZY	0	-	0	0	5409	0.0000000
zheyou73v0_A07	17450848	17454424	BnaA07T0146800ZY.1	0	-	0	0	3576	0.0000000
zheyou73v0_A07	17462159	17463884	BnaA07T0146900ZY	0	+	0	0	1725	0.0000000
zheyou73v0_A07	17475269	17476580	BnaA07T0147000ZY	0	+	0	0	1311	0.0000000
zheyou73v0_A07	17477060	17478514	BnaA07T0147100ZY	0	-	0	0	1454	0.0000000
zheyou73v0_A07	17484195	17484477	BnaA07T0147200ZY	0	+	0	0	282	0.0000000
zheyou73v0_A07	17485583	17486486	BnaA07T0147300ZY	0	-	0	0	903	0.0000000
zheyou73v0_A07	17490259	17490712	BnaA07T0147400ZY	0	+	0	0	453	0.0000000
zheyou73v0_A07	17490963	17493593	BnaA07T0147500ZY	0	-	0	0	2630	0.0000000
zheyou73v0_A07	17499524	17502604	BnaA07T0147600ZY	0	-	0	0	3080	0.0000000
zheyou73v0_A07	17499524	17502604	BnaA07T0147600ZY.2	0	-	0	0	3080	0.0000000
zheyou73v0_A07	17500015	17502604	BnaA07T0147600ZY.1	0	-	0	0	2589	0.0000000
zheyou73v0_A07	17510328	17513080	BnaA07T0147700ZY	0	+	0	0	2752	0.0000000
zheyou73v0_A07	17517767	17517980	BnaA07T0147800ZY	0	-	0	0	213	0.0000000
zheyou73v0_A07	17527372	17528973	BnaA07T0147900ZY	0	-	0	0	1601	0.0000000
zheyou73v0_A07	17531658	17539960	BnaA07T0148000ZY	0	-	0	0	8302	0.0000000
zheyou73v0_A07	17546425	17548328	BnaA07T0148100ZY	0	+	0	0	1903	0.0000000
zheyou73v0_A07	17549023	17549707	BnaA07T0148200ZY	0	+	0	0	684	0.0000000
zheyou73v0_A07	17554133	17555713	BnaA07T0148300ZY	0	+	0	0	1580	0.0000000
zheyou73v0_A07	17563339	17564449	BnaA07T0148400ZY	0	+	0	0	1110	0.0000000
zheyou73v0_A07	17566663	17577406	BnaA07T0148500ZY.1	0	-	0	0	10743	0.0000000
zheyou73v0_A07	17574252	17577726	BnaA07T0148500ZY	0	-	0	0	3474	0.0000000
zheyou73v0_A07	17581560	17583497	BnaA07T0148600ZY	0	-	0	0	1937	0.0000000
zheyou73v0_A07	17593340	17598806	BnaA07T0148700ZY	0	+	0	0	5466	0.0000000
zheyou73v0_A07	17599332	17600581	BnaA07T0148800ZY	0	-	0	0	1249	0.0000000
zheyou73v0_A07	17601922	17603401	BnaA07T0148900ZY	0	-	0	0	1479	0.0000000
zheyou73v0_A07	17601922	17603401	BnaA07T0148900ZY.1	0	-	0	0	1479	0.0000000
zheyou73v0_A07	17604938	17605992	BnaA07T0149000ZY	0	+	0	0	1054	0.0000000
zheyou73v0_A07	17611436	17612633	BnaA07T0149100ZY	0	-	0	0	1197	0.0000000
zheyou73v0_A07	17635148	17640062	BnaA07T0149200ZY	0	-	0	0	4914	0.0000000
zheyou73v0_A07	17641742	17644068	BnaA07T0149300ZY	0	+	0	0	2326	0.0000000
zheyou73v0_A07	17645101	17646508	BnaA07T0149400ZY	0	-	0	0	1407	0.0000000
zheyou73v0_A07	17645101	17646508	BnaA07T0149400ZY.1	0	-	0	0	1407	0.0000000
zheyou73v0_A07	17651997	17653972	BnaA07T0149500ZY	0	+	0	0	1975	0.0000000
zheyou73v0_A07	17658816	17661304	BnaA07T0149600ZY	0	-	0	0	2488	0.0000000
zheyou73v0_A07	17662319	17664257	BnaA07T0149700ZY	0	+	0	0	1938	0.0000000
zheyou73v0_A07	17662319	17664257	BnaA07T0149700ZY.1	0	+	0	0	1938	0.0000000
zheyou73v0_A07	17666412	17669207	BnaA07T0149800ZY	0	+	0	0	2795	0.0000000
zheyou73v0_A07	17666412	17669207	BnaA07T0149800ZY.1	0	+	0	0	2795	0.0000000
zheyou73v0_A07	17670686	17672545	BnaA07T0149900ZY	0	-	0	0	1859	0.0000000
zheyou73v0_A07	17678228	17678939	BnaA07T0150000ZY	0	-	0	0	711	0.0000000
zheyou73v0_A07	17682759	17683966	BnaA07T0150100ZY	0	-	0	0	1207	0.0000000
zheyou73v0_A07	17684575	17687291	BnaA07T0150200ZY	0	+	0	0	2716	0.0000000
zheyou73v0_A07	17684575	17687291	BnaA07T0150200ZY.1	0	+	0	0	2716	0.0000000
zheyou73v0_A07	17688768	17690871	BnaA07T0150300ZY	0	-	0	0	2103	0.0000000
zheyou73v0_A07	17703141	17704772	BnaA07T0150400ZY	0	+	0	0	1631	0.0000000
zheyou73v0_A07	17705107	17707602	BnaA07T0150500ZY	0	-	0	0	2495	0.0000000
zheyou73v0_A07	17708416	17711955	BnaA07T0150600ZY	0	-	0	0	3539	0.0000000
zheyou73v0_A07	17712360	17720182	BnaA07T0150700ZY	0	+	0	0	7822	0.0000000
zheyou73v0_A07	17720618	17720881	BnaA07T0150800ZY	0	-	0	0	263	0.0000000
zheyou73v0_A07	17722340	17724208	BnaA07T0150900ZY	0	+	0	0	1868	0.0000000
zheyou73v0_A07	17727462	17727612	BnaA07T0151000ZY	0	-	0	0	150	0.0000000
zheyou73v0_A07	17731387	17732384	BnaA07T0151100ZY	0	-	0	0	997	0.0000000
zheyou73v0_A07	17733821	17735623	BnaA07T0151200ZY	0	-	0	0	1802	0.0000000
zheyou73v0_A07	17742724	17744525	BnaA07T0151300ZY	0	-	0	0	1801	0.0000000
zheyou73v0_A07	17745197	17746862	BnaA07T0151400ZY	0	-	0	0	1665	0.0000000
zheyou73v0_A07	17747837	17753216	BnaA07T0151500ZY	0	-	0	0	5379	0.0000000
zheyou73v0_A07	17756521	17757505	BnaA07T0151600ZY	0	+	0	0	984	0.0000000
zheyou73v0_A07	17761685	17762914	BnaA07T0151700ZY	0	-	0	0	1229	0.0000000
zheyou73v0_A07	17772160	17775594	BnaA07T0151800ZY	0	+	0	0	3434	0.0000000
zheyou73v0_A07	17772160	17775594	BnaA07T0151800ZY.1	0	+	0	0	3434	0.0000000
zheyou73v0_A07	17772160	17775594	BnaA07T0151800ZY.2	0	+	0	0	3434	0.0000000
zheyou73v0_A07	17776395	17780225	BnaA07T0151900ZY	0	-	0	0	3830	0.0000000
zheyou73v0_A07	17781193	17782487	BnaA07T0152000ZY	0	-	0	0	1294	0.0000000
zheyou73v0_A07	17783258	17785079	BnaA07T0152100ZY	0	-	0	0	1821	0.0000000
zheyou73v0_A07	17786707	17787991	BnaA07T0152200ZY	0	+	0	0	1284	0.0000000
zheyou73v0_A07	17788880	17791064	BnaA07T0152300ZY	0	+	0	0	2184	0.0000000
zheyou73v0_A07	17791436	17794890	BnaA07T0152400ZY	0	-	0	0	3454	0.0000000
zheyou73v0_A07	17795846	17799820	BnaA07T0152500ZY	0	+	0	0	3974	0.0000000
zheyou73v0_A07	17800523	17801237	BnaA07T0152600ZY	0	-	0	0	714	0.0000000
zheyou73v0_A07	17801629	17804868	BnaA07T0152700ZY	0	-	0	0	3239	0.0000000
zheyou73v0_A07	17808573	17812052	BnaA07T0152800ZY	0	+	0	0	3479	0.0000000
zheyou73v0_A07	17812076	17815130	BnaA07T0152900ZY	0	-	0	0	3054	0.0000000
zheyou73v0_A07	17816703	17819746	BnaA07T0153000ZY	0	+	0	0	3043	0.0000000
zheyou73v0_A07	17819934	17821980	BnaA07T0153100ZY	0	-	0	0	2046	0.0000000
zheyou73v0_A07	17822549	17826282	BnaA07T0153200ZY	0	+	0	0	3733	0.0000000
zheyou73v0_A07	17829095	17833417	BnaA07T0153300ZY	0	-	0	0	4322	0.0000000
zheyou73v0_A07	17836378	17837735	BnaA07T0153400ZY	0	-	0	0	1357	0.0000000
zheyou73v0_A07	17838688	17841560	BnaA07T0153500ZY	0	-	0	0	2872	0.0000000
zheyou73v0_A07	17844053	17845485	BnaA07T0153600ZY	0	+	0	0	1432	0.0000000
zheyou73v0_A07	17845770	17846982	BnaA07T0153700ZY	0	+	0	0	1212	0.0000000
zheyou73v0_A07	17847625	17849062	BnaA07T0153800ZY	0	+	0	0	1437	0.0000000
zheyou73v0_A07	17849293	17850335	BnaA07T0153900ZY	0	-	0	0	1042	0.0000000
zheyou73v0_A07	17850584	17851886	BnaA07T0154000ZY	0	-	0	0	1302	0.0000000
zheyou73v0_A07	17877778	17880659	BnaA07T0154100ZY	0	-	0	0	2881	0.0000000
zheyou73v0_A07	17877778	17880659	BnaA07T0154100ZY.1	0	-	0	0	2881	0.0000000
zheyou73v0_A07	17886878	17891115	BnaA07T0154200ZY	0	+	0	0	4237	0.0000000
zheyou73v0_A07	17891768	17895982	BnaA07T0154300ZY	0	-	0	0	4214	0.0000000
zheyou73v0_A07	17897789	17899475	BnaA07T0154400ZY	0	-	0	0	1686	0.0000000
zheyou73v0_A07	17898172	17899475	BnaA07T0154400ZY.1	0	-	0	0	1303	0.0000000
zheyou73v0_A07	17900224	17902054	BnaA07T0154500ZY	0	-	0	0	1830	0.0000000
zheyou73v0_A07	17914092	17920606	BnaA07T0154600ZY	0	-	0	0	6514	0.0000000
zheyou73v0_A07	17922208	17924886	BnaA07T0154700ZY	0	+	0	0	2678	0.0000000
zheyou73v0_A07	17925669	17928649	BnaA07T0154800ZY	0	-	0	0	2980	0.0000000
zheyou73v0_A07	17936791	17938629	BnaA07T0154900ZY	0	+	0	0	1838	0.0000000
zheyou73v0_A07	17942997	17953393	BnaA07T0155000ZY	0	+	0	0	10396	0.0000000
zheyou73v0_A07	17954394	17957684	BnaA07T0155100ZY	0	+	0	0	3290	0.0000000
zheyou73v0_A07	17960836	17969368	BnaA07T0155200ZY	0	+	0	0	8532	0.0000000
zheyou73v0_A07	17970195	17973517	BnaA07T0155300ZY	0	+	0	0	3322	0.0000000
zheyou73v0_A07	17979105	17979718	BnaA07T0155400ZY	0	+	0	0	613	0.0000000
zheyou73v0_A07	17980810	17982135	BnaA07T0155500ZY	0	-	0	0	1325	0.0000000
zheyou73v0_A07	17985457	17986950	BnaA07T0155600ZY	0	-	0	0	1493	0.0000000
zheyou73v0_A07	17998707	18001634	BnaA07T0155700ZY	0	+	0	0	2927	0.0000000
zheyou73v0_A07	18005890	18008138	BnaA07T0155800ZY.1	0	+	0	0	2248	0.0000000
zheyou73v0_A07	18006042	18007956	BnaA07T0155800ZY	0	+	0	0	1914	0.0000000
zheyou73v0_A07	18009139	18012725	BnaA07T0155900ZY	0	+	0	0	3586	0.0000000
zheyou73v0_A07	18009139	18012725	BnaA07T0155900ZY.1	0	+	0	0	3586	0.0000000
zheyou73v0_A07	18011772	18012555	BnaA07T0156000ZY	0	-	0	0	783	0.0000000
zheyou73v0_A07	18021891	18022663	BnaA07T0156100ZY	0	+	0	0	772	0.0000000
zheyou73v0_A07	18022799	18024549	BnaA07T0156200ZY	0	-	0	0	1750	0.0000000
zheyou73v0_A07	18022799	18024008	BnaA07T0156200ZY.1	0	-	0	0	1209	0.0000000
zheyou73v0_A07	18025737	18027243	BnaA07T0156300ZY	0	+	0	0	1506	0.0000000
zheyou73v0_A07	18025737	18026733	BnaA07T0156300ZY.1	0	+	0	0	996	0.0000000
zheyou73v0_A07	18028031	18029739	BnaA07T0156400ZY	0	+	0	0	1708	0.0000000
zheyou73v0_A07	18029810	18031037	BnaA07T0156500ZY	0	-	0	0	1227	0.0000000
zheyou73v0_A07	18036368	18037594	BnaA07T0156600ZY	0	-	0	0	1226	0.0000000
zheyou73v0_A07	18045238	18049592	BnaA07T0156700ZY	0	+	0	0	4354	0.0000000
zheyou73v0_A07	18051631	18052788	BnaA07T0156800ZY	0	-	0	0	1157	0.0000000
zheyou73v0_A07	18053513	18054145	BnaA07T0156900ZY	0	+	0	0	632	0.0000000
zheyou73v0_A07	18054473	18058204	BnaA07T0157000ZY	0	-	0	0	3731	0.0000000
zheyou73v0_A07	18060801	18062469	BnaA07T0157100ZY	0	+	0	0	1668	0.0000000
zheyou73v0_A07	18067625	18069310	BnaA07T0157200ZY	0	-	0	0	1685	0.0000000
zheyou73v0_A07	18072062	18072449	BnaA07T0157300ZY	0	-	0	0	387	0.0000000
zheyou73v0_A07	18073997	18080502	BnaA07T0157400ZY	0	-	0	0	6505	0.0000000
zheyou73v0_A07	18081564	18084959	BnaA07T0157500ZY	0	+	0	0	3395	0.0000000
zheyou73v0_A07	18088032	18090169	BnaA07T0157600ZY	0	+	0	0	2137	0.0000000
zheyou73v0_A07	18105230	18105828	BnaA07T0157700ZY	0	+	0	0	598	0.0000000
zheyou73v0_A07	18106427	18109281	BnaA07T0157800ZY	0	-	0	0	2854	0.0000000
zheyou73v0_A07	18109566	18109848	BnaA07T0157900ZY	0	-	0	0	282	0.0000000
zheyou73v0_A07	18115788	18116754	BnaA07T0158000ZY	0	+	0	0	966	0.0000000
zheyou73v0_A07	18117400	18120795	BnaA07T0158100ZY	0	+	0	0	3395	0.0000000
zheyou73v0_A07	18124915	18127878	BnaA07T0158200ZY	0	+	0	0	2963	0.0000000
zheyou73v0_A07	18124915	18128087	BnaA07T0158200ZY.1	0	+	0	0	3172	0.0000000
zheyou73v0_A07	18124915	18128087	BnaA07T0158200ZY.2	0	+	0	0	3172	0.0000000
zheyou73v0_A07	18124915	18127878	BnaA07T0158200ZY.3	0	+	0	0	2963	0.0000000
zheyou73v0_A07	18128914	18132462	BnaA07T0158300ZY	0	+	0	0	3548	0.0000000
zheyou73v0_A07	18132754	18135363	BnaA07T0158400ZY	0	-	0	0	2609	0.0000000
zheyou73v0_A07	18142855	18145585	BnaA07T0158500ZY	0	+	0	0	2730	0.0000000
zheyou73v0_A07	18147918	18155423	BnaA07T0158600ZY	0	+	0	0	7505	0.0000000
zheyou73v0_A07	18155244	18162137	BnaA07T0158700ZY	0	-	0	0	6893	0.0000000
zheyou73v0_A07	18175440	18176539	BnaA07T0158800ZY	0	+	0	0	1099	0.0000000
zheyou73v0_A07	18177859	18179889	BnaA07T0158900ZY	0	-	0	0	2030	0.0000000
zheyou73v0_A07	18183923	18186212	BnaA07T0159000ZY	0	-	0	0	2289	0.0000000
zheyou73v0_A07	18186524	18187170	BnaA07T0159100ZY	0	+	0	0	646	0.0000000
zheyou73v0_A07	18187588	18189081	BnaA07T0159200ZY	0	-	0	0	1493	0.0000000
zheyou73v0_A07	18187588	18189081	BnaA07T0159200ZY.1	0	-	0	0	1493	0.0000000
zheyou73v0_A07	18193005	18196012	BnaA07T0159300ZY	0	+	0	0	3007	0.0000000
zheyou73v0_A07	18196821	18200610	BnaA07T0159400ZY	0	+	0	0	3789	0.0000000
zheyou73v0_A07	18198956	18201571	BnaA07T0159500ZY	0	-	0	0	2615	0.0000000
zheyou73v0_A07	18205676	18209565	BnaA07T0159600ZY	0	+	0	0	3889	0.0000000
zheyou73v0_A07	18209741	18210797	BnaA07T0159700ZY	0	-	0	0	1056	0.0000000
zheyou73v0_A07	18212539	18214938	BnaA07T0159800ZY	0	+	0	0	2399	0.0000000
zheyou73v0_A07	18219534	18220396	BnaA07T0159900ZY	0	+	0	0	862	0.0000000
zheyou73v0_A07	18235140	18236916	BnaA07T0160000ZY	0	+	0	0	1776	0.0000000
zheyou73v0_A07	18237308	18240046	BnaA07T0160100ZY	0	-	0	0	2738	0.0000000
zheyou73v0_A07	18243001	18243978	BnaA07T0160200ZY	0	-	0	0	977	0.0000000
zheyou73v0_A07	18260911	18262309	BnaA07T0160300ZY	0	+	0	0	1398	0.0000000
zheyou73v0_A07	18266955	18268014	BnaA07T0160400ZY	0	+	0	0	1059	0.0000000
zheyou73v0_A07	18269114	18270439	BnaA07T0160500ZY	0	+	0	0	1325	0.0000000
zheyou73v0_A07	18271532	18272420	BnaA07T0160600ZY	0	+	0	0	888	0.0000000
zheyou73v0_A07	18278111	18280317	BnaA07T0160700ZY	0	+	0	0	2206	0.0000000
zheyou73v0_A07	18281125	18281605	BnaA07T0160800ZY	0	+	0	0	480	0.0000000
zheyou73v0_A07	18283073	18287833	BnaA07T0160900ZY	0	+	0	0	4760	0.0000000
zheyou73v0_A07	18288522	18289760	BnaA07T0161000ZY	0	-	0	0	1238	0.0000000
zheyou73v0_A07	18290143	18291822	BnaA07T0161100ZY	0	-	0	0	1679	0.0000000
zheyou73v0_A07	18292207	18294085	BnaA07T0161200ZY	0	+	0	0	1878	0.0000000
zheyou73v0_A07	18296605	18298740	BnaA07T0161300ZY	0	+	0	0	2135	0.0000000
zheyou73v0_A07	18298851	18299365	BnaA07T0161400ZY	0	-	0	0	514	0.0000000
zheyou73v0_A07	18300581	18301856	BnaA07T0161500ZY	0	-	0	0	1275	0.0000000
zheyou73v0_A07	18307785	18309213	BnaA07T0161600ZY	0	+	0	0	1428	0.0000000
zheyou73v0_A07	18309672	18313245	BnaA07T0161700ZY	0	+	0	0	3573	0.0000000
zheyou73v0_A07	18313538	18313694	BnaA07T0161800ZY	0	-	0	0	156	0.0000000
zheyou73v0_A07	18313791	18315025	BnaA07T0161900ZY	0	-	0	0	1234	0.0000000
zheyou73v0_A07	18318447	18320289	BnaA07T0162000ZY	0	+	0	0	1842	0.0000000
zheyou73v0_A07	18318447	18320289	BnaA07T0162000ZY.1	0	+	0	0	1842	0.0000000
zheyou73v0_A07	18320951	18321876	BnaA07T0162100ZY	0	-	0	0	925	0.0000000
zheyou73v0_A07	18326185	18329195	BnaA07T0162200ZY	0	+	0	0	3010	0.0000000
zheyou73v0_A07	18331515	18340419	BnaA07T0162300ZY	0	+	0	0	8904	0.0000000
zheyou73v0_A07	18341922	18344647	BnaA07T0162400ZY	0	+	0	0	2725	0.0000000
zheyou73v0_A07	18347938	18359314	BnaA07T0162500ZY	0	+	0	0	11376	0.0000000
zheyou73v0_A07	18365268	18367763	BnaA07T0162600ZY	0	+	0	0	2495	0.0000000
zheyou73v0_A07	18370703	18371945	BnaA07T0162700ZY	0	+	0	0	1242	0.0000000
zheyou73v0_A07	18380551	18381071	BnaA07T0162800ZY	0	+	0	0	520	0.0000000
zheyou73v0_A07	18383433	18385472	BnaA07T0162900ZY	0	+	0	0	2039	0.0000000
zheyou73v0_A07	18383433	18385472	BnaA07T0162900ZY.1	0	+	0	0	2039	0.0000000
zheyou73v0_A07	18386513	18396416	BnaA07T0163000ZY	0	+	0	0	9903	0.0000000
zheyou73v0_A07	18399720	18401203	BnaA07T0163100ZY	0	-	0	0	1483	0.0000000
zheyou73v0_A07	18403106	18404732	BnaA07T0163200ZY	0	+	0	0	1626	0.0000000
zheyou73v0_A07	18403106	18404732	BnaA07T0163200ZY.1	0	+	0	0	1626	0.0000000
zheyou73v0_A07	18413947	18416244	BnaA07T0163300ZY	0	+	0	0	2297	0.0000000
zheyou73v0_A07	18416464	18417111	BnaA07T0163400ZY	0	+	0	0	647	0.0000000
zheyou73v0_A07	18417473	18420329	BnaA07T0163500ZY	0	-	0	0	2856	0.0000000
zheyou73v0_A07	18417473	18420329	BnaA07T0163500ZY.1	0	-	0	0	2856	0.0000000
zheyou73v0_A07	18431634	18432358	BnaA07T0163600ZY	0	-	0	0	724	0.0000000
zheyou73v0_A07	18435306	18435876	BnaA07T0163700ZY	0	-	0	0	570	0.0000000
zheyou73v0_A07	18442570	18444220	BnaA07T0163800ZY	0	+	0	0	1650	0.0000000
zheyou73v0_A07	18449886	18452291	BnaA07T0163900ZY	0	-	0	0	2405	0.0000000
zheyou73v0_A07	18452775	18455260	BnaA07T0164000ZY	0	-	0	0	2485	0.0000000
zheyou73v0_A07	18458202	18460606	BnaA07T0164100ZY	0	+	0	0	2404	0.0000000
zheyou73v0_A07	18458202	18460606	BnaA07T0164100ZY.1	0	+	0	0	2404	0.0000000
zheyou73v0_A07	18461744	18463446	BnaA07T0164200ZY	0	+	0	0	1702	0.0000000
zheyou73v0_A07	18463595	18467437	BnaA07T0164300ZY	0	-	0	0	3842	0.0000000
zheyou73v0_A07	18468688	18470421	BnaA07T0164400ZY	0	+	0	0	1733	0.0000000
zheyou73v0_A07	18474358	18475882	BnaA07T0164500ZY	0	+	0	0	1524	0.0000000
zheyou73v0_A07	18477541	18479709	BnaA07T0164600ZY	0	+	0	0	2168	0.0000000
zheyou73v0_A07	18483495	18484966	BnaA07T0164700ZY	0	-	0	0	1471	0.0000000
zheyou73v0_A07	18488938	18490151	BnaA07T0164800ZY	0	+	0	0	1213	0.0000000
zheyou73v0_A07	18491650	18494250	BnaA07T0164900ZY	0	-	0	0	2600	0.0000000
zheyou73v0_A07	18499487	18500687	BnaA07T0165000ZY	0	-	0	0	1200	0.0000000
zheyou73v0_A07	18506484	18512093	BnaA07T0165100ZY	0	+	0	0	5609	0.0000000
zheyou73v0_A07	18513846	18517344	BnaA07T0165200ZY	0	+	0	0	3498	0.0000000
zheyou73v0_A07	18517610	18520573	BnaA07T0165300ZY	0	-	0	0	2963	0.0000000
zheyou73v0_A07	18521929	18523974	BnaA07T0165400ZY	0	-	0	0	2045	0.0000000
zheyou73v0_A07	18524304	18530032	BnaA07T0165500ZY	0	-	0	0	5728	0.0000000
zheyou73v0_A07	18534209	18536259	BnaA07T0165600ZY	0	-	0	0	2050	0.0000000
zheyou73v0_A07	18537682	18541378	BnaA07T0165700ZY	0	-	0	0	3696	0.0000000
zheyou73v0_A07	18543180	18544540	BnaA07T0165800ZY	0	+	0	0	1360	0.0000000
zheyou73v0_A07	18544888	18548422	BnaA07T0165900ZY	0	-	0	0	3534	0.0000000
zheyou73v0_A07	18548789	18550934	BnaA07T0166000ZY	0	-	0	0	2145	0.0000000
zheyou73v0_A07	18551596	18554099	BnaA07T0166100ZY	0	-	0	0	2503	0.0000000
zheyou73v0_A07	18554430	18555993	BnaA07T0166200ZY	0	+	0	0	1563	0.0000000
zheyou73v0_A07	18557322	18558894	BnaA07T0166300ZY	0	-	0	0	1572	0.0000000
zheyou73v0_A07	18560902	18561514	BnaA07T0166400ZY	0	+	0	0	612	0.0000000
zheyou73v0_A07	18574579	18577836	BnaA07T0166500ZY	0	-	0	0	3257	0.0000000
zheyou73v0_A07	18587830	18588756	BnaA07T0166600ZY	0	+	0	0	926	0.0000000
zheyou73v0_A07	18592219	18593634	BnaA07T0166700ZY	0	-	0	0	1415	0.0000000
zheyou73v0_A07	18603580	18604766	BnaA07T0166800ZY	0	+	0	0	1186	0.0000000
zheyou73v0_A07	18605616	18608118	BnaA07T0166900ZY	0	-	0	0	2502	0.0000000
zheyou73v0_A07	18605616	18607946	BnaA07T0166900ZY.1	0	-	0	0	2330	0.0000000
zheyou73v0_A07	18609356	18615833	BnaA07T0167000ZY	0	-	0	0	6477	0.0000000
zheyou73v0_A07	18619092	18620915	BnaA07T0167100ZY	0	+	0	0	1823	0.0000000
zheyou73v0_A07	18621187	18622431	BnaA07T0167200ZY	0	+	0	0	1244	0.0000000
zheyou73v0_A07	18624715	18627507	BnaA07T0167300ZY	0	-	0	0	2792	0.0000000
zheyou73v0_A07	18624715	18627507	BnaA07T0167300ZY.1	0	-	0	0	2792	0.0000000
zheyou73v0_A07	18630944	18633078	BnaA07T0167400ZY	0	-	0	0	2134	0.0000000
zheyou73v0_A07	18634197	18634882	BnaA07T0167500ZY	0	-	0	0	685	0.0000000
zheyou73v0_A07	18635755	18638988	BnaA07T0167600ZY	0	-	0	0	3233	0.0000000
zheyou73v0_A07	18635755	18638988	BnaA07T0167600ZY.1	0	-	0	0	3233	0.0000000
zheyou73v0_A07	18643015	18644478	BnaA07T0167700ZY	0	-	0	0	1463	0.0000000
zheyou73v0_A07	18644726	18647054	BnaA07T0167800ZY	0	+	0	0	2328	0.0000000
zheyou73v0_A07	18649002	18650869	BnaA07T0167900ZY	0	+	0	0	1867	0.0000000
zheyou73v0_A07	18651607	18654085	BnaA07T0168000ZY	0	+	0	0	2478	0.0000000
zheyou73v0_A07	18654997	18655861	BnaA07T0168100ZY	0	+	0	0	864	0.0000000
zheyou73v0_A07	18656288	18656675	BnaA07T0168200ZY	0	+	0	0	387	0.0000000
zheyou73v0_A07	18657034	18657439	BnaA07T0168300ZY	0	-	0	0	405	0.0000000
zheyou73v0_A07	18660334	18662660	BnaA07T0168400ZY	0	-	0	0	2326	0.0000000
zheyou73v0_A07	18665827	18667081	BnaA07T0168500ZY	0	-	0	0	1254	0.0000000
zheyou73v0_A07	18670275	18671054	BnaA07T0168600ZY	0	+	0	0	779	0.0000000
zheyou73v0_A07	18673514	18675254	BnaA07T0168700ZY	0	+	0	0	1740	0.0000000
zheyou73v0_A07	18675815	18677198	BnaA07T0168800ZY	0	+	0	0	1383	0.0000000
zheyou73v0_A07	18685151	18691592	BnaA07T0168900ZY	0	-	0	0	6441	0.0000000
zheyou73v0_A07	18698444	18701221	BnaA07T0169000ZY	0	-	0	0	2777	0.0000000
zheyou73v0_A07	18702712	18704602	BnaA07T0169100ZY	0	-	0	0	1890	0.0000000
zheyou73v0_A07	18704914	18705914	BnaA07T0169200ZY	0	-	0	0	1000	0.0000000
zheyou73v0_A07	18707707	18710205	BnaA07T0169300ZY	0	+	0	0	2498	0.0000000
zheyou73v0_A07	18710412	18713491	BnaA07T0169400ZY	0	-	0	0	3079	0.0000000
zheyou73v0_A07	18713675	18715540	BnaA07T0169500ZY	0	+	0	0	1865	0.0000000
zheyou73v0_A07	18715586	18721734	BnaA07T0169600ZY	0	-	0	0	6148	0.0000000
zheyou73v0_A07	18725222	18725531	BnaA07T0169700ZY	0	-	0	0	309	0.0000000
zheyou73v0_A07	18737286	18737884	BnaA07T0169800ZY	0	+	0	0	598	0.0000000
zheyou73v0_A07	18743842	18746550	BnaA07T0169900ZY	0	-	0	0	2708	0.0000000
zheyou73v0_A07	18755750	18756020	BnaA07T0170000ZY	0	+	0	0	270	0.0000000
zheyou73v0_A07	18759644	18761263	BnaA07T0170100ZY	0	+	0	0	1619	0.0000000
zheyou73v0_A07	18765341	18772370	BnaA07T0170200ZY	0	+	0	0	7029	0.0000000
zheyou73v0_A07	18772603	18773836	BnaA07T0170300ZY	0	+	0	0	1233	0.0000000
zheyou73v0_A07	18774807	18776522	BnaA07T0170400ZY	0	+	0	0	1715	0.0000000
zheyou73v0_A07	18779121	18780023	BnaA07T0170500ZY	0	+	0	0	902	0.0000000
zheyou73v0_A07	18780570	18781966	BnaA07T0170600ZY	0	-	0	0	1396	0.0000000
zheyou73v0_A07	18782526	18788674	BnaA07T0170700ZY	0	-	0	0	6148	0.0000000
zheyou73v0_A07	18803816	18809238	BnaA07T0170800ZY	0	-	0	0	5422	0.0000000
zheyou73v0_A07	18810663	18813979	BnaA07T0170900ZY	0	+	0	0	3316	0.0000000
zheyou73v0_A07	18815258	18815870	BnaA07T0171000ZY	0	+	0	0	612	0.0000000
zheyou73v0_A07	18816796	18817573	BnaA07T0171100ZY	0	+	0	0	777	0.0000000
zheyou73v0_A07	18817713	18818844	BnaA07T0171200ZY	0	-	0	0	1131	0.0000000
zheyou73v0_A07	18819205	18819842	BnaA07T0171300ZY	0	+	0	0	637	0.0000000
zheyou73v0_A07	18820510	18822665	BnaA07T0171400ZY	0	+	0	0	2155	0.0000000
zheyou73v0_A07	18822990	18832715	BnaA07T0171500ZY	0	-	0	0	9725	0.0000000
zheyou73v0_A07	18842864	18847304	BnaA07T0171600ZY	0	+	0	0	4440	0.0000000
zheyou73v0_A07	18847508	18852200	BnaA07T0171700ZY	0	-	0	0	4692	0.0000000
zheyou73v0_A07	18852727	18854305	BnaA07T0171800ZY	0	+	0	0	1578	0.0000000
zheyou73v0_A07	18854306	18856574	BnaA07T0171900ZY	0	-	0	0	2268	0.0000000
zheyou73v0_A07	18854306	18856574	BnaA07T0171900ZY.1	0	-	0	0	2268	0.0000000
zheyou73v0_A07	18857259	18860768	BnaA07T0172000ZY	0	+	0	0	3509	0.0000000
zheyou73v0_A07	18862174	18867652	BnaA07T0172100ZY	0	+	0	0	5478	0.0000000
zheyou73v0_A07	18868565	18870399	BnaA07T0172200ZY	0	+	0	0	1834	0.0000000
zheyou73v0_A07	18870898	18878088	BnaA07T0172300ZY	0	+	0	0	7190	0.0000000
zheyou73v0_A07	18878899	18882815	BnaA07T0172400ZY	0	+	0	0	3916	0.0000000
zheyou73v0_A07	18883408	18885800	BnaA07T0172500ZY	0	+	0	0	2392	0.0000000
zheyou73v0_A07	18901076	18902895	BnaA07T0172600ZY	0	-	0	0	1819	0.0000000
zheyou73v0_A07	18903383	18905188	BnaA07T0172700ZY	0	-	0	0	1805	0.0000000
zheyou73v0_A07	18909505	18910999	BnaA07T0172800ZY	0	-	0	0	1494	0.0000000
zheyou73v0_A07	18916517	18917434	BnaA07T0172900ZY	0	+	0	0	917	0.0000000
zheyou73v0_A07	18919439	18921048	BnaA07T0173000ZY	0	+	0	0	1609	0.0000000
zheyou73v0_A07	18921127	18921571	BnaA07T0173100ZY	0	-	0	0	444	0.0000000
zheyou73v0_A07	18924788	18927384	BnaA07T0173200ZY	0	-	0	0	2596	0.0000000
zheyou73v0_A07	18933017	18934993	BnaA07T0173300ZY	0	-	0	0	1976	0.0000000
zheyou73v0_A07	18937284	18938548	BnaA07T0173400ZY	0	+	0	0	1264	0.0000000
zheyou73v0_A07	18946474	18948901	BnaA07T0173500ZY	0	+	0	0	2427	0.0000000
zheyou73v0_A07	18951046	18953436	BnaA07T0173600ZY	0	+	0	0	2390	0.0000000
zheyou73v0_A07	18953849	18956156	BnaA07T0173700ZY	0	-	0	0	2307	0.0000000
zheyou73v0_A07	18956811	18958660	BnaA07T0173800ZY	0	-	0	0	1849	0.0000000
zheyou73v0_A07	18964732	18967202	BnaA07T0173900ZY	0	+	0	0	2470	0.0000000
zheyou73v0_A07	18968271	18970560	BnaA07T0174000ZY	0	+	0	0	2289	0.0000000
zheyou73v0_A07	18971589	18978241	BnaA07T0174100ZY	0	-	0	0	6652	0.0000000
zheyou73v0_A07	18980202	18980841	BnaA07T0174200ZY	0	-	0	0	639	0.0000000
zheyou73v0_A07	18982454	18984897	BnaA07T0174300ZY	0	-	0	0	2443	0.0000000
zheyou73v0_A07	18985204	18986980	BnaA07T0174400ZY	0	-	0	0	1776	0.0000000
zheyou73v0_A07	18987369	18993518	BnaA07T0174500ZY	0	-	0	0	6149	0.0000000
zheyou73v0_A07	18987518	18993518	BnaA07T0174500ZY.1	0	-	0	0	6000	0.0000000
zheyou73v0_A07	19000276	19001904	BnaA07T0174600ZY	0	+	0	0	1628	0.0000000
zheyou73v0_A07	19003598	19004392	BnaA07T0174700ZY	0	+	0	0	794	0.0000000
zheyou73v0_A07	19004842	19006989	BnaA07T0174800ZY	0	-	0	0	2147	0.0000000
zheyou73v0_A07	19009865	19013354	BnaA07T0174900ZY	0	-	0	0	3489	0.0000000
zheyou73v0_A07	19031700	19036555	BnaA07T0175000ZY	0	-	0	0	4855	0.0000000
zheyou73v0_A07	19037269	19039714	BnaA07T0175100ZY	0	-	0	0	2445	0.0000000
zheyou73v0_A07	19040164	19044683	BnaA07T0175200ZY	0	+	0	0	4519	0.0000000
zheyou73v0_A07	19040164	19044044	BnaA07T0175200ZY.1	0	+	0	0	3880	0.0000000
zheyou73v0_A07	19045182	19046812	BnaA07T0175300ZY	0	+	0	0	1630	0.0000000
zheyou73v0_A07	19047203	19048481	BnaA07T0175400ZY	0	-	0	0	1278	0.0000000
zheyou73v0_A07	19050267	19051282	BnaA07T0175500ZY	0	+	0	0	1015	0.0000000
zheyou73v0_A07	19057313	19058152	BnaA07T0175600ZY	0	-	0	0	839	0.0000000
zheyou73v0_A07	19061530	19062944	BnaA07T0175700ZY	0	+	0	0	1414	0.0000000
zheyou73v0_A07	19063119	19065253	BnaA07T0175800ZY	0	+	0	0	2134	0.0000000
zheyou73v0_A07	19070819	19073557	BnaA07T0175900ZY	0	+	0	0	2738	0.0000000
zheyou73v0_A07	19071095	19073557	BnaA07T0175900ZY.1	0	+	0	0	2462	0.0000000
zheyou73v0_A07	19075134	19078132	BnaA07T0176000ZY	0	+	0	0	2998	0.0000000
zheyou73v0_A07	19078198	19078922	BnaA07T0176100ZY	0	+	0	0	724	0.0000000
zheyou73v0_A07	19079670	19083366	BnaA07T0176200ZY	0	-	0	0	3696	0.0000000
zheyou73v0_A07	19097132	19098748	BnaA07T0176300ZY	0	+	0	0	1616	0.0000000
zheyou73v0_A07	19098927	19100424	BnaA07T0176400ZY	0	-	0	0	1497	0.0000000
zheyou73v0_A07	19103801	19104801	BnaA07T0176500ZY	0	+	0	0	1000	0.0000000
zheyou73v0_A07	19105482	19107529	BnaA07T0176600ZY	0	+	0	0	2047	0.0000000
zheyou73v0_A07	19107838	19108624	BnaA07T0176700ZY	0	-	0	0	786	0.0000000
zheyou73v0_A07	19110499	19110923	BnaA07T0176800ZY	0	-	0	0	424	0.0000000
zheyou73v0_A07	19110929	19111921	BnaA07T0176900ZY	0	-	0	0	992	0.0000000
zheyou73v0_A07	19113816	19114861	BnaA07T0177000ZY	0	+	0	0	1045	0.0000000
zheyou73v0_A07	19114902	19117655	BnaA07T0177100ZY.1	0	-	0	0	2753	0.0000000
zheyou73v0_A07	19115343	19117655	BnaA07T0177100ZY	0	-	0	0	2312	0.0000000
zheyou73v0_A07	19120331	19122192	BnaA07T0177200ZY	0	+	0	0	1861	0.0000000
zheyou73v0_A07	19123213	19127555	BnaA07T0177300ZY	0	-	0	0	4342	0.0000000
zheyou73v0_A07	19130698	19143023	BnaA07T0177400ZY	0	+	0	0	12325	0.0000000
zheyou73v0_A07	19143247	19147001	BnaA07T0177500ZY	0	+	0	0	3754	0.0000000
zheyou73v0_A07	19147755	19150828	BnaA07T0177600ZY	0	+	0	0	3073	0.0000000
zheyou73v0_A07	19151246	19155414	BnaA07T0177700ZY	0	+	0	0	4168	0.0000000
zheyou73v0_A07	19151246	19155414	BnaA07T0177700ZY.1	0	+	0	0	4168	0.0000000
zheyou73v0_A07	19156894	19163717	BnaA07T0177800ZY	0	+	0	0	6823	0.0000000
zheyou73v0_A07	19167634	19169773	BnaA07T0177900ZY	0	+	0	0	2139	0.0000000
zheyou73v0_A07	19171833	19176326	BnaA07T0178000ZY	0	+	0	0	4493	0.0000000
zheyou73v0_A07	19176678	19181550	BnaA07T0178100ZY	0	-	0	0	4872	0.0000000
zheyou73v0_A07	19182061	19184030	BnaA07T0178200ZY	0	+	0	0	1969	0.0000000
zheyou73v0_A07	19186548	19189392	BnaA07T0178300ZY	0	+	0	0	2844	0.0000000
zheyou73v0_A07	19189955	19193050	BnaA07T0178400ZY	0	+	0	0	3095	0.0000000
zheyou73v0_A07	19195620	19196823	BnaA07T0178500ZY	0	+	0	0	1203	0.0000000
zheyou73v0_A07	19197135	19199912	BnaA07T0178600ZY.1	0	-	0	0	2777	0.0000000
zheyou73v0_A07	19197688	19199912	BnaA07T0178600ZY	0	-	0	0	2224	0.0000000
zheyou73v0_A07	19200731	19203332	BnaA07T0178700ZY	0	-	0	0	2601	0.0000000
zheyou73v0_A07	19209183	19211599	BnaA07T0178800ZY	0	-	0	0	2416	0.0000000
zheyou73v0_A07	19221277	19222847	BnaA07T0178900ZY	0	+	0	0	1570	0.0000000
zheyou73v0_A07	19230230	19231053	BnaA07T0179000ZY	0	+	0	0	823	0.0000000
zheyou73v0_A07	19231373	19233410	BnaA07T0179100ZY	0	-	0	0	2037	0.0000000
zheyou73v0_A07	19233956	19235254	BnaA07T0179200ZY	0	-	0	0	1298	0.0000000
zheyou73v0_A07	19236748	19249396	BnaA07T0179300ZY	0	+	0	0	12648	0.0000000
zheyou73v0_A07	19236748	19249396	BnaA07T0179300ZY.1	0	+	0	0	12648	0.0000000
zheyou73v0_A07	19249755	19252451	BnaA07T0179400ZY	0	-	0	0	2696	0.0000000
zheyou73v0_A07	19258147	19258425	BnaA07T0179500ZY	0	+	0	0	278	0.0000000
zheyou73v0_A07	19259047	19262018	BnaA07T0179600ZY	0	-	0	0	2971	0.0000000
zheyou73v0_A07	19262366	19264771	BnaA07T0179700ZY	0	+	0	0	2405	0.0000000
zheyou73v0_A07	19265194	19266171	BnaA07T0179800ZY	0	-	0	0	977	0.0000000
zheyou73v0_A07	19269533	19270560	BnaA07T0179900ZY	0	+	0	0	1027	0.0000000
zheyou73v0_A07	19271252	19271923	BnaA07T0180000ZY	0	+	0	0	671	0.0000000
zheyou73v0_A07	19273142	19273766	BnaA07T0180100ZY	0	+	0	0	624	0.0000000
zheyou73v0_A07	19275827	19276220	BnaA07T0180200ZY	0	+	0	0	393	0.0000000
zheyou73v0_A07	19280030	19283394	BnaA07T0180300ZY	0	+	0	0	3364	0.0000000
zheyou73v0_A07	19284305	19286895	BnaA07T0180400ZY	0	+	0	0	2590	0.0000000
zheyou73v0_A07	19287114	19287741	BnaA07T0180500ZY	0	-	0	0	627	0.0000000
zheyou73v0_A07	19290001	19292452	BnaA07T0180600ZY	0	+	0	0	2451	0.0000000
zheyou73v0_A07	19293162	19296088	BnaA07T0180700ZY	0	+	0	0	2926	0.0000000
zheyou73v0_A07	19296233	19298308	BnaA07T0180800ZY	0	+	0	0	2075	0.0000000
zheyou73v0_A07	19298577	19299317	BnaA07T0180900ZY	0	+	0	0	740	0.0000000
zheyou73v0_A07	19298577	19299628	BnaA07T0180900ZY.1	0	+	0	0	1051	0.0000000
zheyou73v0_A07	19298577	19299628	BnaA07T0180900ZY.2	0	+	0	0	1051	0.0000000
zheyou73v0_A07	19305172	19306718	BnaA07T0181000ZY	0	+	0	0	1546	0.0000000
zheyou73v0_A07	19310792	19319518	BnaA07T0181100ZY	0	-	0	0	8726	0.0000000
zheyou73v0_A07	19310792	19319253	BnaA07T0181100ZY.1	0	-	0	0	8461	0.0000000
zheyou73v0_A07	19323299	19323929	BnaA07T0181200ZY	0	+	0	0	630	0.0000000
zheyou73v0_A07	19325400	19326502	BnaA07T0181300ZY	0	+	0	0	1102	0.0000000
zheyou73v0_A07	19327459	19330214	BnaA07T0181400ZY	0	+	0	0	2755	0.0000000
zheyou73v0_A07	19330523	19334916	BnaA07T0181500ZY	0	-	0	0	4393	0.0000000
zheyou73v0_A07	19335184	19336699	BnaA07T0181600ZY	0	+	0	0	1515	0.0000000
zheyou73v0_A07	19336947	19338642	BnaA07T0181700ZY	0	-	0	0	1695	0.0000000
zheyou73v0_A07	19340770	19342257	BnaA07T0181800ZY	0	+	0	0	1487	0.0000000
zheyou73v0_A07	19346237	19346825	BnaA07T0181900ZY	0	+	0	0	588	0.0000000
zheyou73v0_A07	19346861	19347596	BnaA07T0182000ZY	0	+	0	0	735	0.0000000
zheyou73v0_A07	19351424	19352001	BnaA07T0182100ZY	0	+	0	0	577	0.0000000
zheyou73v0_A07	19356631	19358323	BnaA07T0182200ZY	0	-	0	0	1692	0.0000000
zheyou73v0_A07	19359997	19361400	BnaA07T0182300ZY	0	-	0	0	1403	0.0000000
zheyou73v0_A07	19363775	19365124	BnaA07T0182400ZY	0	-	0	0	1349	0.0000000
zheyou73v0_A07	19367109	19367502	BnaA07T0182500ZY	0	-	0	0	393	0.0000000
zheyou73v0_A07	19367525	19370680	BnaA07T0182600ZY	0	-	0	0	3155	0.0000000
zheyou73v0_A07	19371560	19371878	BnaA07T0182700ZY	0	-	0	0	318	0.0000000
zheyou73v0_A07	19377809	19379426	BnaA07T0182800ZY	0	+	0	0	1617	0.0000000
zheyou73v0_A07	19391747	19393195	BnaA07T0182900ZY	0	+	0	0	1448	0.0000000
zheyou73v0_A07	19393900	19394779	BnaA07T0183000ZY	0	-	0	0	879	0.0000000
zheyou73v0_A07	19395024	19396783	BnaA07T0183100ZY	0	-	0	0	1759	0.0000000
zheyou73v0_A07	19398486	19400695	BnaA07T0183200ZY	0	+	0	0	2209	0.0000000
zheyou73v0_A07	19402656	19405919	BnaA07T0183300ZY	0	-	0	0	3263	0.0000000
zheyou73v0_A07	19424379	19427976	BnaA07T0183400ZY	0	+	0	0	3597	0.0000000
zheyou73v0_A07	19424379	19427976	BnaA07T0183400ZY.1	0	+	0	0	3597	0.0000000
zheyou73v0_A07	19428227	19430095	BnaA07T0183500ZY	0	-	0	0	1868	0.0000000
zheyou73v0_A07	19431108	19436352	BnaA07T0183600ZY	0	+	0	0	5244	0.0000000
zheyou73v0_A07	19436820	19437695	BnaA07T0183700ZY	0	-	0	0	875	0.0000000
zheyou73v0_A07	19441910	19442246	BnaA07T0183800ZY	0	+	0	0	336	0.0000000
zheyou73v0_A07	19448261	19450803	BnaA07T0183900ZY	0	+	0	0	2542	0.0000000
zheyou73v0_A07	19451755	19453084	BnaA07T0184000ZY	0	-	0	0	1329	0.0000000
zheyou73v0_A07	19458196	19460031	BnaA07T0184100ZY	0	-	0	0	1835	0.0000000
zheyou73v0_A07	19461745	19462054	BnaA07T0184200ZY	0	-	0	0	309	0.0000000
zheyou73v0_A07	19478012	19478891	BnaA07T0184300ZY	0	-	0	0	879	0.0000000
zheyou73v0_A07	19485626	19486666	BnaA07T0184400ZY	0	+	0	0	1040	0.0000000
zheyou73v0_A07	19486736	19487244	BnaA07T0184500ZY	0	-	0	0	508	0.0000000
zheyou73v0_A07	19487808	19488857	BnaA07T0184600ZY	0	+	0	0	1049	0.0000000
zheyou73v0_A07	19489181	19493072	BnaA07T0184700ZY	0	-	0	0	3891	0.0000000
zheyou73v0_A07	19501423	19501982	BnaA07T0184800ZY	0	-	0	0	559	0.0000000
zheyou73v0_A07	19510519	19512242	BnaA07T0184900ZY	0	-	0	0	1723	0.0000000
zheyou73v0_A07	19512857	19514473	BnaA07T0185000ZY	0	-	0	0	1616	0.0000000
zheyou73v0_A07	19520878	19521559	BnaA07T0185100ZY	0	+	0	0	681	0.0000000
zheyou73v0_A07	19524097	19526045	BnaA07T0185200ZY	0	+	0	0	1948	0.0000000
zheyou73v0_A07	19535434	19539147	BnaA07T0185300ZY	0	+	0	0	3713	0.0000000
zheyou73v0_A07	19541716	19547906	BnaA07T0185400ZY	0	-	0	0	6190	0.0000000
zheyou73v0_A07	19552680	19555742	BnaA07T0185500ZY	0	-	0	0	3062	0.0000000
zheyou73v0_A07	19555933	19557063	BnaA07T0185600ZY	0	-	0	0	1130	0.0000000
zheyou73v0_A07	19557685	19559091	BnaA07T0185700ZY	0	-	0	0	1406	0.0000000
zheyou73v0_A07	19561399	19564061	BnaA07T0185800ZY	0	+	0	0	2662	0.0000000
zheyou73v0_A07	19571856	19573753	BnaA07T0185900ZY	0	+	0	0	1897	0.0000000
zheyou73v0_A07	19573823	19576237	BnaA07T0186000ZY	0	+	0	0	2414	0.0000000
zheyou73v0_A07	19579300	19579617	BnaA07T0186100ZY	0	-	0	0	317	0.0000000
zheyou73v0_A07	19588830	19589178	BnaA07T0186200ZY	0	+	0	0	348	0.0000000
zheyou73v0_A07	19589884	19603399	BnaA07T0186300ZY	0	-	0	0	13515	0.0000000
zheyou73v0_A07	19615032	19617845	BnaA07T0186400ZY	0	+	0	0	2813	0.0000000
zheyou73v0_A07	19617963	19618406	BnaA07T0186500ZY	0	+	0	0	443	0.0000000
zheyou73v0_A07	19619601	19620375	BnaA07T0186600ZY	0	+	0	0	774	0.0000000
zheyou73v0_A07	19621357	19623033	BnaA07T0186700ZY	0	-	0	0	1676	0.0000000
zheyou73v0_A07	19628876	19630387	BnaA07T0186800ZY	0	-	0	0	1511	0.0000000
zheyou73v0_A07	19642299	19644601	BnaA07T0186900ZY	0	+	0	0	2302	0.0000000
zheyou73v0_A07	19644654	19651971	BnaA07T0187000ZY	0	-	0	0	7317	0.0000000
zheyou73v0_A07	19660732	19661164	BnaA07T0187100ZY	0	+	0	0	432	0.0000000
zheyou73v0_A07	19668216	19669936	BnaA07T0187200ZY	0	+	0	0	1720	0.0000000
zheyou73v0_A07	19670339	19674023	BnaA07T0187300ZY	0	-	0	0	3684	0.0000000
zheyou73v0_A07	19676320	19678678	BnaA07T0187400ZY	0	+	0	0	2358	0.0000000
zheyou73v0_A07	19676320	19678678	BnaA07T0187400ZY.1	0	+	0	0	2358	0.0000000
zheyou73v0_A07	19681032	19682851	BnaA07T0187500ZY	0	-	0	0	1819	0.0000000
zheyou73v0_A07	19683501	19687317	BnaA07T0187600ZY	0	+	0	0	3816	0.0000000
zheyou73v0_A07	19688286	19688810	BnaA07T0187700ZY	0	-	0	0	524	0.0000000
zheyou73v0_A07	19688890	19690208	BnaA07T0187800ZY	0	-	0	0	1318	0.0000000
zheyou73v0_A07	19692476	19696374	BnaA07T0187900ZY	0	-	0	0	3898	0.0000000
zheyou73v0_A07	19698007	19700982	BnaA07T0188000ZY	0	-	0	0	2975	0.0000000
zheyou73v0_A07	19703659	19705110	BnaA07T0188100ZY	0	+	0	0	1451	0.0000000
zheyou73v0_A07	19705947	19707748	BnaA07T0188200ZY	0	+	0	0	1801	0.0000000
zheyou73v0_A07	19714539	19715510	BnaA07T0188300ZY	0	+	0	0	971	0.0000000
zheyou73v0_A07	19720645	19721392	BnaA07T0188400ZY	0	-	0	0	747	0.0000000
zheyou73v0_A07	19728148	19728695	BnaA07T0188500ZY	0	+	0	0	547	0.0000000
zheyou73v0_A07	19733172	19738301	BnaA07T0188600ZY	0	-	0	0	5129	0.0000000
zheyou73v0_A07	19750756	19752238	BnaA07T0188700ZY	0	-	0	0	1482	0.0000000
zheyou73v0_A07	19756892	19758246	BnaA07T0188800ZY	0	+	0	0	1354	0.0000000
zheyou73v0_A07	19758254	19758764	BnaA07T0188900ZY	0	+	0	0	510	0.0000000
zheyou73v0_A07	19765926	19768804	BnaA07T0189000ZY	0	-	0	0	2878	0.0000000
zheyou73v0_A07	19775536	19777071	BnaA07T0189100ZY	0	-	0	0	1535	0.0000000
zheyou73v0_A07	19779032	19779919	BnaA07T0189200ZY	0	+	0	0	887	0.0000000
zheyou73v0_A07	19780216	19786295	BnaA07T0189300ZY	0	-	0	0	6079	0.0000000
zheyou73v0_A07	19790574	19791331	BnaA07T0189400ZY	0	+	0	0	757	0.0000000
zheyou73v0_A07	19792040	19792490	BnaA07T0189500ZY	0	-	0	0	450	0.0000000
zheyou73v0_A07	19793193	19796193	BnaA07T0189600ZY	0	-	0	0	3000	0.0000000
zheyou73v0_A07	19797398	19799199	BnaA07T0189700ZY	0	+	0	0	1801	0.0000000
zheyou73v0_A07	19797398	19799199	BnaA07T0189700ZY.1	0	+	0	0	1801	0.0000000
zheyou73v0_A07	19800573	19802449	BnaA07T0189800ZY	0	+	0	0	1876	0.0000000
zheyou73v0_A07	19804030	19804704	BnaA07T0189900ZY	0	+	0	0	674	0.0000000
zheyou73v0_A07	19808453	19809128	BnaA07T0190000ZY	0	-	0	0	675	0.0000000
zheyou73v0_A07	19817390	19818335	BnaA07T0190100ZY	0	-	0	0	945	0.0000000
zheyou73v0_A07	19823084	19824232	BnaA07T0190200ZY	0	-	0	0	1148	0.0000000
zheyou73v0_A07	19833846	19835754	BnaA07T0190300ZY	0	-	0	0	1908	0.0000000
zheyou73v0_A07	19833846	19835754	BnaA07T0190300ZY.1	0	-	0	0	1908	0.0000000
zheyou73v0_A07	19841700	19842596	BnaA07T0190400ZY	0	-	0	0	896	0.0000000
zheyou73v0_A07	19850060	19851468	BnaA07T0190500ZY	0	+	0	0	1408	0.0000000
zheyou73v0_A07	19852716	19856714	BnaA07T0190600ZY	0	+	0	0	3998	0.0000000
zheyou73v0_A07	19861339	19862155	BnaA07T0190700ZY	0	-	0	0	816	0.0000000
zheyou73v0_A07	19869270	19870566	BnaA07T0190800ZY	0	-	0	0	1296	0.0000000
zheyou73v0_A07	19871147	19871742	BnaA07T0190900ZY	0	+	0	0	595	0.0000000
zheyou73v0_A07	19873358	19875220	BnaA07T0191000ZY	0	+	0	0	1862	0.0000000
zheyou73v0_A07	19878510	19881277	BnaA07T0191100ZY	0	+	0	0	2767	0.0000000
zheyou73v0_A07	19881687	19882431	BnaA07T0191200ZY	0	+	0	0	744	0.0000000
zheyou73v0_A07	19882922	19884772	BnaA07T0191300ZY	0	-	0	0	1850	0.0000000
zheyou73v0_A07	19886411	19887406	BnaA07T0191400ZY	0	+	0	0	995	0.0000000
zheyou73v0_A07	19890312	19892749	BnaA07T0191500ZY	0	+	0	0	2437	0.0000000
zheyou73v0_A07	19895810	19898643	BnaA07T0191600ZY	0	+	0	0	2833	0.0000000
zheyou73v0_A07	19904238	19904735	BnaA07T0191700ZY	0	-	0	0	497	0.0000000
zheyou73v0_A07	19905284	19906252	BnaA07T0191800ZY	0	-	0	0	968	0.0000000
zheyou73v0_A07	19910795	19911855	BnaA07T0191900ZY	0	+	0	0	1060	0.0000000
zheyou73v0_A07	19924897	19927738	BnaA07T0192000ZY	0	+	0	0	2841	0.0000000
zheyou73v0_A07	19928498	19929560	BnaA07T0192100ZY	0	+	0	0	1062	0.0000000
zheyou73v0_A07	19930896	19932245	BnaA07T0192200ZY	0	-	0	0	1349	0.0000000
zheyou73v0_A07	19934522	19936843	BnaA07T0192300ZY	0	-	0	0	2321	0.0000000
zheyou73v0_A07	19934522	19936843	BnaA07T0192300ZY.1	0	-	0	0	2321	0.0000000
zheyou73v0_A07	19943955	19946177	BnaA07T0192400ZY	0	-	0	0	2222	0.0000000
zheyou73v0_A07	19943955	19946177	BnaA07T0192400ZY.1	0	-	0	0	2222	0.0000000
zheyou73v0_A07	19956813	19959880	BnaA07T0192500ZY	0	-	0	0	3067	0.0000000
zheyou73v0_A07	19962501	19963190	BnaA07T0192600ZY	0	-	0	0	689	0.0000000
zheyou73v0_A07	19965499	19965847	BnaA07T0192700ZY	0	-	0	0	348	0.0000000
zheyou73v0_A07	19968602	19969724	BnaA07T0192800ZY	0	+	0	0	1122	0.0000000
zheyou73v0_A07	19970401	19971992	BnaA07T0192900ZY.1	0	+	0	0	1591	0.0000000
zheyou73v0_A07	19970424	19971992	BnaA07T0192900ZY	0	+	0	0	1568	0.0000000
zheyou73v0_A07	19981968	19982795	BnaA07T0193000ZY	0	+	0	0	827	0.0000000
zheyou73v0_A07	19983593	19985606	BnaA07T0193100ZY	0	+	0	0	2013	0.0000000
zheyou73v0_A07	19988061	19988778	BnaA07T0193200ZY	0	-	0	0	717	0.0000000
zheyou73v0_A07	19992002	19992602	BnaA07T0193300ZY	0	-	0	0	600	0.0000000
zheyou73v0_A07	19998362	19998836	BnaA07T0193400ZY	0	+	0	0	474	0.0000000
zheyou73v0_A07	20002217	20003495	BnaA07T0193500ZY	0	-	0	0	1278	0.0000000
zheyou73v0_A07	20023145	20024799	BnaA07T0193600ZY	0	+	0	0	1654	0.0000000
zheyou73v0_A07	20028300	20030093	BnaA07T0193700ZY	0	+	0	0	1793	0.0000000
zheyou73v0_A07	20040509	20042885	BnaA07T0193800ZY	0	+	0	0	2376	0.0000000
zheyou73v0_A07	20043813	20044428	BnaA07T0193900ZY	0	-	0	0	615	0.0000000
zheyou73v0_A07	20063802	20065936	BnaA07T0194000ZY	0	+	0	0	2134	0.0000000
zheyou73v0_A07	20066544	20067096	BnaA07T0194100ZY	0	-	0	0	552	0.0000000
zheyou73v0_A07	20073437	20074184	BnaA07T0194200ZY	0	-	0	0	747	0.0000000
zheyou73v0_A07	20086344	20087822	BnaA07T0194300ZY	0	+	0	0	1478	0.0000000
zheyou73v0_A07	20092130	20095833	BnaA07T0194400ZY	0	+	0	0	3703	0.0000000
zheyou73v0_A07	20092130	20095833	BnaA07T0194400ZY.1	0	+	0	0	3703	0.0000000
zheyou73v0_A07	20099405	20101254	BnaA07T0194500ZY	0	+	0	0	1849	0.0000000
zheyou73v0_A07	20107476	20108512	BnaA07T0194600ZY	0	-	0	0	1036	0.0000000
zheyou73v0_A07	20113333	20115631	BnaA07T0194700ZY	0	-	0	0	2298	0.0000000
zheyou73v0_A07	20120300	20123335	BnaA07T0194800ZY	0	+	0	0	3035	0.0000000
zheyou73v0_A07	20124298	20128737	BnaA07T0194900ZY	0	-	0	0	4439	0.0000000
zheyou73v0_A07	20130255	20140792	BnaA07T0195000ZY	0	-	0	0	10537	0.0000000
zheyou73v0_A07	20142338	20145185	BnaA07T0195100ZY	0	+	0	0	2847	0.0000000
zheyou73v0_A07	20142338	20145185	BnaA07T0195100ZY.1	0	+	0	0	2847	0.0000000
zheyou73v0_A07	20145553	20145819	BnaA07T0195200ZY	0	-	0	0	266	0.0000000
zheyou73v0_A07	20147902	20148900	BnaA07T0195300ZY	0	+	0	0	998	0.0000000
zheyou73v0_A07	20152324	20155274	BnaA07T0195400ZY	0	+	0	0	2950	0.0000000
zheyou73v0_A07	20152324	20155274	BnaA07T0195400ZY.1	0	+	0	0	2950	0.0000000
zheyou73v0_A07	20155357	20156028	BnaA07T0195500ZY	0	-	0	0	671	0.0000000
zheyou73v0_A07	20156360	20164545	BnaA07T0195600ZY	0	-	0	0	8185	0.0000000
zheyou73v0_A07	20156360	20164545	BnaA07T0195600ZY.1	0	-	0	0	8185	0.0000000
zheyou73v0_A07	20166364	20168626	BnaA07T0195700ZY	0	-	0	0	2262	0.0000000
zheyou73v0_A07	20170333	20172393	BnaA07T0195800ZY	0	+	0	0	2060	0.0000000
zheyou73v0_A07	20173536	20175259	BnaA07T0195900ZY	0	+	0	0	1723	0.0000000
zheyou73v0_A07	20175637	20176998	BnaA07T0196000ZY	0	+	0	0	1361	0.0000000
zheyou73v0_A07	20176878	20178571	BnaA07T0196100ZY	0	-	0	0	1693	0.0000000
zheyou73v0_A07	20183020	20183500	BnaA07T0196200ZY	0	+	0	0	480	0.0000000
zheyou73v0_A07	20183601	20184692	BnaA07T0196300ZY	0	-	0	0	1091	0.0000000
zheyou73v0_A07	20185775	20187034	BnaA07T0196400ZY	0	-	0	0	1259	0.0000000
zheyou73v0_A07	20189648	20190841	BnaA07T0196500ZY	0	+	0	0	1193	0.0000000
zheyou73v0_A07	20194713	20197970	BnaA07T0196600ZY	0	+	0	0	3257	0.0000000
zheyou73v0_A07	20199724	20201296	BnaA07T0196700ZY	0	+	0	0	1572	0.0000000
zheyou73v0_A07	20202808	20204512	BnaA07T0196800ZY	0	-	0	0	1704	0.0000000
zheyou73v0_A07	20205224	20206185	BnaA07T0196900ZY	0	-	0	0	961	0.0000000
zheyou73v0_A07	20209036	20212036	BnaA07T0197000ZY	0	+	0	0	3000	0.0000000
zheyou73v0_A07	20212539	20215370	BnaA07T0197100ZY	0	+	0	0	2831	0.0000000
zheyou73v0_A07	20216172	20217644	BnaA07T0197200ZY.1	0	+	0	0	1472	0.0000000
zheyou73v0_A07	20216213	20217644	BnaA07T0197200ZY	0	+	0	0	1431	0.0000000
zheyou73v0_A07	20218610	20220023	BnaA07T0197300ZY	0	+	0	0	1413	0.0000000
zheyou73v0_A07	20220851	20221687	BnaA07T0197400ZY	0	+	0	0	836	0.0000000
zheyou73v0_A07	20222866	20225813	BnaA07T0197500ZY	0	+	0	0	2947	0.0000000
zheyou73v0_A07	20226218	20228643	BnaA07T0197600ZY	0	-	0	0	2425	0.0000000
zheyou73v0_A07	20230448	20234019	BnaA07T0197700ZY	0	-	0	0	3571	0.0000000
zheyou73v0_A07	20235479	20238681	BnaA07T0197800ZY	0	-	0	0	3202	0.0000000
zheyou73v0_A07	20243304	20247031	BnaA07T0197900ZY	0	-	0	0	3727	0.0000000
zheyou73v0_A07	20243304	20247031	BnaA07T0197900ZY.1	0	-	0	0	3727	0.0000000
zheyou73v0_A07	20243304	20247031	BnaA07T0197900ZY.2	0	-	0	0	3727	0.0000000
zheyou73v0_A07	20254970	20259860	BnaA07T0198000ZY	0	-	0	0	4890	0.0000000
zheyou73v0_A07	20267644	20268309	BnaA07T0198100ZY	0	+	0	0	665	0.0000000
zheyou73v0_A07	20274446	20276472	BnaA07T0198200ZY	0	-	0	0	2026	0.0000000
zheyou73v0_A07	20274446	20276472	BnaA07T0198200ZY.1	0	-	0	0	2026	0.0000000
zheyou73v0_A07	20293465	20294611	BnaA07T0198300ZY	0	+	0	0	1146	0.0000000
zheyou73v0_A07	20295908	20297405	BnaA07T0198400ZY	0	-	0	0	1497	0.0000000
zheyou73v0_A07	20299465	20301654	BnaA07T0198500ZY	0	-	0	0	2189	0.0000000
zheyou73v0_A07	20329270	20331757	BnaA07T0198600ZY	0	-	0	0	2487	0.0000000
zheyou73v0_A07	20340135	20345016	BnaA07T0198700ZY	0	+	0	0	4881	0.0000000
zheyou73v0_A07	20347397	20349697	BnaA07T0198800ZY	0	+	0	0	2300	0.0000000
zheyou73v0_A07	20350625	20352667	BnaA07T0198900ZY	0	+	0	0	2042	0.0000000
zheyou73v0_A07	20352951	20353456	BnaA07T0199000ZY	0	-	0	0	505	0.0000000
zheyou73v0_A07	20368303	20372207	BnaA07T0199100ZY	0	-	0	0	3904	0.0000000
zheyou73v0_A07	20381746	20383535	BnaA07T0199200ZY	0	+	0	0	1789	0.0000000
zheyou73v0_A07	20385011	20386415	BnaA07T0199300ZY	0	-	0	0	1404	0.0000000
zheyou73v0_A07	20386850	20388521	BnaA07T0199400ZY	0	-	0	0	1671	0.0000000
zheyou73v0_A07	20389542	20394344	BnaA07T0199500ZY	0	+	0	0	4802	0.0000000
zheyou73v0_A07	20394755	20395649	BnaA07T0199600ZY	0	+	0	0	894	0.0000000
zheyou73v0_A07	20396339	20400920	BnaA07T0199700ZY	0	+	0	0	4581	0.0000000
zheyou73v0_A07	20401319	20402917	BnaA07T0199800ZY	0	-	0	0	1598	0.0000000
zheyou73v0_A07	20405768	20424411	BnaA07T0199900ZY	0	+	0	0	18643	0.0000000
zheyou73v0_A07	20425843	20427540	BnaA07T0200000ZY	0	-	0	0	1697	0.0000000
zheyou73v0_A07	20433972	20435976	BnaA07T0200100ZY	0	-	0	0	2004	0.0000000
zheyou73v0_A07	20442580	20443775	BnaA07T0200200ZY	0	+	0	0	1195	0.0000000
zheyou73v0_A07	20444218	20447235	BnaA07T0200300ZY	0	-	0	0	3017	0.0000000
zheyou73v0_A07	20450944	20451679	BnaA07T0200400ZY	0	-	0	0	735	0.0000000
zheyou73v0_A07	20453306	20455066	BnaA07T0200500ZY	0	-	0	0	1760	0.0000000
zheyou73v0_A07	20456929	20457463	BnaA07T0200600ZY	0	+	0	0	534	0.0000000
zheyou73v0_A07	20458247	20464085	BnaA07T0200700ZY	0	+	0	0	5838	0.0000000
zheyou73v0_A07	20464826	20466908	BnaA07T0200800ZY	0	+	0	0	2082	0.0000000
zheyou73v0_A07	20467695	20469391	BnaA07T0200900ZY	0	+	0	0	1696	0.0000000
zheyou73v0_A07	20467695	20469078	BnaA07T0200900ZY.1	0	+	0	0	1383	0.0000000
zheyou73v0_A07	20479900	20483670	BnaA07T0201000ZY	0	+	0	0	3770	0.0000000
zheyou73v0_A07	20483932	20484623	BnaA07T0201100ZY	0	-	0	0	691	0.0000000
zheyou73v0_A07	20486984	20488382	BnaA07T0201200ZY	0	+	0	0	1398	0.0000000
zheyou73v0_A07	20490619	20492945	BnaA07T0201300ZY	0	+	0	0	2326	0.0000000
zheyou73v0_A07	20497176	20499743	BnaA07T0201400ZY	0	+	0	0	2567	0.0000000
zheyou73v0_A07	20504885	20509703	BnaA07T0201500ZY	0	+	0	0	4818	0.0000000
zheyou73v0_A07	20510266	20511477	BnaA07T0201600ZY	0	-	0	0	1211	0.0000000
zheyou73v0_A07	20513201	20514347	BnaA07T0201700ZY	0	+	0	0	1146	0.0000000
zheyou73v0_A07	20518059	20519020	BnaA07T0201800ZY	0	+	0	0	961	0.0000000
zheyou73v0_A07	20527520	20529488	BnaA07T0201900ZY	0	+	0	0	1968	0.0000000
zheyou73v0_A07	20529923	20530445	BnaA07T0202000ZY	0	-	0	0	522	0.0000000
zheyou73v0_A07	20530936	20531226	BnaA07T0202100ZY	0	+	0	0	290	0.0000000
zheyou73v0_A07	20532444	20535320	BnaA07T0202200ZY	0	+	0	0	2876	0.0000000
zheyou73v0_A07	20535919	20548961	BnaA07T0202300ZY	0	-	0	0	13042	0.0000000
zheyou73v0_A07	20554909	20555684	BnaA07T0202400ZY	0	+	0	0	775	0.0000000
zheyou73v0_A07	20556496	20557615	BnaA07T0202500ZY	0	+	0	0	1119	0.0000000
zheyou73v0_A07	20562035	20563277	BnaA07T0202600ZY	0	+	0	0	1242	0.0000000
zheyou73v0_A07	20565920	20569234	BnaA07T0202700ZY	0	-	0	0	3314	0.0000000
zheyou73v0_A07	20571480	20572062	BnaA07T0202800ZY	0	-	0	0	582	0.0000000
zheyou73v0_A07	20572220	20576873	BnaA07T0202900ZY	0	-	0	0	4653	0.0000000
zheyou73v0_A07	20579620	20583371	BnaA07T0203000ZY	0	+	0	0	3751	0.0000000
zheyou73v0_A07	20586253	20592066	BnaA07T0203100ZY	0	+	0	0	5813	0.0000000
zheyou73v0_A07	20592948	20594521	BnaA07T0203200ZY	0	+	0	0	1573	0.0000000
zheyou73v0_A07	20604612	20605221	BnaA07T0203300ZY	0	+	0	0	609	0.0000000
zheyou73v0_A07	20607204	20608720	BnaA07T0203400ZY	0	+	0	0	1516	0.0000000
zheyou73v0_A07	20611600	20613417	BnaA07T0203500ZY	0	+	0	0	1817	0.0000000
zheyou73v0_A07	20615555	20616516	BnaA07T0203600ZY	0	+	0	0	961	0.0000000
zheyou73v0_A07	20617722	20618680	BnaA07T0203700ZY	0	-	0	0	958	0.0000000
zheyou73v0_A07	20619201	20622755	BnaA07T0203800ZY	0	-	0	0	3554	0.0000000
zheyou73v0_A07	20623007	20623876	BnaA07T0203900ZY	0	+	0	0	869	0.0000000
zheyou73v0_A07	20628721	20628955	BnaA07T0204000ZY	0	+	0	0	234	0.0000000
zheyou73v0_A07	20630006	20631473	BnaA07T0204100ZY	0	-	0	0	1467	0.0000000
zheyou73v0_A07	20632797	20635492	BnaA07T0204200ZY	0	-	0	0	2695	0.0000000
zheyou73v0_A07	20637761	20641956	BnaA07T0204300ZY	0	-	0	0	4195	0.0000000
zheyou73v0_A07	20644043	20647405	BnaA07T0204400ZY	0	-	0	0	3362	0.0000000
zheyou73v0_A07	20648119	20651439	BnaA07T0204500ZY	0	+	0	0	3320	0.0000000
zheyou73v0_A07	20653024	20658626	BnaA07T0204600ZY	0	+	0	0	5602	0.0000000
zheyou73v0_A07	20658550	20661720	BnaA07T0204700ZY	0	-	0	0	3170	0.0000000
zheyou73v0_A07	20669447	20670700	BnaA07T0204800ZY	0	-	0	0	1253	0.0000000
zheyou73v0_A07	20677144	20678816	BnaA07T0204900ZY	0	-	0	0	1672	0.0000000
zheyou73v0_A07	20683851	20686406	BnaA07T0205000ZY	0	+	0	0	2555	0.0000000
zheyou73v0_A07	20692989	20694766	BnaA07T0205100ZY	0	+	0	0	1777	0.0000000
zheyou73v0_A07	20695276	20696686	BnaA07T0205200ZY	0	+	0	0	1410	0.0000000
zheyou73v0_A07	20697675	20698842	BnaA07T0205300ZY	0	-	0	0	1167	0.0000000
zheyou73v0_A07	20702011	20703883	BnaA07T0205400ZY	0	-	0	0	1872	0.0000000
zheyou73v0_A07	20716965	20718357	BnaA07T0205500ZY	0	-	0	0	1392	0.0000000
zheyou73v0_A07	20719445	20720350	BnaA07T0205600ZY	0	+	0	0	905	0.0000000
zheyou73v0_A07	20726859	20728294	BnaA07T0205700ZY	0	+	0	0	1435	0.0000000
zheyou73v0_A07	20729066	20730239	BnaA07T0205800ZY	0	-	0	0	1173	0.0000000
zheyou73v0_A07	20729066	20730239	BnaA07T0205800ZY.1	0	-	0	0	1173	0.0000000
zheyou73v0_A07	20730614	20731173	BnaA07T0205900ZY	0	-	0	0	559	0.0000000
zheyou73v0_A07	20746335	20747569	BnaA07T0206000ZY	0	+	0	0	1234	0.0000000
zheyou73v0_A07	20750046	20752196	BnaA07T0206100ZY	0	-	0	0	2150	0.0000000
zheyou73v0_A07	20755258	20757629	BnaA07T0206200ZY	0	-	0	0	2371	0.0000000
zheyou73v0_A07	20764787	20765744	BnaA07T0206300ZY	0	+	0	0	957	0.0000000
zheyou73v0_A07	20767797	20769680	BnaA07T0206400ZY	0	+	0	0	1883	0.0000000
zheyou73v0_A07	20770061	20771019	BnaA07T0206500ZY	0	-	0	0	958	0.0000000
zheyou73v0_A07	20772511	20773150	BnaA07T0206600ZY	0	+	0	0	639	0.0000000
zheyou73v0_A07	20773675	20777963	BnaA07T0206700ZY	0	-	0	0	4288	0.0000000
zheyou73v0_A07	20781972	20784474	BnaA07T0206800ZY	0	-	0	0	2502	0.0000000
zheyou73v0_A07	20791429	20791886	BnaA07T0206900ZY	0	+	0	0	457	0.0000000
zheyou73v0_A07	20797952	20799350	BnaA07T0207000ZY	0	+	0	0	1398	0.0000000
zheyou73v0_A07	20800462	20802963	BnaA07T0207100ZY	0	+	0	0	2501	0.0000000
zheyou73v0_A07	20802186	20805495	BnaA07T0207200ZY	0	-	0	0	3309	0.0000000
zheyou73v0_A07	20811753	20813056	BnaA07T0207300ZY	0	-	0	0	1303	0.0000000
zheyou73v0_A07	20813425	20815425	BnaA07T0207400ZY	0	+	0	0	2000	0.0000000
zheyou73v0_A07	20813425	20814702	BnaA07T0207400ZY.1	0	+	0	0	1277	0.0000000
zheyou73v0_A07	20820347	20822640	BnaA07T0207500ZY	0	-	0	0	2293	0.0000000
zheyou73v0_A07	20824649	20830286	BnaA07T0207600ZY	0	-	0	0	5637	0.0000000
zheyou73v0_A07	20831087	20833551	BnaA07T0207700ZY	0	-	0	0	2464	0.0000000
zheyou73v0_A07	20834195	20836310	BnaA07T0207800ZY	0	-	0	0	2115	0.0000000
zheyou73v0_A07	20837168	20841440	BnaA07T0207900ZY	0	-	0	0	4272	0.0000000
zheyou73v0_A07	20842189	20845257	BnaA07T0208000ZY	0	-	0	0	3068	0.0000000
zheyou73v0_A07	20846793	20849104	BnaA07T0208100ZY	0	-	0	0	2311	0.0000000
zheyou73v0_A07	20851454	20853355	BnaA07T0208200ZY	0	-	0	0	1901	0.0000000
zheyou73v0_A07	20854369	20854750	BnaA07T0208300ZY	0	-	0	0	381	0.0000000
zheyou73v0_A07	20859246	20860636	BnaA07T0208400ZY	0	-	0	0	1390	0.0000000
zheyou73v0_A07	20861239	20861990	BnaA07T0208500ZY	0	+	0	0	751	0.0000000
zheyou73v0_A07	20868524	20869279	BnaA07T0208600ZY	0	-	0	0	755	0.0000000
zheyou73v0_A07	20877778	20884107	BnaA07T0208700ZY	0	+	0	0	6329	0.0000000
zheyou73v0_A07	20884693	20888159	BnaA07T0208800ZY	0	-	0	0	3466	0.0000000
zheyou73v0_A07	20889072	20891045	BnaA07T0208900ZY	0	-	0	0	1973	0.0000000
zheyou73v0_A07	20892116	20894498	BnaA07T0209000ZY	0	-	0	0	2382	0.0000000
zheyou73v0_A07	20892116	20894498	BnaA07T0209000ZY.1	0	-	0	0	2382	0.0000000
zheyou73v0_A07	20921349	20922774	BnaA07T0209100ZY	0	+	0	0	1425	0.0000000
zheyou73v0_A07	20921349	20922774	BnaA07T0209100ZY.1	0	+	0	0	1425	0.0000000
zheyou73v0_A07	20921349	20922774	BnaA07T0209100ZY.2	0	+	0	0	1425	0.0000000
zheyou73v0_A07	20924355	20924760	BnaA07T0209200ZY	0	+	0	0	405	0.0000000
zheyou73v0_A07	20926201	20928230	BnaA07T0209300ZY	0	-	0	0	2029	0.0000000
zheyou73v0_A07	20928887	20932418	BnaA07T0209400ZY	0	-	0	0	3531	0.0000000
zheyou73v0_A07	20935342	20942247	BnaA07T0209500ZY	0	-	0	0	6905	0.0000000
zheyou73v0_A07	20935342	20942118	BnaA07T0209500ZY.1	0	-	0	0	6776	0.0000000
zheyou73v0_A07	20943328	20945805	BnaA07T0209600ZY	0	-	0	0	2477	0.0000000
zheyou73v0_A07	20946042	20947549	BnaA07T0209700ZY	0	+	0	0	1507	0.0000000
zheyou73v0_A07	20948443	20951463	BnaA07T0209800ZY	0	+	0	0	3020	0.0000000
zheyou73v0_A07	20964501	20967884	BnaA07T0209900ZY	0	+	0	0	3383	0.0000000
zheyou73v0_A07	20964501	20967884	BnaA07T0209900ZY.1	0	+	0	0	3383	0.0000000
zheyou73v0_A07	20968648	20969845	BnaA07T0210000ZY	0	+	0	0	1197	0.0000000
zheyou73v0_A07	20973429	20974829	BnaA07T0210100ZY	0	+	0	0	1400	0.0000000
zheyou73v0_A07	20977792	20979192	BnaA07T0210200ZY	0	+	0	0	1400	0.0000000
zheyou73v0_A07	20980548	20982634	BnaA07T0210300ZY	0	-	0	0	2086	0.0000000
zheyou73v0_A07	20997441	20999575	BnaA07T0210400ZY	0	+	0	0	2134	0.0000000
zheyou73v0_A07	21001586	21003667	BnaA07T0210500ZY	0	+	0	0	2081	0.0000000
zheyou73v0_A07	21004434	21006950	BnaA07T0210600ZY	0	-	0	0	2516	0.0000000
zheyou73v0_A07	21008068	21010535	BnaA07T0210700ZY	0	+	0	0	2467	0.0000000
zheyou73v0_A07	21010575	21012068	BnaA07T0210800ZY	0	-	0	0	1493	0.0000000
zheyou73v0_A07	21014318	21014861	BnaA07T0210900ZY	0	-	0	0	543	0.0000000
zheyou73v0_A07	21034933	21036908	BnaA07T0211000ZY	0	+	0	0	1975	0.0000000
zheyou73v0_A07	21037914	21040160	BnaA07T0211100ZY	0	+	0	0	2246	0.0000000
zheyou73v0_A07	21041513	21043777	BnaA07T0211200ZY	0	-	0	0	2264	0.0000000
zheyou73v0_A07	21044171	21045259	BnaA07T0211300ZY	0	+	0	0	1088	0.0000000
zheyou73v0_A07	21045485	21046900	BnaA07T0211400ZY	0	-	0	0	1415	0.0000000
zheyou73v0_A07	21048020	21051760	BnaA07T0211500ZY	0	-	0	0	3740	0.0000000
zheyou73v0_A07	21053720	21054198	BnaA07T0211600ZY	0	-	0	0	478	0.0000000
zheyou73v0_A07	21054663	21056262	BnaA07T0211700ZY	0	+	0	0	1599	0.0000000
zheyou73v0_A07	21056738	21058100	BnaA07T0211800ZY	0	+	0	0	1362	0.0000000
zheyou73v0_A07	21058262	21060239	BnaA07T0211900ZY	0	-	0	0	1977	0.0000000
zheyou73v0_A07	21062656	21063408	BnaA07T0212000ZY	0	-	0	0	752	0.0000000
zheyou73v0_A07	21065681	21067403	BnaA07T0212100ZY	0	+	0	0	1722	0.0000000
zheyou73v0_A07	21087680	21091134	BnaA07T0212200ZY	0	-	0	0	3454	0.0000000
zheyou73v0_A07	21097393	21097872	BnaA07T0212300ZY	0	+	0	0	479	0.0000000
zheyou73v0_A07	21100170	21100539	BnaA07T0212400ZY	0	+	0	0	369	0.0000000
zheyou73v0_A07	21100957	21101307	BnaA07T0212500ZY	0	-	0	0	350	0.0000000
zheyou73v0_A07	21112474	21113693	BnaA07T0212600ZY	0	-	0	0	1219	0.0000000
zheyou73v0_A07	21115125	21115485	BnaA07T0212700ZY	0	+	0	0	360	0.0000000
zheyou73v0_A07	21115542	21115895	BnaA07T0212800ZY	0	-	0	0	353	0.0000000
zheyou73v0_A07	21116451	21118267	BnaA07T0212900ZY	0	-	0	0	1816	0.0000000
zheyou73v0_A07	21123432	21127540	BnaA07T0213000ZY	0	+	0	0	4108	0.0000000
zheyou73v0_A07	21134915	21135429	BnaA07T0213100ZY	0	+	0	0	514	0.0000000
zheyou73v0_A07	21140078	21140818	BnaA07T0213200ZY	0	-	0	0	740	0.0000000
zheyou73v0_A07	21144649	21148691	BnaA07T0213300ZY	0	+	0	0	4042	0.0000000
zheyou73v0_A07	21148861	21150284	BnaA07T0213400ZY	0	-	0	0	1423	0.0000000
zheyou73v0_A07	21151636	21153135	BnaA07T0213500ZY	0	-	0	0	1499	0.0000000
zheyou73v0_A07	21157854	21159761	BnaA07T0213600ZY	0	-	0	0	1907	0.0000000
zheyou73v0_A07	21160107	21164463	BnaA07T0213700ZY	0	-	0	0	4356	0.0000000
zheyou73v0_A07	21160107	21164463	BnaA07T0213700ZY.1	0	-	0	0	4356	0.0000000
zheyou73v0_A07	21160107	21163344	BnaA07T0213700ZY.2	0	-	0	0	3237	0.0000000
zheyou73v0_A07	21160107	21163344	BnaA07T0213700ZY.3	0	-	0	0	3237	0.0000000
zheyou73v0_A07	21169800	21170702	BnaA07T0213800ZY	0	+	0	0	902	0.0000000
zheyou73v0_A07	21172131	21173008	BnaA07T0213900ZY	0	+	0	0	877	0.0000000
zheyou73v0_A07	21173837	21174557	BnaA07T0214000ZY	0	+	0	0	720	0.0000000
zheyou73v0_A07	21184093	21186664	BnaA07T0214100ZY	0	+	0	0	2571	0.0000000
zheyou73v0_A07	21189615	21190408	BnaA07T0214200ZY	0	+	0	0	793	0.0000000
zheyou73v0_A07	21193584	21195920	BnaA07T0214300ZY	0	+	0	0	2336	0.0000000
zheyou73v0_A07	21197787	21198225	BnaA07T0214400ZY	0	-	0	0	438	0.0000000
zheyou73v0_A07	21205283	21207770	BnaA07T0214500ZY	0	+	0	0	2487	0.0000000
zheyou73v0_A07	21212300	21213640	BnaA07T0214600ZY	0	-	0	0	1340	0.0000000
zheyou73v0_A07	21220957	21221122	BnaA07T0214700ZY	0	+	0	0	165	0.0000000
zheyou73v0_A07	21222432	21224655	BnaA07T0214800ZY	0	+	0	0	2223	0.0000000
zheyou73v0_A07	21226568	21228588	BnaA07T0214900ZY	0	+	0	0	2020	0.0000000
zheyou73v0_A07	21229312	21229957	BnaA07T0215000ZY	0	-	0	0	645	0.0000000
zheyou73v0_A07	21236522	21239548	BnaA07T0215100ZY	0	-	0	0	3026	0.0000000
zheyou73v0_A07	21241093	21242394	BnaA07T0215200ZY	0	-	0	0	1301	0.0000000
zheyou73v0_A07	21243752	21245371	BnaA07T0215300ZY	0	+	0	0	1619	0.0000000
zheyou73v0_A07	21247799	21254066	BnaA07T0215400ZY	0	-	0	0	6267	0.0000000
zheyou73v0_A07	21247799	21253804	BnaA07T0215400ZY.1	0	-	0	0	6005	0.0000000
zheyou73v0_A07	21256100	21256849	BnaA07T0215500ZY	0	-	0	0	749	0.0000000
zheyou73v0_A07	21257970	21258796	BnaA07T0215600ZY	0	-	0	0	826	0.0000000
zheyou73v0_A07	21281517	21282887	BnaA07T0215700ZY	0	+	0	0	1370	0.0000000
zheyou73v0_A07	21292383	21293407	BnaA07T0215800ZY	0	+	0	0	1024	0.0000000
zheyou73v0_A07	21295339	21296292	BnaA07T0215900ZY	0	-	0	0	953	0.0000000
zheyou73v0_A07	21298683	21299130	BnaA07T0216000ZY	0	-	0	0	447	0.0000000
zheyou73v0_A07	21300995	21303098	BnaA07T0216100ZY	0	-	0	0	2103	0.0000000
zheyou73v0_A07	21308041	21308505	BnaA07T0216200ZY	0	+	0	0	464	0.0000000
zheyou73v0_A07	21318096	21322627	BnaA07T0216300ZY	0	-	0	0	4531	0.0000000
zheyou73v0_A07	21328556	21328820	BnaA07T0216400ZY	0	+	0	0	264	0.0000000
zheyou73v0_A07	21332607	21334331	BnaA07T0216500ZY	0	-	0	0	1724	0.0000000
zheyou73v0_A07	21356084	21357000	BnaA07T0216600ZY	0	+	0	0	916	0.0000000
zheyou73v0_A07	21365950	21366756	BnaA07T0216700ZY	0	-	0	0	806	0.0000000
zheyou73v0_A07	21367513	21369008	BnaA07T0216800ZY	0	-	0	0	1495	0.0000000
zheyou73v0_A07	21375749	21376663	BnaA07T0216900ZY	0	+	0	0	914	0.0000000
zheyou73v0_A07	21379332	21380301	BnaA07T0217000ZY	0	-	0	0	969	0.0000000
zheyou73v0_A07	21389955	21391471	BnaA07T0217100ZY	0	-	0	0	1516	0.0000000
zheyou73v0_A07	21393383	21395968	BnaA07T0217200ZY	0	+	0	0	2585	0.0000000
zheyou73v0_A07	21396488	21396841	BnaA07T0217300ZY	0	+	0	0	353	0.0000000
zheyou73v0_A07	21398379	21399809	BnaA07T0217400ZY	0	+	0	0	1430	0.0000000
zheyou73v0_A07	21401208	21402319	BnaA07T0217500ZY	0	-	0	0	1111	0.0000000
zheyou73v0_A07	21404246	21404618	BnaA07T0217600ZY	0	-	0	0	372	0.0000000
zheyou73v0_A07	21416009	21416418	BnaA07T0217700ZY	0	-	0	0	409	0.0000000
zheyou73v0_A07	21418135	21419662	BnaA07T0217800ZY	0	-	0	0	1527	0.0000000
zheyou73v0_A07	21425469	21426169	BnaA07T0217900ZY	0	+	0	0	700	0.0000000
zheyou73v0_A07	21429199	21430272	BnaA07T0218000ZY	0	-	0	0	1073	0.0000000
zheyou73v0_A07	21446950	21448154	BnaA07T0218100ZY	0	-	0	0	1204	0.0000000
zheyou73v0_A07	21446950	21448154	BnaA07T0218100ZY.1	0	-	0	0	1204	0.0000000
zheyou73v0_A07	21454924	21458539	BnaA07T0218200ZY	0	+	0	0	3615	0.0000000
zheyou73v0_A07	21462649	21467950	BnaA07T0218300ZY	0	-	0	0	5301	0.0000000
zheyou73v0_A07	21480280	21482400	BnaA07T0218400ZY	0	-	0	0	2120	0.0000000
zheyou73v0_A07	21480280	21482400	BnaA07T0218400ZY.1	0	-	0	0	2120	0.0000000
zheyou73v0_A07	21489325	21493123	BnaA07T0218500ZY	0	+	0	0	3798	0.0000000
zheyou73v0_A07	21497281	21498509	BnaA07T0218600ZY	0	+	0	0	1228	0.0000000
zheyou73v0_A07	21501308	21502987	BnaA07T0218700ZY	0	-	0	0	1679	0.0000000
zheyou73v0_A07	21506521	21507532	BnaA07T0218800ZY	0	-	0	0	1011	0.0000000
zheyou73v0_A07	21507734	21509443	BnaA07T0218900ZY	0	-	0	0	1709	0.0000000
zheyou73v0_A07	21511785	21513349	BnaA07T0219000ZY	0	-	0	0	1564	0.0000000
zheyou73v0_A07	21522134	21526327	BnaA07T0219100ZY	0	+	0	0	4193	0.0000000
zheyou73v0_A07	21526981	21527624	BnaA07T0219200ZY	0	-	0	0	643	0.0000000
zheyou73v0_A07	21528912	21529515	BnaA07T0219300ZY	0	-	0	0	603	0.0000000
zheyou73v0_A07	21530713	21536084	BnaA07T0219400ZY	0	+	0	0	5371	0.0000000
zheyou73v0_A07	21547703	21548201	BnaA07T0219500ZY	0	+	0	0	498	0.0000000
zheyou73v0_A07	21554331	21554950	BnaA07T0219600ZY	0	-	0	0	619	0.0000000
zheyou73v0_A07	21560290	21561718	BnaA07T0219700ZY	0	+	0	0	1428	0.0000000
zheyou73v0_A07	21563780	21565365	BnaA07T0219800ZY	0	-	0	0	1585	0.0000000
zheyou73v0_A07	21582024	21587708	BnaA07T0219900ZY	0	+	0	0	5684	0.0000000
zheyou73v0_A07	21592208	21594475	BnaA07T0220000ZY	0	+	0	0	2267	0.0000000
zheyou73v0_A07	21609089	21612233	BnaA07T0220100ZY	0	+	0	0	3144	0.0000000
zheyou73v0_A07	21614911	21617424	BnaA07T0220200ZY	0	-	0	0	2513	0.0000000
zheyou73v0_A07	21621021	21622044	BnaA07T0220300ZY	0	-	0	0	1023	0.0000000
zheyou73v0_A07	21622386	21623642	BnaA07T0220400ZY	0	+	0	0	1256	0.0000000
zheyou73v0_A07	21624340	21625105	BnaA07T0220500ZY	0	-	0	0	765	0.0000000
zheyou73v0_A07	21627239	21628501	BnaA07T0220600ZY	0	-	0	0	1262	0.0000000
zheyou73v0_A07	21632489	21633266	BnaA07T0220700ZY	0	+	0	0	777	0.0000000
zheyou73v0_A07	21633407	21633965	BnaA07T0220800ZY	0	-	0	0	558	0.0000000
zheyou73v0_A07	21634730	21638574	BnaA07T0220900ZY	0	-	0	0	3844	0.0000000
zheyou73v0_A07	21657730	21661940	BnaA07T0221000ZY	0	+	0	0	4210	0.0000000
zheyou73v0_A07	21677101	21677458	BnaA07T0221100ZY	0	+	0	0	357	0.0000000
zheyou73v0_A07	21677575	21678523	BnaA07T0221200ZY	0	+	0	0	948	0.0000000
zheyou73v0_A07	21690180	21692719	BnaA07T0221300ZY	0	+	0	0	2539	0.0000000
zheyou73v0_A07	21697377	21699281	BnaA07T0221400ZY	0	+	0	0	1904	0.0000000
zheyou73v0_A07	21705051	21705934	BnaA07T0221500ZY	0	-	0	0	883	0.0000000
zheyou73v0_A07	21713544	21714546	BnaA07T0221600ZY	0	+	0	0	1002	0.0000000
zheyou73v0_A07	21721479	21721905	BnaA07T0221700ZY	0	+	0	0	426	0.0000000
zheyou73v0_A07	21723410	21727480	BnaA07T0221800ZY	0	+	0	0	4070	0.0000000
zheyou73v0_A07	21727532	21728333	BnaA07T0221900ZY	0	-	0	0	801	0.0000000
zheyou73v0_A07	21735291	21736552	BnaA07T0222000ZY	0	-	0	0	1261	0.0000000
zheyou73v0_A07	21740771	21742207	BnaA07T0222100ZY	0	-	0	0	1436	0.0000000
zheyou73v0_A07	21749766	21753177	BnaA07T0222200ZY	0	+	0	0	3411	0.0000000
zheyou73v0_A07	21756822	21758449	BnaA07T0222300ZY	0	+	0	0	1627	0.0000000
zheyou73v0_A07	21762155	21770386	BnaA07T0222400ZY	0	-	0	0	8231	0.0000000
zheyou73v0_A07	21772024	21773736	BnaA07T0222500ZY	0	-	0	0	1712	0.0000000
zheyou73v0_A07	21772024	21773736	BnaA07T0222500ZY.1	0	-	0	0	1712	0.0000000
zheyou73v0_A07	21778065	21779046	BnaA07T0222600ZY	0	+	0	0	981	0.0000000
zheyou73v0_A07	21780027	21780402	BnaA07T0222700ZY	0	-	0	0	375	0.0000000
zheyou73v0_A07	21785215	21785632	BnaA07T0222800ZY	0	+	0	0	417	0.0000000
zheyou73v0_A07	21787222	21789887	BnaA07T0222900ZY	0	+	0	0	2665	0.0000000
zheyou73v0_A07	21797371	21799710	BnaA07T0223000ZY	0	-	0	0	2339	0.0000000
zheyou73v0_A07	21809172	21811767	BnaA07T0223100ZY	0	-	0	0	2595	0.0000000
zheyou73v0_A07	21812051	21813748	BnaA07T0223200ZY	0	+	0	0	1697	0.0000000
zheyou73v0_A07	21814414	21817114	BnaA07T0223300ZY	0	+	0	0	2700	0.0000000
zheyou73v0_A07	21814414	21817480	BnaA07T0223300ZY.1	0	+	0	0	3066	0.0000000
zheyou73v0_A07	21817889	21820913	BnaA07T0223400ZY	0	-	0	0	3024	0.0000000
zheyou73v0_A07	21824097	21826793	BnaA07T0223500ZY	0	-	0	0	2696	0.0000000
zheyou73v0_A07	21827275	21828657	BnaA07T0223600ZY	0	-	0	0	1382	0.0000000
zheyou73v0_A07	21879390	21880100	BnaA07T0223700ZY	0	+	0	0	710	0.0000000
zheyou73v0_A07	21881414	21881950	BnaA07T0223800ZY	0	-	0	0	536	0.0000000
zheyou73v0_A07	21889932	21892049	BnaA07T0223900ZY	0	+	0	0	2117	0.0000000
zheyou73v0_A07	21894444	21896707	BnaA07T0224000ZY	0	-	0	0	2263	0.0000000
zheyou73v0_A07	21909983	21912011	BnaA07T0224100ZY	0	+	0	0	2028	0.0000000
zheyou73v0_A07	21915424	21917045	BnaA07T0224200ZY	0	+	0	0	1621	0.0000000
zheyou73v0_A07	21925073	21929424	BnaA07T0224300ZY	0	-	0	0	4351	0.0000000
zheyou73v0_A07	21932484	21935205	BnaA07T0224400ZY	0	-	0	0	2721	0.0000000
zheyou73v0_A07	21941282	21941894	BnaA07T0224500ZY	0	+	0	0	612	0.0000000
zheyou73v0_A07	21944156	21945011	BnaA07T0224600ZY	0	+	0	0	855	0.0000000
zheyou73v0_A07	21949747	21950543	BnaA07T0224700ZY	0	+	0	0	796	0.0000000
zheyou73v0_A07	21952003	21953871	BnaA07T0224800ZY	0	-	0	0	1868	0.0000000
zheyou73v0_A07	21961829	21964139	BnaA07T0224900ZY	0	-	0	0	2310	0.0000000
zheyou73v0_A07	21967139	21968225	BnaA07T0225000ZY	0	+	0	0	1086	0.0000000
zheyou73v0_A07	21975336	21977197	BnaA07T0225100ZY	0	+	0	0	1861	0.0000000
zheyou73v0_A07	21977303	21979012	BnaA07T0225200ZY	0	-	0	0	1709	0.0000000
zheyou73v0_A07	21977303	21979012	BnaA07T0225200ZY.1	0	-	0	0	1709	0.0000000
zheyou73v0_A07	21979332	21983698	BnaA07T0225300ZY	0	-	0	0	4366	0.0000000
zheyou73v0_A07	21983990	21986144	BnaA07T0225400ZY	0	+	0	0	2154	0.0000000
zheyou73v0_A07	21986303	21986657	BnaA07T0225500ZY	0	+	0	0	354	0.0000000
zheyou73v0_A07	21989021	21991675	BnaA07T0225600ZY	0	-	0	0	2654	0.0000000
zheyou73v0_A07	21993739	21998558	BnaA07T0225700ZY	0	-	0	0	4819	0.0000000
zheyou73v0_A07	22003237	22007319	BnaA07T0225800ZY	0	-	0	0	4082	0.0000000
zheyou73v0_A07	22008527	22017509	BnaA07T0225900ZY	0	+	0	0	8982	0.0000000
zheyou73v0_A07	22019157	22025190	BnaA07T0226000ZY	0	+	0	0	6033	0.0000000
zheyou73v0_A07	22026175	22026861	BnaA07T0226100ZY	0	-	0	0	686	0.0000000
zheyou73v0_A07	22027500	22028920	BnaA07T0226200ZY	0	-	0	0	1420	0.0000000
zheyou73v0_A07	22029787	22035133	BnaA07T0226300ZY	0	-	0	0	5346	0.0000000
zheyou73v0_A07	22036375	22038144	BnaA07T0226400ZY	0	+	0	0	1769	0.0000000
zheyou73v0_A07	22040098	22040703	BnaA07T0226500ZY	0	+	0	0	605	0.0000000
zheyou73v0_A07	22043400	22044546	BnaA07T0226600ZY	0	+	0	0	1146	0.0000000
zheyou73v0_A07	22043400	22044546	BnaA07T0226600ZY.1	0	+	0	0	1146	0.0000000
zheyou73v0_A07	22053022	22054566	BnaA07T0226700ZY	0	-	0	0	1544	0.0000000
zheyou73v0_A07	22069873	22070749	BnaA07T0226800ZY	0	-	0	0	876	0.0000000
zheyou73v0_A07	22070835	22079692	BnaA07T0226900ZY	0	+	0	0	8857	0.0000000
zheyou73v0_A07	22081661	22084740	BnaA07T0227000ZY	0	+	0	0	3079	0.0000000
zheyou73v0_A07	22089441	22094536	BnaA07T0227100ZY	0	+	0	0	5095	0.0000000
zheyou73v0_A07	22096476	22098541	BnaA07T0227200ZY	0	+	0	0	2065	0.0000000
zheyou73v0_A07	22100308	22101333	BnaA07T0227300ZY	0	+	0	0	1025	0.0000000
zheyou73v0_A07	22103006	22106906	BnaA07T0227400ZY	0	-	0	0	3900	0.0000000
zheyou73v0_A07	22115815	22120050	BnaA07T0227500ZY	0	+	0	0	4235	0.0000000
zheyou73v0_A07	22128326	22130670	BnaA07T0227600ZY	0	+	0	0	2344	0.0000000
zheyou73v0_A07	22132873	22135034	BnaA07T0227700ZY	0	+	0	0	2161	0.0000000
zheyou73v0_A07	22132873	22135034	BnaA07T0227700ZY.2	0	+	0	0	2161	0.0000000
zheyou73v0_A07	22133097	22135034	BnaA07T0227700ZY.1	0	+	0	0	1937	0.0000000
zheyou73v0_A07	22135634	22136060	BnaA07T0227800ZY	0	-	0	0	426	0.0000000
zheyou73v0_A07	22136614	22137643	BnaA07T0227900ZY	0	-	0	0	1029	0.0000000
zheyou73v0_A07	22139262	22140146	BnaA07T0228000ZY	0	+	0	0	884	0.0000000
zheyou73v0_A07	22140538	22142456	BnaA07T0228100ZY	0	-	0	0	1918	0.0000000
zheyou73v0_A07	22157151	22163393	BnaA07T0228200ZY	0	+	0	0	6242	0.0000000
zheyou73v0_A07	22163788	22165121	BnaA07T0228300ZY	0	-	0	0	1333	0.0000000
zheyou73v0_A07	22166401	22166947	BnaA07T0228400ZY	0	-	0	0	546	0.0000000
zheyou73v0_A07	22169525	22171006	BnaA07T0228500ZY	0	+	0	0	1481	0.0000000
zheyou73v0_A07	22171549	22174943	BnaA07T0228600ZY	0	-	0	0	3394	0.0000000
zheyou73v0_A07	22176306	22176981	BnaA07T0228700ZY	0	-	0	0	675	0.0000000
zheyou73v0_A07	22177288	22184308	BnaA07T0228800ZY	0	-	0	0	7020	0.0000000
zheyou73v0_A07	22185736	22188826	BnaA07T0228900ZY	0	+	0	0	3090	0.0000000
zheyou73v0_A07	22189024	22193045	BnaA07T0229000ZY	0	-	0	0	4021	0.0000000
zheyou73v0_A07	22206399	22208759	BnaA07T0229100ZY	0	+	0	0	2360	0.0000000
zheyou73v0_A07	22211306	22215645	BnaA07T0229200ZY	0	-	0	0	4339	0.0000000
zheyou73v0_A07	22211306	22215645	BnaA07T0229200ZY.1	0	-	0	0	4339	0.0000000
zheyou73v0_A07	22216993	22219076	BnaA07T0229300ZY	0	-	0	0	2083	0.0000000
zheyou73v0_A07	22220624	22226754	BnaA07T0229400ZY	0	-	0	0	6130	0.0000000
zheyou73v0_A07	22229326	22234912	BnaA07T0229500ZY	0	+	0	0	5586	0.0000000
zheyou73v0_A07	22229326	22234912	BnaA07T0229500ZY.1	0	+	0	0	5586	0.0000000
zheyou73v0_A07	22229326	22234912	BnaA07T0229500ZY.2	0	+	0	0	5586	0.0000000
zheyou73v0_A07	22236162	22238718	BnaA07T0229600ZY	0	+	0	0	2556	0.0000000
zheyou73v0_A07	22238933	22241236	BnaA07T0229700ZY	0	-	0	0	2303	0.0000000
zheyou73v0_A07	22238933	22241236	BnaA07T0229700ZY.1	0	-	0	0	2303	0.0000000
zheyou73v0_A07	22241881	22243557	BnaA07T0229800ZY	0	-	0	0	1676	0.0000000
zheyou73v0_A07	22246798	22250865	BnaA07T0229900ZY	0	+	0	0	4067	0.0000000
zheyou73v0_A07	22250901	22251815	BnaA07T0230000ZY	0	-	0	0	914	0.0000000
zheyou73v0_A07	22254343	22259510	BnaA07T0230100ZY	0	+	0	0	5167	0.0000000
zheyou73v0_A07	22259291	22262796	BnaA07T0230200ZY	0	-	0	0	3505	0.0000000
zheyou73v0_A07	22281037	22283097	BnaA07T0230300ZY	0	-	0	0	2060	0.0000000
zheyou73v0_A07	22285492	22289262	BnaA07T0230400ZY	0	-	0	0	3770	0.0000000
zheyou73v0_A07	22294164	22297104	BnaA07T0230500ZY	0	+	0	0	2940	0.0000000
zheyou73v0_A07	22297705	22301946	BnaA07T0230600ZY	0	-	0	0	4241	0.0000000
zheyou73v0_A07	22304690	22312876	BnaA07T0230700ZY	0	+	0	0	8186	0.0000000
zheyou73v0_A07	22313505	22314384	BnaA07T0230800ZY	0	-	0	0	879	0.0000000
zheyou73v0_A07	22315480	22316478	BnaA07T0230900ZY	0	+	0	0	998	0.0000000
zheyou73v0_A07	22317327	22319301	BnaA07T0231000ZY	0	-	0	0	1974	0.0000000
zheyou73v0_A07	22324629	22326408	BnaA07T0231100ZY	0	+	0	0	1779	0.0000000
zheyou73v0_A07	22328151	22329203	BnaA07T0231200ZY	0	-	0	0	1052	0.0000000
zheyou73v0_A07	22331260	22332030	BnaA07T0231300ZY	0	-	0	0	770	0.0000000
zheyou73v0_A07	22332577	22336695	BnaA07T0231400ZY	0	-	0	0	4118	0.0000000
zheyou73v0_A07	22338256	22339315	BnaA07T0231500ZY	0	-	0	0	1059	0.0000000
zheyou73v0_A07	22340091	22341998	BnaA07T0231600ZY	0	+	0	0	1907	0.0000000
zheyou73v0_A07	22343210	22344133	BnaA07T0231700ZY	0	-	0	0	923	0.0000000
zheyou73v0_A07	22352853	22355760	BnaA07T0231800ZY	0	+	0	0	2907	0.0000000
zheyou73v0_A07	22371567	22374603	BnaA07T0231900ZY	0	-	0	0	3036	0.0000000
zheyou73v0_A07	22376605	22379739	BnaA07T0232000ZY	0	+	0	0	3134	0.0000000
zheyou73v0_A07	22380632	22381575	BnaA07T0232100ZY	0	+	0	0	943	0.0000000
zheyou73v0_A07	22392206	22393982	BnaA07T0232200ZY	0	-	0	0	1776	0.0000000
zheyou73v0_A07	22395602	22397544	BnaA07T0232300ZY	0	-	0	0	1942	0.0000000
zheyou73v0_A07	22398538	22399297	BnaA07T0232400ZY	0	-	0	0	759	0.0000000
zheyou73v0_A07	22399742	22400045	BnaA07T0232500ZY	0	-	0	0	303	0.0000000
zheyou73v0_A07	22403406	22405361	BnaA07T0232600ZY	0	-	0	0	1955	0.0000000
zheyou73v0_A07	22407176	22409245	BnaA07T0232700ZY	0	-	0	0	2069	0.0000000
zheyou73v0_A07	22410061	22411930	BnaA07T0232800ZY	0	-	0	0	1869	0.0000000
zheyou73v0_A07	22414549	22417190	BnaA07T0232900ZY	0	+	0	0	2641	0.0000000
zheyou73v0_A07	22419972	22421524	BnaA07T0233000ZY	0	-	0	0	1552	0.0000000
zheyou73v0_A07	22423475	22435289	BnaA07T0233100ZY	0	+	0	0	11814	0.0000000
zheyou73v0_A07	22437332	22437917	BnaA07T0233200ZY	0	-	0	0	585	0.0000000
zheyou73v0_A07	22440477	22473388	BnaA07T0233300ZY	0	+	0	0	32911	0.0000000
zheyou73v0_A07	22475663	22477328	BnaA07T0233400ZY	0	+	0	0	1665	0.0000000
zheyou73v0_A07	22492240	22493110	BnaA07T0233500ZY	0	-	0	0	870	0.0000000
zheyou73v0_A07	22494458	22495714	BnaA07T0233600ZY	0	+	0	0	1256	0.0000000
zheyou73v0_A07	22500909	22505116	BnaA07T0233700ZY	0	+	0	0	4207	0.0000000
zheyou73v0_A07	22505042	22507231	BnaA07T0233800ZY	0	-	0	0	2189	0.0000000
zheyou73v0_A07	22508315	22508861	BnaA07T0233900ZY	0	+	0	0	546	0.0000000
zheyou73v0_A07	22515271	22516581	BnaA07T0234000ZY	0	+	0	0	1310	0.0000000
zheyou73v0_A07	22526560	22528177	BnaA07T0234100ZY	0	-	0	0	1617	0.0000000
zheyou73v0_A07	22531078	22532409	BnaA07T0234200ZY	0	-	0	0	1331	0.0000000
zheyou73v0_A07	22532669	22535355	BnaA07T0234300ZY	0	+	0	0	2686	0.0000000
zheyou73v0_A07	22535646	22537619	BnaA07T0234400ZY	0	-	0	0	1973	0.0000000
zheyou73v0_A07	22539340	22540523	BnaA07T0234500ZY	0	-	0	0	1183	0.0000000
zheyou73v0_A07	22542796	22544046	BnaA07T0234600ZY	0	+	0	0	1250	0.0000000
zheyou73v0_A07	22546047	22547263	BnaA07T0234700ZY	0	-	0	0	1216	0.0000000
zheyou73v0_A07	22549535	22551346	BnaA07T0234800ZY	0	-	0	0	1811	0.0000000
zheyou73v0_A07	22551673	22554202	BnaA07T0234900ZY	0	-	0	0	2529	0.0000000
zheyou73v0_A07	22589533	22590381	BnaA07T0235000ZY	0	+	0	0	848	0.0000000
zheyou73v0_A07	22619338	22620820	BnaA07T0235100ZY	0	-	0	0	1482	0.0000000
zheyou73v0_A07	22623040	22624044	BnaA07T0235200ZY	0	-	0	0	1004	0.0000000
zheyou73v0_A07	22633486	22640001	BnaA07T0235300ZY	0	+	0	0	6515	0.0000000
zheyou73v0_A07	22640631	22642072	BnaA07T0235400ZY	0	+	0	0	1441	0.0000000
zheyou73v0_A07	22642322	22644357	BnaA07T0235500ZY	0	+	0	0	2035	0.0000000
zheyou73v0_A07	22644739	22649398	BnaA07T0235600ZY	0	+	0	0	4659	0.0000000
zheyou73v0_A07	22644739	22649398	BnaA07T0235600ZY.1	0	+	0	0	4659	0.0000000
zheyou73v0_A07	22644739	22649398	BnaA07T0235600ZY.2	0	+	0	0	4659	0.0000000
zheyou73v0_A07	22644739	22649398	BnaA07T0235600ZY.3	0	+	0	0	4659	0.0000000
zheyou73v0_A07	22644739	22649398	BnaA07T0235600ZY.4	0	+	0	0	4659	0.0000000
zheyou73v0_A07	22649782	22652174	BnaA07T0235700ZY	0	+	0	0	2392	0.0000000
zheyou73v0_A07	22658518	22660684	BnaA07T0235800ZY	0	+	0	0	2166	0.0000000
zheyou73v0_A07	22677638	22678658	BnaA07T0235900ZY	0	-	0	0	1020	0.0000000
zheyou73v0_A07	22680106	22680665	BnaA07T0236000ZY	0	+	0	0	559	0.0000000
zheyou73v0_A07	22684014	22686825	BnaA07T0236100ZY	0	-	0	0	2811	0.0000000
zheyou73v0_A07	22697186	22699555	BnaA07T0236200ZY	0	-	0	0	2369	0.0000000
zheyou73v0_A07	22700399	22700837	BnaA07T0236300ZY	0	+	0	0	438	0.0000000
zheyou73v0_A07	22701451	22701701	BnaA07T0236400ZY	0	-	0	0	250	0.0000000
zheyou73v0_A07	22703235	22712613	BnaA07T0236500ZY	0	+	0	0	9378	0.0000000
zheyou73v0_A07	22713116	22716737	BnaA07T0236600ZY	0	+	0	0	3621	0.0000000
zheyou73v0_A07	22720631	22721388	BnaA07T0236700ZY	0	+	0	0	757	0.0000000
zheyou73v0_A07	22721956	22722217	BnaA07T0236800ZY	0	+	0	0	261	0.0000000
zheyou73v0_A07	22732951	22734337	BnaA07T0236900ZY	0	-	0	0	1386	0.0000000
zheyou73v0_A07	22739649	22740505	BnaA07T0237000ZY	0	+	0	0	856	0.0000000
zheyou73v0_A07	22745937	22748833	BnaA07T0237100ZY	0	+	0	0	2896	0.0000000
zheyou73v0_A07	22750780	22751479	BnaA07T0237200ZY	0	+	0	0	699	0.0000000
zheyou73v0_A07	22751666	22754344	BnaA07T0237300ZY	0	-	0	0	2678	0.0000000
zheyou73v0_A07	22761340	22763860	BnaA07T0237400ZY	0	+	0	0	2520	0.0000000
zheyou73v0_A07	22764588	22780286	BnaA07T0237500ZY	0	-	0	0	15698	0.0000000
zheyou73v0_A07	22780714	22782197	BnaA07T0237600ZY	0	+	0	0	1483	0.0000000
zheyou73v0_A07	22784459	22786068	BnaA07T0237700ZY	0	+	0	0	1609	0.0000000
zheyou73v0_A07	22792704	22793079	BnaA07T0237800ZY	0	-	0	0	375	0.0000000
zheyou73v0_A07	22795958	22800889	BnaA07T0237900ZY	0	-	0	0	4931	0.0000000
zheyou73v0_A07	22804536	22806033	BnaA07T0238000ZY	0	-	0	0	1497	0.0000000
zheyou73v0_A07	22809422	22810748	BnaA07T0238100ZY	0	-	0	0	1326	0.0000000
zheyou73v0_A07	22823970	22827604	BnaA07T0238200ZY	0	-	0	0	3634	0.0000000
zheyou73v0_A07	22831087	22832964	BnaA07T0238300ZY	0	-	0	0	1877	0.0000000
zheyou73v0_A07	22833620	22836037	BnaA07T0238400ZY	0	-	0	0	2417	0.0000000
zheyou73v0_A07	22837057	22840095	BnaA07T0238500ZY	0	-	0	0	3038	0.0000000
zheyou73v0_A07	22840611	22850367	BnaA07T0238600ZY	0	-	0	0	9756	0.0000000
zheyou73v0_A07	22878779	22880422	BnaA07T0238700ZY	0	+	0	0	1643	0.0000000
zheyou73v0_A07	22886333	22887338	BnaA07T0238800ZY	0	+	0	0	1005	0.0000000
zheyou73v0_A07	22887987	22892342	BnaA07T0238900ZY	0	-	0	0	4355	0.0000000
zheyou73v0_A07	22896159	22901515	BnaA07T0239000ZY	0	+	0	0	5356	0.0000000
zheyou73v0_A07	22905104	22905413	BnaA07T0239100ZY	0	+	0	0	309	0.0000000
zheyou73v0_A07	22908095	22909538	BnaA07T0239200ZY	0	+	0	0	1443	0.0000000
zheyou73v0_A07	22909589	22911590	BnaA07T0239300ZY	0	-	0	0	2001	0.0000000
zheyou73v0_A07	22914985	22918006	BnaA07T0239400ZY	0	-	0	0	3021	0.0000000
zheyou73v0_A07	22921888	22923702	BnaA07T0239500ZY	0	-	0	0	1814	0.0000000
zheyou73v0_A07	22926895	22928199	BnaA07T0239600ZY	0	-	0	0	1304	0.0000000
zheyou73v0_A07	22928763	22932299	BnaA07T0239700ZY	0	+	0	0	3536	0.0000000
zheyou73v0_A07	22932573	22933483	BnaA07T0239800ZY	0	-	0	0	910	0.0000000
zheyou73v0_A07	22934875	22937276	BnaA07T0239900ZY	0	+	0	0	2401	0.0000000
zheyou73v0_A07	22937636	22941397	BnaA07T0240000ZY	0	-	0	0	3761	0.0000000
zheyou73v0_A07	22937636	22941397	BnaA07T0240000ZY.1	0	-	0	0	3761	0.0000000
zheyou73v0_A07	22943144	22944794	BnaA07T0240100ZY	0	-	0	0	1650	0.0000000
zheyou73v0_A07	22943144	22944794	BnaA07T0240100ZY.1	0	-	0	0	1650	0.0000000
zheyou73v0_A07	22947278	22948771	BnaA07T0240200ZY	0	-	0	0	1493	0.0000000
zheyou73v0_A07	22949543	22951185	BnaA07T0240300ZY	0	+	0	0	1642	0.0000000
zheyou73v0_A07	22951550	22952604	BnaA07T0240400ZY	0	+	0	0	1054	0.0000000
zheyou73v0_A07	22956537	22957874	BnaA07T0240500ZY	0	+	0	0	1337	0.0000000
zheyou73v0_A07	22958352	22958538	BnaA07T0240600ZY	0	+	0	0	186	0.0000000
zheyou73v0_A07	22958802	22961277	BnaA07T0240700ZY	0	-	0	0	2475	0.0000000
zheyou73v0_A07	22964687	22969626	BnaA07T0240800ZY	0	+	0	0	4939	0.0000000
zheyou73v0_A07	22964687	22969626	BnaA07T0240800ZY.1	0	+	0	0	4939	0.0000000
zheyou73v0_A07	22969868	22971404	BnaA07T0240900ZY	0	+	0	0	1536	0.0000000
zheyou73v0_A07	22971957	22973843	BnaA07T0241000ZY	0	-	0	0	1886	0.0000000
zheyou73v0_A07	22984448	22986638	BnaA07T0241100ZY	0	+	0	0	2190	0.0000000
zheyou73v0_A07	22986210	22989648	BnaA07T0241200ZY	0	-	0	0	3438	0.0000000
zheyou73v0_A07	22990934	22996090	BnaA07T0241300ZY	0	-	0	0	5156	0.0000000
zheyou73v0_A07	23006331	23007424	BnaA07T0241400ZY	0	+	0	0	1093	0.0000000
zheyou73v0_A07	23008758	23010960	BnaA07T0241500ZY	0	+	0	0	2202	0.0000000
zheyou73v0_A07	23008758	23010960	BnaA07T0241500ZY.1	0	+	0	0	2202	0.0000000
zheyou73v0_A07	23016149	23017350	BnaA07T0241600ZY	0	-	0	0	1201	0.0000000
zheyou73v0_A07	23022598	23024493	BnaA07T0241700ZY	0	+	0	0	1895	0.0000000
zheyou73v0_A07	23031653	23033143	BnaA07T0241800ZY	0	+	0	0	1490	0.0000000
zheyou73v0_A07	23038941	23041127	BnaA07T0241900ZY	0	+	0	0	2186	0.0000000
zheyou73v0_A07	23043420	23044447	BnaA07T0242000ZY	0	-	0	0	1027	0.0000000
zheyou73v0_A07	23044749	23045365	BnaA07T0242100ZY	0	-	0	0	616	0.0000000
zheyou73v0_A07	23045414	23045767	BnaA07T0242200ZY	0	-	0	0	353	0.0000000
zheyou73v0_A07	23046102	23046354	BnaA07T0242300ZY	0	-	0	0	252	0.0000000
zheyou73v0_A07	23046774	23053661	BnaA07T0242400ZY	0	+	0	0	6887	0.0000000
zheyou73v0_A07	23055504	23058094	BnaA07T0242500ZY	0	-	0	0	2590	0.0000000
zheyou73v0_A07	23059040	23063231	BnaA07T0242600ZY	0	-	0	0	4191	0.0000000
zheyou73v0_A07	23059040	23061499	BnaA07T0242600ZY.1	0	-	0	0	2459	0.0000000
zheyou73v0_A07	23059040	23061383	BnaA07T0242600ZY.2	0	-	0	0	2343	0.0000000
zheyou73v0_A07	23069302	23070215	BnaA07T0242700ZY	0	+	0	0	913	0.0000000
zheyou73v0_A07	23071677	23072868	BnaA07T0242800ZY	0	-	0	0	1191	0.0000000
zheyou73v0_A07	23073856	23075722	BnaA07T0242900ZY	0	-	0	0	1866	0.0000000
zheyou73v0_A07	23080754	23081225	BnaA07T0243000ZY	0	-	0	0	471	0.0000000
zheyou73v0_A07	23084232	23085477	BnaA07T0243100ZY	0	-	0	0	1245	0.0000000
zheyou73v0_A07	23087868	23088075	BnaA07T0243200ZY	0	+	0	0	207	0.0000000
zheyou73v0_A07	23087918	23091918	BnaA07T0243300ZY	0	-	0	0	4000	0.0000000
zheyou73v0_A07	23093310	23099215	BnaA07T0243400ZY	0	+	0	0	5905	0.0000000
zheyou73v0_A07	23099373	23100437	BnaA07T0243500ZY	0	-	0	0	1064	0.0000000
zheyou73v0_A07	23101076	23102847	BnaA07T0243600ZY	0	-	0	0	1771	0.0000000
zheyou73v0_A07	23103983	23105349	BnaA07T0243700ZY	0	+	0	0	1366	0.0000000
zheyou73v0_A07	23105885	23107495	BnaA07T0243800ZY	0	+	0	0	1610	0.0000000
zheyou73v0_A07	23107874	23110590	BnaA07T0243900ZY	0	+	0	0	2716	0.0000000
zheyou73v0_A07	23111157	23112500	BnaA07T0244000ZY	0	-	0	0	1343	0.0000000
zheyou73v0_A07	23114695	23117499	BnaA07T0244100ZY	0	+	0	0	2804	0.0000000
zheyou73v0_A07	23118149	23124139	BnaA07T0244200ZY	0	-	0	0	5990	0.0000000
zheyou73v0_A07	23127932	23131203	BnaA07T0244300ZY	0	-	0	0	3271	0.0000000
zheyou73v0_A07	23127932	23131203	BnaA07T0244300ZY.1	0	-	0	0	3271	0.0000000
zheyou73v0_A07	23131980	23133607	BnaA07T0244400ZY	0	-	0	0	1627	0.0000000
zheyou73v0_A07	23131980	23133706	BnaA07T0244400ZY.1	0	-	0	0	1726	0.0000000
zheyou73v0_A07	23134398	23136792	BnaA07T0244500ZY	0	+	0	0	2394	0.0000000
zheyou73v0_A07	23137460	23138986	BnaA07T0244600ZY	0	+	0	0	1526	0.0000000
zheyou73v0_A07	23144174	23146159	BnaA07T0244700ZY	0	+	0	0	1985	0.0000000
zheyou73v0_A07	23153252	23155475	BnaA07T0244800ZY	0	-	0	0	2223	0.0000000
zheyou73v0_A07	23158928	23160862	BnaA07T0244900ZY	0	+	0	0	1934	0.0000000
zheyou73v0_A07	23162005	23164384	BnaA07T0245000ZY	0	-	0	0	2379	0.0000000
zheyou73v0_A07	23165738	23167725	BnaA07T0245100ZY	0	+	0	0	1987	0.0000000
zheyou73v0_A07	23169136	23171082	BnaA07T0245200ZY	0	+	0	0	1946	0.0000000
zheyou73v0_A07	23173045	23176914	BnaA07T0245300ZY	0	+	0	0	3869	0.0000000
zheyou73v0_A07	23178571	23179735	BnaA07T0245400ZY	0	+	0	0	1164	0.0000000
zheyou73v0_A07	23178571	23179735	BnaA07T0245400ZY.1	0	+	0	0	1164	0.0000000
zheyou73v0_A07	23180583	23181588	BnaA07T0245500ZY	0	+	0	0	1005	0.0000000
zheyou73v0_A07	23186297	23187860	BnaA07T0245600ZY	0	+	0	0	1563	0.0000000
zheyou73v0_A07	23187934	23189047	BnaA07T0245700ZY	0	-	0	0	1113	0.0000000
zheyou73v0_A07	23187934	23189047	BnaA07T0245700ZY.1	0	-	0	0	1113	0.0000000
zheyou73v0_A07	23189108	23190704	BnaA07T0245800ZY	0	+	0	0	1596	0.0000000
zheyou73v0_A07	23193282	23194654	BnaA07T0245900ZY	0	+	0	0	1372	0.0000000
zheyou73v0_A07	23200134	23201220	BnaA07T0246000ZY	0	+	0	0	1086	0.0000000
zheyou73v0_A07	23203109	23204062	BnaA07T0246100ZY	0	-	0	0	953	0.0000000
zheyou73v0_A07	23210196	23211163	BnaA07T0246200ZY	0	-	0	0	967	0.0000000
zheyou73v0_A07	23219537	23221839	BnaA07T0246300ZY	0	-	0	0	2302	0.0000000
zheyou73v0_A07	23223159	23225095	BnaA07T0246400ZY	0	-	0	0	1936	0.0000000
zheyou73v0_A07	23230704	23233896	BnaA07T0246500ZY	0	-	0	0	3192	0.0000000
zheyou73v0_A07	23235754	23235979	BnaA07T0246600ZY	0	-	0	0	225	0.0000000
zheyou73v0_A07	23237655	23239388	BnaA07T0246700ZY	0	+	0	0	1733	0.0000000
zheyou73v0_A07	23241690	23246110	BnaA07T0246800ZY	0	+	0	0	4420	0.0000000
zheyou73v0_A07	23246927	23248525	BnaA07T0246900ZY	0	+	0	0	1598	0.0000000
zheyou73v0_A07	23248623	23249233	BnaA07T0247000ZY	0	-	0	0	610	0.0000000
zheyou73v0_A07	23254593	23255889	BnaA07T0247100ZY	0	+	0	0	1296	0.0000000
zheyou73v0_A07	23257642	23259711	BnaA07T0247200ZY	0	-	0	0	2069	0.0000000
zheyou73v0_A07	23268188	23269738	BnaA07T0247300ZY	0	-	0	0	1550	0.0000000
zheyou73v0_A07	23283398	23285308	BnaA07T0247400ZY.1	0	+	0	0	1910	0.0000000
zheyou73v0_A07	23283398	23285308	BnaA07T0247400ZY.2	0	+	0	0	1910	0.0000000
zheyou73v0_A07	23283417	23285308	BnaA07T0247400ZY	0	+	0	0	1891	0.0000000
zheyou73v0_A07	23296391	23296827	BnaA07T0247500ZY	0	+	0	0	436	0.0000000
zheyou73v0_A07	23308782	23309902	BnaA07T0247600ZY	0	+	0	0	1120	0.0000000
zheyou73v0_A07	23310616	23311233	BnaA07T0247700ZY	0	-	0	0	617	0.0000000
zheyou73v0_A07	23314744	23315160	BnaA07T0247800ZY	0	-	0	0	416	0.0000000
zheyou73v0_A07	23315211	23315938	BnaA07T0247900ZY	0	-	0	0	727	0.0000000
zheyou73v0_A07	23319124	23320369	BnaA07T0248000ZY	0	+	0	0	1245	0.0000000
zheyou73v0_A07	23322113	23323031	BnaA07T0248100ZY	0	-	0	0	918	0.0000000
zheyou73v0_A07	23323099	23323449	BnaA07T0248200ZY	0	-	0	0	350	0.0000000
zheyou73v0_A07	23332719	23336670	BnaA07T0248300ZY	0	-	0	0	3951	0.0000000
zheyou73v0_A07	23366459	23372342	BnaA07T0248400ZY	0	+	0	0	5883	0.0000000
zheyou73v0_A07	23373684	23374092	BnaA07T0248500ZY	0	+	0	0	408	0.0000000
zheyou73v0_A07	23374111	23374568	BnaA07T0248600ZY	0	+	0	0	457	0.0000000
zheyou73v0_A07	23378004	23381936	BnaA07T0248700ZY	0	+	0	0	3932	0.0000000
zheyou73v0_A07	23378004	23381936	BnaA07T0248700ZY.1	0	+	0	0	3932	0.0000000
zheyou73v0_A07	23382991	23383830	BnaA07T0248800ZY	0	-	0	0	839	0.0000000
zheyou73v0_A07	23387062	23387654	BnaA07T0248900ZY	0	+	0	0	592	0.0000000
zheyou73v0_A07	23393916	23395133	BnaA07T0249000ZY	0	+	0	0	1217	0.0000000
zheyou73v0_A07	23398631	23399401	BnaA07T0249100ZY	0	+	0	0	770	0.0000000
zheyou73v0_A07	23399610	23402258	BnaA07T0249200ZY	0	-	0	0	2648	0.0000000
zheyou73v0_A07	23409777	23410256	BnaA07T0249300ZY	0	+	0	0	479	0.0000000
zheyou73v0_A07	23411006	23412904	BnaA07T0249400ZY	0	+	0	0	1898	0.0000000
zheyou73v0_A07	23418299	23422469	BnaA07T0249500ZY	0	+	0	0	4170	0.0000000
zheyou73v0_A07	23423898	23427678	BnaA07T0249600ZY	0	-	0	0	3780	0.0000000
zheyou73v0_A07	23436251	23437114	BnaA07T0249700ZY	0	+	0	0	863	0.0000000
zheyou73v0_A07	23437285	23437997	BnaA07T0249800ZY	0	-	0	0	712	0.0000000
zheyou73v0_A07	23438821	23442743	BnaA07T0249900ZY	0	-	0	0	3922	0.0000000
zheyou73v0_A07	23438821	23442743	BnaA07T0249900ZY.1	0	-	0	0	3922	0.0000000
zheyou73v0_A07	23438821	23442743	BnaA07T0249900ZY.3	0	-	0	0	3922	0.0000000
zheyou73v0_A07	23439362	23442743	BnaA07T0249900ZY.2	0	-	0	0	3381	0.0000000
zheyou73v0_A07	23459377	23459754	BnaA07T0250000ZY	0	-	0	0	377	0.0000000
zheyou73v0_A07	23461075	23463314	BnaA07T0250100ZY	0	-	0	0	2239	0.0000000
zheyou73v0_A07	23467584	23468509	BnaA07T0250200ZY	0	-	0	0	925	0.0000000
zheyou73v0_A07	23498052	23499814	BnaA07T0250300ZY	0	+	0	0	1762	0.0000000
zheyou73v0_A07	23504734	23507845	BnaA07T0250400ZY.1	0	+	0	0	3111	0.0000000
zheyou73v0_A07	23505280	23507753	BnaA07T0250400ZY	0	+	0	0	2473	0.0000000
zheyou73v0_A07	23513423	23516059	BnaA07T0250500ZY	0	-	0	0	2636	0.0000000
zheyou73v0_A07	23517623	23517875	BnaA07T0250600ZY	0	-	0	0	252	0.0000000
zheyou73v0_A07	23520589	23521393	BnaA07T0250700ZY	0	+	0	0	804	0.0000000
zheyou73v0_A07	23523049	23524493	BnaA07T0250800ZY	0	-	0	0	1444	0.0000000
zheyou73v0_A07	23529308	23530301	BnaA07T0250900ZY	0	+	0	0	993	0.0000000
zheyou73v0_A07	23532835	23533412	BnaA07T0251000ZY	0	-	0	0	577	0.0000000
zheyou73v0_A07	23537235	23538363	BnaA07T0251100ZY	0	-	0	0	1128	0.0000000
zheyou73v0_A07	23542086	23543390	BnaA07T0251200ZY	0	-	0	0	1304	0.0000000
zheyou73v0_A07	23547645	23548779	BnaA07T0251300ZY	0	-	0	0	1134	0.0000000
zheyou73v0_A07	23554689	23555079	BnaA07T0251400ZY	0	-	0	0	390	0.0000000
zheyou73v0_A07	23555304	23558147	BnaA07T0251500ZY	0	-	0	0	2843	0.0000000
zheyou73v0_A07	23555304	23558397	BnaA07T0251500ZY.1	0	-	0	0	3093	0.0000000
zheyou73v0_A07	23565537	23568314	BnaA07T0251600ZY	0	+	0	0	2777	0.0000000
zheyou73v0_A07	23565637	23568314	BnaA07T0251600ZY.1	0	+	0	0	2677	0.0000000
zheyou73v0_A07	23569198	23569903	BnaA07T0251700ZY	0	+	0	0	705	0.0000000
zheyou73v0_A07	23570697	23571901	BnaA07T0251800ZY	0	+	0	0	1204	0.0000000
zheyou73v0_A07	23573909	23577501	BnaA07T0251900ZY	0	-	0	0	3592	0.0000000
zheyou73v0_A07	23579111	23580560	BnaA07T0252000ZY	0	+	0	0	1449	0.0000000
zheyou73v0_A07	23581281	23587003	BnaA07T0252100ZY	0	-	0	0	5722	0.0000000
zheyou73v0_A07	23588229	23589889	BnaA07T0252200ZY	0	+	0	0	1660	0.0000000
zheyou73v0_A07	23590181	23593247	BnaA07T0252300ZY	0	-	0	0	3066	0.0000000
zheyou73v0_A07	23609805	23611881	BnaA07T0252400ZY	0	+	0	0	2076	0.0000000
zheyou73v0_A07	23615444	23616074	BnaA07T0252500ZY	0	+	0	0	630	0.0000000
zheyou73v0_A07	23621238	23624248	BnaA07T0252600ZY	0	+	0	0	3010	0.0000000
zheyou73v0_A07	23621238	23624248	BnaA07T0252600ZY.1	0	+	0	0	3010	0.0000000
zheyou73v0_A07	23624531	23625582	BnaA07T0252700ZY	0	-	0	0	1051	0.0000000
zheyou73v0_A07	23630464	23634558	BnaA07T0252800ZY	0	-	0	0	4094	0.0000000
zheyou73v0_A07	23650335	23651553	BnaA07T0252900ZY	0	+	0	0	1218	0.0000000
zheyou73v0_A07	23660890	23661790	BnaA07T0253000ZY	0	+	0	0	900	0.0000000
zheyou73v0_A07	23662063	23663754	BnaA07T0253100ZY	0	-	0	0	1691	0.0000000
zheyou73v0_A07	23662063	23663754	BnaA07T0253100ZY.1	0	-	0	0	1691	0.0000000
zheyou73v0_A07	23669606	23672223	BnaA07T0253200ZY	0	+	0	0	2617	0.0000000
zheyou73v0_A07	23672159	23672492	BnaA07T0253300ZY	0	-	0	0	333	0.0000000
zheyou73v0_A07	23672629	23673767	BnaA07T0253400ZY	0	-	0	0	1138	0.0000000
zheyou73v0_A07	23673996	23677930	BnaA07T0253500ZY	0	-	0	0	3934	0.0000000
zheyou73v0_A07	23683435	23686059	BnaA07T0253600ZY	0	+	0	0	2624	0.0000000
zheyou73v0_A07	23687642	23688451	BnaA07T0253700ZY	0	+	0	0	809	0.0000000
zheyou73v0_A07	23692440	23693787	BnaA07T0253800ZY	0	+	0	0	1347	0.0000000
zheyou73v0_A07	23694150	23695572	BnaA07T0253900ZY	0	-	0	0	1422	0.0000000
zheyou73v0_A07	23698806	23699406	BnaA07T0254000ZY	0	-	0	0	600	0.0000000
zheyou73v0_A07	23703315	23714112	BnaA07T0254100ZY	0	-	0	0	10797	0.0000000
zheyou73v0_A07	23717071	23720239	BnaA07T0254200ZY	0	-	0	0	3168	0.0000000
zheyou73v0_A07	23724797	23732128	BnaA07T0254300ZY	0	+	0	0	7331	0.0000000
zheyou73v0_A07	23732372	23734745	BnaA07T0254400ZY	0	+	0	0	2373	0.0000000
zheyou73v0_A07	23734657	23738729	BnaA07T0254500ZY.1	0	-	0	0	4072	0.0000000
zheyou73v0_A07	23734677	23738729	BnaA07T0254500ZY	0	-	0	0	4052	0.0000000
zheyou73v0_A07	23742281	23744932	BnaA07T0254600ZY	0	-	0	0	2651	0.0000000
zheyou73v0_A07	23753704	23755339	BnaA07T0254700ZY	0	+	0	0	1635	0.0000000
zheyou73v0_A07	23755376	23757551	BnaA07T0254800ZY	0	-	0	0	2175	0.0000000
zheyou73v0_A07	23757806	23759098	BnaA07T0254900ZY	0	+	0	0	1292	0.0000000
zheyou73v0_A07	23764580	23768261	BnaA07T0255000ZY	0	+	0	0	3681	0.0000000
zheyou73v0_A07	23764686	23768261	BnaA07T0255000ZY.1	0	+	0	0	3575	0.0000000
zheyou73v0_A07	23768809	23771788	BnaA07T0255100ZY	0	-	0	0	2979	0.0000000
zheyou73v0_A07	23772691	23774144	BnaA07T0255200ZY	0	-	0	0	1453	0.0000000
zheyou73v0_A07	23776914	23779738	BnaA07T0255300ZY	0	-	0	0	2824	0.0000000
zheyou73v0_A07	23779759	23781623	BnaA07T0255400ZY	0	-	0	0	1864	0.0000000
zheyou73v0_A07	23782565	23784395	BnaA07T0255500ZY	0	-	0	0	1830	0.0000000
zheyou73v0_A07	23782899	23784280	BnaA07T0255500ZY.1	0	-	0	0	1381	0.0000000
zheyou73v0_A07	23788898	23790196	BnaA07T0255600ZY	0	+	0	0	1298	0.0000000
zheyou73v0_A07	23790758	23793150	BnaA07T0255700ZY	0	+	0	0	2392	0.0000000
zheyou73v0_A07	23803515	23813986	BnaA07T0255800ZY	0	+	0	0	10471	0.0000000
zheyou73v0_A07	23830898	23834310	BnaA07T0255900ZY	0	+	0	0	3412	0.0000000
zheyou73v0_A07	23859482	23861060	BnaA07T0256000ZY	0	+	0	0	1578	0.0000000
zheyou73v0_A07	23863144	23865812	BnaA07T0256100ZY	0	-	0	0	2668	0.0000000
zheyou73v0_A07	23863144	23865812	BnaA07T0256100ZY.1	0	-	0	0	2668	0.0000000
zheyou73v0_A07	23870318	23871490	BnaA07T0256200ZY	0	+	0	0	1172	0.0000000
zheyou73v0_A07	23875131	23877461	BnaA07T0256300ZY	0	+	0	0	2330	0.0000000
zheyou73v0_A07	23893961	23895944	BnaA07T0256400ZY	0	+	0	0	1983	0.0000000
zheyou73v0_A07	23899855	23900406	BnaA07T0256500ZY	0	+	0	0	551	0.0000000
zheyou73v0_A07	23904795	23905145	BnaA07T0256600ZY	0	+	0	0	350	0.0000000
zheyou73v0_A07	23907799	23908320	BnaA07T0256700ZY	0	+	0	0	521	0.0000000
zheyou73v0_A07	23915909	23917058	BnaA07T0256800ZY	0	+	0	0	1149	0.0000000
zheyou73v0_A07	23919287	23920423	BnaA07T0256900ZY	0	+	0	0	1136	0.0000000
zheyou73v0_A07	23921793	23922536	BnaA07T0257000ZY	0	+	0	0	743	0.0000000
zheyou73v0_A07	23923160	23924069	BnaA07T0257100ZY	0	+	0	0	909	0.0000000
zheyou73v0_A07	23924614	23926449	BnaA07T0257200ZY	0	+	0	0	1835	0.0000000
zheyou73v0_A07	23926880	23928033	BnaA07T0257300ZY	0	-	0	0	1153	0.0000000
zheyou73v0_A07	23932458	23934130	BnaA07T0257400ZY	0	-	0	0	1672	0.0000000
zheyou73v0_A07	23934966	23936942	BnaA07T0257500ZY	0	-	0	0	1976	0.0000000
zheyou73v0_A07	23937116	23938946	BnaA07T0257600ZY	0	+	0	0	1830	0.0000000
zheyou73v0_A07	23937343	23938946	BnaA07T0257600ZY.1	0	+	0	0	1603	0.0000000
zheyou73v0_A07	23937343	23938946	BnaA07T0257600ZY.2	0	+	0	0	1603	0.0000000
zheyou73v0_A07	23953492	23954501	BnaA07T0257700ZY	0	+	0	0	1009	0.0000000
zheyou73v0_A07	23957270	23958959	BnaA07T0257800ZY	0	+	0	0	1689	0.0000000
zheyou73v0_A07	24000115	24002932	BnaA07T0257900ZY	0	+	0	0	2817	0.0000000
zheyou73v0_A07	24000115	24002932	BnaA07T0257900ZY.1	0	+	0	0	2817	0.0000000
zheyou73v0_A07	24004612	24005095	BnaA07T0258000ZY	0	+	0	0	483	0.0000000
zheyou73v0_A07	24006333	24007409	BnaA07T0258100ZY	0	+	0	0	1076	0.0000000
zheyou73v0_A07	24008113	24009389	BnaA07T0258200ZY	0	+	0	0	1276	0.0000000
zheyou73v0_A07	24015015	24015978	BnaA07T0258300ZY	0	-	0	0	963	0.0000000
zheyou73v0_A07	24044416	24046319	BnaA07T0258400ZY	0	+	0	0	1903	0.0000000
zheyou73v0_A07	24057675	24059984	BnaA07T0258500ZY	0	+	0	0	2309	0.0000000
zheyou73v0_A07	24068032	24069503	BnaA07T0258600ZY	0	-	0	0	1471	0.0000000
zheyou73v0_A07	24070310	24074608	BnaA07T0258700ZY	0	-	0	0	4298	0.0000000
zheyou73v0_A07	24077744	24082580	BnaA07T0258800ZY	0	-	0	0	4836	0.0000000
zheyou73v0_A07	24083492	24084940	BnaA07T0258900ZY	0	-	0	0	1448	0.0000000
zheyou73v0_A07	24088038	24090675	BnaA07T0259000ZY	0	-	0	0	2637	0.0000000
zheyou73v0_A07	24105263	24107594	BnaA07T0259100ZY	0	+	0	0	2331	0.0000000
zheyou73v0_A07	24111942	24116685	BnaA07T0259200ZY	0	+	0	0	4743	0.0000000
zheyou73v0_A07	24136218	24137265	BnaA07T0259300ZY	0	-	0	0	1047	0.0000000
zheyou73v0_A07	24141054	24142291	BnaA07T0259400ZY	0	-	0	0	1237	0.0000000
zheyou73v0_A07	24143607	24144822	BnaA07T0259500ZY	0	-	0	0	1215	0.0000000
zheyou73v0_A07	24147976	24149190	BnaA07T0259600ZY	0	-	0	0	1214	0.0000000
zheyou73v0_A07	24158501	24160118	BnaA07T0259700ZY	0	-	0	0	1617	0.0000000
zheyou73v0_A07	24161037	24164007	BnaA07T0259800ZY	0	-	0	0	2970	0.0000000
zheyou73v0_A07	24172051	24173496	BnaA07T0259900ZY	0	-	0	0	1445	0.0000000
zheyou73v0_A07	24177027	24178067	BnaA07T0260000ZY	0	-	0	0	1040	0.0000000
zheyou73v0_A07	24178551	24180354	BnaA07T0260100ZY	0	-	0	0	1803	0.0000000
zheyou73v0_A07	24229837	24230234	BnaA07T0260200ZY	0	+	0	0	397	0.0000000
zheyou73v0_A07	24231090	24231835	BnaA07T0260300ZY	0	+	0	0	745	0.0000000
zheyou73v0_A07	24235873	24241988	BnaA07T0260400ZY	0	+	0	0	6115	0.0000000
zheyou73v0_A07	24236031	24241988	BnaA07T0260400ZY.1	0	+	0	0	5957	0.0000000
zheyou73v0_A07	24241844	24246297	BnaA07T0260500ZY	0	-	0	0	4453	0.0000000
zheyou73v0_A07	24247239	24248016	BnaA07T0260600ZY	0	-	0	0	777	0.0000000
zheyou73v0_A07	24250725	24252799	BnaA07T0260700ZY	0	+	0	0	2074	0.0000000
zheyou73v0_A07	24261548	24261725	BnaA07T0260800ZY	0	+	0	0	177	0.0000000
zheyou73v0_A07	24262035	24264164	BnaA07T0260900ZY	0	-	0	0	2129	0.0000000
zheyou73v0_A07	24282674	24284139	BnaA07T0261000ZY	0	+	0	0	1465	0.0000000
zheyou73v0_A07	24285117	24288091	BnaA07T0261100ZY	0	+	0	0	2974	0.0000000
zheyou73v0_A07	24285117	24288091	BnaA07T0261100ZY.2	0	+	0	0	2974	0.0000000
zheyou73v0_A07	24285265	24288091	BnaA07T0261100ZY.1	0	+	0	0	2826	0.0000000
zheyou73v0_A07	24289292	24291362	BnaA07T0261200ZY	0	-	0	0	2070	0.0000000
zheyou73v0_A07	24293348	24295406	BnaA07T0261300ZY	0	-	0	0	2058	0.0000000
zheyou73v0_A07	24296652	24299149	BnaA07T0261400ZY	0	-	0	0	2497	0.0000000
zheyou73v0_A07	24300833	24303406	BnaA07T0261500ZY	0	+	0	0	2573	0.0000000
zheyou73v0_A07	24300833	24303510	BnaA07T0261500ZY.1	0	+	0	0	2677	0.0000000
zheyou73v0_A07	24303942	24306072	BnaA07T0261600ZY	0	+	0	0	2130	0.0000000
zheyou73v0_A07	24303942	24306072	BnaA07T0261600ZY.1	0	+	0	0	2130	0.0000000
zheyou73v0_A07	24306267	24307874	BnaA07T0261700ZY	0	-	0	0	1607	0.0000000
zheyou73v0_A07	24309322	24310855	BnaA07T0261800ZY	0	+	0	0	1533	0.0000000
zheyou73v0_A07	24328062	24329913	BnaA07T0261900ZY	0	+	0	0	1851	0.0000000
zheyou73v0_A07	24338383	24339888	BnaA07T0262000ZY	0	+	0	0	1505	0.0000000
zheyou73v0_A07	24343350	24345433	BnaA07T0262100ZY	0	-	0	0	2083	0.0000000
zheyou73v0_A07	24348544	24351028	BnaA07T0262200ZY	0	-	0	0	2484	0.0000000
zheyou73v0_A07	24348544	24350692	BnaA07T0262200ZY.1	0	-	0	0	2148	0.0000000
zheyou73v0_A07	24353961	24359189	BnaA07T0262300ZY	0	-	0	0	5228	0.0000000
zheyou73v0_A07	24353961	24359189	BnaA07T0262300ZY.1	0	-	0	0	5228	0.0000000
zheyou73v0_A07	24353961	24359189	BnaA07T0262300ZY.2	0	-	0	0	5228	0.0000000
zheyou73v0_A07	24427460	24430435	BnaA07T0262400ZY	0	-	0	0	2975	0.0000000
zheyou73v0_A07	24441866	24444384	BnaA07T0262500ZY	0	-	0	0	2518	0.0000000
zheyou73v0_A07	24455661	24457019	BnaA07T0262600ZY	0	-	0	0	1358	0.0000000
zheyou73v0_A07	24459980	24465334	BnaA07T0262700ZY	0	-	0	0	5354	0.0000000
zheyou73v0_A07	24466860	24467603	BnaA07T0262800ZY	0	-	0	0	743	0.0000000
zheyou73v0_A07	24469484	24470455	BnaA07T0262900ZY	0	-	0	0	971	0.0000000
zheyou73v0_A07	24476297	24479778	BnaA07T0263000ZY	0	+	0	0	3481	0.0000000
zheyou73v0_A07	24480395	24481591	BnaA07T0263100ZY	0	-	0	0	1196	0.0000000
zheyou73v0_A07	24482756	24485894	BnaA07T0263200ZY	0	+	0	0	3138	0.0000000
zheyou73v0_A07	24486189	24487104	BnaA07T0263300ZY	0	-	0	0	915	0.0000000
zheyou73v0_A07	24488940	24489374	BnaA07T0263400ZY	0	+	0	0	434	0.0000000
zheyou73v0_A07	24489497	24490785	BnaA07T0263500ZY	0	+	0	0	1288	0.0000000
zheyou73v0_A07	24491273	24492283	BnaA07T0263600ZY	0	-	0	0	1010	0.0000000
zheyou73v0_A07	24494618	24499507	BnaA07T0263700ZY	0	+	0	0	4889	0.0000000
zheyou73v0_A07	24500417	24502460	BnaA07T0263800ZY	0	-	0	0	2043	0.0000000
zheyou73v0_A07	24503415	24504569	BnaA07T0263900ZY	0	-	0	0	1154	0.0000000
zheyou73v0_A07	24505795	24507110	BnaA07T0264000ZY	0	-	0	0	1315	0.0000000
zheyou73v0_A07	24512902	24514311	BnaA07T0264100ZY	0	-	0	0	1409	0.0000000
zheyou73v0_A07	24517303	24519030	BnaA07T0264200ZY	0	+	0	0	1727	0.0000000
zheyou73v0_A07	24519373	24528555	BnaA07T0264300ZY	0	-	0	0	9182	0.0000000
zheyou73v0_A07	24538606	24541699	BnaA07T0264400ZY	0	-	0	0	3093	0.0000000
zheyou73v0_A07	24547317	24550228	BnaA07T0264500ZY	0	+	0	0	2911	0.0000000
zheyou73v0_A07	24561165	24563329	BnaA07T0264600ZY	0	+	0	0	2164	0.0000000
zheyou73v0_A07	24564635	24565415	BnaA07T0264700ZY	0	+	0	0	780	0.0000000
zheyou73v0_A07	24567969	24569744	BnaA07T0264800ZY	0	+	0	0	1775	0.0000000
zheyou73v0_A07	24571522	24572776	BnaA07T0264900ZY	0	+	0	0	1254	0.0000000
zheyou73v0_A07	24573436	24576427	BnaA07T0265000ZY	0	+	0	0	2991	0.0000000
zheyou73v0_A07	24577481	24578465	BnaA07T0265100ZY	0	+	0	0	984	0.0000000
zheyou73v0_A07	24585650	24587954	BnaA07T0265200ZY	0	+	0	0	2304	0.0000000
zheyou73v0_A07	24592575	24594380	BnaA07T0265300ZY	0	+	0	0	1805	0.0000000
zheyou73v0_A07	24592575	24594380	BnaA07T0265300ZY.1	0	+	0	0	1805	0.0000000
zheyou73v0_A07	24598133	24599690	BnaA07T0265400ZY	0	+	0	0	1557	0.0000000
zheyou73v0_A07	24598133	24599690	BnaA07T0265400ZY.1	0	+	0	0	1557	0.0000000
zheyou73v0_A07	24601199	24603782	BnaA07T0265500ZY	0	+	0	0	2583	0.0000000
zheyou73v0_A07	24606587	24610392	BnaA07T0265600ZY	0	-	0	0	3805	0.0000000
zheyou73v0_A07	24620507	24622635	BnaA07T0265700ZY	0	-	0	0	2128	0.0000000
zheyou73v0_A07	24620507	24622244	BnaA07T0265700ZY.1	0	-	0	0	1737	0.0000000
zheyou73v0_A07	24627608	24631167	BnaA07T0265800ZY	0	-	0	0	3559	0.0000000
zheyou73v0_A07	24637951	24640757	BnaA07T0265900ZY	0	+	0	0	2806	0.0000000
zheyou73v0_A07	24640770	24644747	BnaA07T0266000ZY	0	-	0	0	3977	0.0000000
zheyou73v0_A07	24649457	24651251	BnaA07T0266100ZY	0	+	0	0	1794	0.0000000
zheyou73v0_A07	24651434	24652860	BnaA07T0266200ZY	0	+	0	0	1426	0.0000000
zheyou73v0_A07	24653349	24656524	BnaA07T0266300ZY	0	+	0	0	3175	0.0000000
zheyou73v0_A07	24653349	24656524	BnaA07T0266300ZY.1	0	+	0	0	3175	0.0000000
zheyou73v0_A07	24656901	24658161	BnaA07T0266400ZY	0	-	0	0	1260	0.0000000
zheyou73v0_A07	24664910	24665129	BnaA07T0266500ZY	0	-	0	0	219	0.0000000
zheyou73v0_A07	24669602	24670595	BnaA07T0266600ZY	0	-	0	0	993	0.0000000
zheyou73v0_A07	24672695	24673036	BnaA07T0266700ZY	0	-	0	0	341	0.0000000
zheyou73v0_A07	24680426	24681399	BnaA07T0266800ZY	0	+	0	0	973	0.0000000
zheyou73v0_A07	24681642	24682575	BnaA07T0266900ZY	0	+	0	0	933	0.0000000
zheyou73v0_A07	24686507	24688636	BnaA07T0267000ZY	0	+	0	0	2129	0.0000000
zheyou73v0_A07	24686507	24688636	BnaA07T0267000ZY.1	0	+	0	0	2129	0.0000000
zheyou73v0_A07	24686507	24688636	BnaA07T0267000ZY.2	0	+	0	0	2129	0.0000000
zheyou73v0_A07	24691396	24693578	BnaA07T0267100ZY	0	+	0	0	2182	0.0000000
zheyou73v0_A07	24714679	24717965	BnaA07T0267200ZY	0	+	0	0	3286	0.0000000
zheyou73v0_A07	24714679	24717965	BnaA07T0267200ZY.1	0	+	0	0	3286	0.0000000
zheyou73v0_A07	24723825	24726428	BnaA07T0267300ZY	0	+	0	0	2603	0.0000000
zheyou73v0_A07	24726805	24727960	BnaA07T0267400ZY	0	-	0	0	1155	0.0000000
zheyou73v0_A07	24729755	24730364	BnaA07T0267500ZY	0	-	0	0	609	0.0000000
zheyou73v0_A07	24731725	24733027	BnaA07T0267600ZY	0	-	0	0	1302	0.0000000
zheyou73v0_A07	24750195	24752019	BnaA07T0267700ZY	0	-	0	0	1824	0.0000000
zheyou73v0_A07	24757202	24763068	BnaA07T0267800ZY	0	+	0	0	5866	0.0000000
zheyou73v0_A07	24764397	24764685	BnaA07T0267900ZY	0	-	0	0	288	0.0000000
zheyou73v0_A07	24765893	24768737	BnaA07T0268000ZY	0	-	0	0	2844	0.0000000
zheyou73v0_A07	24771437	24772602	BnaA07T0268100ZY	0	-	0	0	1165	0.0000000
zheyou73v0_A07	24771437	24772602	BnaA07T0268100ZY.1	0	-	0	0	1165	0.0000000
zheyou73v0_A07	24783883	24787148	BnaA07T0268200ZY	0	-	0	0	3265	0.0000000
zheyou73v0_A07	24790644	24791537	BnaA07T0268300ZY	0	-	0	0	893	0.0000000
zheyou73v0_A07	24794270	24796216	BnaA07T0268400ZY	0	-	0	0	1946	0.0000000
zheyou73v0_A07	24796549	24798255	BnaA07T0268500ZY	0	-	0	0	1706	0.0000000
zheyou73v0_A07	24800704	24802727	BnaA07T0268600ZY	0	+	0	0	2023	0.0000000
zheyou73v0_A07	24800704	24802727	BnaA07T0268600ZY.1	0	+	0	0	2023	0.0000000
zheyou73v0_A07	24800704	24802727	BnaA07T0268600ZY.2	0	+	0	0	2023	0.0000000
zheyou73v0_A07	24805270	24808362	BnaA07T0268700ZY	0	+	0	0	3092	0.0000000
zheyou73v0_A07	24808504	24814057	BnaA07T0268800ZY	0	+	0	0	5553	0.0000000
zheyou73v0_A07	24817035	24818948	BnaA07T0268900ZY	0	-	0	0	1913	0.0000000
zheyou73v0_A07	24819498	24822717	BnaA07T0269000ZY	0	-	0	0	3219	0.0000000
zheyou73v0_A07	24826834	24832982	BnaA07T0269100ZY	0	+	0	0	6148	0.0000000
zheyou73v0_A07	24833366	24835535	BnaA07T0269200ZY	0	-	0	0	2169	0.0000000
zheyou73v0_A07	24836825	24840200	BnaA07T0269300ZY	0	+	0	0	3375	0.0000000
zheyou73v0_A07	24841182	24845161	BnaA07T0269400ZY	0	+	0	0	3979	0.0000000
zheyou73v0_A07	24841182	24845161	BnaA07T0269400ZY.1	0	+	0	0	3979	0.0000000
zheyou73v0_A07	24845478	24846978	BnaA07T0269500ZY	0	+	0	0	1500	0.0000000
zheyou73v0_A07	24846954	24848632	BnaA07T0269600ZY	0	-	0	0	1678	0.0000000
zheyou73v0_A07	24848857	24855062	BnaA07T0269700ZY	0	+	0	0	6205	0.0000000
zheyou73v0_A07	24848857	24855062	BnaA07T0269700ZY.1	0	+	0	0	6205	0.0000000
zheyou73v0_A07	24859525	24860937	BnaA07T0269800ZY	0	-	0	0	1412	0.0000000
zheyou73v0_A07	24867322	24869278	BnaA07T0269900ZY	0	-	0	0	1956	0.0000000
zheyou73v0_A07	24867322	24869278	BnaA07T0269900ZY.1	0	-	0	0	1956	0.0000000
zheyou73v0_A07	24871072	24873467	BnaA07T0270000ZY	0	-	0	0	2395	0.0000000
zheyou73v0_A07	24874160	24877237	BnaA07T0270100ZY	0	-	0	0	3077	0.0000000
zheyou73v0_A07	24879279	24881266	BnaA07T0270200ZY	0	-	0	0	1987	0.0000000
zheyou73v0_A07	24899368	24904366	BnaA07T0270300ZY	0	-	0	0	4998	0.0000000
zheyou73v0_A07	24904673	24906905	BnaA07T0270400ZY	0	-	0	0	2232	0.0000000
zheyou73v0_A07	24908395	24909731	BnaA07T0270500ZY	0	+	0	0	1336	0.0000000
zheyou73v0_A07	24911139	24914833	BnaA07T0270600ZY	0	-	0	0	3694	0.0000000
zheyou73v0_A07	24911205	24911742	BnaA07T0270700ZY	0	+	0	0	537	0.0000000
zheyou73v0_A07	24917918	24918470	BnaA07T0270800ZY	0	+	0	0	552	0.0000000
zheyou73v0_A07	24918952	24921199	BnaA07T0270900ZY	0	-	0	0	2247	0.0000000
zheyou73v0_A07	24921769	24925709	BnaA07T0271000ZY	0	+	0	0	3940	0.0000000
zheyou73v0_A07	24927733	24928384	BnaA07T0271100ZY	0	+	0	0	651	0.0000000
zheyou73v0_A07	24929722	24932398	BnaA07T0271200ZY	0	+	0	0	2676	0.0000000
zheyou73v0_A07	24933724	24936397	BnaA07T0271300ZY	0	+	0	0	2673	0.0000000
zheyou73v0_A07	24936825	24938000	BnaA07T0271400ZY	0	+	0	0	1175	0.0000000
zheyou73v0_A07	24938587	24940812	BnaA07T0271500ZY	0	-	0	0	2225	0.0000000
zheyou73v0_A07	24942660	24945505	BnaA07T0271600ZY	0	-	0	0	2845	0.0000000
zheyou73v0_A07	24959946	24962161	BnaA07T0271700ZY	0	+	0	0	2215	0.0000000
zheyou73v0_A07	24964286	24966407	BnaA07T0271800ZY	0	+	0	0	2121	0.0000000
zheyou73v0_A07	24967633	24967909	BnaA07T0271900ZY	0	+	0	0	276	0.0000000
zheyou73v0_A07	24968158	24971342	BnaA07T0272000ZY	0	-	0	0	3184	0.0000000
zheyou73v0_A07	24968671	24971342	BnaA07T0272000ZY.1	0	-	0	0	2671	0.0000000
zheyou73v0_A07	24979708	24981835	BnaA07T0272100ZY	0	+	0	0	2127	0.0000000
zheyou73v0_A07	24982111	24982573	BnaA07T0272200ZY	0	-	0	0	462	0.0000000
zheyou73v0_A07	24982977	24983379	BnaA07T0272300ZY	0	+	0	0	402	0.0000000
zheyou73v0_A07	24983100	24984594	BnaA07T0272400ZY	0	-	0	0	1494	0.0000000
zheyou73v0_A07	24983100	24984594	BnaA07T0272400ZY.1	0	-	0	0	1494	0.0000000
zheyou73v0_A07	24983100	24984594	BnaA07T0272400ZY.2	0	-	0	0	1494	0.0000000
zheyou73v0_A07	24983100	24984594	BnaA07T0272400ZY.3	0	-	0	0	1494	0.0000000
zheyou73v0_A07	24986934	24987923	BnaA07T0272500ZY	0	+	0	0	989	0.0000000
zheyou73v0_A07	24987978	24990740	BnaA07T0272600ZY	0	-	0	0	2762	0.0000000
zheyou73v0_A07	24992917	24993994	BnaA07T0272700ZY	0	-	0	0	1077	0.0000000
zheyou73v0_A07	24994202	24996221	BnaA07T0272800ZY	0	+	0	0	2019	0.0000000
zheyou73v0_A07	24996619	24997896	BnaA07T0272900ZY	0	-	0	0	1277	0.0000000
zheyou73v0_A07	24999011	25004805	BnaA07T0273000ZY	0	-	0	0	5794	0.0000000
zheyou73v0_A07	25005478	25012868	BnaA07T0273100ZY	0	+	0	0	7390	0.0000000
zheyou73v0_A07	25005478	25012868	BnaA07T0273100ZY.1	0	+	0	0	7390	0.0000000
zheyou73v0_A07	25007564	25012868	BnaA07T0273100ZY.2	0	+	0	0	5304	0.0000000
zheyou73v0_A07	25014883	25019105	BnaA07T0273200ZY	0	+	0	0	4222	0.0000000
zheyou73v0_A07	25019317	25021286	BnaA07T0273300ZY	0	+	0	0	1969	0.0000000
zheyou73v0_A07	25019317	25021286	BnaA07T0273300ZY.1	0	+	0	0	1969	0.0000000
zheyou73v0_A07	25022318	25022534	BnaA07T0273400ZY	0	+	0	0	216	0.0000000
zheyou73v0_A07	25022666	25023806	BnaA07T0273500ZY	0	-	0	0	1140	0.0000000
zheyou73v0_A07	25024007	25026462	BnaA07T0273600ZY	0	-	0	0	2455	0.0000000
zheyou73v0_A07	25027650	25029309	BnaA07T0273700ZY	0	+	0	0	1659	0.0000000
zheyou73v0_A07	25030399	25032851	BnaA07T0273800ZY	0	-	0	0	2452	0.0000000
zheyou73v0_A07	25060959	25063159	BnaA07T0273900ZY	0	+	0	0	2200	0.0000000
zheyou73v0_A07	25064640	25066911	BnaA07T0274000ZY	0	+	0	0	2271	0.0000000
zheyou73v0_A07	25073079	25076572	BnaA07T0274100ZY	0	+	0	0	3493	0.0000000
zheyou73v0_A07	25086700	25087689	BnaA07T0274200ZY	0	+	0	0	989	0.0000000
zheyou73v0_A07	25088920	25090655	BnaA07T0274300ZY	0	+	0	0	1735	0.0000000
zheyou73v0_A07	25091617	25092870	BnaA07T0274400ZY	0	-	0	0	1253	0.0000000
zheyou73v0_A07	25093985	25099817	BnaA07T0274500ZY	0	-	0	0	5832	0.0000000
zheyou73v0_A07	25093985	25099538	BnaA07T0274500ZY.1	0	-	0	0	5553	0.0000000
zheyou73v0_A07	25104290	25106621	BnaA07T0274600ZY	0	+	0	0	2331	0.0000000
zheyou73v0_A07	25113903	25115520	BnaA07T0274700ZY	0	+	0	0	1617	0.0000000
zheyou73v0_A07	25117683	25119175	BnaA07T0274800ZY	0	+	0	0	1492	0.0000000
zheyou73v0_A07	25120717	25123543	BnaA07T0274900ZY	0	+	0	0	2826	0.0000000
zheyou73v0_A07	25127746	25128823	BnaA07T0275000ZY	0	+	0	0	1077	0.0000000
zheyou73v0_A07	25129298	25129968	BnaA07T0275100ZY	0	-	0	0	670	0.0000000
zheyou73v0_A07	25130676	25133168	BnaA07T0275200ZY	0	-	0	0	2492	0.0000000
zheyou73v0_A07	25136469	25139317	BnaA07T0275300ZY	0	-	0	0	2848	0.0000000
zheyou73v0_A07	25145292	25147025	BnaA07T0275400ZY	0	-	0	0	1733	0.0000000
zheyou73v0_A07	25148256	25152001	BnaA07T0275500ZY	0	+	0	0	3745	0.0000000
zheyou73v0_A07	25152675	25155310	BnaA07T0275600ZY	0	+	0	0	2635	0.0000000
zheyou73v0_A07	25160509	25162957	BnaA07T0275700ZY	0	+	0	0	2448	0.0000000
zheyou73v0_A07	25166007	25167074	BnaA07T0275800ZY	0	+	0	0	1067	0.0000000
zheyou73v0_A07	25168050	25169524	BnaA07T0275900ZY	0	+	0	0	1474	0.0000000
zheyou73v0_A07	25177836	25181146	BnaA07T0276000ZY	0	+	0	0	3310	0.0000000
zheyou73v0_A07	25187386	25190071	BnaA07T0276100ZY	0	+	0	0	2685	0.0000000
zheyou73v0_A07	25195033	25196140	BnaA07T0276200ZY	0	-	0	0	1107	0.0000000
zheyou73v0_A07	25198402	25199933	BnaA07T0276300ZY	0	+	0	0	1531	0.0000000
zheyou73v0_A07	25203217	25203780	BnaA07T0276400ZY	0	+	0	0	563	0.0000000
zheyou73v0_A07	25206634	25212248	BnaA07T0276500ZY	0	+	0	0	5614	0.0000000
zheyou73v0_A07	25213765	25216324	BnaA07T0276600ZY	0	-	0	0	2559	0.0000000
zheyou73v0_A07	25234179	25240986	BnaA07T0276700ZY	0	-	0	0	6807	0.0000000
zheyou73v0_A07	25246718	25248211	BnaA07T0276800ZY	0	+	0	0	1493	0.0000000
zheyou73v0_A07	25248943	25249670	BnaA07T0276900ZY	0	+	0	0	727	0.0000000
zheyou73v0_A07	25249626	25253332	BnaA07T0277000ZY	0	-	0	0	3706	0.0000000
zheyou73v0_A07	25249626	25253332	BnaA07T0277000ZY.1	0	-	0	0	3706	0.0000000
zheyou73v0_A07	25253952	25255471	BnaA07T0277100ZY	0	+	0	0	1519	0.0000000
zheyou73v0_A07	25256184	25258075	BnaA07T0277200ZY	0	+	0	0	1891	0.0000000
zheyou73v0_A07	25258836	25259490	BnaA07T0277300ZY	0	-	0	0	654	0.0000000
zheyou73v0_A07	25259899	25262866	BnaA07T0277400ZY	0	+	0	0	2967	0.0000000
zheyou73v0_A07	25263737	25264727	BnaA07T0277500ZY	0	+	0	0	990	0.0000000
zheyou73v0_A07	25265517	25267010	BnaA07T0277600ZY	0	-	0	0	1493	0.0000000
zheyou73v0_A07	25267247	25273487	BnaA07T0277700ZY	0	+	0	0	6240	0.0000000
zheyou73v0_A07	25274269	25275911	BnaA07T0277800ZY	0	-	0	0	1642	0.0000000
zheyou73v0_A07	25274269	25275911	BnaA07T0277800ZY.1	0	-	0	0	1642	0.0000000
zheyou73v0_A07	25276745	25278511	BnaA07T0277900ZY	0	-	0	0	1766	0.0000000
zheyou73v0_A07	25286662	25287019	BnaA07T0278000ZY	0	-	0	0	357	0.0000000
zheyou73v0_A07	25292332	25297275	BnaA07T0278100ZY	0	-	0	0	4943	0.0000000
zheyou73v0_A07	25299251	25300745	BnaA07T0278200ZY	0	-	0	0	1494	0.0000000
zheyou73v0_A07	25303302	25305540	BnaA07T0278300ZY	0	-	0	0	2238	0.0000000
zheyou73v0_A07	25307096	25308323	BnaA07T0278400ZY	0	-	0	0	1227	0.0000000
zheyou73v0_A07	25321031	25324468	BnaA07T0278500ZY	0	-	0	0	3437	0.0000000
zheyou73v0_A07	25329542	25329971	BnaA07T0278600ZY	0	-	0	0	429	0.0000000
zheyou73v0_A07	25335144	25335541	BnaA07T0278700ZY	0	+	0	0	397	0.0000000
zheyou73v0_A07	25339858	25340598	BnaA07T0278800ZY	0	+	0	0	740	0.0000000
zheyou73v0_A07	25342791	25343689	BnaA07T0278900ZY	0	+	0	0	898	0.0000000
zheyou73v0_A07	25344366	25345853	BnaA07T0279000ZY	0	-	0	0	1487	0.0000000
zheyou73v0_A07	25352013	25353125	BnaA07T0279100ZY	0	-	0	0	1112	0.0000000
zheyou73v0_A07	25353558	25354428	BnaA07T0279200ZY	0	-	0	0	870	0.0000000
zheyou73v0_A07	25361956	25362247	BnaA07T0279300ZY	0	-	0	0	291	0.0000000
zheyou73v0_A07	25362359	25366492	BnaA07T0279400ZY	0	-	0	0	4133	0.0000000
zheyou73v0_A07	25367582	25368873	BnaA07T0279500ZY	0	+	0	0	1291	0.0000000
zheyou73v0_A07	25368704	25370205	BnaA07T0279600ZY	0	-	0	0	1501	0.0000000
zheyou73v0_A07	25370423	25371821	BnaA07T0279700ZY	0	+	0	0	1398	0.0000000
zheyou73v0_A07	25374201	25375770	BnaA07T0279800ZY	0	-	0	0	1569	0.0000000
zheyou73v0_A07	25377031	25378633	BnaA07T0279900ZY	0	+	0	0	1602	0.0000000
zheyou73v0_A07	25377031	25378633	BnaA07T0279900ZY.1	0	+	0	0	1602	0.0000000
zheyou73v0_A07	25385086	25390559	BnaA07T0280000ZY	0	+	0	0	5473	0.0000000
zheyou73v0_A07	25391751	25395563	BnaA07T0280100ZY	0	+	0	0	3812	0.0000000
zheyou73v0_A07	25399858	25400254	BnaA07T0280200ZY	0	-	0	0	396	0.0000000
zheyou73v0_A07	25403190	25405238	BnaA07T0280300ZY	0	-	0	0	2048	0.0000000
zheyou73v0_A07	25403190	25405238	BnaA07T0280300ZY.1	0	-	0	0	2048	0.0000000
zheyou73v0_A07	25406072	25407006	BnaA07T0280400ZY	0	+	0	0	934	0.0000000
zheyou73v0_A07	25407734	25410920	BnaA07T0280500ZY	0	-	0	0	3186	0.0000000
zheyou73v0_A07	25414184	25416954	BnaA07T0280600ZY	0	+	0	0	2770	0.0000000
zheyou73v0_A07	25414184	25416954	BnaA07T0280600ZY.1	0	+	0	0	2770	0.0000000
zheyou73v0_A07	25419183	25420653	BnaA07T0280700ZY	0	+	0	0	1470	0.0000000
zheyou73v0_A07	25422331	25423834	BnaA07T0280800ZY	0	+	0	0	1503	0.0000000
zheyou73v0_A07	25424480	25426761	BnaA07T0280900ZY	0	-	0	0	2281	0.0000000
zheyou73v0_A07	25429323	25431739	BnaA07T0281000ZY	0	-	0	0	2416	0.0000000
zheyou73v0_A07	25436468	25437897	BnaA07T0281100ZY	0	+	0	0	1429	0.0000000
zheyou73v0_A07	25440883	25441737	BnaA07T0281200ZY	0	+	0	0	854	0.0000000
zheyou73v0_A07	25450297	25451522	BnaA07T0281300ZY	0	+	0	0	1225	0.0000000
zheyou73v0_A07	25451750	25452860	BnaA07T0281400ZY	0	+	0	0	1110	0.0000000
zheyou73v0_A07	25454898	25456030	BnaA07T0281500ZY	0	+	0	0	1132	0.0000000
zheyou73v0_A07	25456151	25460380	BnaA07T0281600ZY	0	+	0	0	4229	0.0000000
zheyou73v0_A07	25463621	25465008	BnaA07T0281700ZY	0	-	0	0	1387	0.0000000
zheyou73v0_A07	25469938	25473771	BnaA07T0281800ZY	0	-	0	0	3833	0.0000000
zheyou73v0_A07	25474089	25475421	BnaA07T0281900ZY	0	+	0	0	1332	0.0000000
zheyou73v0_A07	25476577	25477463	BnaA07T0282000ZY	0	-	0	0	886	0.0000000
zheyou73v0_A07	25477909	25480247	BnaA07T0282100ZY	0	+	0	0	2338	0.0000000
zheyou73v0_A07	25480525	25483173	BnaA07T0282200ZY	0	+	0	0	2648	0.0000000
zheyou73v0_A07	25486673	25488704	BnaA07T0282300ZY	0	+	0	0	2031	0.0000000
zheyou73v0_A07	25488991	25491290	BnaA07T0282400ZY	0	-	0	0	2299	0.0000000
zheyou73v0_A07	25491824	25492257	BnaA07T0282500ZY	0	-	0	0	433	0.0000000
zheyou73v0_A07	25498799	25499288	BnaA07T0282600ZY	0	-	0	0	489	0.0000000
zheyou73v0_A07	25506097	25507148	BnaA07T0282700ZY	0	+	0	0	1051	0.0000000
zheyou73v0_A07	25507257	25510161	BnaA07T0282800ZY	0	-	0	0	2904	0.0000000
zheyou73v0_A07	25511833	25514314	BnaA07T0282900ZY	0	-	0	0	2481	0.0000000
zheyou73v0_A07	25525374	25527719	BnaA07T0283000ZY	0	+	0	0	2345	0.0000000
zheyou73v0_A07	25527915	25528756	BnaA07T0283100ZY	0	-	0	0	841	0.0000000
zheyou73v0_A07	25529382	25531814	BnaA07T0283200ZY	0	-	0	0	2432	0.0000000
zheyou73v0_A07	25532338	25533840	BnaA07T0283300ZY	0	-	0	0	1502	0.0000000
zheyou73v0_A07	25558132	25559032	BnaA07T0283400ZY	0	-	0	0	900	0.0000000
zheyou73v0_A07	25562335	25563314	BnaA07T0283500ZY	0	-	0	0	979	0.0000000
zheyou73v0_A07	25564638	25566749	BnaA07T0283600ZY	0	+	0	0	2111	0.0000000
zheyou73v0_A07	25566969	25568577	BnaA07T0283700ZY	0	-	0	0	1608	0.0000000
zheyou73v0_A07	25566969	25568670	BnaA07T0283700ZY.1	0	-	0	0	1701	0.0000000
zheyou73v0_A07	25566969	25568670	BnaA07T0283700ZY.2	0	-	0	0	1701	0.0000000
zheyou73v0_A07	25566969	25568670	BnaA07T0283700ZY.3	0	-	0	0	1701	0.0000000
zheyou73v0_A07	25566969	25568670	BnaA07T0283700ZY.4	0	-	0	0	1701	0.0000000
zheyou73v0_A07	25566969	25568670	BnaA07T0283700ZY.5	0	-	0	0	1701	0.0000000
zheyou73v0_A07	25566969	25568670	BnaA07T0283700ZY.6	0	-	0	0	1701	0.0000000
zheyou73v0_A07	25569827	25574171	BnaA07T0283800ZY	0	-	0	0	4344	0.0000000
zheyou73v0_A07	25578877	25582652	BnaA07T0283900ZY	0	-	0	0	3775	0.0000000
zheyou73v0_A07	25583718	25587535	BnaA07T0284000ZY	0	-	0	0	3817	0.0000000
zheyou73v0_A07	25583718	25587535	BnaA07T0284000ZY.1	0	-	0	0	3817	0.0000000
zheyou73v0_A07	25583718	25587535	BnaA07T0284000ZY.2	0	-	0	0	3817	0.0000000
zheyou73v0_A07	25594680	25596321	BnaA07T0284100ZY	0	+	0	0	1641	0.0000000
zheyou73v0_A07	25598797	25600214	BnaA07T0284200ZY	0	+	0	0	1417	0.0000000
zheyou73v0_A07	25606576	25612717	BnaA07T0284300ZY	0	+	0	0	6141	0.0000000
zheyou73v0_A07	25613400	25620580	BnaA07T0284400ZY	0	+	0	0	7180	0.0000000
zheyou73v0_A07	25622968	25625412	BnaA07T0284500ZY	0	+	0	0	2444	0.0000000
zheyou73v0_A07	25626080	25626938	BnaA07T0284600ZY	0	-	0	0	858	0.0000000
zheyou73v0_A07	25628575	25629195	BnaA07T0284700ZY	0	-	0	0	620	0.0000000
zheyou73v0_A07	25630288	25631263	BnaA07T0284800ZY	0	-	0	0	975	0.0000000
zheyou73v0_A07	25633157	25634070	BnaA07T0284900ZY	0	-	0	0	913	0.0000000
zheyou73v0_A07	25633157	25634070	BnaA07T0284900ZY.1	0	-	0	0	913	0.0000000
zheyou73v0_A07	25636688	25640220	BnaA07T0285000ZY	0	+	0	0	3532	0.0000000
zheyou73v0_A07	25644244	25644511	BnaA07T0285100ZY	0	+	0	0	267	0.0000000
zheyou73v0_A07	25644993	25647006	BnaA07T0285200ZY	0	-	0	0	2013	0.0000000
zheyou73v0_A07	25651251	25652744	BnaA07T0285300ZY	0	+	0	0	1493	0.0000000
zheyou73v0_A07	25654958	25656191	BnaA07T0285400ZY	0	+	0	0	1233	0.0000000
zheyou73v0_A07	25657688	25658739	BnaA07T0285500ZY	0	+	0	0	1051	0.0000000
zheyou73v0_A07	25659267	25660806	BnaA07T0285600ZY	0	-	0	0	1539	0.0000000
zheyou73v0_A07	25661367	25668626	BnaA07T0285700ZY	0	-	0	0	7259	0.0000000
zheyou73v0_A07	25680506	25683692	BnaA07T0285800ZY	0	-	0	0	3186	0.0000000
zheyou73v0_A07	25680506	25683692	BnaA07T0285800ZY.1	0	-	0	0	3186	0.0000000
zheyou73v0_A07	25691099	25692828	BnaA07T0285900ZY	0	+	0	0	1729	0.0000000
zheyou73v0_A07	25693216	25696010	BnaA07T0286000ZY	0	-	0	0	2794	0.0000000
zheyou73v0_A07	25697237	25700390	BnaA07T0286100ZY	0	+	0	0	3153	0.0000000
zheyou73v0_A07	25700749	25704748	BnaA07T0286200ZY	0	+	0	0	3999	0.0000000
zheyou73v0_A07	25705055	25707576	BnaA07T0286300ZY	0	-	0	0	2521	0.0000000
zheyou73v0_A07	25711752	25713347	BnaA07T0286400ZY	0	+	0	0	1595	0.0000000
zheyou73v0_A07	25714264	25716764	BnaA07T0286500ZY	0	+	0	0	2500	0.0000000
zheyou73v0_A07	25714264	25716764	BnaA07T0286500ZY.1	0	+	0	0	2500	0.0000000
zheyou73v0_A07	25717233	25719466	BnaA07T0286600ZY	0	-	0	0	2233	0.0000000
zheyou73v0_A07	25721180	25721694	BnaA07T0286700ZY	0	+	0	0	514	0.0000000
zheyou73v0_A07	25722368	25723267	BnaA07T0286800ZY	0	+	0	0	899	0.0000000
zheyou73v0_A07	25723329	25726775	BnaA07T0286900ZY	0	-	0	0	3446	0.0000000
zheyou73v0_A07	25730088	25737230	BnaA07T0287000ZY	0	-	0	0	7142	0.0000000
zheyou73v0_A07	25738162	25738420	BnaA07T0287100ZY	0	-	0	0	258	0.0000000
zheyou73v0_A07	25739956	25742169	BnaA07T0287200ZY	0	+	0	0	2213	0.0000000
zheyou73v0_A07	25744571	25745878	BnaA07T0287300ZY	0	+	0	0	1307	0.0000000
zheyou73v0_A07	25750292	25752303	BnaA07T0287400ZY	0	-	0	0	2011	0.0000000
zheyou73v0_A07	25753878	25757563	BnaA07T0287500ZY	0	+	0	0	3685	0.0000000
zheyou73v0_A07	25757756	25762723	BnaA07T0287600ZY	0	-	0	0	4967	0.0000000
zheyou73v0_A07	25764290	25767906	BnaA07T0287700ZY	0	+	0	0	3616	0.0000000
zheyou73v0_A07	25768109	25768871	BnaA07T0287800ZY	0	-	0	0	762	0.0000000
zheyou73v0_A07	25770395	25774085	BnaA07T0287900ZY	0	+	0	0	3690	0.0000000
zheyou73v0_A07	25770395	25774085	BnaA07T0287900ZY.1	0	+	0	0	3690	0.0000000
zheyou73v0_A07	25774231	25775127	BnaA07T0288000ZY	0	-	0	0	896	0.0000000
zheyou73v0_A07	25776237	25779926	BnaA07T0288100ZY	0	-	0	0	3689	0.0000000
zheyou73v0_A07	25776237	25779926	BnaA07T0288100ZY.1	0	-	0	0	3689	0.0000000
zheyou73v0_A07	25780469	25789238	BnaA07T0288200ZY	0	-	0	0	8769	0.0000000
zheyou73v0_A07	25794012	25794580	BnaA07T0288300ZY	0	+	0	0	568	0.0000000
zheyou73v0_A07	25796038	25799162	BnaA07T0288400ZY	0	+	0	0	3124	0.0000000
zheyou73v0_A07	25799700	25800816	BnaA07T0288500ZY	0	+	0	0	1116	0.0000000
zheyou73v0_A07	25805457	25809067	BnaA07T0288600ZY	0	+	0	0	3610	0.0000000
zheyou73v0_A07	25809252	25809930	BnaA07T0288700ZY	0	+	0	0	678	0.0000000
zheyou73v0_A07	25810265	25811532	BnaA07T0288800ZY	0	-	0	0	1267	0.0000000
zheyou73v0_A07	25811867	25813813	BnaA07T0288900ZY	0	-	0	0	1946	0.0000000
zheyou73v0_A07	25817689	25820380	BnaA07T0289000ZY	0	-	0	0	2691	0.0000000
zheyou73v0_A07	25822080	25822518	BnaA07T0289100ZY	0	+	0	0	438	0.0000000
zheyou73v0_A07	25822108	25824020	BnaA07T0289200ZY	0	-	0	0	1912	0.0000000
zheyou73v0_A07	25826176	25827637	BnaA07T0289300ZY	0	+	0	0	1461	0.0000000
zheyou73v0_A07	25833469	25841271	BnaA07T0289400ZY	0	+	0	0	7802	0.0000000
zheyou73v0_A07	25841468	25842485	BnaA07T0289500ZY	0	-	0	0	1017	0.0000000
zheyou73v0_A07	25843836	25845710	BnaA07T0289600ZY	0	-	0	0	1874	0.0000000
zheyou73v0_A07	25850386	25850995	BnaA07T0289700ZY	0	+	0	0	609	0.0000000
zheyou73v0_A07	25852250	25853756	BnaA07T0289800ZY	0	-	0	0	1506	0.0000000
zheyou73v0_A07	25863391	25865872	BnaA07T0289900ZY	0	+	0	0	2481	0.0000000
zheyou73v0_A07	25870681	25878913	BnaA07T0290000ZY	0	-	0	0	8232	0.0000000
zheyou73v0_A07	25879471	25881444	BnaA07T0290100ZY	0	+	0	0	1973	0.0000000
zheyou73v0_A07	25882040	25884442	BnaA07T0290200ZY	0	+	0	0	2402	0.0000000
zheyou73v0_A07	25885182	25890061	BnaA07T0290300ZY	0	-	0	0	4879	0.0000000
zheyou73v0_A07	25890546	25891664	BnaA07T0290400ZY	0	-	0	0	1118	0.0000000
zheyou73v0_A07	25891992	25893171	BnaA07T0290500ZY	0	+	0	0	1179	0.0000000
zheyou73v0_A07	25893477	25897056	BnaA07T0290600ZY	0	-	0	0	3579	0.0000000
zheyou73v0_A07	25897782	25899346	BnaA07T0290700ZY	0	+	0	0	1564	0.0000000
zheyou73v0_A07	25899787	25903664	BnaA07T0290800ZY	0	-	0	0	3877	0.0000000
zheyou73v0_A07	25907322	25907697	BnaA07T0290900ZY	0	-	0	0	375	0.0000000
zheyou73v0_A07	25908016	25910404	BnaA07T0291000ZY	0	-	0	0	2388	0.0000000
zheyou73v0_A07	25913132	25917275	BnaA07T0291100ZY	0	+	0	0	4143	0.0000000
zheyou73v0_A07	25917318	25918168	BnaA07T0291200ZY	0	-	0	0	850	0.0000000
zheyou73v0_A07	25918722	25920458	BnaA07T0291300ZY	0	+	0	0	1736	0.0000000
zheyou73v0_A07	25920864	25922988	BnaA07T0291400ZY	0	-	0	0	2124	0.0000000
zheyou73v0_A07	25923391	25925604	BnaA07T0291500ZY	0	+	0	0	2213	0.0000000
zheyou73v0_A07	25928291	25929148	BnaA07T0291600ZY	0	-	0	0	857	0.0000000
zheyou73v0_A07	25932808	25935571	BnaA07T0291700ZY	0	+	0	0	2763	0.0000000
zheyou73v0_A07	25938953	25940996	BnaA07T0291800ZY	0	+	0	0	2043	0.0000000
zheyou73v0_A07	25944559	25945737	BnaA07T0291900ZY	0	-	0	0	1178	0.0000000
zheyou73v0_A07	25952248	25953397	BnaA07T0292000ZY	0	+	0	0	1149	0.0000000
zheyou73v0_A07	25955480	25956252	BnaA07T0292100ZY	0	+	0	0	772	0.0000000
zheyou73v0_A07	25957277	25959508	BnaA07T0292200ZY	0	+	0	0	2231	0.0000000
zheyou73v0_A07	25959506	25960597	BnaA07T0292300ZY	0	-	0	0	1091	0.0000000
zheyou73v0_A07	25964245	25964932	BnaA07T0292400ZY	0	-	0	0	687	0.0000000
zheyou73v0_A07	25971036	25972988	BnaA07T0292500ZY	0	+	0	0	1952	0.0000000
zheyou73v0_A07	25971036	25972988	BnaA07T0292500ZY.1	0	+	0	0	1952	0.0000000
zheyou73v0_A07	25973218	25974208	BnaA07T0292600ZY	0	-	0	0	990	0.0000000
zheyou73v0_A07	25974223	25976953	BnaA07T0292700ZY	0	-	0	0	2730	0.0000000
zheyou73v0_A07	25977774	25980128	BnaA07T0292800ZY	0	+	0	0	2354	0.0000000
zheyou73v0_A07	25981991	25984688	BnaA07T0292900ZY	0	-	0	0	2697	0.0000000
zheyou73v0_A07	26000568	26002343	BnaA07T0293000ZY	0	+	0	0	1775	0.0000000
zheyou73v0_A07	26008929	26009281	BnaA07T0293100ZY	0	-	0	0	352	0.0000000
zheyou73v0_A07	26044587	26045899	BnaA07T0293200ZY	0	-	0	0	1312	0.0000000
zheyou73v0_A07	26046738	26049233	BnaA07T0293300ZY	0	-	0	0	2495	0.0000000
zheyou73v0_A07	26046738	26049233	BnaA07T0293300ZY.1	0	-	0	0	2495	0.0000000
zheyou73v0_A07	26049782	26051208	BnaA07T0293400ZY	0	-	0	0	1426	0.0000000
zheyou73v0_A07	26053573	26054919	BnaA07T0293500ZY	0	+	0	0	1346	0.0000000
zheyou73v0_A07	26062743	26065479	BnaA07T0293600ZY	0	+	0	0	2736	0.0000000
zheyou73v0_A07	26062743	26065479	BnaA07T0293600ZY.1	0	+	0	0	2736	0.0000000
zheyou73v0_A07	26062743	26065479	BnaA07T0293600ZY.2	0	+	0	0	2736	0.0000000
zheyou73v0_A07	26076077	26078223	BnaA07T0293700ZY	0	+	0	0	2146	0.0000000
zheyou73v0_A07	26092899	26096747	BnaA07T0293800ZY	0	+	0	0	3848	0.0000000
zheyou73v0_A07	26097046	26097953	BnaA07T0293900ZY	0	+	0	0	907	0.0000000
zheyou73v0_A07	26098218	26100655	BnaA07T0294000ZY	0	-	0	0	2437	0.0000000
zheyou73v0_A07	26105051	26107268	BnaA07T0294100ZY	0	+	0	0	2217	0.0000000
zheyou73v0_A07	26107563	26112760	BnaA07T0294200ZY	0	-	0	0	5197	0.0000000
zheyou73v0_A07	26115658	26118537	BnaA07T0294300ZY	0	+	0	0	2879	0.0000000
zheyou73v0_A07	26118691	26121857	BnaA07T0294400ZY	0	-	0	0	3166	0.0000000
zheyou73v0_A07	26118691	26121857	BnaA07T0294400ZY.1	0	-	0	0	3166	0.0000000
zheyou73v0_A07	26123766	26125605	BnaA07T0294500ZY	0	-	0	0	1839	0.0000000
zheyou73v0_A07	26126678	26128079	BnaA07T0294600ZY	0	-	0	0	1401	0.0000000
zheyou73v0_A07	26129224	26132680	BnaA07T0294700ZY	0	-	0	0	3456	0.0000000
zheyou73v0_A07	26133904	26136182	BnaA07T0294800ZY	0	+	0	0	2278	0.0000000
zheyou73v0_A07	26137077	26138371	BnaA07T0294900ZY	0	+	0	0	1294	0.0000000
zheyou73v0_A07	26137776	26139516	BnaA07T0295000ZY	0	-	0	0	1740	0.0000000
zheyou73v0_A07	26137776	26139516	BnaA07T0295000ZY.1	0	-	0	0	1740	0.0000000
zheyou73v0_A07	26140029	26141138	BnaA07T0295100ZY	0	-	0	0	1109	0.0000000
zheyou73v0_A07	26142766	26144206	BnaA07T0295200ZY	0	+	0	0	1440	0.0000000
zheyou73v0_A07	26144503	26147326	BnaA07T0295300ZY	0	-	0	0	2823	0.0000000
zheyou73v0_A07	26144503	26147326	BnaA07T0295300ZY.1	0	-	0	0	2823	0.0000000
zheyou73v0_A07	26151260	26152494	BnaA07T0295400ZY	0	+	0	0	1234	0.0000000
zheyou73v0_A07	26153550	26155291	BnaA07T0295500ZY	0	-	0	0	1741	0.0000000
zheyou73v0_A07	26153550	26155291	BnaA07T0295500ZY.1	0	-	0	0	1741	0.0000000
zheyou73v0_A07	26157363	26160790	BnaA07T0295600ZY	0	-	0	0	3427	0.0000000
zheyou73v0_A07	26163346	26164133	BnaA07T0295700ZY	0	-	0	0	787	0.0000000
zheyou73v0_A07	26165058	26165454	BnaA07T0295800ZY	0	-	0	0	396	0.0000000
zheyou73v0_A07	26169119	26169813	BnaA07T0295900ZY	0	+	0	0	694	0.0000000
zheyou73v0_A07	26170078	26174286	BnaA07T0296000ZY	0	-	0	0	4208	0.0000000
zheyou73v0_A07	26177059	26179502	BnaA07T0296100ZY	0	+	0	0	2443	0.0000000
zheyou73v0_A07	26180091	26180926	BnaA07T0296200ZY	0	+	0	0	835	0.0000000
zheyou73v0_A07	26182837	26183684	BnaA07T0296300ZY	0	+	0	0	847	0.0000000
zheyou73v0_A07	26183913	26186040	BnaA07T0296400ZY	0	-	0	0	2127	0.0000000
zheyou73v0_A07	26189593	26191112	BnaA07T0296500ZY	0	+	0	0	1519	0.0000000
zheyou73v0_A07	26191147	26192994	BnaA07T0296600ZY	0	-	0	0	1847	0.0000000
zheyou73v0_A07	26193883	26197180	BnaA07T0296700ZY	0	-	0	0	3297	0.0000000
zheyou73v0_A07	26202724	26204778	BnaA07T0296800ZY	0	-	0	0	2054	0.0000000
zheyou73v0_A07	26205627	26209382	BnaA07T0296900ZY	0	-	0	0	3755	0.0000000
zheyou73v0_A07	26212147	26215729	BnaA07T0297000ZY	0	+	0	0	3582	0.0000000
zheyou73v0_A07	26215962	26218179	BnaA07T0297100ZY	0	-	0	0	2217	0.0000000
zheyou73v0_A07	26219531	26219927	BnaA07T0297200ZY	0	+	0	0	396	0.0000000
zheyou73v0_A07	26220667	26223412	BnaA07T0297300ZY	0	-	0	0	2745	0.0000000
zheyou73v0_A07	26224787	26228956	BnaA07T0297400ZY	0	+	0	0	4169	0.0000000
zheyou73v0_A07	26229343	26234569	BnaA07T0297500ZY	0	-	0	0	5226	0.0000000
zheyou73v0_A07	26239268	26240649	BnaA07T0297600ZY	0	+	0	0	1381	0.0000000
zheyou73v0_A07	26247601	26249444	BnaA07T0297700ZY	0	+	0	0	1843	0.0000000
zheyou73v0_A07	26250017	26251479	BnaA07T0297800ZY	0	+	0	0	1462	0.0000000
zheyou73v0_A07	26252405	26253756	BnaA07T0297900ZY	0	+	0	0	1351	0.0000000
zheyou73v0_A07	26253781	26254649	BnaA07T0298000ZY	0	+	0	0	868	0.0000000
zheyou73v0_A07	26265203	26270020	BnaA07T0298100ZY	0	+	0	0	4817	0.0000000
zheyou73v0_A07	26270574	26272759	BnaA07T0298200ZY	0	-	0	0	2185	0.0000000
zheyou73v0_A07	26273374	26274203	BnaA07T0298300ZY	0	+	0	0	829	0.0000000
zheyou73v0_A07	26275831	26276535	BnaA07T0298400ZY	0	+	0	0	704	0.0000000
zheyou73v0_A07	26279691	26280374	BnaA07T0298500ZY	0	+	0	0	683	0.0000000
zheyou73v0_A07	26291952	26293694	BnaA07T0298600ZY	0	+	0	0	1742	0.0000000
zheyou73v0_A07	26300169	26301951	BnaA07T0298700ZY	0	+	0	0	1782	0.0000000
zheyou73v0_A07	26302703	26305656	BnaA07T0298800ZY	0	-	0	0	2953	0.0000000
zheyou73v0_A07	26308001	26309812	BnaA07T0298900ZY	0	-	0	0	1811	0.0000000
zheyou73v0_A07	26312584	26314220	BnaA07T0299000ZY	0	+	0	0	1636	0.0000000
zheyou73v0_A07	26314525	26317403	BnaA07T0299100ZY	0	-	0	0	2878	0.0000000
zheyou73v0_A07	26330937	26333215	BnaA07T0299200ZY	0	+	0	0	2278	0.0000000
zheyou73v0_A07	26333322	26333943	BnaA07T0299300ZY	0	+	0	0	621	0.0000000
zheyou73v0_A07	26335594	26337419	BnaA07T0299400ZY	0	-	0	0	1825	0.0000000
zheyou73v0_A07	26351752	26354522	BnaA07T0299500ZY	0	-	0	0	2770	0.0000000
zheyou73v0_A07	26355579	26357200	BnaA07T0299600ZY	0	-	0	0	1621	0.0000000
zheyou73v0_A07	26367384	26369796	BnaA07T0299700ZY	0	+	0	0	2412	0.0000000
zheyou73v0_A07	26376990	26378734	BnaA07T0299800ZY	0	+	0	0	1744	0.0000000
zheyou73v0_A07	26380439	26381214	BnaA07T0299900ZY	0	-	0	0	775	0.0000000
zheyou73v0_A07	26388488	26389161	BnaA07T0300000ZY	0	+	0	0	673	0.0000000
zheyou73v0_A07	26397713	26398547	BnaA07T0300100ZY	0	-	0	0	834	0.0000000
zheyou73v0_A07	26405901	26407560	BnaA07T0300200ZY	0	-	0	0	1659	0.0000000
zheyou73v0_A07	26411392	26414966	BnaA07T0300300ZY	0	-	0	0	3574	0.0000000
zheyou73v0_A07	26416206	26421785	BnaA07T0300400ZY	0	+	0	0	5579	0.0000000
zheyou73v0_A07	26422903	26425935	BnaA07T0300500ZY	0	-	0	0	3032	0.0000000
zheyou73v0_A07	26426637	26427671	BnaA07T0300600ZY	0	-	0	0	1034	0.0000000
zheyou73v0_A07	26428050	26429527	BnaA07T0300700ZY	0	+	0	0	1477	0.0000000
zheyou73v0_A07	26432653	26435295	BnaA07T0300800ZY	0	+	0	0	2642	0.0000000
zheyou73v0_A07	26437603	26437873	BnaA07T0300900ZY	0	+	0	0	270	0.0000000
zheyou73v0_A07	26438585	26439440	BnaA07T0301000ZY	0	-	0	0	855	0.0000000
zheyou73v0_A07	26440033	26443492	BnaA07T0301100ZY	0	-	0	0	3459	0.0000000
zheyou73v0_A07	26440033	26443492	BnaA07T0301100ZY.1	0	-	0	0	3459	0.0000000
zheyou73v0_A07	26445008	26445890	BnaA07T0301200ZY	0	-	0	0	882	0.0000000
zheyou73v0_A07	26448758	26450804	BnaA07T0301300ZY	0	-	0	0	2046	0.0000000
zheyou73v0_A07	26452531	26453082	BnaA07T0301400ZY	0	+	0	0	551	0.0000000
zheyou73v0_A07	26455907	26457368	BnaA07T0301500ZY	0	+	0	0	1461	0.0000000
zheyou73v0_A07	26460363	26461386	BnaA07T0301600ZY	0	+	0	0	1023	0.0000000
zheyou73v0_A07	26461459	26464222	BnaA07T0301700ZY	0	-	0	0	2763	0.0000000
zheyou73v0_A07	26468980	26470978	BnaA07T0301800ZY	0	+	0	0	1998	0.0000000
zheyou73v0_A07	26475095	26476072	BnaA07T0301900ZY	0	+	0	0	977	0.0000000
zheyou73v0_A07	26476154	26479664	BnaA07T0302000ZY	0	-	0	0	3510	0.0000000
zheyou73v0_A07	26490826	26491186	BnaA07T0302100ZY	0	-	0	0	360	0.0000000
zheyou73v0_A07	26503298	26504784	BnaA07T0302200ZY	0	+	0	0	1486	0.0000000
zheyou73v0_A07	26505218	26511700	BnaA07T0302300ZY	0	-	0	0	6482	0.0000000
zheyou73v0_A07	26512153	26513689	BnaA07T0302400ZY	0	-	0	0	1536	0.0000000
zheyou73v0_A07	26518837	26520450	BnaA07T0302500ZY	0	+	0	0	1613	0.0000000
zheyou73v0_A07	26521453	26523458	BnaA07T0302600ZY	0	+	0	0	2005	0.0000000
zheyou73v0_A07	26529715	26532551	BnaA07T0302700ZY	0	+	0	0	2836	0.0000000
zheyou73v0_A07	26529715	26532551	BnaA07T0302700ZY.1	0	+	0	0	2836	0.0000000
zheyou73v0_A07	26535341	26536461	BnaA07T0302800ZY	0	+	0	0	1120	0.0000000
zheyou73v0_A07	26546152	26547464	BnaA07T0302900ZY	0	-	0	0	1312	0.0000000
zheyou73v0_A07	26548304	26550799	BnaA07T0303000ZY	0	-	0	0	2495	0.0000000
zheyou73v0_A07	26548304	26550799	BnaA07T0303000ZY.1	0	-	0	0	2495	0.0000000
zheyou73v0_A07	26551348	26552774	BnaA07T0303100ZY	0	-	0	0	1426	0.0000000
zheyou73v0_A07	26553212	26556601	BnaA07T0303200ZY	0	+	0	0	3389	0.0000000
zheyou73v0_A07	26553212	26556601	BnaA07T0303200ZY.1	0	+	0	0	3389	0.0000000
zheyou73v0_A07	26567159	26570037	BnaA07T0303300ZY	0	+	0	0	2878	0.0000000
zheyou73v0_A07	26570470	26572381	BnaA07T0303400ZY	0	+	0	0	1911	0.0000000
zheyou73v0_A07	26579087	26579441	BnaA07T0303500ZY	0	-	0	0	354	0.0000000
zheyou73v0_A07	26579723	26580454	BnaA07T0303600ZY	0	+	0	0	731	0.0000000
zheyou73v0_A07	26596574	26596928	BnaA07T0303700ZY	0	-	0	0	354	0.0000000
zheyou73v0_A07	26597210	26597941	BnaA07T0303800ZY	0	+	0	0	731	0.0000000
zheyou73v0_A07	26606981	26607841	BnaA07T0303900ZY	0	-	0	0	860	0.0000000
zheyou73v0_A07	26609943	26610741	BnaA07T0304000ZY	0	+	0	0	798	0.0000000
zheyou73v0_A07	26614253	26615826	BnaA07T0304100ZY	0	-	0	0	1573	0.0000000
zheyou73v0_A07	26616889	26617975	BnaA07T0304200ZY	0	-	0	0	1086	0.0000000
zheyou73v0_A07	26622459	26623658	BnaA07T0304300ZY	0	-	0	0	1199	0.0000000
zheyou73v0_A07	26624132	26626210	BnaA07T0304400ZY	0	-	0	0	2078	0.0000000
zheyou73v0_A07	26630526	26632260	BnaA07T0304500ZY	0	+	0	0	1734	0.0000000
zheyou73v0_A07	26633751	26637160	BnaA07T0304600ZY	0	+	0	0	3409	0.0000000
zheyou73v0_A07	26642648	26646186	BnaA07T0304700ZY	0	+	0	0	3538	0.0000000
zheyou73v0_A07	26646557	26648633	BnaA07T0304800ZY	0	-	0	0	2076	0.0000000
zheyou73v0_A07	26649186	26652443	BnaA07T0304900ZY	0	-	0	0	3257	0.0000000
zheyou73v0_A07	26653963	26656110	BnaA07T0305000ZY	0	-	0	0	2147	0.0000000
zheyou73v0_A07	26654471	26656110	BnaA07T0305000ZY.1	0	-	0	0	1639	0.0000000
zheyou73v0_A07	26657250	26658128	BnaA07T0305100ZY	0	-	0	0	878	0.0000000
zheyou73v0_A07	26661668	26662061	BnaA07T0305200ZY	0	+	0	0	393	0.0000000
zheyou73v0_A07	26662695	26663312	BnaA07T0305300ZY	0	+	0	0	617	0.0000000
zheyou73v0_A07	26666812	26667487	BnaA07T0305400ZY	0	-	0	0	675	0.0000000
zheyou73v0_A07	26669005	26669761	BnaA07T0305500ZY	0	-	0	0	756	0.0000000
zheyou73v0_A07	26671736	26672313	BnaA07T0305600ZY	0	-	0	0	577	0.0000000
zheyou73v0_A07	26674748	26675666	BnaA07T0305700ZY	0	-	0	0	918	0.0000000
zheyou73v0_A07	26679780	26682804	BnaA07T0305800ZY	0	-	0	0	3024	0.0000000
zheyou73v0_A07	26683841	26685940	BnaA07T0305900ZY	0	+	0	0	2099	0.0000000
zheyou73v0_A07	26686642	26689387	BnaA07T0306000ZY	0	-	0	0	2745	0.0000000
zheyou73v0_A07	26690355	26694280	BnaA07T0306100ZY	0	-	0	0	3925	0.0000000
zheyou73v0_A07	26690355	26694280	BnaA07T0306100ZY.1	0	-	0	0	3925	0.0000000
zheyou73v0_A07	26702417	26707538	BnaA07T0306200ZY	0	+	0	0	5121	0.0000000
zheyou73v0_A07	26727473	26729971	BnaA07T0306300ZY	0	-	0	0	2498	0.0000000
zheyou73v0_A07	26733758	26734112	BnaA07T0306400ZY	0	+	0	0	354	0.0000000
zheyou73v0_A07	26734811	26736306	BnaA07T0306500ZY	0	-	0	0	1495	0.0000000
zheyou73v0_A07	26741766	26745808	BnaA07T0306600ZY	0	+	0	0	4042	0.0000000
zheyou73v0_A07	26746135	26749323	BnaA07T0306700ZY	0	-	0	0	3188	0.0000000
zheyou73v0_A07	26751445	26753411	BnaA07T0306800ZY	0	-	0	0	1966	0.0000000
zheyou73v0_A07	26754667	26758242	BnaA07T0306900ZY	0	-	0	0	3575	0.0000000
zheyou73v0_A07	26758729	26762562	BnaA07T0307000ZY	0	+	0	0	3833	0.0000000
zheyou73v0_A07	26761398	26765503	BnaA07T0307100ZY	0	-	0	0	4105	0.0000000
zheyou73v0_A07	26765823	26767534	BnaA07T0307200ZY	0	+	0	0	1711	0.0000000
zheyou73v0_A07	26773513	26774378	BnaA07T0307300ZY	0	+	0	0	865	0.0000000
zheyou73v0_A07	26778411	26780491	BnaA07T0307400ZY	0	-	0	0	2080	0.0000000
zheyou73v0_A07	26786429	26787508	BnaA07T0307500ZY	0	+	0	0	1079	0.0000000
zheyou73v0_A07	26786429	26788859	BnaA07T0307500ZY.1	0	+	0	0	2430	0.0000000
zheyou73v0_A07	26786429	26787770	BnaA07T0307500ZY.2	0	+	0	0	1341	0.0000000
zheyou73v0_A07	26786429	26787770	BnaA07T0307500ZY.3	0	+	0	0	1341	0.0000000
zheyou73v0_A07	26792207	26796407	BnaA07T0307600ZY	0	-	0	0	4200	0.0000000
zheyou73v0_A07	26798385	26799159	BnaA07T0307700ZY	0	-	0	0	774	0.0000000
zheyou73v0_A07	26800768	26802018	BnaA07T0307800ZY	0	-	0	0	1250	0.0000000
zheyou73v0_A07	26803601	26805546	BnaA07T0307900ZY	0	+	0	0	1945	0.0000000
zheyou73v0_A07	26806097	26807453	BnaA07T0308000ZY	0	+	0	0	1356	0.0000000
zheyou73v0_A07	26807882	26809623	BnaA07T0308100ZY	0	-	0	0	1741	0.0000000
zheyou73v0_A07	26810556	26812331	BnaA07T0308200ZY	0	-	0	0	1775	0.0000000
zheyou73v0_A07	26816119	26818516	BnaA07T0308300ZY	0	+	0	0	2397	0.0000000
zheyou73v0_A07	26820107	26820984	BnaA07T0308400ZY	0	+	0	0	877	0.0000000
zheyou73v0_A07	26827218	26828224	BnaA07T0308500ZY	0	+	0	0	1006	0.0000000
zheyou73v0_A07	26830930	26834130	BnaA07T0308600ZY	0	-	0	0	3200	0.0000000
zheyou73v0_A07	26830930	26834130	BnaA07T0308600ZY.1	0	-	0	0	3200	0.0000000
zheyou73v0_A07	26830930	26834130	BnaA07T0308600ZY.2	0	-	0	0	3200	0.0000000
zheyou73v0_A07	26836085	26838060	BnaA07T0308700ZY	0	+	0	0	1975	0.0000000
zheyou73v0_A07	26840168	26844313	BnaA07T0308800ZY	0	-	0	0	4145	0.0000000
zheyou73v0_A07	26845752	26846385	BnaA07T0308900ZY	0	+	0	0	633	0.0000000
zheyou73v0_A07	26850713	26854977	BnaA07T0309000ZY	0	+	0	0	4264	0.0000000
zheyou73v0_A07	26857424	26859136	BnaA07T0309100ZY.1	0	+	0	0	1712	0.0000000
zheyou73v0_A07	26857424	26859136	BnaA07T0309100ZY.3	0	+	0	0	1712	0.0000000
zheyou73v0_A07	26857502	26859136	BnaA07T0309100ZY.2	0	+	0	0	1634	0.0000000
zheyou73v0_A07	26857618	26859136	BnaA07T0309100ZY	0	+	0	0	1518	0.0000000
zheyou73v0_A07	26862008	26862721	BnaA07T0309200ZY	0	+	0	0	713	0.0000000
zheyou73v0_A07	26864924	26865515	BnaA07T0309300ZY	0	+	0	0	591	0.0000000
zheyou73v0_A07	26876587	26879034	BnaA07T0309400ZY	0	+	0	0	2447	0.0000000
zheyou73v0_A07	26879721	26884673	BnaA07T0309500ZY	0	+	0	0	4952	0.0000000
zheyou73v0_A07	26884899	26885409	BnaA07T0309600ZY	0	-	0	0	510	0.0000000
zheyou73v0_A07	26886650	26887341	BnaA07T0309700ZY	0	-	0	0	691	0.0000000
zheyou73v0_A07	26888328	26890420	BnaA07T0309800ZY	0	-	0	0	2092	0.0000000
zheyou73v0_A07	26892124	26894611	BnaA07T0309900ZY	0	-	0	0	2487	0.0000000
zheyou73v0_A07	26895867	26899090	BnaA07T0310000ZY	0	-	0	0	3223	0.0000000
zheyou73v0_A07	26900871	26901466	BnaA07T0310100ZY	0	-	0	0	595	0.0000000
zheyou73v0_A07	26903445	26905760	BnaA07T0310200ZY	0	-	0	0	2315	0.0000000
zheyou73v0_A07	26910612	26917259	BnaA07T0310300ZY	0	+	0	0	6647	0.0000000
zheyou73v0_A07	26916982	26918912	BnaA07T0310400ZY	0	-	0	0	1930	0.0000000
zheyou73v0_A07	26919460	26919625	BnaA07T0310500ZY	0	+	0	0	165	0.0000000
zheyou73v0_A07	26920381	26920930	BnaA07T0310600ZY	0	+	0	0	549	0.0000000
zheyou73v0_A07	26921000	26922936	BnaA07T0310700ZY	0	-	0	0	1936	0.0000000
zheyou73v0_A07	26921000	26922936	BnaA07T0310700ZY.1	0	-	0	0	1936	0.0000000
zheyou73v0_A07	26942864	26945154	BnaA07T0310800ZY	0	+	0	0	2290	0.0000000
zheyou73v0_A07	26952565	26954557	BnaA07T0310900ZY	0	-	0	0	1992	0.0000000
zheyou73v0_A07	26962461	26964744	BnaA07T0311000ZY	0	+	0	0	2283	0.0000000
zheyou73v0_A07	26966627	26968378	BnaA07T0311100ZY	0	-	0	0	1751	0.0000000
zheyou73v0_A07	26980129	26982354	BnaA07T0311200ZY	0	-	0	0	2225	0.0000000
zheyou73v0_A07	26985393	26991389	BnaA07T0311300ZY	0	+	0	0	5996	0.0000000
zheyou73v0_A07	26991969	26992575	BnaA07T0311400ZY	0	-	0	0	606	0.0000000
zheyou73v0_A07	27000199	27000827	BnaA07T0311500ZY	0	-	0	0	628	0.0000000
zheyou73v0_A07	27004353	27005076	BnaA07T0311600ZY	0	-	0	0	723	0.0000000
zheyou73v0_A07	27007006	27007846	BnaA07T0311700ZY	0	-	0	0	840	0.0000000
zheyou73v0_A07	27007402	27013733	BnaA07T0311800ZY	0	+	0	0	6331	0.0000000
zheyou73v0_A07	27015061	27017553	BnaA07T0311900ZY	0	-	0	0	2492	0.0000000
zheyou73v0_A07	27018199	27019813	BnaA07T0312000ZY	0	-	0	0	1614	0.0000000
zheyou73v0_A07	27029997	27032187	BnaA07T0312100ZY	0	+	0	0	2190	0.0000000
zheyou73v0_A07	27036485	27038854	BnaA07T0312200ZY	0	+	0	0	2369	0.0000000
zheyou73v0_A07	27039562	27041339	BnaA07T0312300ZY	0	-	0	0	1777	0.0000000
zheyou73v0_A07	27042129	27044066	BnaA07T0312400ZY	0	-	0	0	1937	0.0000000
zheyou73v0_A07	27044909	27046464	BnaA07T0312500ZY	0	-	0	0	1555	0.0000000
zheyou73v0_A07	27047018	27048439	BnaA07T0312600ZY	0	-	0	0	1421	0.0000000
zheyou73v0_A07	27052807	27056358	BnaA07T0312700ZY	0	+	0	0	3551	0.0000000
zheyou73v0_A07	27052807	27056358	BnaA07T0312700ZY.1	0	+	0	0	3551	0.0000000
zheyou73v0_A07	27057627	27059287	BnaA07T0312800ZY	0	+	0	0	1660	0.0000000
zheyou73v0_A07	27057627	27059287	BnaA07T0312800ZY.1	0	+	0	0	1660	0.0000000
zheyou73v0_A07	27059411	27060915	BnaA07T0312900ZY	0	-	0	0	1504	0.0000000
zheyou73v0_A07	27075386	27078894	BnaA07T0313000ZY	0	-	0	0	3508	0.0000000
zheyou73v0_A07	27082172	27083208	BnaA07T0313100ZY	0	-	0	0	1036	0.0000000
zheyou73v0_A07	27086868	27090432	BnaA07T0313200ZY	0	-	0	0	3564	0.0000000
zheyou73v0_A07	27088451	27090432	BnaA07T0313200ZY.1	0	-	0	0	1981	0.0000000
zheyou73v0_A07	27091888	27094707	BnaA07T0313300ZY	0	+	0	0	2819	0.0000000
zheyou73v0_A07	27095344	27097002	BnaA07T0313400ZY	0	-	0	0	1658	0.0000000
zheyou73v0_A07	27099220	27101996	BnaA07T0313500ZY	0	-	0	0	2776	0.0000000
zheyou73v0_A07	27103137	27106823	BnaA07T0313600ZY	0	-	0	0	3686	0.0000000
zheyou73v0_A07	27108178	27111213	BnaA07T0313700ZY	0	-	0	0	3035	0.0000000
zheyou73v0_A07	27115975	27117512	BnaA07T0313800ZY	0	+	0	0	1537	0.0000000
zheyou73v0_A07	27117530	27124753	BnaA07T0313900ZY	0	-	0	0	7223	0.0000000
zheyou73v0_A07	27127550	27131576	BnaA07T0314000ZY	0	+	0	0	4026	0.0000000
zheyou73v0_A07	27131897	27137711	BnaA07T0314100ZY	0	+	0	0	5814	0.0000000
zheyou73v0_A07	27137597	27139189	BnaA07T0314200ZY	0	-	0	0	1592	0.0000000
zheyou73v0_A07	27145594	27147281	BnaA07T0314300ZY	0	+	0	0	1687	0.0000000
zheyou73v0_A07	27147358	27150148	BnaA07T0314400ZY	0	-	0	0	2790	0.0000000
zheyou73v0_A07	27154010	27154304	BnaA07T0314500ZY	0	-	0	0	294	0.0000000
zheyou73v0_A07	27155091	27157118	BnaA07T0314600ZY	0	-	0	0	2027	0.0000000
zheyou73v0_A07	27158792	27159763	BnaA07T0314700ZY	0	+	0	0	971	0.0000000
zheyou73v0_A07	27160135	27162014	BnaA07T0314800ZY	0	-	0	0	1879	0.0000000
zheyou73v0_A07	27163077	27165248	BnaA07T0314900ZY	0	+	0	0	2171	0.0000000
zheyou73v0_A07	27167509	27171276	BnaA07T0315000ZY	0	+	0	0	3767	0.0000000
zheyou73v0_A07	27167509	27171053	BnaA07T0315000ZY.1	0	+	0	0	3544	0.0000000
zheyou73v0_A07	27172192	27173942	BnaA07T0315100ZY	0	+	0	0	1750	0.0000000
zheyou73v0_A07	27175467	27178201	BnaA07T0315200ZY	0	+	0	0	2734	0.0000000
zheyou73v0_A07	27179466	27180922	BnaA07T0315300ZY	0	+	0	0	1456	0.0000000
zheyou73v0_A07	27181815	27185093	BnaA07T0315400ZY	0	-	0	0	3278	0.0000000
zheyou73v0_A07	27181815	27184431	BnaA07T0315400ZY.1	0	-	0	0	2616	0.0000000
zheyou73v0_A07	27190993	27195711	BnaA07T0315500ZY	0	-	0	0	4718	0.0000000
zheyou73v0_A07	27200492	27201212	BnaA07T0315600ZY	0	+	0	0	720	0.0000000
zheyou73v0_A07	27203416	27204815	BnaA07T0315700ZY	0	+	0	0	1399	0.0000000
zheyou73v0_A07	27205703	27208425	BnaA07T0315800ZY	0	+	0	0	2722	0.0000000
zheyou73v0_A07	27208548	27209687	BnaA07T0315900ZY	0	-	0	0	1139	0.0000000
zheyou73v0_A07	27216344	27219877	BnaA07T0316000ZY	0	-	0	0	3533	0.0000000
zheyou73v0_A07	27232159	27234927	BnaA07T0316100ZY	0	+	0	0	2768	0.0000000
zheyou73v0_A07	27236111	27242379	BnaA07T0316200ZY	0	+	0	0	6268	0.0000000
zheyou73v0_A07	27236111	27242379	BnaA07T0316200ZY.1	0	+	0	0	6268	0.0000000
zheyou73v0_A07	27242960	27245628	BnaA07T0316300ZY	0	-	0	0	2668	0.0000000
zheyou73v0_A07	27247372	27249040	BnaA07T0316400ZY	0	+	0	0	1668	0.0000000
zheyou73v0_A07	27251491	27254580	BnaA07T0316500ZY	0	+	0	0	3089	0.0000000
zheyou73v0_A07	27257702	27258803	BnaA07T0316600ZY	0	-	0	0	1101	0.0000000
zheyou73v0_A07	27265077	27267150	BnaA07T0316700ZY	0	-	0	0	2073	0.0000000
zheyou73v0_A07	27269057	27269306	BnaA07T0316800ZY	0	-	0	0	249	0.0000000
zheyou73v0_A07	27271523	27272183	BnaA07T0316900ZY	0	+	0	0	660	0.0000000
zheyou73v0_A07	27274351	27285234	BnaA07T0317000ZY	0	+	0	0	10883	0.0000000
zheyou73v0_A07	27285958	27287023	BnaA07T0317100ZY	0	-	0	0	1065	0.0000000
zheyou73v0_A07	27294377	27298258	BnaA07T0317200ZY	0	+	0	0	3881	0.0000000
zheyou73v0_A07	27294377	27298258	BnaA07T0317200ZY.1	0	+	0	0	3881	0.0000000
zheyou73v0_A07	27298759	27301638	BnaA07T0317300ZY	0	-	0	0	2879	0.0000000
zheyou73v0_A07	27302592	27304903	BnaA07T0317400ZY	0	-	0	0	2311	0.0000000
zheyou73v0_A07	27302592	27304060	BnaA07T0317400ZY.1	0	-	0	0	1468	0.0000000
zheyou73v0_A07	27306087	27310240	BnaA07T0317500ZY	0	-	0	0	4153	0.0000000
zheyou73v0_A07	27318417	27321614	BnaA07T0317600ZY	0	+	0	0	3197	0.0000000
zheyou73v0_A07	27322504	27325909	BnaA07T0317700ZY	0	+	0	0	3405	0.0000000
zheyou73v0_A07	27328498	27329584	BnaA07T0317800ZY	0	+	0	0	1086	0.0000000
zheyou73v0_A07	27333247	27334186	BnaA07T0317900ZY	0	+	0	0	939	0.0000000
zheyou73v0_A07	27335639	27337535	BnaA07T0318000ZY	0	+	0	0	1896	0.0000000
zheyou73v0_A07	27337713	27341691	BnaA07T0318100ZY	0	-	0	0	3978	0.0000000
zheyou73v0_A07	27343483	27346784	BnaA07T0318200ZY	0	+	0	0	3301	0.0000000
zheyou73v0_A07	27344229	27346784	BnaA07T0318200ZY.2	0	+	0	0	2555	0.0000000
zheyou73v0_A07	27344560	27346784	BnaA07T0318200ZY.1	0	+	0	0	2224	0.0000000
zheyou73v0_A07	27352814	27353801	BnaA07T0318300ZY	0	+	0	0	987	0.0000000
zheyou73v0_A07	27356543	27359166	BnaA07T0318400ZY	0	-	0	0	2623	0.0000000
zheyou73v0_A07	27373464	27376476	BnaA07T0318500ZY	0	+	0	0	3012	0.0000000
zheyou73v0_A07	27373464	27374976	BnaA07T0318500ZY.1	0	+	0	0	1512	0.0000000
zheyou73v0_A07	27386491	27387746	BnaA07T0318600ZY	0	+	0	0	1255	0.0000000
zheyou73v0_A07	27390938	27392329	BnaA07T0318700ZY	0	+	0	0	1391	0.0000000
zheyou73v0_A07	27393140	27395673	BnaA07T0318800ZY	0	-	0	0	2533	0.0000000
zheyou73v0_A07	27396442	27397441	BnaA07T0318900ZY	0	-	0	0	999	0.0000000
zheyou73v0_A07	27400919	27403190	BnaA07T0319000ZY	0	-	0	0	2271	0.0000000
zheyou73v0_A07	27403988	27406739	BnaA07T0319100ZY	0	+	0	0	2751	0.0000000
zheyou73v0_A07	27426409	27427771	BnaA07T0319200ZY	0	+	0	0	1362	0.0000000
zheyou73v0_A07	27428765	27434672	BnaA07T0319300ZY	0	-	0	0	5907	0.0000000
zheyou73v0_A07	27435779	27437056	BnaA07T0319400ZY	0	+	0	0	1277	0.0000000
zheyou73v0_A07	27439664	27441804	BnaA07T0319500ZY	0	-	0	0	2140	0.0000000
zheyou73v0_A07	27443834	27445099	BnaA07T0319600ZY	0	-	0	0	1265	0.0000000
zheyou73v0_A07	27448921	27452262	BnaA07T0319700ZY	0	+	0	0	3341	0.0000000
zheyou73v0_A07	27448921	27452262	BnaA07T0319700ZY.1	0	+	0	0	3341	0.0000000
zheyou73v0_A07	27448921	27450820	BnaA07T0319700ZY.2	0	+	0	0	1899	0.0000000
zheyou73v0_A07	27452763	27456046	BnaA07T0319800ZY	0	-	0	0	3283	0.0000000
zheyou73v0_A07	27466046	27469106	BnaA07T0319900ZY	0	+	0	0	3060	0.0000000
zheyou73v0_A07	27469777	27472373	BnaA07T0320000ZY	0	+	0	0	2596	0.0000000
zheyou73v0_A07	27469777	27471847	BnaA07T0320000ZY.1	0	+	0	0	2070	0.0000000
zheyou73v0_A07	27473163	27477932	BnaA07T0320100ZY	0	+	0	0	4769	0.0000000
zheyou73v0_A07	27478106	27478915	BnaA07T0320200ZY	0	-	0	0	809	0.0000000
zheyou73v0_A07	27480553	27481334	BnaA07T0320300ZY	0	+	0	0	781	0.0000000
zheyou73v0_A07	27483536	27484638	BnaA07T0320400ZY	0	-	0	0	1102	0.0000000
zheyou73v0_A07	27486653	27487603	BnaA07T0320500ZY	0	-	0	0	950	0.0000000
zheyou73v0_A07	27487810	27488793	BnaA07T0320600ZY	0	-	0	0	983	0.0000000
zheyou73v0_A07	27488984	27490261	BnaA07T0320700ZY	0	-	0	0	1277	0.0000000
zheyou73v0_A07	27498790	27500858	BnaA07T0320800ZY	0	-	0	0	2068	0.0000000
zheyou73v0_A07	27505489	27506860	BnaA07T0320900ZY	0	-	0	0	1371	0.0000000
zheyou73v0_A07	27509683	27509998	BnaA07T0321000ZY	0	+	0	0	315	0.0000000
zheyou73v0_A07	27511868	27514029	BnaA07T0321100ZY	0	+	0	0	2161	0.0000000
zheyou73v0_A07	27517439	27518992	BnaA07T0321200ZY	0	-	0	0	1553	0.0000000
zheyou73v0_A07	27532382	27534110	BnaA07T0321300ZY	0	-	0	0	1728	0.0000000
zheyou73v0_A07	27539405	27540338	BnaA07T0321400ZY	0	-	0	0	933	0.0000000
zheyou73v0_A07	27541336	27542390	BnaA07T0321500ZY	0	-	0	0	1054	0.0000000
zheyou73v0_A07	27546738	27555403	BnaA07T0321600ZY	0	+	0	0	8665	0.0000000
zheyou73v0_A07	27558205	27560884	BnaA07T0321700ZY	0	-	0	0	2679	0.0000000
zheyou73v0_A07	27561242	27561916	BnaA07T0321800ZY	0	-	0	0	674	0.0000000
zheyou73v0_A07	27562545	27564183	BnaA07T0321900ZY	0	-	0	0	1638	0.0000000
zheyou73v0_A07	27562545	27564183	BnaA07T0321900ZY.1	0	-	0	0	1638	0.0000000
zheyou73v0_A07	27565025	27565396	BnaA07T0322000ZY	0	+	0	0	371	0.0000000
zheyou73v0_A07	27566203	27567431	BnaA07T0322100ZY	0	-	0	0	1228	0.0000000
zheyou73v0_A07	27567592	27570129	BnaA07T0322200ZY	0	-	0	0	2537	0.0000000
zheyou73v0_A07	27571716	27574434	BnaA07T0322300ZY	0	+	0	0	2718	0.0000000
zheyou73v0_A07	27574563	27579089	BnaA07T0322400ZY	0	-	0	0	4526	0.0000000
zheyou73v0_A07	27587694	27589596	BnaA07T0322500ZY	0	+	0	0	1902	0.0000000
zheyou73v0_A07	27590571	27591774	BnaA07T0322600ZY	0	+	0	0	1203	0.0000000
zheyou73v0_A07	27592076	27592482	BnaA07T0322700ZY	0	-	0	0	406	0.0000000
zheyou73v0_A07	27593075	27594891	BnaA07T0322800ZY	0	-	0	0	1816	0.0000000
zheyou73v0_A07	27596036	27598499	BnaA07T0322900ZY	0	-	0	0	2463	0.0000000
zheyou73v0_A07	27598741	27603030	BnaA07T0323000ZY	0	+	0	0	4289	0.0000000
zheyou73v0_A07	27619385	27623077	BnaA07T0323100ZY	0	+	0	0	3692	0.0000000
zheyou73v0_A07	27623169	27624999	BnaA07T0323200ZY.1	0	-	0	0	1830	0.0000000
zheyou73v0_A07	27623287	27624999	BnaA07T0323200ZY	0	-	0	0	1712	0.0000000
zheyou73v0_A07	27625311	27626446	BnaA07T0323300ZY	0	-	0	0	1135	0.0000000
zheyou73v0_A07	27626954	27628815	BnaA07T0323400ZY	0	-	0	0	1861	0.0000000
zheyou73v0_A07	27629850	27630099	BnaA07T0323500ZY	0	+	0	0	249	0.0000000
zheyou73v0_A07	27633022	27633738	BnaA07T0323600ZY	0	-	0	0	716	0.0000000
zheyou73v0_A07	27635801	27637499	BnaA07T0323700ZY	0	-	0	0	1698	0.0000000
zheyou73v0_A07	27641349	27643188	BnaA07T0323800ZY	0	+	0	0	1839	0.0000000
zheyou73v0_A07	27641448	27643188	BnaA07T0323800ZY.1	0	+	0	0	1740	0.0000000
zheyou73v0_A07	27644454	27646064	BnaA07T0323900ZY	0	-	0	0	1610	0.0000000
zheyou73v0_A07	27647671	27648268	BnaA07T0324000ZY	0	+	0	0	597	0.0000000
zheyou73v0_A07	27648566	27649132	BnaA07T0324100ZY	0	+	0	0	566	0.0000000
zheyou73v0_A07	27649410	27650620	BnaA07T0324200ZY	0	-	0	0	1210	0.0000000
zheyou73v0_A07	27653365	27655106	BnaA07T0324300ZY	0	-	0	0	1741	0.0000000
zheyou73v0_A07	27657141	27659153	BnaA07T0324400ZY	0	+	0	0	2012	0.0000000
zheyou73v0_A07	27659158	27662161	BnaA07T0324500ZY	0	-	0	0	3003	0.0000000
zheyou73v0_A07	27664474	27668367	BnaA07T0324600ZY.1	0	+	0	0	3893	0.0000000
zheyou73v0_A07	27664518	27668652	BnaA07T0324600ZY	0	+	0	0	4134	0.0000000
zheyou73v0_A07	27669179	27671559	BnaA07T0324700ZY	0	+	0	0	2380	0.0000000
zheyou73v0_A07	27672628	27677182	BnaA07T0324800ZY	0	+	0	0	4554	0.0000000
zheyou73v0_A07	27677376	27684338	BnaA07T0324900ZY	0	-	0	0	6962	0.0000000
zheyou73v0_A07	27685056	27689608	BnaA07T0325000ZY	0	-	0	0	4552	0.0000000
zheyou73v0_A07	27692571	27704237	BnaA07T0325100ZY	0	+	0	0	11666	0.0000000
zheyou73v0_A07	27704413	27707698	BnaA07T0325200ZY	0	-	0	0	3285	0.0000000
zheyou73v0_A07	27711557	27713240	BnaA07T0325300ZY	0	-	0	0	1683	0.0000000
zheyou73v0_A07	27720001	27727658	BnaA07T0325400ZY	0	-	0	0	7657	0.0000000
zheyou73v0_A07	27727737	27729707	BnaA07T0325500ZY	0	-	0	0	1970	0.0000000
zheyou73v0_A07	27730012	27732620	BnaA07T0325600ZY	0	-	0	0	2608	0.0000000
zheyou73v0_A07	27741358	27742088	BnaA07T0325700ZY	0	-	0	0	730	0.0000000
zheyou73v0_A07	27742124	27748800	BnaA07T0325800ZY	0	-	0	0	6676	0.0000000
zheyou73v0_A07	27742124	27746931	BnaA07T0325800ZY.1	0	-	0	0	4807	0.0000000
zheyou73v0_A07	27751358	27752044	BnaA07T0325900ZY	0	+	0	0	686	0.0000000
zheyou73v0_A07	27751358	27752044	BnaA07T0325900ZY.1	0	+	0	0	686	0.0000000
zheyou73v0_A07	27753958	27755612	BnaA07T0326000ZY	0	+	0	0	1654	0.0000000
zheyou73v0_A07	27756615	27757511	BnaA07T0326100ZY	0	-	0	0	896	0.0000000
zheyou73v0_A07	27756615	27757511	BnaA07T0326100ZY.1	0	-	0	0	896	0.0000000
zheyou73v0_A07	27758076	27759947	BnaA07T0326200ZY	0	-	0	0	1871	0.0000000
zheyou73v0_A07	27760187	27763771	BnaA07T0326300ZY	0	-	0	0	3584	0.0000000
zheyou73v0_A07	27768205	27769609	BnaA07T0326400ZY	0	+	0	0	1404	0.0000000
zheyou73v0_A07	27776575	27777888	BnaA07T0326500ZY	0	-	0	0	1313	0.0000000
zheyou73v0_A07	27779496	27780302	BnaA07T0326600ZY	0	+	0	0	806	0.0000000
zheyou73v0_A07	27782063	27786361	BnaA07T0326700ZY	0	-	0	0	4298	0.0000000
zheyou73v0_A07	27789742	27790539	BnaA07T0326800ZY	0	-	0	0	797	0.0000000
zheyou73v0_A07	27801888	27803152	BnaA07T0326900ZY	0	+	0	0	1264	0.0000000
zheyou73v0_A07	27804185	27805624	BnaA07T0327000ZY	0	+	0	0	1439	0.0000000
zheyou73v0_A07	27805638	27813188	BnaA07T0327100ZY	0	-	0	0	7550	0.0000000
zheyou73v0_A07	27814786	27817363	BnaA07T0327200ZY	0	-	0	0	2577	0.0000000
zheyou73v0_A07	27817497	27818619	BnaA07T0327300ZY	0	+	0	0	1122	0.0000000
zheyou73v0_A07	27819341	27821941	BnaA07T0327400ZY	0	+	0	0	2600	0.0000000
zheyou73v0_A07	27822234	27822471	BnaA07T0327500ZY	0	-	0	0	237	0.0000000
zheyou73v0_A07	27822844	27827638	BnaA07T0327600ZY	0	-	0	0	4794	0.0000000
zheyou73v0_A07	27831447	27834119	BnaA07T0327700ZY	0	+	0	0	2672	0.0000000
zheyou73v0_A07	27833570	27846285	BnaA07T0327800ZY	0	-	0	0	12715	0.0000000
zheyou73v0_A07	27850556	27855018	BnaA07T0327900ZY	0	+	0	0	4462	0.0000000
zheyou73v0_A07	27855919	27859837	BnaA07T0328000ZY	0	+	0	0	3918	0.0000000
zheyou73v0_A07	27860342	27868501	BnaA07T0328100ZY	0	-	0	0	8159	0.0000000
zheyou73v0_A07	27875906	27877460	BnaA07T0328200ZY	0	-	0	0	1554	0.0000000
zheyou73v0_A07	27880088	27883249	BnaA07T0328300ZY	0	+	0	0	3161	0.0000000
zheyou73v0_A07	27883593	27884787	BnaA07T0328400ZY	0	-	0	0	1194	0.0000000
zheyou73v0_A07	27885174	27888439	BnaA07T0328500ZY	0	+	0	0	3265	0.0000000
zheyou73v0_A07	27890989	27892599	BnaA07T0328600ZY	0	-	0	0	1610	0.0000000
zheyou73v0_A07	27894494	27897454	BnaA07T0328700ZY	0	+	0	0	2960	0.0000000
zheyou73v0_A07	27900725	27902545	BnaA07T0328800ZY	0	-	0	0	1820	0.0000000
zheyou73v0_A07	27905552	27910389	BnaA07T0328900ZY	0	-	0	0	4837	0.0000000
zheyou73v0_A07	27910900	27914807	BnaA07T0329000ZY	0	+	0	0	3907	0.0000000
zheyou73v0_A07	27910900	27914814	BnaA07T0329000ZY.1	0	+	0	0	3914	0.0000000
zheyou73v0_A07	27915090	27917543	BnaA07T0329100ZY	0	-	0	0	2453	0.0000000
zheyou73v0_A07	27919718	27921447	BnaA07T0329200ZY	0	-	0	0	1729	0.0000000
zheyou73v0_A07	27919718	27921447	BnaA07T0329200ZY.1	0	-	0	0	1729	0.0000000
zheyou73v0_A07	27924443	27927000	BnaA07T0329300ZY.1	0	-	0	0	2557	0.0000000
zheyou73v0_A07	27924536	27927021	BnaA07T0329300ZY	0	-	0	0	2485	0.0000000
zheyou73v0_A07	27928786	27930800	BnaA07T0329400ZY	0	-	0	0	2014	0.0000000
zheyou73v0_A07	27931368	27936676	BnaA07T0329500ZY	0	-	0	0	5308	0.0000000
zheyou73v0_A07	27936907	27941597	BnaA07T0329600ZY	0	+	0	0	4690	0.0000000
zheyou73v0_A07	27941228	27942193	BnaA07T0329700ZY	0	-	0	0	965	0.0000000
zheyou73v0_A07	27946388	27950191	BnaA07T0329800ZY	0	+	0	0	3803	0.0000000
zheyou73v0_A07	27946545	27950191	BnaA07T0329800ZY.1	0	+	0	0	3646	0.0000000
zheyou73v0_A07	27950727	27954526	BnaA07T0329900ZY	0	-	0	0	3799	0.0000000
zheyou73v0_A07	27955687	27958490	BnaA07T0330000ZY	0	-	0	0	2803	0.0000000
zheyou73v0_A07	27959570	27963546	BnaA07T0330100ZY	0	-	0	0	3976	0.0000000
zheyou73v0_A07	27965672	27965957	BnaA07T0330200ZY	0	+	0	0	285	0.0000000
zheyou73v0_A07	27967453	27968638	BnaA07T0330300ZY	0	-	0	0	1185	0.0000000
zheyou73v0_A07	27969292	27971636	BnaA07T0330400ZY	0	-	0	0	2344	0.0000000
zheyou73v0_A07	27973266	27977851	BnaA07T0330500ZY	0	+	0	0	4585	0.0000000
zheyou73v0_A07	27978005	27980968	BnaA07T0330600ZY	0	-	0	0	2963	0.0000000
zheyou73v0_A07	27982068	27985660	BnaA07T0330700ZY	0	+	0	0	3592	0.0000000
zheyou73v0_A07	27982068	27985660	BnaA07T0330700ZY.1	0	+	0	0	3592	0.0000000
zheyou73v0_A07	27984416	27986288	BnaA07T0330800ZY	0	-	0	0	1872	0.0000000
zheyou73v0_A07	27987703	27990356	BnaA07T0330900ZY	0	+	0	0	2653	0.0000000
zheyou73v0_A07	27987703	27990883	BnaA07T0330900ZY.1	0	+	0	0	3180	0.0000000
zheyou73v0_A07	27990761	27991858	BnaA07T0331000ZY	0	-	0	0	1097	0.0000000
zheyou73v0_A07	27990761	27991858	BnaA07T0331000ZY.1	0	-	0	0	1097	0.0000000
zheyou73v0_A07	27992811	27996406	BnaA07T0331100ZY	0	+	0	0	3595	0.0000000
zheyou73v0_A07	27997153	27997840	BnaA07T0331200ZY	0	+	0	0	687	0.0000000
zheyou73v0_A07	27998204	27998628	BnaA07T0331300ZY	0	-	0	0	424	0.0000000
zheyou73v0_A07	27999961	28001344	BnaA07T0331400ZY	0	+	0	0	1383	0.0000000
zheyou73v0_A07	28001616	28002177	BnaA07T0331500ZY	0	-	0	0	561	0.0000000
zheyou73v0_A07	28002420	28004440	BnaA07T0331600ZY	0	-	0	0	2020	0.0000000
zheyou73v0_A07	28009035	28009769	BnaA07T0331700ZY	0	+	0	0	734	0.0000000
zheyou73v0_A07	28013954	28016074	BnaA07T0331800ZY	0	+	0	0	2120	0.0000000
zheyou73v0_A07	28016292	28017849	BnaA07T0331900ZY	0	-	0	0	1557	0.0000000
zheyou73v0_A07	28024681	28027756	BnaA07T0332000ZY	0	+	0	0	3075	0.0000000
zheyou73v0_A07	28027904	28029922	BnaA07T0332100ZY	0	-	0	0	2018	0.0000000
zheyou73v0_A07	28031307	28034662	BnaA07T0332200ZY	0	-	0	0	3355	0.0000000
zheyou73v0_A07	28035831	28036801	BnaA07T0332300ZY	0	-	0	0	970	0.0000000
zheyou73v0_A07	28038573	28040076	BnaA07T0332400ZY	0	-	0	0	1503	0.0000000
zheyou73v0_A07	28040402	28042918	BnaA07T0332500ZY	0	-	0	0	2516	0.0000000
zheyou73v0_A07	28047414	28049073	BnaA07T0332600ZY	0	+	0	0	1659	0.0000000
zheyou73v0_A07	28053112	28053991	BnaA07T0332700ZY	0	+	0	0	879	0.0000000
zheyou73v0_A07	28059948	28061101	BnaA07T0332800ZY	0	-	0	0	1153	0.0000000
zheyou73v0_A07	28061476	28064334	BnaA07T0332900ZY	0	+	0	0	2858	0.0000000
zheyou73v0_A07	28063884	28065136	BnaA07T0333000ZY	0	-	0	0	1252	0.0000000
zheyou73v0_A07	28066385	28067934	BnaA07T0333100ZY	0	+	0	0	1549	0.0000000
zheyou73v0_A07	28066385	28067934	BnaA07T0333100ZY.1	0	+	0	0	1549	0.0000000
zheyou73v0_A07	28069131	28069720	BnaA07T0333200ZY	0	+	0	0	589	0.0000000
zheyou73v0_A07	28070401	28070587	BnaA07T0333300ZY	0	-	0	0	186	0.0000000
zheyou73v0_A07	28070731	28071126	BnaA07T0333400ZY	0	-	0	0	395	0.0000000
zheyou73v0_A07	28075838	28078324	BnaA07T0333500ZY	0	+	0	0	2486	0.0000000
zheyou73v0_A07	28078648	28082646	BnaA07T0333600ZY	0	+	0	0	3998	0.0000000
zheyou73v0_A07	28082865	28084997	BnaA07T0333700ZY	0	-	0	0	2132	0.0000000
zheyou73v0_A07	28082865	28084997	BnaA07T0333700ZY.1	0	-	0	0	2132	0.0000000
zheyou73v0_A07	28085862	28089961	BnaA07T0333800ZY	0	-	0	0	4099	0.0000000
zheyou73v0_A07	28085910	28087590	BnaA07T0333900ZY	0	+	0	0	1680	0.0000000
zheyou73v0_A07	28090740	28097310	BnaA07T0334000ZY	0	+	0	0	6570	0.0000000
zheyou73v0_A07	28097711	28098264	BnaA07T0334100ZY	0	+	0	0	553	0.0000000
zheyou73v0_A07	28098779	28099235	BnaA07T0334200ZY	0	+	0	0	456	0.0000000
zheyou73v0_A07	28099538	28101762	BnaA07T0334300ZY	0	-	0	0	2224	0.0000000
zheyou73v0_A07	28102092	28103884	BnaA07T0334400ZY	0	+	0	0	1792	0.0000000
zheyou73v0_A07	28104317	28107034	BnaA07T0334500ZY	0	+	0	0	2717	0.0000000
zheyou73v0_A07	28109310	28111614	BnaA07T0334600ZY	0	+	0	0	2304	0.0000000
zheyou73v0_A07	28112344	28118466	BnaA07T0334700ZY	0	+	0	0	6122	0.0000000
zheyou73v0_A07	28118830	28119574	BnaA07T0334800ZY	0	-	0	0	744	0.0000000
zheyou73v0_A07	28120847	28122302	BnaA07T0334900ZY	0	-	0	0	1455	0.0000000
zheyou73v0_A07	28122930	28123197	BnaA07T0335000ZY	0	-	0	0	267	0.0000000
zheyou73v0_A07	28123310	28123952	BnaA07T0335100ZY	0	-	0	0	642	0.0000000
zheyou73v0_A07	28124571	28127055	BnaA07T0335200ZY	0	+	0	0	2484	0.0000000
zheyou73v0_A07	28127317	28127548	BnaA07T0335300ZY	0	+	0	0	231	0.0000000
zheyou73v0_A07	28127860	28130859	BnaA07T0335400ZY	0	-	0	0	2999	0.0000000
zheyou73v0_A07	28131919	28134329	BnaA07T0335500ZY	0	-	0	0	2410	0.0000000
zheyou73v0_A07	28135345	28137633	BnaA07T0335600ZY	0	+	0	0	2288	0.0000000
zheyou73v0_A07	28138768	28139272	BnaA07T0335700ZY	0	+	0	0	504	0.0000000
zheyou73v0_A07	28140328	28141953	BnaA07T0335800ZY	0	-	0	0	1625	0.0000000
zheyou73v0_A07	28146450	28152966	BnaA07T0335900ZY	0	+	0	0	6516	0.0000000
zheyou73v0_A07	28158005	28159228	BnaA07T0336000ZY	0	+	0	0	1223	0.0000000
zheyou73v0_A07	28162081	28164453	BnaA07T0336100ZY	0	-	0	0	2372	0.0000000
zheyou73v0_A07	28165002	28167203	BnaA07T0336200ZY	0	-	0	0	2201	0.0000000
zheyou73v0_A07	28175532	28177314	BnaA07T0336300ZY	0	+	0	0	1782	0.0000000
zheyou73v0_A07	28179361	28180618	BnaA07T0336400ZY	0	-	0	0	1257	0.0000000
zheyou73v0_A07	28179521	28179899	BnaA07T0336500ZY	0	+	0	0	378	0.0000000
zheyou73v0_A07	28180763	28182440	BnaA07T0336600ZY	0	-	0	0	1677	0.0000000
zheyou73v0_A07	28182748	28185258	BnaA07T0336700ZY	0	-	0	0	2510	0.0000000
zheyou73v0_A07	28182748	28185258	BnaA07T0336700ZY.1	0	-	0	0	2510	0.0000000
zheyou73v0_A07	28187228	28188645	BnaA07T0336800ZY	0	-	0	0	1417	0.0000000
zheyou73v0_A07	28197040	28197751	BnaA07T0336900ZY	0	-	0	0	711	0.0000000
zheyou73v0_A07	28202562	28203760	BnaA07T0337000ZY	0	+	0	0	1198	0.0000000
zheyou73v0_A07	28206592	28207716	BnaA07T0337100ZY	0	-	0	0	1124	0.0000000
zheyou73v0_A07	28210946	28218938	BnaA07T0337200ZY	0	-	0	0	7992	0.0000000
zheyou73v0_A07	28223752	28225277	BnaA07T0337300ZY	0	-	0	0	1525	0.0000000
zheyou73v0_A07	28228644	28228897	BnaA07T0337400ZY	0	-	0	0	253	0.0000000
zheyou73v0_A07	28233113	28236568	BnaA07T0337500ZY	0	+	0	0	3455	0.0000000
zheyou73v0_A07	28236662	28239511	BnaA07T0337600ZY	0	+	0	0	2849	0.0000000
zheyou73v0_A07	28240719	28241915	BnaA07T0337700ZY	0	+	0	0	1196	0.0000000
zheyou73v0_A07	28241989	28242430	BnaA07T0337800ZY	0	-	0	0	441	0.0000000
zheyou73v0_A07	28242617	28245791	BnaA07T0337900ZY	0	-	0	0	3174	0.0000000
zheyou73v0_A07	28246075	28246344	BnaA07T0338000ZY	0	-	0	0	269	0.0000000
zheyou73v0_A07	28246538	28246875	BnaA07T0338100ZY	0	-	0	0	337	0.0000000
zheyou73v0_A07	28247668	28249156	BnaA07T0338200ZY	0	-	0	0	1488	0.0000000
zheyou73v0_A07	28249368	28250673	BnaA07T0338300ZY	0	-	0	0	1305	0.0000000
zheyou73v0_A08	55085	59654	BnaA08T0000100ZY	0	-	0	0	4569	0.0000000
zheyou73v0_A08	60143	62265	BnaA08T0000200ZY	0	+	0	0	2122	0.0000000
zheyou73v0_A08	60143	62265	BnaA08T0000200ZY.1	0	+	0	0	2122	0.0000000
zheyou73v0_A08	67485	68564	BnaA08T0000300ZY	0	-	0	0	1079	0.0000000
zheyou73v0_A08	88173	104848	BnaA08T0000400ZY	0	+	0	0	16675	0.0000000
zheyou73v0_A08	94291	99023	BnaA08T0000500ZY	0	-	0	0	4732	0.0000000
zheyou73v0_A08	100427	105564	BnaA08T0000600ZY.1	0	+	0	0	5137	0.0000000
zheyou73v0_A08	105975	108301	BnaA08T0000700ZY	0	+	0	0	2326	0.0000000
zheyou73v0_A08	111762	112709	BnaA08T0000800ZY	0	+	0	0	947	0.0000000
zheyou73v0_A08	113421	118365	BnaA08T0000900ZY	0	-	0	0	4944	0.0000000
zheyou73v0_A08	132448	133164	BnaA08T0001000ZY	0	+	0	0	716	0.0000000
zheyou73v0_A08	134966	135216	BnaA08T0001100ZY	0	+	0	0	250	0.0000000
zheyou73v0_A08	169689	174349	BnaA08T0001200ZY	0	+	0	0	4660	0.0000000
zheyou73v0_A08	175902	177009	BnaA08T0001300ZY	0	-	0	0	1107	0.0000000
zheyou73v0_A08	182775	186963	BnaA08T0001400ZY	0	+	0	0	4188	0.0000000
zheyou73v0_A08	187396	189407	BnaA08T0001500ZY	0	-	0	0	2011	0.0000000
zheyou73v0_A08	189704	191579	BnaA08T0001600ZY	0	+	0	0	1875	0.0000000
zheyou73v0_A08	191754	192453	BnaA08T0001700ZY	0	-	0	0	699	0.0000000
zheyou73v0_A08	195250	196496	BnaA08T0001800ZY	0	-	0	0	1246	0.0000000
zheyou73v0_A08	196822	199172	BnaA08T0001900ZY	0	-	0	0	2350	0.0000000
zheyou73v0_A08	203077	203628	BnaA08T0002000ZY	0	+	0	0	551	0.0000000
zheyou73v0_A08	203703	204906	BnaA08T0002100ZY	0	+	0	0	1203	0.0000000
zheyou73v0_A08	203703	204906	BnaA08T0002100ZY.1	0	+	0	0	1203	0.0000000
zheyou73v0_A08	205070	207244	BnaA08T0002200ZY	0	-	0	0	2174	0.0000000
zheyou73v0_A08	228525	230667	BnaA08T0002300ZY	0	-	0	0	2142	0.0000000
zheyou73v0_A08	231672	234129	BnaA08T0002400ZY	0	-	0	0	2457	0.0000000
zheyou73v0_A08	236266	239066	BnaA08T0002500ZY.1	0	-	0	0	2800	0.0000000
zheyou73v0_A08	236281	239066	BnaA08T0002500ZY	0	-	0	0	2785	0.0000000
zheyou73v0_A08	240814	241540	BnaA08T0002600ZY	0	+	0	0	726	0.0000000
zheyou73v0_A08	242021	245260	BnaA08T0002700ZY	0	+	0	0	3239	0.0000000
zheyou73v0_A08	246836	247358	BnaA08T0002800ZY	0	+	0	0	522	0.0000000
zheyou73v0_A08	251115	253157	BnaA08T0002900ZY	0	+	0	0	2042	0.0000000
zheyou73v0_A08	255762	257127	BnaA08T0003000ZY	0	-	0	0	1365	0.0000000
zheyou73v0_A08	257404	258157	BnaA08T0003100ZY	0	-	0	0	753	0.0000000
zheyou73v0_A08	260913	264473	BnaA08T0003200ZY	0	+	0	0	3560	0.0000000
zheyou73v0_A08	265221	267414	BnaA08T0003300ZY	0	+	0	0	2193	0.0000000
zheyou73v0_A08	277200	289179	BnaA08T0003400ZY	0	+	0	0	11979	0.0000000
zheyou73v0_A08	289297	289783	BnaA08T0003500ZY	0	+	0	0	486	0.0000000
zheyou73v0_A08	291505	292385	BnaA08T0003600ZY	0	+	0	0	880	0.0000000
zheyou73v0_A08	292885	297023	BnaA08T0003700ZY	0	+	0	0	4138	0.0000000
zheyou73v0_A08	300874	304966	BnaA08T0003800ZY	0	+	0	0	4092	0.0000000
zheyou73v0_A08	342326	342724	BnaA08T0003900ZY	0	-	0	0	398	0.0000000
zheyou73v0_A08	342826	343713	BnaA08T0004000ZY	0	-	0	0	887	0.0000000
zheyou73v0_A08	345439	348019	BnaA08T0004100ZY	0	+	0	0	2580	0.0000000
zheyou73v0_A08	386507	386832	BnaA08T0004200ZY	0	-	0	0	325	0.0000000
zheyou73v0_A08	393189	394352	BnaA08T0004300ZY	0	-	0	0	1163	0.0000000
zheyou73v0_A08	394363	396176	BnaA08T0004400ZY	0	-	0	0	1813	0.0000000
zheyou73v0_A08	401169	403885	BnaA08T0004500ZY	0	+	0	0	2716	0.0000000
zheyou73v0_A08	404231	408105	BnaA08T0004600ZY	0	-	0	0	3874	0.0000000
zheyou73v0_A08	409262	411698	BnaA08T0004700ZY	0	+	0	0	2436	0.0000000
zheyou73v0_A08	422824	431515	BnaA08T0004800ZY	0	+	0	0	8691	0.0000000
zheyou73v0_A08	422824	431515	BnaA08T0004800ZY.1	0	+	0	0	8691	0.0000000
zheyou73v0_A08	431753	434083	BnaA08T0004900ZY	0	+	0	0	2330	0.0000000
zheyou73v0_A08	434479	436438	BnaA08T0005000ZY	0	+	0	0	1959	0.0000000
zheyou73v0_A08	437324	438589	BnaA08T0005100ZY	0	+	0	0	1265	0.0000000
zheyou73v0_A08	458082	459837	BnaA08T0005200ZY	0	+	0	0	1755	0.0000000
zheyou73v0_A08	474055	474622	BnaA08T0005300ZY	0	-	0	0	567	0.0000000
zheyou73v0_A08	475391	477560	BnaA08T0005400ZY	0	+	0	0	2169	0.0000000
zheyou73v0_A08	477614	479878	BnaA08T0005500ZY	0	-	0	0	2264	0.0000000
zheyou73v0_A08	480859	482294	BnaA08T0005600ZY	0	+	0	0	1435	0.0000000
zheyou73v0_A08	482562	486262	BnaA08T0005700ZY	0	+	0	0	3700	0.0000000
zheyou73v0_A08	488217	489837	BnaA08T0005800ZY	0	-	0	0	1620	0.0000000
zheyou73v0_A08	490830	493225	BnaA08T0005900ZY	0	-	0	0	2395	0.0000000
zheyou73v0_A08	502834	504622	BnaA08T0006000ZY	0	+	0	0	1788	0.0000000
zheyou73v0_A08	514077	514293	BnaA08T0006100ZY	0	+	0	0	216	0.0000000
zheyou73v0_A08	518577	521033	BnaA08T0006200ZY	0	+	0	0	2456	0.0000000
zheyou73v0_A08	521190	523002	BnaA08T0006300ZY	0	-	0	0	1812	0.0000000
zheyou73v0_A08	521190	523002	BnaA08T0006300ZY.1	0	-	0	0	1812	0.0000000
zheyou73v0_A08	521190	523002	BnaA08T0006300ZY.2	0	-	0	0	1812	0.0000000
zheyou73v0_A08	529618	530290	BnaA08T0006400ZY	0	+	0	0	672	0.0000000
zheyou73v0_A08	530881	533599	BnaA08T0006500ZY	0	-	0	0	2718	0.0000000
zheyou73v0_A08	548144	549840	BnaA08T0006600ZY	0	+	0	0	1696	0.0000000
zheyou73v0_A08	551505	553627	BnaA08T0006700ZY	0	+	0	0	2122	0.0000000
zheyou73v0_A08	562898	564606	BnaA08T0006800ZY	0	-	0	0	1708	0.0000000
zheyou73v0_A08	562898	564606	BnaA08T0006800ZY.1	0	-	0	0	1708	0.0000000
zheyou73v0_A08	562898	564606	BnaA08T0006800ZY.2	0	-	0	0	1708	0.0000000
zheyou73v0_A08	571615	576284	BnaA08T0006900ZY	0	-	0	0	4669	0.0000000
zheyou73v0_A08	581037	583154	BnaA08T0007000ZY	0	-	0	0	2117	0.0000000
zheyou73v0_A08	605101	606149	BnaA08T0007100ZY	0	+	0	0	1048	0.0000000
zheyou73v0_A08	612085	612756	BnaA08T0007200ZY	0	+	0	0	671	0.0000000
zheyou73v0_A08	614410	615640	BnaA08T0007300ZY	0	-	0	0	1230	0.0000000
zheyou73v0_A08	620984	621535	BnaA08T0007400ZY	0	+	0	0	551	0.0000000
zheyou73v0_A08	622599	623690	BnaA08T0007500ZY	0	-	0	0	1091	0.0000000
zheyou73v0_A08	625313	626264	BnaA08T0007600ZY	0	-	0	0	951	0.0000000
zheyou73v0_A08	628973	631395	BnaA08T0007700ZY	0	+	0	0	2422	0.0000000
zheyou73v0_A08	632061	633236	BnaA08T0007800ZY	0	-	0	0	1175	0.0000000
zheyou73v0_A08	644680	646656	BnaA08T0007900ZY	0	-	0	0	1976	0.0000000
zheyou73v0_A08	662410	663504	BnaA08T0008000ZY	0	+	0	0	1094	0.0000000
zheyou73v0_A08	680326	681692	BnaA08T0008100ZY	0	-	0	0	1366	0.0000000
zheyou73v0_A08	682428	685082	BnaA08T0008200ZY	0	-	0	0	2654	0.0000000
zheyou73v0_A08	685650	688144	BnaA08T0008300ZY	0	+	0	0	2494	0.0000000
zheyou73v0_A08	699572	702127	BnaA08T0008400ZY	0	+	0	0	2555	0.0000000
zheyou73v0_A08	702629	703111	BnaA08T0008500ZY	0	-	0	0	482	0.0000000
zheyou73v0_A08	718093	718621	BnaA08T0008600ZY	0	+	0	0	528	0.0000000
zheyou73v0_A08	722320	722737	BnaA08T0008700ZY	0	+	0	0	417	0.0000000
zheyou73v0_A08	723920	724475	BnaA08T0008800ZY	0	-	0	0	555	0.0000000
zheyou73v0_A08	727776	731923	BnaA08T0008900ZY	0	-	0	0	4147	0.0000000
zheyou73v0_A08	733147	736873	BnaA08T0009000ZY	0	+	0	0	3726	0.0000000
zheyou73v0_A08	737662	742751	BnaA08T0009100ZY	0	+	0	0	5089	0.0000000
zheyou73v0_A08	755947	756308	BnaA08T0009200ZY	0	-	0	0	361	0.0000000
zheyou73v0_A08	758585	759392	BnaA08T0009300ZY	0	+	0	0	807	0.0000000
zheyou73v0_A08	759633	760352	BnaA08T0009400ZY	0	-	0	0	719	0.0000000
zheyou73v0_A08	761006	774433	BnaA08T0009500ZY	0	-	0	0	13427	0.0000000
zheyou73v0_A08	775818	776682	BnaA08T0009600ZY	0	+	0	0	864	0.0000000
zheyou73v0_A08	777318	777954	BnaA08T0009700ZY	0	+	0	0	636	0.0000000
zheyou73v0_A08	792091	792418	BnaA08T0009800ZY	0	-	0	0	327	0.0000000
zheyou73v0_A08	792699	793335	BnaA08T0009900ZY	0	-	0	0	636	0.0000000
zheyou73v0_A08	813343	814804	BnaA08T0010000ZY	0	+	0	0	1461	0.0000000
zheyou73v0_A08	814742	817103	BnaA08T0010100ZY	0	-	0	0	2361	0.0000000
zheyou73v0_A08	818728	819926	BnaA08T0010200ZY	0	+	0	0	1198	0.0000000
zheyou73v0_A08	821037	821316	BnaA08T0010300ZY	0	-	0	0	279	0.0000000
zheyou73v0_A08	825288	825791	BnaA08T0010400ZY	0	-	0	0	503	0.0000000
zheyou73v0_A08	829274	831596	BnaA08T0010500ZY	0	-	0	0	2322	0.0000000
zheyou73v0_A08	832715	836089	BnaA08T0010600ZY	0	+	0	0	3374	0.0000000
zheyou73v0_A08	836499	838602	BnaA08T0010700ZY	0	-	0	0	2103	0.0000000
zheyou73v0_A08	840749	843299	BnaA08T0010800ZY	0	+	0	0	2550	0.0000000
zheyou73v0_A08	844274	845201	BnaA08T0010900ZY	0	-	0	0	927	0.0000000
zheyou73v0_A08	848120	848982	BnaA08T0011000ZY	0	+	0	0	862	0.0000000
zheyou73v0_A08	851065	853076	BnaA08T0011100ZY	0	-	0	0	2011	0.0000000
zheyou73v0_A08	861892	862471	BnaA08T0011200ZY	0	+	0	0	579	0.0000000
zheyou73v0_A08	866979	869305	BnaA08T0011300ZY.1	0	-	0	0	2326	0.0000000
zheyou73v0_A08	867167	869305	BnaA08T0011300ZY	0	-	0	0	2138	0.0000000
zheyou73v0_A08	905654	928874	BnaA08T0011400ZY	0	+	0	0	23220	0.0000000
zheyou73v0_A08	913041	914192	BnaA08T0011500ZY	0	+	0	0	1151	0.0000000
zheyou73v0_A08	914409	915607	BnaA08T0011600ZY	0	-	0	0	1198	0.0000000
zheyou73v0_A08	933875	937069	BnaA08T0011700ZY	0	-	0	0	3194	0.0000000
zheyou73v0_A08	937925	939875	BnaA08T0011800ZY	0	-	0	0	1950	0.0000000
zheyou73v0_A08	948887	951255	BnaA08T0011900ZY	0	-	0	0	2368	0.0000000
zheyou73v0_A08	952594	954590	BnaA08T0012000ZY	0	-	0	0	1996	0.0000000
zheyou73v0_A08	963944	964418	BnaA08T0012100ZY	0	-	0	0	474	0.0000000
zheyou73v0_A08	966182	971502	BnaA08T0012200ZY	0	+	0	0	5320	0.0000000
zheyou73v0_A08	971917	974517	BnaA08T0012300ZY	0	+	0	0	2600	0.0000000
zheyou73v0_A08	974775	978314	BnaA08T0012400ZY	0	-	0	0	3539	0.0000000
zheyou73v0_A08	986832	989953	BnaA08T0012500ZY	0	+	0	0	3121	0.0000000
zheyou73v0_A08	993037	993924	BnaA08T0012600ZY	0	+	0	0	887	0.0000000
zheyou73v0_A08	1015950	1026785	BnaA08T0012700ZY	0	+	0	0	10835	0.0000000
zheyou73v0_A08	1043144	1044996	BnaA08T0012800ZY	0	+	0	0	1852	0.0000000
zheyou73v0_A08	1051349	1051695	BnaA08T0012900ZY	0	-	0	0	346	0.0000000
zheyou73v0_A08	1054088	1056946	BnaA08T0013000ZY	0	-	0	0	2858	0.0000000
zheyou73v0_A08	1072093	1072615	BnaA08T0013100ZY	0	+	0	0	522	0.0000000
zheyou73v0_A08	1083822	1087424	BnaA08T0013200ZY	0	-	0	0	3602	0.0000000
zheyou73v0_A08	1089319	1091447	BnaA08T0013300ZY	0	+	0	0	2128	0.0000000
zheyou73v0_A08	1106850	1107672	BnaA08T0013400ZY	0	+	0	0	822	0.0000000
zheyou73v0_A08	1118503	1118848	BnaA08T0013500ZY	0	+	0	0	345	0.0000000
zheyou73v0_A08	1119710	1121033	BnaA08T0013600ZY	0	+	0	0	1323	0.0000000
zheyou73v0_A08	1125474	1127630	BnaA08T0013700ZY	0	+	0	0	2156	0.0000000
zheyou73v0_A08	1126662	1129439	BnaA08T0013800ZY	0	-	0	0	2777	0.0000000
zheyou73v0_A08	1131390	1134174	BnaA08T0013900ZY	0	+	0	0	2784	0.0000000
zheyou73v0_A08	1138326	1139902	BnaA08T0014000ZY	0	-	0	0	1576	0.0000000
zheyou73v0_A08	1153865	1156800	BnaA08T0014100ZY	0	-	0	0	2935	0.0000000
zheyou73v0_A08	1166678	1168445	BnaA08T0014200ZY	0	-	0	0	1767	0.0000000
zheyou73v0_A08	1170067	1171480	BnaA08T0014300ZY	0	-	0	0	1413	0.0000000
zheyou73v0_A08	1175684	1177581	BnaA08T0014400ZY	0	+	0	0	1897	0.0000000
zheyou73v0_A08	1186514	1187781	BnaA08T0014500ZY	0	+	0	0	1267	0.0000000
zheyou73v0_A08	1195029	1198196	BnaA08T0014600ZY	0	-	0	0	3167	0.0000000
zheyou73v0_A08	1213574	1214817	BnaA08T0014700ZY	0	-	0	0	1243	0.0000000
zheyou73v0_A08	1229160	1229991	BnaA08T0014800ZY	0	+	0	0	831	0.0000000
zheyou73v0_A08	1249852	1251735	BnaA08T0014900ZY	0	+	0	0	1883	0.0000000
zheyou73v0_A08	1253902	1257176	BnaA08T0015000ZY	0	-	0	0	3274	0.0000000
zheyou73v0_A08	1267228	1270069	BnaA08T0015100ZY	0	+	0	0	2841	0.0000000
zheyou73v0_A08	1268111	1270069	BnaA08T0015100ZY.1	0	+	0	0	1958	0.0000000
zheyou73v0_A08	1275565	1277029	BnaA08T0015200ZY	0	+	0	0	1464	0.0000000
zheyou73v0_A08	1286306	1288963	BnaA08T0015300ZY	0	+	0	0	2657	0.0000000
zheyou73v0_A08	1286306	1288963	BnaA08T0015300ZY.1	0	+	0	0	2657	0.0000000
zheyou73v0_A08	1292427	1294847	BnaA08T0015400ZY	0	+	0	0	2420	0.0000000
zheyou73v0_A08	1292427	1294847	BnaA08T0015400ZY.1	0	+	0	0	2420	0.0000000
zheyou73v0_A08	1293376	1294847	BnaA08T0015400ZY.2	0	+	0	0	1471	0.0000000
zheyou73v0_A08	1305323	1305895	BnaA08T0015500ZY	0	+	0	0	572	0.0000000
zheyou73v0_A08	1306487	1306685	BnaA08T0015600ZY	0	+	0	0	198	0.0000000
zheyou73v0_A08	1310879	1311927	BnaA08T0015700ZY	0	-	0	0	1048	0.0000000
zheyou73v0_A08	1321249	1321964	BnaA08T0015800ZY	0	+	0	0	715	0.0000000
zheyou73v0_A08	1324272	1325457	BnaA08T0015900ZY	0	-	0	0	1185	0.0000000
zheyou73v0_A08	1336053	1338227	BnaA08T0016000ZY	0	-	0	0	2174	0.0000000
zheyou73v0_A08	1349398	1350012	BnaA08T0016100ZY	0	+	0	0	614	0.0000000
zheyou73v0_A08	1363437	1365646	BnaA08T0016200ZY	0	+	0	0	2209	0.0000000
zheyou73v0_A08	1373625	1374066	BnaA08T0016300ZY	0	-	0	0	441	0.0000000
zheyou73v0_A08	1378495	1379551	BnaA08T0016400ZY	0	+	0	0	1056	0.0000000
zheyou73v0_A08	1453767	1455432	BnaA08T0016500ZY	0	-	0	0	1665	0.0000000
zheyou73v0_A08	1459877	1460988	BnaA08T0016600ZY	0	+	0	0	1111	0.0000000
zheyou73v0_A08	1462291	1465502	BnaA08T0016700ZY	0	+	0	0	3211	0.0000000
zheyou73v0_A08	1468190	1469345	BnaA08T0016800ZY	0	+	0	0	1155	0.0000000
zheyou73v0_A08	1478510	1479080	BnaA08T0016900ZY	0	+	0	0	570	0.0000000
zheyou73v0_A08	1481805	1483165	BnaA08T0017000ZY	0	+	0	0	1360	0.0000000
zheyou73v0_A08	1488737	1491553	BnaA08T0017100ZY	0	-	0	0	2816	0.0000000
zheyou73v0_A08	1494031	1495244	BnaA08T0017200ZY	0	+	0	0	1213	0.0000000
zheyou73v0_A08	1497018	1499691	BnaA08T0017300ZY	0	+	0	0	2673	0.0000000
zheyou73v0_A08	1497018	1500031	BnaA08T0017300ZY.1	0	+	0	0	3013	0.0000000
zheyou73v0_A08	1500745	1502225	BnaA08T0017400ZY	0	+	0	0	1480	0.0000000
zheyou73v0_A08	1502406	1505248	BnaA08T0017500ZY	0	-	0	0	2842	0.0000000
zheyou73v0_A08	1514091	1514545	BnaA08T0017600ZY	0	+	0	0	454	0.0000000
zheyou73v0_A08	1515219	1516056	BnaA08T0017700ZY	0	-	0	0	837	0.0000000
zheyou73v0_A08	1521761	1523282	BnaA08T0017800ZY	0	+	0	0	1521	0.0000000
zheyou73v0_A08	1521761	1523282	BnaA08T0017800ZY.1	0	+	0	0	1521	0.0000000
zheyou73v0_A08	1540726	1544823	BnaA08T0017900ZY	0	+	0	0	4097	0.0000000
zheyou73v0_A08	1548272	1550904	BnaA08T0018000ZY	0	-	0	0	2632	0.0000000
zheyou73v0_A08	1564224	1565814	BnaA08T0018100ZY	0	-	0	0	1590	0.0000000
zheyou73v0_A08	1565877	1566711	BnaA08T0018200ZY	0	-	0	0	834	0.0000000
zheyou73v0_A08	1568928	1571223	BnaA08T0018300ZY	0	+	0	0	2295	0.0000000
zheyou73v0_A08	1568928	1571223	BnaA08T0018300ZY.1	0	+	0	0	2295	0.0000000
zheyou73v0_A08	1568928	1571223	BnaA08T0018300ZY.2	0	+	0	0	2295	0.0000000
zheyou73v0_A08	1589700	1590378	BnaA08T0018400ZY	0	+	0	0	678	0.0000000
zheyou73v0_A08	1597650	1598690	BnaA08T0018500ZY	0	+	0	0	1040	0.0000000
zheyou73v0_A08	1599162	1601751	BnaA08T0018600ZY	0	-	0	0	2589	0.0000000
zheyou73v0_A08	1649395	1649944	BnaA08T0018700ZY	0	-	0	0	549	0.0000000
zheyou73v0_A08	1669288	1672726	BnaA08T0018800ZY	0	+	0	0	3438	0.0000000
zheyou73v0_A08	1675975	1677055	BnaA08T0018900ZY	0	-	0	0	1080	0.0000000
zheyou73v0_A08	1678386	1680710	BnaA08T0019000ZY.1	0	-	0	0	2324	0.0000000
zheyou73v0_A08	1678673	1680107	BnaA08T0019000ZY	0	-	0	0	1434	0.0000000
zheyou73v0_A08	1692090	1695814	BnaA08T0019100ZY	0	+	0	0	3724	0.0000000
zheyou73v0_A08	1692090	1695814	BnaA08T0019100ZY.1	0	+	0	0	3724	0.0000000
zheyou73v0_A08	1697323	1702521	BnaA08T0019200ZY	0	+	0	0	5198	0.0000000
zheyou73v0_A08	1704995	1706894	BnaA08T0019300ZY	0	+	0	0	1899	0.0000000
zheyou73v0_A08	1707316	1711770	BnaA08T0019400ZY	0	-	0	0	4454	0.0000000
zheyou73v0_A08	1714452	1718161	BnaA08T0019500ZY	0	+	0	0	3709	0.0000000
zheyou73v0_A08	1714452	1718081	BnaA08T0019500ZY.1	0	+	0	0	3629	0.0000000
zheyou73v0_A08	1719501	1720477	BnaA08T0019600ZY	0	-	0	0	976	0.0000000
zheyou73v0_A08	1721920	1725428	BnaA08T0019700ZY	0	-	0	0	3508	0.0000000
zheyou73v0_A08	1755005	1756506	BnaA08T0019800ZY	0	-	0	0	1501	0.0000000
zheyou73v0_A08	1762436	1763342	BnaA08T0019900ZY	0	-	0	0	906	0.0000000
zheyou73v0_A08	1765674	1765827	BnaA08T0020000ZY	0	-	0	0	153	0.0000000
zheyou73v0_A08	1766028	1766404	BnaA08T0020100ZY	0	+	0	0	376	0.0000000
zheyou73v0_A08	1771808	1773933	BnaA08T0020200ZY	0	+	0	0	2125	0.0000000
zheyou73v0_A08	1779252	1781375	BnaA08T0020300ZY	0	-	0	0	2123	0.0000000
zheyou73v0_A08	1779252	1781449	BnaA08T0020300ZY.1	0	-	0	0	2197	0.0000000
zheyou73v0_A08	1781272	1781470	BnaA08T0020400ZY	0	+	0	0	198	0.0000000
zheyou73v0_A08	1782167	1785473	BnaA08T0020500ZY	0	+	0	0	3306	0.0000000
zheyou73v0_A08	1785646	1787956	BnaA08T0020600ZY	0	-	0	0	2310	0.0000000
zheyou73v0_A08	1791305	1793099	BnaA08T0020700ZY	0	+	0	0	1794	0.0000000
zheyou73v0_A08	1831813	1832479	BnaA08T0020800ZY	0	+	0	0	666	0.0000000
zheyou73v0_A08	1838719	1839461	BnaA08T0020900ZY	0	+	0	0	742	0.0000000
zheyou73v0_A08	1841656	1842109	BnaA08T0021000ZY	0	-	0	0	453	0.0000000
zheyou73v0_A08	1853797	1855346	BnaA08T0021100ZY	0	+	0	0	1549	0.0000000
zheyou73v0_A08	1853797	1855346	BnaA08T0021100ZY.1	0	+	0	0	1549	0.0000000
zheyou73v0_A08	1853797	1855346	BnaA08T0021100ZY.2	0	+	0	0	1549	0.0000000
zheyou73v0_A08	1853797	1855346	BnaA08T0021100ZY.3	0	+	0	0	1549	0.0000000
zheyou73v0_A08	1853797	1855346	BnaA08T0021100ZY.4	0	+	0	0	1549	0.0000000
zheyou73v0_A08	1858188	1859252	BnaA08T0021200ZY	0	+	0	0	1064	0.0000000
zheyou73v0_A08	1859752	1860821	BnaA08T0021300ZY	0	+	0	0	1069	0.0000000
zheyou73v0_A08	1864308	1865406	BnaA08T0021400ZY	0	-	0	0	1098	0.0000000
zheyou73v0_A08	1871364	1871721	BnaA08T0021500ZY	0	+	0	0	357	0.0000000
zheyou73v0_A08	1875852	1877685	BnaA08T0021600ZY	0	+	0	0	1833	0.0000000
zheyou73v0_A08	1890391	1890610	BnaA08T0021700ZY	0	+	0	0	219	0.0000000
zheyou73v0_A08	1890625	1890835	BnaA08T0021800ZY	0	+	0	0	210	0.0000000
zheyou73v0_A08	1893131	1894420	BnaA08T0021900ZY.1	0	+	0	0	1289	0.0000000
zheyou73v0_A08	1893152	1894420	BnaA08T0021900ZY	0	+	0	0	1268	0.0000000
zheyou73v0_A08	1895882	1897170	BnaA08T0022000ZY	0	-	0	0	1288	0.0000000
zheyou73v0_A08	1897816	1902718	BnaA08T0022100ZY	0	-	0	0	4902	0.0000000
zheyou73v0_A08	1912501	1913975	BnaA08T0022200ZY	0	+	0	0	1474	0.0000000
zheyou73v0_A08	1923978	1924653	BnaA08T0022300ZY	0	-	0	0	675	0.0000000
zheyou73v0_A08	1925701	1928480	BnaA08T0022400ZY	0	-	0	0	2779	0.0000000
zheyou73v0_A08	1945834	1947127	BnaA08T0022500ZY	0	-	0	0	1293	0.0000000
zheyou73v0_A08	1955925	1960433	BnaA08T0022600ZY	0	-	0	0	4508	0.0000000
zheyou73v0_A08	1960621	1962834	BnaA08T0022700ZY	0	-	0	0	2213	0.0000000
zheyou73v0_A08	1968976	1971786	BnaA08T0022800ZY	0	+	0	0	2810	0.0000000
zheyou73v0_A08	1975045	1975383	BnaA08T0022900ZY	0	+	0	0	338	0.0000000
zheyou73v0_A08	1997028	1997799	BnaA08T0023000ZY	0	+	0	0	771	0.0000000
zheyou73v0_A08	2001531	2002327	BnaA08T0023100ZY	0	+	0	0	796	0.0000000
zheyou73v0_A08	2022542	2024587	BnaA08T0023200ZY	0	+	0	0	2045	0.0000000
zheyou73v0_A08	2026204	2028810	BnaA08T0023300ZY	0	+	0	0	2606	0.0000000
zheyou73v0_A08	2028777	2030743	BnaA08T0023400ZY	0	-	0	0	1966	0.0000000
zheyou73v0_A08	2042212	2043871	BnaA08T0023500ZY	0	+	0	0	1659	0.0000000
zheyou73v0_A08	2045503	2047108	BnaA08T0023600ZY	0	+	0	0	1605	0.0000000
zheyou73v0_A08	2049765	2051863	BnaA08T0023700ZY	0	-	0	0	2098	0.0000000
zheyou73v0_A08	2058621	2060651	BnaA08T0023800ZY	0	+	0	0	2030	0.0000000
zheyou73v0_A08	2058621	2061980	BnaA08T0023800ZY.1	0	+	0	0	3359	0.0000000
zheyou73v0_A08	2062687	2065040	BnaA08T0023900ZY	0	-	0	0	2353	0.0000000
zheyou73v0_A08	2068274	2070628	BnaA08T0024000ZY	0	-	0	0	2354	0.0000000
zheyou73v0_A08	2072714	2073291	BnaA08T0024100ZY	0	+	0	0	577	0.0000000
zheyou73v0_A08	2073737	2076919	BnaA08T0024200ZY	0	-	0	0	3182	0.0000000
zheyou73v0_A08	2090077	2093921	BnaA08T0024300ZY	0	+	0	0	3844	0.0000000
zheyou73v0_A08	2105250	2107246	BnaA08T0024400ZY	0	+	0	0	1996	0.0000000
zheyou73v0_A08	2107716	2109989	BnaA08T0024500ZY	0	-	0	0	2273	0.0000000
zheyou73v0_A08	2118581	2122294	BnaA08T0024600ZY	0	-	0	0	3713	0.0000000
zheyou73v0_A08	2124132	2124480	BnaA08T0024700ZY	0	-	0	0	348	0.0000000
zheyou73v0_A08	2126835	2134630	BnaA08T0024800ZY	0	+	0	0	7795	0.0000000
zheyou73v0_A08	2135419	2138395	BnaA08T0024900ZY	0	-	0	0	2976	0.0000000
zheyou73v0_A08	2145137	2147440	BnaA08T0025000ZY	0	+	0	0	2303	0.0000000
zheyou73v0_A08	2165916	2169495	BnaA08T0025100ZY	0	+	0	0	3579	0.0000000
zheyou73v0_A08	2165916	2169495	BnaA08T0025100ZY.1	0	+	0	0	3579	0.0000000
zheyou73v0_A08	2171660	2174280	BnaA08T0025200ZY	0	+	0	0	2620	0.0000000
zheyou73v0_A08	2175031	2182281	BnaA08T0025300ZY	0	-	0	0	7250	0.0000000
zheyou73v0_A08	2175031	2182435	BnaA08T0025300ZY.1	0	-	0	0	7404	0.0000000
zheyou73v0_A08	2186563	2193458	BnaA08T0025400ZY	0	+	0	0	6895	0.0000000
zheyou73v0_A08	2196646	2200833	BnaA08T0025500ZY	0	-	0	0	4187	0.0000000
zheyou73v0_A08	2201459	2203045	BnaA08T0025600ZY	0	-	0	0	1586	0.0000000
zheyou73v0_A08	2201459	2202932	BnaA08T0025600ZY.1	0	-	0	0	1473	0.0000000
zheyou73v0_A08	2204176	2211933	BnaA08T0025700ZY.1	0	+	0	0	7757	0.0000000
zheyou73v0_A08	2204527	2212142	BnaA08T0025700ZY	0	+	0	0	7615	0.0000000
zheyou73v0_A08	2213773	2218057	BnaA08T0025800ZY	0	-	0	0	4284	0.0000000
zheyou73v0_A08	2231268	2234038	BnaA08T0025900ZY	0	-	0	0	2770	0.0000000
zheyou73v0_A08	2235583	2236694	BnaA08T0026000ZY	0	-	0	0	1111	0.0000000
zheyou73v0_A08	2246943	2247922	BnaA08T0026100ZY	0	+	0	0	979	0.0000000
zheyou73v0_A08	2251267	2255289	BnaA08T0026200ZY	0	+	0	0	4022	0.0000000
zheyou73v0_A08	2256034	2256389	BnaA08T0026300ZY	0	+	0	0	355	0.0000000
zheyou73v0_A08	2257339	2258834	BnaA08T0026400ZY	0	+	0	0	1495	0.0000000
zheyou73v0_A08	2258928	2261089	BnaA08T0026500ZY	0	-	0	0	2161	0.0000000
zheyou73v0_A08	2270794	2278597	BnaA08T0026600ZY	0	-	0	0	7803	0.0000000
zheyou73v0_A08	2279910	2281955	BnaA08T0026700ZY	0	+	0	0	2045	0.0000000
zheyou73v0_A08	2290081	2292736	BnaA08T0026800ZY	0	+	0	0	2655	0.0000000
zheyou73v0_A08	2292932	2295844	BnaA08T0026900ZY	0	-	0	0	2912	0.0000000
zheyou73v0_A08	2298843	2300487	BnaA08T0027000ZY	0	+	0	0	1644	0.0000000
zheyou73v0_A08	2298843	2300487	BnaA08T0027000ZY.1	0	+	0	0	1644	0.0000000
zheyou73v0_A08	2300149	2303202	BnaA08T0027100ZY	0	-	0	0	3053	0.0000000
zheyou73v0_A08	2304821	2306264	BnaA08T0027200ZY	0	+	0	0	1443	0.0000000
zheyou73v0_A08	2313384	2316623	BnaA08T0027300ZY	0	-	0	0	3239	0.0000000
zheyou73v0_A08	2329827	2331623	BnaA08T0027400ZY	0	-	0	0	1796	0.0000000
zheyou73v0_A08	2337341	2340554	BnaA08T0027500ZY	0	-	0	0	3213	0.0000000
zheyou73v0_A08	2361551	2362551	BnaA08T0027600ZY	0	+	0	0	1000	0.0000000
zheyou73v0_A08	2363039	2365030	BnaA08T0027700ZY	0	-	0	0	1991	0.0000000
zheyou73v0_A08	2370232	2371063	BnaA08T0027800ZY	0	-	0	0	831	0.0000000
zheyou73v0_A08	2372152	2375368	BnaA08T0027900ZY	0	-	0	0	3216	0.0000000
zheyou73v0_A08	2378115	2380834	BnaA08T0028000ZY	0	-	0	0	2719	0.0000000
zheyou73v0_A08	2381433	2383419	BnaA08T0028100ZY	0	-	0	0	1986	0.0000000
zheyou73v0_A08	2392826	2394149	BnaA08T0028200ZY	0	+	0	0	1323	0.0000000
zheyou73v0_A08	2394639	2396016	BnaA08T0028300ZY	0	-	0	0	1377	0.0000000
zheyou73v0_A08	2396895	2401053	BnaA08T0028400ZY	0	-	0	0	4158	0.0000000
zheyou73v0_A08	2440603	2442947	BnaA08T0028500ZY	0	-	0	0	2344	0.0000000
zheyou73v0_A08	2452576	2455309	BnaA08T0028600ZY	0	+	0	0	2733	0.0000000
zheyou73v0_A08	2452576	2455309	BnaA08T0028600ZY.1	0	+	0	0	2733	0.0000000
zheyou73v0_A08	2455390	2457739	BnaA08T0028700ZY	0	-	0	0	2349	0.0000000
zheyou73v0_A08	2459531	2462112	BnaA08T0028800ZY	0	-	0	0	2581	0.0000000
zheyou73v0_A08	2463293	2464565	BnaA08T0028900ZY	0	-	0	0	1272	0.0000000
zheyou73v0_A08	2476547	2476877	BnaA08T0029000ZY	0	-	0	0	330	0.0000000
zheyou73v0_A08	2490402	2491212	BnaA08T0029100ZY	0	+	0	0	810	0.0000000
zheyou73v0_A08	2491936	2495022	BnaA08T0029200ZY	0	-	0	0	3086	0.0000000
zheyou73v0_A08	2500602	2503368	BnaA08T0029300ZY	0	-	0	0	2766	0.0000000
zheyou73v0_A08	2519699	2520014	BnaA08T0029400ZY	0	-	0	0	315	0.0000000
zheyou73v0_A08	2521647	2526035	BnaA08T0029500ZY	0	+	0	0	4388	0.0000000
zheyou73v0_A08	2528647	2529858	BnaA08T0029600ZY	0	+	0	0	1211	0.0000000
zheyou73v0_A08	2571793	2572142	BnaA08T0029700ZY	0	+	0	0	349	0.0000000
zheyou73v0_A08	2579067	2581307	BnaA08T0029800ZY	0	+	0	0	2240	0.0000000
zheyou73v0_A08	2586653	2588587	BnaA08T0029900ZY	0	+	0	0	1934	0.0000000
zheyou73v0_A08	2588915	2590002	BnaA08T0030000ZY	0	-	0	0	1087	0.0000000
zheyou73v0_A08	2592989	2594133	BnaA08T0030100ZY	0	-	0	0	1144	0.0000000
zheyou73v0_A08	2597512	2599516	BnaA08T0030200ZY	0	-	0	0	2004	0.0000000
zheyou73v0_A08	2622575	2623980	BnaA08T0030300ZY	0	+	0	0	1405	0.0000000
zheyou73v0_A08	2629083	2630056	BnaA08T0030400ZY	0	+	0	0	973	0.0000000
zheyou73v0_A08	2633227	2634138	BnaA08T0030500ZY	0	+	0	0	911	0.0000000
zheyou73v0_A08	2633227	2634138	BnaA08T0030500ZY.1	0	+	0	0	911	0.0000000
zheyou73v0_A08	2634583	2635632	BnaA08T0030600ZY	0	-	0	0	1049	0.0000000
zheyou73v0_A08	2636097	2638400	BnaA08T0030700ZY	0	-	0	0	2303	0.0000000
zheyou73v0_A08	2643881	2644263	BnaA08T0030800ZY	0	+	0	0	382	0.0000000
zheyou73v0_A08	2652548	2652752	BnaA08T0030900ZY	0	-	0	0	204	0.0000000
zheyou73v0_A08	2657944	2659301	BnaA08T0031000ZY	0	-	0	0	1357	0.0000000
zheyou73v0_A08	2678406	2680008	BnaA08T0031100ZY	0	-	0	0	1602	0.0000000
zheyou73v0_A08	2678406	2680008	BnaA08T0031100ZY.1	0	-	0	0	1602	0.0000000
zheyou73v0_A08	2687961	2688357	BnaA08T0031200ZY	0	-	0	0	396	0.0000000
zheyou73v0_A08	2690828	2691784	BnaA08T0031300ZY	0	+	0	0	956	0.0000000
zheyou73v0_A08	2699014	2700391	BnaA08T0031400ZY	0	-	0	0	1377	0.0000000
zheyou73v0_A08	2701711	2703616	BnaA08T0031500ZY	0	+	0	0	1905	0.0000000
zheyou73v0_A08	2714790	2715471	BnaA08T0031600ZY	0	-	0	0	681	0.0000000
zheyou73v0_A08	2717511	2718378	BnaA08T0031700ZY	0	-	0	0	867	0.0000000
zheyou73v0_A08	2739101	2741011	BnaA08T0031800ZY	0	-	0	0	1910	0.0000000
zheyou73v0_A08	2753676	2755858	BnaA08T0031900ZY	0	+	0	0	2182	0.0000000
zheyou73v0_A08	2753676	2755858	BnaA08T0031900ZY.1	0	+	0	0	2182	0.0000000
zheyou73v0_A08	2753676	2755858	BnaA08T0031900ZY.2	0	+	0	0	2182	0.0000000
zheyou73v0_A08	2753676	2755858	BnaA08T0031900ZY.3	0	+	0	0	2182	0.0000000
zheyou73v0_A08	2753676	2755858	BnaA08T0031900ZY.4	0	+	0	0	2182	0.0000000
zheyou73v0_A08	2759724	2775042	BnaA08T0032000ZY	0	+	0	0	15318	0.0000000
zheyou73v0_A08	2780892	2781884	BnaA08T0032100ZY	0	-	0	0	992	0.0000000
zheyou73v0_A08	2782714	2782906	BnaA08T0032200ZY	0	+	0	0	192	0.0000000
zheyou73v0_A08	2831973	2832798	BnaA08T0032300ZY	0	+	0	0	825	0.0000000
zheyou73v0_A08	2833282	2834150	BnaA08T0032400ZY	0	+	0	0	868	0.0000000
zheyou73v0_A08	2840072	2843122	BnaA08T0032500ZY	0	+	0	0	3050	0.0000000
zheyou73v0_A08	2840072	2843122	BnaA08T0032500ZY.1	0	+	0	0	3050	0.0000000
zheyou73v0_A08	2843439	2844406	BnaA08T0032600ZY	0	-	0	0	967	0.0000000
zheyou73v0_A08	2846234	2849426	BnaA08T0032700ZY	0	-	0	0	3192	0.0000000
zheyou73v0_A08	2851566	2852382	BnaA08T0032800ZY	0	+	0	0	816	0.0000000
zheyou73v0_A08	2853234	2864813	BnaA08T0032900ZY	0	-	0	0	11579	0.0000000
zheyou73v0_A08	2876391	2876727	BnaA08T0033000ZY	0	+	0	0	336	0.0000000
zheyou73v0_A08	2881947	2884718	BnaA08T0033100ZY	0	+	0	0	2771	0.0000000
zheyou73v0_A08	2885075	2887297	BnaA08T0033200ZY	0	-	0	0	2222	0.0000000
zheyou73v0_A08	2907306	2907958	BnaA08T0033300ZY	0	+	0	0	652	0.0000000
zheyou73v0_A08	2923641	2926370	BnaA08T0033400ZY	0	+	0	0	2729	0.0000000
zheyou73v0_A08	2943479	2946618	BnaA08T0033500ZY	0	+	0	0	3139	0.0000000
zheyou73v0_A08	2943479	2946618	BnaA08T0033500ZY.1	0	+	0	0	3139	0.0000000
zheyou73v0_A08	2947381	2948216	BnaA08T0033600ZY	0	-	0	0	835	0.0000000
zheyou73v0_A08	2961086	2961380	BnaA08T0033700ZY	0	-	0	0	294	0.0000000
zheyou73v0_A08	2963780	2971413	BnaA08T0033800ZY	0	-	0	0	7633	0.0000000
zheyou73v0_A08	2981738	2982125	BnaA08T0033900ZY	0	-	0	0	387	0.0000000
zheyou73v0_A08	2983808	2985051	BnaA08T0034000ZY	0	+	0	0	1243	0.0000000
zheyou73v0_A08	2999696	3001846	BnaA08T0034100ZY	0	-	0	0	2150	0.0000000
zheyou73v0_A08	3010712	3011518	BnaA08T0034200ZY	0	+	0	0	806	0.0000000
zheyou73v0_A08	3012841	3013961	BnaA08T0034300ZY	0	-	0	0	1120	0.0000000
zheyou73v0_A08	3018889	3019525	BnaA08T0034400ZY	0	-	0	0	636	0.0000000
zheyou73v0_A08	3030492	3031600	BnaA08T0034500ZY	0	+	0	0	1108	0.0000000
zheyou73v0_A08	3037556	3039356	BnaA08T0034600ZY	0	+	0	0	1800	0.0000000
zheyou73v0_A08	3057362	3058806	BnaA08T0034700ZY	0	-	0	0	1444	0.0000000
zheyou73v0_A08	3069523	3070453	BnaA08T0034800ZY	0	-	0	0	930	0.0000000
zheyou73v0_A08	3069523	3070453	BnaA08T0034800ZY.1	0	-	0	0	930	0.0000000
zheyou73v0_A08	3070017	3070329	BnaA08T0034900ZY	0	+	0	0	312	0.0000000
zheyou73v0_A08	3075825	3077898	BnaA08T0035000ZY	0	-	0	0	2073	0.0000000
zheyou73v0_A08	3079378	3079648	BnaA08T0035100ZY	0	-	0	0	270	0.0000000
zheyou73v0_A08	3080543	3094447	BnaA08T0035200ZY	0	-	0	0	13904	0.0000000
zheyou73v0_A08	3109295	3110327	BnaA08T0035300ZY	0	-	0	0	1032	0.0000000
zheyou73v0_A08	3123403	3130164	BnaA08T0035400ZY	0	+	0	0	6761	0.0000000
zheyou73v0_A08	3123403	3127619	BnaA08T0035400ZY.1	0	+	0	0	4216	0.0000000
zheyou73v0_A08	3131944	3134490	BnaA08T0035500ZY	0	-	0	0	2546	0.0000000
zheyou73v0_A08	3144086	3145470	BnaA08T0035600ZY	0	-	0	0	1384	0.0000000
zheyou73v0_A08	3145768	3146694	BnaA08T0035700ZY	0	-	0	0	926	0.0000000
zheyou73v0_A08	3162785	3163993	BnaA08T0035800ZY	0	-	0	0	1208	0.0000000
zheyou73v0_A08	3164383	3168020	BnaA08T0035900ZY	0	+	0	0	3637	0.0000000
zheyou73v0_A08	3177371	3183014	BnaA08T0036000ZY	0	+	0	0	5643	0.0000000
zheyou73v0_A08	3186230	3186829	BnaA08T0036100ZY	0	-	0	0	599	0.0000000
zheyou73v0_A08	3235895	3236871	BnaA08T0036200ZY	0	+	0	0	976	0.0000000
zheyou73v0_A08	3238506	3240046	BnaA08T0036300ZY	0	+	0	0	1540	0.0000000
zheyou73v0_A08	3240676	3243380	BnaA08T0036400ZY	0	-	0	0	2704	0.0000000
zheyou73v0_A08	3243972	3248196	BnaA08T0036500ZY	0	-	0	0	4224	0.0000000
zheyou73v0_A08	3248537	3249485	BnaA08T0036600ZY	0	-	0	0	948	0.0000000
zheyou73v0_A08	3252196	3252747	BnaA08T0036700ZY	0	-	0	0	551	0.0000000
zheyou73v0_A08	3287285	3287575	BnaA08T0036800ZY	0	+	0	0	290	0.0000000
zheyou73v0_A08	3297113	3298015	BnaA08T0036900ZY	0	+	0	0	902	0.0000000
zheyou73v0_A08	3299698	3299952	BnaA08T0037000ZY	0	+	0	0	254	0.0000000
zheyou73v0_A08	3301818	3302619	BnaA08T0037100ZY	0	-	0	0	801	0.0000000
zheyou73v0_A08	3304455	3305936	BnaA08T0037200ZY	0	-	0	0	1481	0.0000000
zheyou73v0_A08	3327375	3331758	BnaA08T0037300ZY	0	+	0	0	4383	0.0000000
zheyou73v0_A08	3331842	3333172	BnaA08T0037400ZY	0	-	0	0	1330	0.0000000
zheyou73v0_A08	3338247	3339142	BnaA08T0037500ZY	0	+	0	0	895	0.0000000
zheyou73v0_A08	3345466	3346191	BnaA08T0037600ZY	0	-	0	0	725	0.0000000
zheyou73v0_A08	3346792	3347932	BnaA08T0037700ZY	0	+	0	0	1140	0.0000000
zheyou73v0_A08	3352803	3354029	BnaA08T0037800ZY	0	-	0	0	1226	0.0000000
zheyou73v0_A08	3354473	3355581	BnaA08T0037900ZY	0	-	0	0	1108	0.0000000
zheyou73v0_A08	3356656	3357568	BnaA08T0038000ZY	0	+	0	0	912	0.0000000
zheyou73v0_A08	3358107	3360181	BnaA08T0038100ZY	0	-	0	0	2074	0.0000000
zheyou73v0_A08	3366403	3366961	BnaA08T0038200ZY	0	-	0	0	558	0.0000000
zheyou73v0_A08	3368857	3369402	BnaA08T0038300ZY	0	+	0	0	545	0.0000000
zheyou73v0_A08	3374194	3378102	BnaA08T0038400ZY	0	-	0	0	3908	0.0000000
zheyou73v0_A08	3379616	3381233	BnaA08T0038500ZY	0	+	0	0	1617	0.0000000
zheyou73v0_A08	3384543	3386718	BnaA08T0038600ZY	0	-	0	0	2175	0.0000000
zheyou73v0_A08	3406920	3407466	BnaA08T0038700ZY	0	+	0	0	546	0.0000000
zheyou73v0_A08	3408967	3409813	BnaA08T0038800ZY	0	+	0	0	846	0.0000000
zheyou73v0_A08	3409866	3411778	BnaA08T0038900ZY	0	+	0	0	1912	0.0000000
zheyou73v0_A08	3412225	3416843	BnaA08T0039000ZY	0	-	0	0	4618	0.0000000
zheyou73v0_A08	3418947	3420433	BnaA08T0039100ZY	0	-	0	0	1486	0.0000000
zheyou73v0_A08	3421067	3422785	BnaA08T0039200ZY	0	-	0	0	1718	0.0000000
zheyou73v0_A08	3421067	3422785	BnaA08T0039200ZY.1	0	-	0	0	1718	0.0000000
zheyou73v0_A08	3423343	3424307	BnaA08T0039300ZY	0	+	0	0	964	0.0000000
zheyou73v0_A08	3427442	3429245	BnaA08T0039400ZY	0	+	0	0	1803	0.0000000
zheyou73v0_A08	3468599	3492594	BnaA08T0039500ZY	0	+	0	0	23995	0.0000000
zheyou73v0_A08	3542928	3546103	BnaA08T0039600ZY	0	-	0	0	3175	0.0000000
zheyou73v0_A08	3552707	3553426	BnaA08T0039700ZY	0	-	0	0	719	0.0000000
zheyou73v0_A08	3578695	3582912	BnaA08T0039800ZY	0	+	0	0	4217	0.0000000
zheyou73v0_A08	3578695	3582912	BnaA08T0039800ZY.1	0	+	0	0	4217	0.0000000
zheyou73v0_A08	3586641	3589222	BnaA08T0039900ZY.1	0	-	0	0	2581	0.0000000
zheyou73v0_A08	3586865	3589222	BnaA08T0039900ZY	0	-	0	0	2357	0.0000000
zheyou73v0_A08	3599070	3601637	BnaA08T0040000ZY	0	+	0	0	2567	0.0000000
zheyou73v0_A08	3609508	3611128	BnaA08T0040100ZY	0	+	0	0	1620	0.0000000
zheyou73v0_A08	3631589	3632312	BnaA08T0040200ZY	0	+	0	0	723	0.0000000
zheyou73v0_A08	3631614	3634877	BnaA08T0040300ZY	0	-	0	0	3263	0.0000000
zheyou73v0_A08	3631614	3634877	BnaA08T0040300ZY.1	0	-	0	0	3263	0.0000000
zheyou73v0_A08	3640594	3641837	BnaA08T0040400ZY	0	-	0	0	1243	0.0000000
zheyou73v0_A08	3651397	3653064	BnaA08T0040500ZY	0	+	0	0	1667	0.0000000
zheyou73v0_A08	3657713	3660896	BnaA08T0040600ZY	0	+	0	0	3183	0.0000000
zheyou73v0_A08	3661089	3661425	BnaA08T0040700ZY	0	-	0	0	336	0.0000000
zheyou73v0_A08	3661432	3662200	BnaA08T0040800ZY	0	-	0	0	768	0.0000000
zheyou73v0_A08	3665427	3668215	BnaA08T0040900ZY	0	+	0	0	2788	0.0000000
zheyou73v0_A08	3671800	3672615	BnaA08T0041000ZY	0	-	0	0	815	0.0000000
zheyou73v0_A08	3682683	3685156	BnaA08T0041100ZY	0	-	0	0	2473	0.0000000
zheyou73v0_A08	3686775	3688437	BnaA08T0041200ZY	0	+	0	0	1662	0.0000000
zheyou73v0_A08	3697168	3697456	BnaA08T0041300ZY	0	+	0	0	288	0.0000000
zheyou73v0_A08	3706883	3707394	BnaA08T0041400ZY	0	+	0	0	511	0.0000000
zheyou73v0_A08	3710312	3710945	BnaA08T0041500ZY	0	-	0	0	633	0.0000000
zheyou73v0_A08	3742524	3744296	BnaA08T0041600ZY	0	-	0	0	1772	0.0000000
zheyou73v0_A08	3747516	3747883	BnaA08T0041700ZY	0	-	0	0	367	0.0000000
zheyou73v0_A08	3753486	3755225	BnaA08T0041800ZY	0	+	0	0	1739	0.0000000
zheyou73v0_A08	3769519	3774265	BnaA08T0041900ZY	0	-	0	0	4746	0.0000000
zheyou73v0_A08	3820398	3823453	BnaA08T0042000ZY	0	+	0	0	3055	0.0000000
zheyou73v0_A08	3829294	3830181	BnaA08T0042100ZY	0	+	0	0	887	0.0000000
zheyou73v0_A08	3830271	3830688	BnaA08T0042200ZY	0	+	0	0	417	0.0000000
zheyou73v0_A08	3831429	3835588	BnaA08T0042300ZY	0	-	0	0	4159	0.0000000
zheyou73v0_A08	3848493	3850571	BnaA08T0042400ZY	0	+	0	0	2078	0.0000000
zheyou73v0_A08	3854681	3855127	BnaA08T0042500ZY	0	+	0	0	446	0.0000000
zheyou73v0_A08	3855259	3856493	BnaA08T0042600ZY	0	-	0	0	1234	0.0000000
zheyou73v0_A08	3862201	3864631	BnaA08T0042700ZY	0	-	0	0	2430	0.0000000
zheyou73v0_A08	3869969	3871795	BnaA08T0042800ZY	0	-	0	0	1826	0.0000000
zheyou73v0_A08	3879243	3879669	BnaA08T0042900ZY	0	+	0	0	426	0.0000000
zheyou73v0_A08	3879791	3882429	BnaA08T0043000ZY	0	+	0	0	2638	0.0000000
zheyou73v0_A08	3883760	3885140	BnaA08T0043100ZY	0	-	0	0	1380	0.0000000
zheyou73v0_A08	3888185	3889782	BnaA08T0043200ZY	0	+	0	0	1597	0.0000000
zheyou73v0_A08	3897531	3897879	BnaA08T0043300ZY	0	+	0	0	348	0.0000000
zheyou73v0_A08	3900700	3902192	BnaA08T0043400ZY	0	+	0	0	1492	0.0000000
zheyou73v0_A08	3902693	3904743	BnaA08T0043500ZY	0	-	0	0	2050	0.0000000
zheyou73v0_A08	3935217	3937539	BnaA08T0043600ZY	0	+	0	0	2322	0.0000000
zheyou73v0_A08	3937503	3939124	BnaA08T0043700ZY	0	-	0	0	1621	0.0000000
zheyou73v0_A08	3946821	3947722	BnaA08T0043800ZY	0	+	0	0	901	0.0000000
zheyou73v0_A08	3948551	3950666	BnaA08T0043900ZY	0	-	0	0	2115	0.0000000
zheyou73v0_A08	3963801	3964170	BnaA08T0044000ZY	0	+	0	0	369	0.0000000
zheyou73v0_A08	3967290	3968960	BnaA08T0044100ZY	0	+	0	0	1670	0.0000000
zheyou73v0_A08	3975646	3976019	BnaA08T0044200ZY	0	-	0	0	373	0.0000000
zheyou73v0_A08	3977859	3979580	BnaA08T0044300ZY	0	-	0	0	1721	0.0000000
zheyou73v0_A08	4000478	4003671	BnaA08T0044400ZY	0	+	0	0	3193	0.0000000
zheyou73v0_A08	4009267	4010067	BnaA08T0044500ZY	0	+	0	0	800	0.0000000
zheyou73v0_A08	4049646	4050953	BnaA08T0044600ZY	0	+	0	0	1307	0.0000000
zheyou73v0_A08	4081719	4082866	BnaA08T0044700ZY	0	-	0	0	1147	0.0000000
zheyou73v0_A08	4103835	4105458	BnaA08T0044800ZY	0	-	0	0	1623	0.0000000
zheyou73v0_A08	4103835	4105061	BnaA08T0044800ZY.1	0	-	0	0	1226	0.0000000
zheyou73v0_A08	4105567	4106429	BnaA08T0044900ZY	0	-	0	0	862	0.0000000
zheyou73v0_A08	4110233	4111328	BnaA08T0045000ZY	0	-	0	0	1095	0.0000000
zheyou73v0_A08	4120694	4120985	BnaA08T0045100ZY	0	-	0	0	291	0.0000000
zheyou73v0_A08	4123470	4125388	BnaA08T0045200ZY	0	-	0	0	1918	0.0000000
zheyou73v0_A08	4133621	4133837	BnaA08T0045300ZY	0	-	0	0	216	0.0000000
zheyou73v0_A08	4154817	4157150	BnaA08T0045400ZY	0	+	0	0	2333	0.0000000
zheyou73v0_A08	4156938	4158653	BnaA08T0045500ZY	0	-	0	0	1715	0.0000000
zheyou73v0_A08	4157657	4158653	BnaA08T0045500ZY.1	0	-	0	0	996	0.0000000
zheyou73v0_A08	4162972	4164475	BnaA08T0045600ZY	0	+	0	0	1503	0.0000000
zheyou73v0_A08	4187307	4190244	BnaA08T0045700ZY	0	+	0	0	2937	0.0000000
zheyou73v0_A08	4208569	4213418	BnaA08T0045800ZY	0	-	0	0	4849	0.0000000
zheyou73v0_A08	4208569	4213418	BnaA08T0045800ZY.1	0	-	0	0	4849	0.0000000
zheyou73v0_A08	4235374	4239326	BnaA08T0045900ZY	0	-	0	0	3952	0.0000000
zheyou73v0_A08	4235374	4239375	BnaA08T0045900ZY.1	0	-	0	0	4001	0.0000000
zheyou73v0_A08	4235374	4239375	BnaA08T0045900ZY.2	0	-	0	0	4001	0.0000000
zheyou73v0_A08	4245987	4247108	BnaA08T0046000ZY	0	+	0	0	1121	0.0000000
zheyou73v0_A08	4254216	4259864	BnaA08T0046100ZY	0	+	0	0	5648	0.0000000
zheyou73v0_A08	4281108	4285385	BnaA08T0046200ZY	0	+	0	0	4277	0.0000000
zheyou73v0_A08	4281108	4285385	BnaA08T0046200ZY.1	0	+	0	0	4277	0.0000000
zheyou73v0_A08	4292556	4299189	BnaA08T0046300ZY	0	-	0	0	6633	0.0000000
zheyou73v0_A08	4310589	4311038	BnaA08T0046400ZY	0	+	0	0	449	0.0000000
zheyou73v0_A08	4311151	4315295	BnaA08T0046500ZY	0	-	0	0	4144	0.0000000
zheyou73v0_A08	4323296	4323825	BnaA08T0046600ZY	0	-	0	0	529	0.0000000
zheyou73v0_A08	4326602	4343275	BnaA08T0046700ZY	0	-	0	0	16673	0.0000000
zheyou73v0_A08	4326602	4343275	BnaA08T0046700ZY.2	0	-	0	0	16673	0.0000000
zheyou73v0_A08	4326602	4341933	BnaA08T0046700ZY.3	0	-	0	0	15331	0.0000000
zheyou73v0_A08	4331059	4342853	BnaA08T0046700ZY.1	0	-	0	0	11794	0.0000000
zheyou73v0_A08	4343945	4346098	BnaA08T0046800ZY	0	+	0	0	2153	0.0000000
zheyou73v0_A08	4343945	4346104	BnaA08T0046800ZY.1	0	+	0	0	2159	0.0000000
zheyou73v0_A08	4343945	4346098	BnaA08T0046800ZY.2	0	+	0	0	2153	0.0000000
zheyou73v0_A08	4351699	4356080	BnaA08T0046900ZY	0	-	0	0	4381	0.0000000
zheyou73v0_A08	4362970	4364984	BnaA08T0047000ZY	0	-	0	0	2014	0.0000000
zheyou73v0_A08	4380046	4386510	BnaA08T0047100ZY	0	+	0	0	6464	0.0000000
zheyou73v0_A08	4418789	4422216	BnaA08T0047200ZY	0	+	0	0	3427	0.0000000
zheyou73v0_A08	4456899	4457335	BnaA08T0047300ZY	0	+	0	0	436	0.0000000
zheyou73v0_A08	4458791	4460326	BnaA08T0047400ZY	0	+	0	0	1535	0.0000000
zheyou73v0_A08	4490898	4492420	BnaA08T0047500ZY	0	-	0	0	1522	0.0000000
zheyou73v0_A08	4500044	4501785	BnaA08T0047600ZY	0	+	0	0	1741	0.0000000
zheyou73v0_A08	4524813	4527892	BnaA08T0047700ZY	0	+	0	0	3079	0.0000000
zheyou73v0_A08	4525136	4527892	BnaA08T0047700ZY.1	0	+	0	0	2756	0.0000000
zheyou73v0_A08	4551399	4554227	BnaA08T0047800ZY	0	+	0	0	2828	0.0000000
zheyou73v0_A08	4572478	4574653	BnaA08T0047900ZY	0	+	0	0	2175	0.0000000
zheyou73v0_A08	4586707	4593317	BnaA08T0048000ZY	0	-	0	0	6610	0.0000000
zheyou73v0_A08	4601460	4612058	BnaA08T0048100ZY	0	+	0	0	10598	0.0000000
zheyou73v0_A08	4614036	4615982	BnaA08T0048200ZY	0	-	0	0	1946	0.0000000
zheyou73v0_A08	4614036	4615650	BnaA08T0048200ZY.1	0	-	0	0	1614	0.0000000
zheyou73v0_A08	4635421	4635733	BnaA08T0048300ZY	0	+	0	0	312	0.0000000
zheyou73v0_A08	4642252	4644063	BnaA08T0048400ZY	0	-	0	0	1811	0.0000000
zheyou73v0_A08	4646625	4649142	BnaA08T0048500ZY	0	-	0	0	2517	0.0000000
zheyou73v0_A08	4657322	4658465	BnaA08T0048600ZY	0	-	0	0	1143	0.0000000
zheyou73v0_A08	4661577	4661793	BnaA08T0048700ZY	0	-	0	0	216	0.0000000
zheyou73v0_A08	4678628	4679194	BnaA08T0048800ZY	0	-	0	0	566	0.0000000
zheyou73v0_A08	4682526	4690430	BnaA08T0048900ZY	0	-	0	0	7904	0.0000000
zheyou73v0_A08	4691899	4694139	BnaA08T0049000ZY	0	+	0	0	2240	0.0000000
zheyou73v0_A08	4724831	4727613	BnaA08T0049100ZY.1	0	+	0	0	2782	0.0000000
zheyou73v0_A08	4725105	4727263	BnaA08T0049100ZY	0	+	0	0	2158	0.0000000
zheyou73v0_A08	4725105	4727613	BnaA08T0049100ZY.2	0	+	0	0	2508	0.0000000
zheyou73v0_A08	4745505	4746358	BnaA08T0049200ZY	0	+	0	0	853	0.0000000
zheyou73v0_A08	4750198	4752342	BnaA08T0049300ZY	0	-	0	0	2144	0.0000000
zheyou73v0_A08	4770422	4772535	BnaA08T0049400ZY	0	+	0	0	2113	0.0000000
zheyou73v0_A08	4786857	4819374	BnaA08T0049500ZY	0	-	0	0	32517	0.0000000
zheyou73v0_A08	4818127	4819374	BnaA08T0049500ZY.1	0	-	0	0	1247	0.0000000
zheyou73v0_A08	4830591	4832935	BnaA08T0049600ZY	0	-	0	0	2344	0.0000000
zheyou73v0_A08	4833701	4834671	BnaA08T0049700ZY	0	-	0	0	970	0.0000000
zheyou73v0_A08	4836692	4837871	BnaA08T0049800ZY	0	+	0	0	1179	0.0000000
zheyou73v0_A08	4850232	4852033	BnaA08T0049900ZY	0	-	0	0	1801	0.0000000
zheyou73v0_A08	4862632	4863498	BnaA08T0050000ZY	0	-	0	0	866	0.0000000
zheyou73v0_A08	4880411	4884623	BnaA08T0050100ZY	0	+	0	0	4212	0.0000000
zheyou73v0_A08	4888906	4901589	BnaA08T0050200ZY	0	-	0	0	12683	0.0000000
zheyou73v0_A08	4914784	4915666	BnaA08T0050300ZY	0	-	0	0	882	0.0000000
zheyou73v0_A08	4919341	4922336	BnaA08T0050400ZY	0	-	0	0	2995	0.0000000
zheyou73v0_A08	4942065	4949051	BnaA08T0050500ZY	0	+	0	0	6986	0.0000000
zheyou73v0_A08	4942065	4945853	BnaA08T0050500ZY.1	0	+	0	0	3788	0.0000000
zheyou73v0_A08	4957872	4958910	BnaA08T0050600ZY	0	-	0	0	1038	0.0000000
zheyou73v0_A08	4965767	4966094	BnaA08T0050700ZY	0	+	0	0	327	0.0000000
zheyou73v0_A08	4968188	4968458	BnaA08T0050800ZY	0	-	0	0	270	0.0000000
zheyou73v0_A08	4977646	4977985	BnaA08T0050900ZY	0	+	0	0	339	0.0000000
zheyou73v0_A08	4982520	4983468	BnaA08T0051000ZY	0	+	0	0	948	0.0000000
zheyou73v0_A08	5030662	5031397	BnaA08T0051100ZY	0	+	0	0	735	0.0000000
zheyou73v0_A08	5030820	5033793	BnaA08T0051200ZY	0	-	0	0	2973	0.0000000
zheyou73v0_A08	5030820	5033793	BnaA08T0051200ZY.1	0	-	0	0	2973	0.0000000
zheyou73v0_A08	5040656	5041819	BnaA08T0051300ZY	0	+	0	0	1163	0.0000000
zheyou73v0_A08	5054795	5055056	BnaA08T0051400ZY	0	+	0	0	261	0.0000000
zheyou73v0_A08	5064135	5065215	BnaA08T0051500ZY	0	+	0	0	1080	0.0000000
zheyou73v0_A08	5081971	5085566	BnaA08T0051600ZY.1	0	+	0	0	3595	0.0000000
zheyou73v0_A08	5081971	5085566	BnaA08T0051600ZY.2	0	+	0	0	3595	0.0000000
zheyou73v0_A08	5081982	5085566	BnaA08T0051600ZY	0	+	0	0	3584	0.0000000
zheyou73v0_A08	5100626	5102664	BnaA08T0051700ZY	0	-	0	0	2038	0.0000000
zheyou73v0_A08	5107447	5115715	BnaA08T0051800ZY	0	+	0	0	8268	0.0000000
zheyou73v0_A08	5116669	5117626	BnaA08T0051900ZY	0	+	0	0	957	0.0000000
zheyou73v0_A08	5159797	5165391	BnaA08T0052000ZY	0	+	0	0	5594	0.0000000
zheyou73v0_A08	5220556	5220850	BnaA08T0052100ZY	0	-	0	0	294	0.0000000
zheyou73v0_A08	5221201	5223679	BnaA08T0052200ZY	0	+	0	0	2478	0.0000000
zheyou73v0_A08	5231573	5234793	BnaA08T0052300ZY	0	+	0	0	3220	0.0000000
zheyou73v0_A08	5247059	5249337	BnaA08T0052400ZY	0	-	0	0	2278	0.0000000
zheyou73v0_A08	5250662	5250917	BnaA08T0052500ZY	0	-	0	0	255	0.0000000
zheyou73v0_A08	5281465	5281802	BnaA08T0052600ZY	0	+	0	0	337	0.0000000
zheyou73v0_A08	5302071	5303178	BnaA08T0052700ZY	0	-	0	0	1107	0.0000000
zheyou73v0_A08	5304815	5305482	BnaA08T0052800ZY	0	+	0	0	667	0.0000000
zheyou73v0_A08	5314997	5317466	BnaA08T0052900ZY	0	+	0	0	2469	0.0000000
zheyou73v0_A08	5335498	5335995	BnaA08T0053000ZY	0	+	0	0	497	0.0000000
zheyou73v0_A08	5350084	5351127	BnaA08T0053100ZY	0	+	0	0	1043	0.0000000
zheyou73v0_A08	5352566	5353207	BnaA08T0053200ZY	0	+	0	0	641	0.0000000
zheyou73v0_A08	5356151	5358116	BnaA08T0053300ZY	0	-	0	0	1965	0.0000000
zheyou73v0_A08	5384101	5384674	BnaA08T0053400ZY	0	-	0	0	573	0.0000000
zheyou73v0_A08	5420606	5434513	BnaA08T0053500ZY	0	-	0	0	13907	0.0000000
zheyou73v0_A08	5439955	5440330	BnaA08T0053600ZY	0	+	0	0	375	0.0000000
zheyou73v0_A08	5455731	5458396	BnaA08T0053700ZY	0	+	0	0	2665	0.0000000
zheyou73v0_A08	5461626	5462364	BnaA08T0053800ZY	0	+	0	0	738	0.0000000
zheyou73v0_A08	5463184	5465053	BnaA08T0053900ZY	0	+	0	0	1869	0.0000000
zheyou73v0_A08	5465292	5466350	BnaA08T0054000ZY	0	-	0	0	1058	0.0000000
zheyou73v0_A08	5473675	5476195	BnaA08T0054100ZY	0	-	0	0	2520	0.0000000
zheyou73v0_A08	5486539	5488153	BnaA08T0054200ZY	0	-	0	0	1614	0.0000000
zheyou73v0_A08	5505961	5507740	BnaA08T0054300ZY	0	+	0	0	1779	0.0000000
zheyou73v0_A08	5505961	5507740	BnaA08T0054300ZY.1	0	+	0	0	1779	0.0000000
zheyou73v0_A08	5525506	5526339	BnaA08T0054400ZY	0	+	0	0	833	0.0000000
zheyou73v0_A08	5525506	5526955	BnaA08T0054400ZY.1	0	+	0	0	1449	0.0000000
zheyou73v0_A08	5549827	5550058	BnaA08T0054500ZY	0	+	0	0	231	0.0000000
zheyou73v0_A08	5601430	5603217	BnaA08T0054600ZY	0	-	0	0	1787	0.0000000
zheyou73v0_A08	5619029	5619338	BnaA08T0054700ZY	0	+	0	0	309	0.0000000
zheyou73v0_A08	5621862	5622653	BnaA08T0054800ZY	0	+	0	0	791	0.0000000
zheyou73v0_A08	5646485	5647321	BnaA08T0054900ZY	0	+	0	0	836	0.0000000
zheyou73v0_A08	5650911	5664040	BnaA08T0055000ZY	0	+	0	0	13129	0.0000000
zheyou73v0_A08	5665056	5668464	BnaA08T0055100ZY	0	-	0	0	3408	0.0000000
zheyou73v0_A08	5685758	5687646	BnaA08T0055200ZY	0	+	0	0	1888	0.0000000
zheyou73v0_A08	5690586	5692021	BnaA08T0055300ZY	0	-	0	0	1435	0.0000000
zheyou73v0_A08	5696954	5698195	BnaA08T0055400ZY	0	-	0	0	1241	0.0000000
zheyou73v0_A08	5705726	5712143	BnaA08T0055500ZY	0	+	0	0	6417	0.0000000
zheyou73v0_A08	5744284	5746119	BnaA08T0055600ZY	0	+	0	0	1835	0.0000000
zheyou73v0_A08	5744284	5746119	BnaA08T0055600ZY.1	0	+	0	0	1835	0.0000000
zheyou73v0_A08	5746367	5747634	BnaA08T0055700ZY	0	+	0	0	1267	0.0000000
zheyou73v0_A08	5761780	5764653	BnaA08T0055800ZY	0	-	0	0	2873	0.0000000
zheyou73v0_A08	5781520	5782785	BnaA08T0055900ZY	0	+	0	0	1265	0.0000000
zheyou73v0_A08	5782659	5785075	BnaA08T0056000ZY	0	-	0	0	2416	0.0000000
zheyou73v0_A08	5847194	5849771	BnaA08T0056100ZY	0	+	0	0	2577	0.0000000
zheyou73v0_A08	5852746	5854817	BnaA08T0056200ZY	0	-	0	0	2071	0.0000000
zheyou73v0_A08	5955958	5957754	BnaA08T0056300ZY	0	+	0	0	1796	0.0000000
zheyou73v0_A08	5965483	5966856	BnaA08T0056400ZY	0	+	0	0	1373	0.0000000
zheyou73v0_A08	5971985	5972430	BnaA08T0056500ZY	0	+	0	0	445	0.0000000
zheyou73v0_A08	5981676	5984679	BnaA08T0056600ZY	0	-	0	0	3003	0.0000000
zheyou73v0_A08	5984885	5986211	BnaA08T0056700ZY	0	-	0	0	1326	0.0000000
zheyou73v0_A08	5988438	5991275	BnaA08T0056800ZY	0	-	0	0	2837	0.0000000
zheyou73v0_A08	5991511	5995226	BnaA08T0056900ZY	0	-	0	0	3715	0.0000000
zheyou73v0_A08	5991511	5995226	BnaA08T0056900ZY.1	0	-	0	0	3715	0.0000000
zheyou73v0_A08	5991511	5995226	BnaA08T0056900ZY.2	0	-	0	0	3715	0.0000000
zheyou73v0_A08	5991511	5995226	BnaA08T0056900ZY.3	0	-	0	0	3715	0.0000000
zheyou73v0_A08	5991511	5995226	BnaA08T0056900ZY.4	0	-	0	0	3715	0.0000000
zheyou73v0_A08	5996602	6019564	BnaA08T0057000ZY	0	+	0	0	22962	0.0000000
zheyou73v0_A08	6036652	6038616	BnaA08T0057100ZY	0	-	0	0	1964	0.0000000
zheyou73v0_A08	6036652	6038616	BnaA08T0057100ZY.1	0	-	0	0	1964	0.0000000
zheyou73v0_A08	6045923	6050738	BnaA08T0057200ZY	0	+	0	0	4815	0.0000000
zheyou73v0_A08	6096993	6098645	BnaA08T0057300ZY	0	-	0	0	1652	0.0000000
zheyou73v0_A08	6128793	6135657	BnaA08T0057400ZY	0	-	0	0	6864	0.0000000
zheyou73v0_A08	6128793	6135657	BnaA08T0057400ZY.1	0	-	0	0	6864	0.0000000
zheyou73v0_A08	6463119	6463806	BnaA08T0057500ZY	0	-	0	0	687	0.0000000
zheyou73v0_A08	6468472	6471120	BnaA08T0057600ZY	0	+	0	0	2648	0.0000000
zheyou73v0_A08	6717055	6717599	BnaA08T0057700ZY	0	+	0	0	544	0.0000000
zheyou73v0_A08	6718071	6724935	BnaA08T0057800ZY	0	-	0	0	6864	0.0000000
zheyou73v0_A08	6725270	6725552	BnaA08T0057900ZY	0	+	0	0	282	0.0000000
zheyou73v0_A08	6725570	6727082	BnaA08T0058000ZY	0	+	0	0	1512	0.0000000
zheyou73v0_A08	6727477	6727960	BnaA08T0058100ZY	0	+	0	0	483	0.0000000
zheyou73v0_A08	6728112	6728601	BnaA08T0058200ZY	0	+	0	0	489	0.0000000
zheyou73v0_A08	6730014	6730263	BnaA08T0058300ZY	0	+	0	0	249	0.0000000
zheyou73v0_A08	6730378	6730747	BnaA08T0058400ZY	0	+	0	0	369	0.0000000
zheyou73v0_A08	6732078	6732495	BnaA08T0058500ZY	0	+	0	0	417	0.0000000
zheyou73v0_A08	6732564	6733548	BnaA08T0058600ZY	0	+	0	0	984	0.0000000
zheyou73v0_A08	6736722	6736944	BnaA08T0058700ZY	0	-	0	0	222	0.0000000
zheyou73v0_A08	6737545	6739380	BnaA08T0058800ZY	0	-	0	0	1835	0.0000000
zheyou73v0_A08	6739562	6740355	BnaA08T0058900ZY	0	+	0	0	793	0.0000000
zheyou73v0_A08	6741225	6741660	BnaA08T0059000ZY	0	+	0	0	435	0.0000000
zheyou73v0_A08	6741841	6742654	BnaA08T0059100ZY	0	+	0	0	813	0.0000000
zheyou73v0_A08	6742720	6743074	BnaA08T0059200ZY	0	+	0	0	354	0.0000000
zheyou73v0_A08	6743899	6744100	BnaA08T0059300ZY	0	-	0	0	201	0.0000000
zheyou73v0_A08	6746718	6748246	BnaA08T0059400ZY	0	+	0	0	1528	0.0000000
zheyou73v0_A08	6749029	6749992	BnaA08T0059500ZY	0	-	0	0	963	0.0000000
zheyou73v0_A08	6751374	6751929	BnaA08T0059600ZY	0	-	0	0	555	0.0000000
zheyou73v0_A08	6753096	6754597	BnaA08T0059700ZY	0	-	0	0	1501	0.0000000
zheyou73v0_A08	6755270	6756731	BnaA08T0059800ZY	0	-	0	0	1461	0.0000000
zheyou73v0_A08	6756864	6759389	BnaA08T0059900ZY	0	+	0	0	2525	0.0000000
zheyou73v0_A08	6761533	6762211	BnaA08T0060000ZY	0	+	0	0	678	0.0000000
zheyou73v0_A08	7018347	7019152	BnaA08T0060100ZY	0	-	0	0	805	0.0000000
zheyou73v0_A08	8050728	8054051	BnaA08T0060200ZY	0	+	0	0	3323	0.0000000
zheyou73v0_A08	8506716	8512532	BnaA08T0060300ZY	0	+	0	0	5816	0.0000000
zheyou73v0_A08	8842614	8842785	BnaA08T0060400ZY	0	+	0	0	171	0.0000000
zheyou73v0_A08	9738410	9740063	BnaA08T0060500ZY	0	-	0	0	1653	0.0000000
zheyou73v0_A08	10025041	10025212	BnaA08T0060600ZY	0	+	0	0	171	0.0000000
zheyou73v0_A08	10179057	10180667	BnaA08T0060700ZY	0	-	0	0	1610	0.0000000
zheyou73v0_A08	10179057	10180667	BnaA08T0060700ZY.1	0	-	0	0	1610	0.0000000
zheyou73v0_A08	10218717	10221162	BnaA08T0060800ZY	0	+	0	0	2445	0.0000000
zheyou73v0_A08	10218717	10221162	BnaA08T0060800ZY.1	0	+	0	0	2445	0.0000000
zheyou73v0_A08	10218717	10221162	BnaA08T0060800ZY.2	0	+	0	0	2445	0.0000000
zheyou73v0_A08	10233168	10235073	BnaA08T0060900ZY	0	-	0	0	1905	0.0000000
zheyou73v0_A08	10241825	10243525	BnaA08T0061000ZY	0	-	0	0	1700	0.0000000
zheyou73v0_A08	10241825	10243525	BnaA08T0061000ZY.1	0	-	0	0	1700	0.0000000
zheyou73v0_A08	10258489	10258678	BnaA08T0061100ZY	0	+	0	0	189	0.0000000
zheyou73v0_A08	10260070	10269481	BnaA08T0061200ZY	0	-	0	0	9411	0.0000000
zheyou73v0_A08	10287040	10287446	BnaA08T0061300ZY	0	-	0	0	406	0.0000000
zheyou73v0_A08	10288873	10290054	BnaA08T0061400ZY	0	-	0	0	1181	0.0000000
zheyou73v0_A08	10292979	10293531	BnaA08T0061500ZY	0	+	0	0	552	0.0000000
zheyou73v0_A08	10294667	10295535	BnaA08T0061600ZY	0	+	0	0	868	0.0000000
zheyou73v0_A08	10309214	10312077	BnaA08T0061700ZY	0	-	0	0	2863	0.0000000
zheyou73v0_A08	10309214	10312077	BnaA08T0061700ZY.1	0	-	0	0	2863	0.0000000
zheyou73v0_A08	10314821	10315132	BnaA08T0061800ZY	0	-	0	0	311	0.0000000
zheyou73v0_A08	10317337	10318199	BnaA08T0061900ZY	0	+	0	0	862	0.0000000
zheyou73v0_A08	10325955	10340318	BnaA08T0062000ZY	0	+	0	0	14363	0.0000000
zheyou73v0_A08	10379906	10381659	BnaA08T0062100ZY	0	-	0	0	1753	0.0000000
zheyou73v0_A08	10395254	10396502	BnaA08T0062200ZY	0	-	0	0	1248	0.0000000
zheyou73v0_A08	10444838	10447302	BnaA08T0062300ZY	0	-	0	0	2464	0.0000000
zheyou73v0_A08	10450919	10453146	BnaA08T0062400ZY	0	-	0	0	2227	0.0000000
zheyou73v0_A08	10472753	10473434	BnaA08T0062500ZY	0	+	0	0	681	0.0000000
zheyou73v0_A08	10476983	10478477	BnaA08T0062600ZY	0	+	0	0	1494	0.0000000
zheyou73v0_A08	10477822	10479901	BnaA08T0062700ZY	0	-	0	0	2079	0.0000000
zheyou73v0_A08	10477822	10479901	BnaA08T0062700ZY.1	0	-	0	0	2079	0.0000000
zheyou73v0_A08	10498632	10501663	BnaA08T0062800ZY	0	-	0	0	3031	0.0000000
zheyou73v0_A08	10580056	10580397	BnaA08T0062900ZY	0	-	0	0	341	0.0000000
zheyou73v0_A08	10598942	10599471	BnaA08T0063000ZY	0	+	0	0	529	0.0000000
zheyou73v0_A08	10606442	10607047	BnaA08T0063100ZY	0	-	0	0	605	0.0000000
zheyou73v0_A08	10613577	10617391	BnaA08T0063200ZY	0	+	0	0	3814	0.0000000
zheyou73v0_A08	10621799	10623940	BnaA08T0063300ZY	0	+	0	0	2141	0.0000000
zheyou73v0_A08	10624596	10627765	BnaA08T0063400ZY	0	-	0	0	3169	0.0000000
zheyou73v0_A08	10624596	10627765	BnaA08T0063400ZY.1	0	-	0	0	3169	0.0000000
zheyou73v0_A08	10631812	10634283	BnaA08T0063500ZY	0	-	0	0	2471	0.0000000
zheyou73v0_A08	10638552	10641055	BnaA08T0063600ZY	0	-	0	0	2503	0.0000000
zheyou73v0_A08	10638552	10641055	BnaA08T0063600ZY.1	0	-	0	0	2503	0.0000000
zheyou73v0_A08	10647708	10649539	BnaA08T0063700ZY	0	-	0	0	1831	0.0000000
zheyou73v0_A08	10651142	10653789	BnaA08T0063800ZY	0	-	0	0	2647	0.0000000
zheyou73v0_A08	10667120	10668795	BnaA08T0063900ZY	0	+	0	0	1675	0.0000000
zheyou73v0_A08	10672563	10674991	BnaA08T0064000ZY	0	+	0	0	2428	0.0000000
zheyou73v0_A08	10675567	10677667	BnaA08T0064100ZY	0	-	0	0	2100	0.0000000
zheyou73v0_A08	10678299	10679106	BnaA08T0064200ZY	0	+	0	0	807	0.0000000
zheyou73v0_A08	10681386	10686752	BnaA08T0064300ZY	0	-	0	0	5366	0.0000000
zheyou73v0_A08	10689111	10689574	BnaA08T0064400ZY	0	-	0	0	463	0.0000000
zheyou73v0_A08	10720207	10722358	BnaA08T0064500ZY	0	+	0	0	2151	0.0000000
zheyou73v0_A08	10720207	10722358	BnaA08T0064500ZY.1	0	+	0	0	2151	0.0000000
zheyou73v0_A08	10728456	10729275	BnaA08T0064600ZY	0	+	0	0	819	0.0000000
zheyou73v0_A08	10729521	10731418	BnaA08T0064700ZY	0	-	0	0	1897	0.0000000
zheyou73v0_A08	10741355	10750426	BnaA08T0064800ZY	0	-	0	0	9071	0.0000000
zheyou73v0_A08	10741355	10750426	BnaA08T0064800ZY.1	0	-	0	0	9071	0.0000000
zheyou73v0_A08	10741355	10750426	BnaA08T0064800ZY.2	0	-	0	0	9071	0.0000000
zheyou73v0_A08	10741355	10750426	BnaA08T0064800ZY.3	0	-	0	0	9071	0.0000000
zheyou73v0_A08	10777074	10782731	BnaA08T0064900ZY	0	-	0	0	5657	0.0000000
zheyou73v0_A08	10795506	10797806	BnaA08T0065000ZY	0	+	0	0	2300	0.0000000
zheyou73v0_A08	10802153	10804644	BnaA08T0065100ZY	0	-	0	0	2491	0.0000000
zheyou73v0_A08	10806437	10807738	BnaA08T0065200ZY	0	-	0	0	1301	0.0000000
zheyou73v0_A08	10809537	10811433	BnaA08T0065300ZY	0	+	0	0	1896	0.0000000
zheyou73v0_A08	10858971	10859157	BnaA08T0065400ZY	0	+	0	0	186	0.0000000
zheyou73v0_A08	10868204	10869731	BnaA08T0065500ZY	0	+	0	0	1527	0.0000000
zheyou73v0_A08	10873113	10875249	BnaA08T0065600ZY	0	+	0	0	2136	0.0000000
zheyou73v0_A08	10882071	10882494	BnaA08T0065700ZY	0	+	0	0	423	0.0000000
zheyou73v0_A08	10902900	10910504	BnaA08T0065800ZY	0	+	0	0	7604	0.0000000
zheyou73v0_A08	10915919	10919176	BnaA08T0065900ZY	0	+	0	0	3257	0.0000000
zheyou73v0_A08	10925403	10927724	BnaA08T0066000ZY	0	-	0	0	2321	0.0000000
zheyou73v0_A08	10947454	10949868	BnaA08T0066100ZY	0	-	0	0	2414	0.0000000
zheyou73v0_A08	10979206	10979473	BnaA08T0066200ZY	0	-	0	0	267	0.0000000
zheyou73v0_A08	10979925	10987938	BnaA08T0066300ZY	0	-	0	0	8013	0.0000000
zheyou73v0_A08	10993181	10994173	BnaA08T0066400ZY	0	-	0	0	992	0.0000000
zheyou73v0_A08	11051670	11054126	BnaA08T0066500ZY	0	+	0	0	2456	0.0000000
zheyou73v0_A08	11051670	11054126	BnaA08T0066500ZY.1	0	+	0	0	2456	0.0000000
zheyou73v0_A08	11051670	11054126	BnaA08T0066500ZY.2	0	+	0	0	2456	0.0000000
zheyou73v0_A08	11055380	11056721	BnaA08T0066600ZY	0	+	0	0	1341	0.0000000
zheyou73v0_A08	11059885	11088824	BnaA08T0066700ZY	0	-	0	0	28939	0.0000000
zheyou73v0_A08	11088935	11089457	BnaA08T0066800ZY	0	-	0	0	522	0.0000000
zheyou73v0_A08	11115124	11116115	BnaA08T0066900ZY	0	-	0	0	991	0.0000000
zheyou73v0_A08	11116737	11117567	BnaA08T0067000ZY	0	-	0	0	830	0.0000000
zheyou73v0_A08	11117853	11118124	BnaA08T0067100ZY	0	+	0	0	271	0.0000000
zheyou73v0_A08	11128034	11132025	BnaA08T0067200ZY	0	-	0	0	3991	0.0000000
zheyou73v0_A08	11135317	11136359	BnaA08T0067300ZY	0	+	0	0	1042	0.0000000
zheyou73v0_A08	11148240	11148510	BnaA08T0067400ZY	0	+	0	0	270	0.0000000
zheyou73v0_A08	11148712	11149619	BnaA08T0067500ZY	0	-	0	0	907	0.0000000
zheyou73v0_A08	11152153	11152819	BnaA08T0067600ZY	0	+	0	0	666	0.0000000
zheyou73v0_A08	11153166	11153522	BnaA08T0067700ZY	0	+	0	0	356	0.0000000
zheyou73v0_A08	11174372	11175133	BnaA08T0067800ZY	0	+	0	0	761	0.0000000
zheyou73v0_A08	11214823	11219307	BnaA08T0067900ZY	0	+	0	0	4484	0.0000000
zheyou73v0_A08	11222111	11223228	BnaA08T0068000ZY	0	+	0	0	1117	0.0000000
zheyou73v0_A08	11229126	11230545	BnaA08T0068100ZY	0	-	0	0	1419	0.0000000
zheyou73v0_A08	11231169	11231644	BnaA08T0068200ZY	0	+	0	0	475	0.0000000
zheyou73v0_A08	11235597	11235762	BnaA08T0068300ZY	0	-	0	0	165	0.0000000
zheyou73v0_A08	11262953	11265577	BnaA08T0068400ZY	0	+	0	0	2624	0.0000000
zheyou73v0_A08	11286270	11286936	BnaA08T0068500ZY	0	-	0	0	666	0.0000000
zheyou73v0_A08	11314666	11322737	BnaA08T0068600ZY	0	+	0	0	8071	0.0000000
zheyou73v0_A08	11336560	11336923	BnaA08T0068700ZY	0	+	0	0	363	0.0000000
zheyou73v0_A08	11341338	11341886	BnaA08T0068800ZY	0	+	0	0	548	0.0000000
zheyou73v0_A08	11353717	11354191	BnaA08T0068900ZY	0	+	0	0	474	0.0000000
zheyou73v0_A08	11354476	11354953	BnaA08T0069000ZY	0	+	0	0	477	0.0000000
zheyou73v0_A08	11358064	11367256	BnaA08T0069100ZY	0	-	0	0	9192	0.0000000
zheyou73v0_A08	11376162	11376747	BnaA08T0069200ZY	0	-	0	0	585	0.0000000
zheyou73v0_A08	11385746	11386206	BnaA08T0069300ZY	0	+	0	0	460	0.0000000
zheyou73v0_A08	11386993	11387631	BnaA08T0069400ZY	0	+	0	0	638	0.0000000
zheyou73v0_A08	11419195	11420709	BnaA08T0069500ZY	0	+	0	0	1514	0.0000000
zheyou73v0_A08	11420854	11421064	BnaA08T0069600ZY	0	+	0	0	210	0.0000000
zheyou73v0_A08	11424664	11425166	BnaA08T0069700ZY	0	+	0	0	502	0.0000000
zheyou73v0_A08	11434433	11434852	BnaA08T0069800ZY	0	+	0	0	419	0.0000000
zheyou73v0_A08	11456670	11460301	BnaA08T0069900ZY	0	+	0	0	3631	0.0000000
zheyou73v0_A08	11463262	11463676	BnaA08T0070000ZY	0	-	0	0	414	0.0000000
zheyou73v0_A08	11470104	11470404	BnaA08T0070100ZY	0	+	0	0	300	0.0000000
zheyou73v0_A08	11471432	11472142	BnaA08T0070200ZY	0	-	0	0	710	0.0000000
zheyou73v0_A08	11471432	11472142	BnaA08T0070200ZY.1	0	-	0	0	710	0.0000000
zheyou73v0_A08	11477442	11478466	BnaA08T0070300ZY	0	-	0	0	1024	0.0000000
zheyou73v0_A08	11487685	11488228	BnaA08T0070400ZY	0	+	0	0	543	0.0000000
zheyou73v0_A08	11502381	11503157	BnaA08T0070500ZY	0	+	0	0	776	0.0000000
zheyou73v0_A08	11503945	11505279	BnaA08T0070600ZY	0	-	0	0	1334	0.0000000
zheyou73v0_A08	11523641	11525843	BnaA08T0070700ZY	0	-	0	0	2202	0.0000000
zheyou73v0_A08	11539114	11541455	BnaA08T0070800ZY	0	+	0	0	2341	0.0000000
zheyou73v0_A08	11548579	11551504	BnaA08T0070900ZY	0	-	0	0	2925	0.0000000
zheyou73v0_A08	11579952	11580830	BnaA08T0071000ZY	0	+	0	0	878	0.0000000
zheyou73v0_A08	11582431	11584112	BnaA08T0071100ZY	0	-	0	0	1681	0.0000000
zheyou73v0_A08	11582431	11584112	BnaA08T0071100ZY.1	0	-	0	0	1681	0.0000000
zheyou73v0_A08	11582431	11584112	BnaA08T0071100ZY.2	0	-	0	0	1681	0.0000000
zheyou73v0_A08	11582431	11584112	BnaA08T0071100ZY.3	0	-	0	0	1681	0.0000000
zheyou73v0_A08	11584315	11590833	BnaA08T0071200ZY	0	-	0	0	6518	0.0000000
zheyou73v0_A08	11593779	11595760	BnaA08T0071300ZY	0	-	0	0	1981	0.0000000
zheyou73v0_A08	11597886	11600497	BnaA08T0071400ZY	0	-	0	0	2611	0.0000000
zheyou73v0_A08	11609038	11611603	BnaA08T0071500ZY	0	-	0	0	2565	0.0000000
zheyou73v0_A08	11617890	11621034	BnaA08T0071600ZY	0	-	0	0	3144	0.0000000
zheyou73v0_A08	11624984	11625699	BnaA08T0071700ZY	0	+	0	0	715	0.0000000
zheyou73v0_A08	11627617	11629735	BnaA08T0071800ZY	0	-	0	0	2118	0.0000000
zheyou73v0_A08	11633982	11636479	BnaA08T0071900ZY	0	-	0	0	2497	0.0000000
zheyou73v0_A08	11656489	11659196	BnaA08T0072000ZY	0	+	0	0	2707	0.0000000
zheyou73v0_A08	11671679	11673696	BnaA08T0072100ZY	0	+	0	0	2017	0.0000000
zheyou73v0_A08	11678891	11684587	BnaA08T0072200ZY	0	+	0	0	5696	0.0000000
zheyou73v0_A08	11693139	11694894	BnaA08T0072300ZY	0	+	0	0	1755	0.0000000
zheyou73v0_A08	11704305	11704899	BnaA08T0072400ZY	0	+	0	0	594	0.0000000
zheyou73v0_A08	11719053	11720206	BnaA08T0072500ZY	0	-	0	0	1153	0.0000000
zheyou73v0_A08	11725506	11725851	BnaA08T0072600ZY	0	-	0	0	345	0.0000000
zheyou73v0_A08	11732205	11732520	BnaA08T0072700ZY	0	+	0	0	315	0.0000000
zheyou73v0_A08	11735787	11739355	BnaA08T0072800ZY	0	+	0	0	3568	0.0000000
zheyou73v0_A08	11748936	11756706	BnaA08T0072900ZY	0	+	0	0	7770	0.0000000
zheyou73v0_A08	11761820	11765310	BnaA08T0073000ZY	0	-	0	0	3490	0.0000000
zheyou73v0_A08	11761820	11765310	BnaA08T0073000ZY.1	0	-	0	0	3490	0.0000000
zheyou73v0_A08	11776586	11778356	BnaA08T0073100ZY	0	-	0	0	1770	0.0000000
zheyou73v0_A08	11776586	11778356	BnaA08T0073100ZY.1	0	-	0	0	1770	0.0000000
zheyou73v0_A08	11783704	11787044	BnaA08T0073200ZY	0	-	0	0	3340	0.0000000
zheyou73v0_A08	11825662	11826784	BnaA08T0073300ZY	0	-	0	0	1122	0.0000000
zheyou73v0_A08	11829033	11831818	BnaA08T0073400ZY	0	-	0	0	2785	0.0000000
zheyou73v0_A08	11832318	11834918	BnaA08T0073500ZY	0	+	0	0	2600	0.0000000
zheyou73v0_A08	11834801	11836867	BnaA08T0073600ZY	0	-	0	0	2066	0.0000000
zheyou73v0_A08	11850901	11851898	BnaA08T0073700ZY	0	+	0	0	997	0.0000000
zheyou73v0_A08	11857960	11858284	BnaA08T0073800ZY	0	-	0	0	324	0.0000000
zheyou73v0_A08	11862910	11863456	BnaA08T0073900ZY	0	+	0	0	546	0.0000000
zheyou73v0_A08	11918419	11918800	BnaA08T0074000ZY	0	+	0	0	381	0.0000000
zheyou73v0_A08	11946233	11946614	BnaA08T0074100ZY	0	+	0	0	381	0.0000000
zheyou73v0_A08	11950793	11951927	BnaA08T0074200ZY	0	+	0	0	1134	0.0000000
zheyou73v0_A08	11965020	11966369	BnaA08T0074300ZY	0	-	0	0	1349	0.0000000
zheyou73v0_A08	11974902	11977962	BnaA08T0074400ZY	0	+	0	0	3060	0.0000000
zheyou73v0_A08	11980554	11981676	BnaA08T0074500ZY	0	-	0	0	1122	0.0000000
zheyou73v0_A08	11986863	12006242	BnaA08T0074600ZY	0	-	0	0	19379	0.0000000
zheyou73v0_A08	12014168	12014980	BnaA08T0074700ZY	0	-	0	0	812	0.0000000
zheyou73v0_A08	12021889	12023645	BnaA08T0074800ZY.1	0	+	0	0	1756	0.0000000
zheyou73v0_A08	12021893	12023645	BnaA08T0074800ZY	0	+	0	0	1752	0.0000000
zheyou73v0_A08	12060284	12064031	BnaA08T0074900ZY	0	-	0	0	3747	0.0000000
zheyou73v0_A08	12091676	12094653	BnaA08T0075000ZY	0	-	0	0	2977	0.0000000
zheyou73v0_A08	12091676	12094653	BnaA08T0075000ZY.1	0	-	0	0	2977	0.0000000
zheyou73v0_A08	12097118	12099521	BnaA08T0075100ZY	0	+	0	0	2403	0.0000000
zheyou73v0_A08	12105163	12108593	BnaA08T0075200ZY	0	+	0	0	3430	0.0000000
zheyou73v0_A08	12105163	12108593	BnaA08T0075200ZY.2	0	+	0	0	3430	0.0000000
zheyou73v0_A08	12105163	12108593	BnaA08T0075200ZY.3	0	+	0	0	3430	0.0000000
zheyou73v0_A08	12105163	12108593	BnaA08T0075200ZY.4	0	+	0	0	3430	0.0000000
zheyou73v0_A08	12106068	12108593	BnaA08T0075200ZY.1	0	+	0	0	2525	0.0000000
zheyou73v0_A08	12109253	12111549	BnaA08T0075300ZY	0	-	0	0	2296	0.0000000
zheyou73v0_A08	12121920	12125517	BnaA08T0075400ZY	0	-	0	0	3597	0.0000000
zheyou73v0_A08	12134622	12138171	BnaA08T0075500ZY	0	+	0	0	3549	0.0000000
zheyou73v0_A08	12134622	12138171	BnaA08T0075500ZY.1	0	+	0	0	3549	0.0000000
zheyou73v0_A08	12143164	12159031	BnaA08T0075600ZY	0	+	0	0	15867	0.0000000
zheyou73v0_A08	12159091	12161736	BnaA08T0075700ZY	0	-	0	0	2645	0.0000000
zheyou73v0_A08	12163833	12164181	BnaA08T0075800ZY	0	+	0	0	348	0.0000000
zheyou73v0_A08	12171561	12174929	BnaA08T0075900ZY	0	+	0	0	3368	0.0000000
zheyou73v0_A08	12171561	12174929	BnaA08T0075900ZY.1	0	+	0	0	3368	0.0000000
zheyou73v0_A08	12171561	12174929	BnaA08T0075900ZY.2	0	+	0	0	3368	0.0000000
zheyou73v0_A08	12182016	12183339	BnaA08T0076000ZY	0	-	0	0	1323	0.0000000
zheyou73v0_A08	12207019	12208534	BnaA08T0076100ZY	0	+	0	0	1515	0.0000000
zheyou73v0_A08	12216133	12218117	BnaA08T0076200ZY	0	-	0	0	1984	0.0000000
zheyou73v0_A08	12235262	12237903	BnaA08T0076300ZY	0	+	0	0	2641	0.0000000
zheyou73v0_A08	12239041	12241513	BnaA08T0076400ZY	0	-	0	0	2472	0.0000000
zheyou73v0_A08	12244487	12245176	BnaA08T0076500ZY	0	-	0	0	689	0.0000000
zheyou73v0_A08	12278160	12279573	BnaA08T0076600ZY	0	+	0	0	1413	0.0000000
zheyou73v0_A08	12278160	12279573	BnaA08T0076600ZY.1	0	+	0	0	1413	0.0000000
zheyou73v0_A08	12278160	12279573	BnaA08T0076600ZY.2	0	+	0	0	1413	0.0000000
zheyou73v0_A08	12282524	12283245	BnaA08T0076700ZY	0	-	0	0	721	0.0000000
zheyou73v0_A08	12285007	12286759	BnaA08T0076800ZY	0	-	0	0	1752	0.0000000
zheyou73v0_A08	12297941	12301930	BnaA08T0076900ZY	0	-	0	0	3989	0.0000000
zheyou73v0_A08	12307160	12309004	BnaA08T0077000ZY	0	-	0	0	1844	0.0000000
zheyou73v0_A08	12312219	12314376	BnaA08T0077100ZY	0	+	0	0	2157	0.0000000
zheyou73v0_A08	12320521	12321592	BnaA08T0077200ZY	0	-	0	0	1071	0.0000000
zheyou73v0_A08	12322698	12324513	BnaA08T0077300ZY	0	+	0	0	1815	0.0000000
zheyou73v0_A08	12335192	12336713	BnaA08T0077400ZY.1	0	-	0	0	1521	0.0000000
zheyou73v0_A08	12335318	12336713	BnaA08T0077400ZY	0	-	0	0	1395	0.0000000
zheyou73v0_A08	12338606	12339166	BnaA08T0077500ZY	0	-	0	0	560	0.0000000
zheyou73v0_A08	12353893	12356414	BnaA08T0077600ZY	0	-	0	0	2521	0.0000000
zheyou73v0_A08	12358000	12359374	BnaA08T0077700ZY	0	-	0	0	1374	0.0000000
zheyou73v0_A08	12360109	12365565	BnaA08T0077800ZY	0	-	0	0	5456	0.0000000
zheyou73v0_A08	12360109	12365565	BnaA08T0077800ZY.1	0	-	0	0	5456	0.0000000
zheyou73v0_A08	12385850	12388336	BnaA08T0077900ZY	0	-	0	0	2486	0.0000000
zheyou73v0_A08	12389130	12391137	BnaA08T0078000ZY	0	-	0	0	2007	0.0000000
zheyou73v0_A08	12392848	12394460	BnaA08T0078100ZY	0	-	0	0	1612	0.0000000
zheyou73v0_A08	12400570	12401830	BnaA08T0078200ZY	0	+	0	0	1260	0.0000000
zheyou73v0_A08	12404430	12405930	BnaA08T0078300ZY	0	-	0	0	1500	0.0000000
zheyou73v0_A08	12406106	12406880	BnaA08T0078400ZY	0	-	0	0	774	0.0000000
zheyou73v0_A08	12412276	12413147	BnaA08T0078500ZY	0	-	0	0	871	0.0000000
zheyou73v0_A08	12414514	12415542	BnaA08T0078600ZY	0	-	0	0	1028	0.0000000
zheyou73v0_A08	12440610	12442073	BnaA08T0078700ZY	0	-	0	0	1463	0.0000000
zheyou73v0_A08	12440610	12442073	BnaA08T0078700ZY.1	0	-	0	0	1463	0.0000000
zheyou73v0_A08	12440610	12442073	BnaA08T0078700ZY.2	0	-	0	0	1463	0.0000000
zheyou73v0_A08	12444352	12446567	BnaA08T0078800ZY	0	-	0	0	2215	0.0000000
zheyou73v0_A08	12456394	12457525	BnaA08T0078900ZY	0	+	0	0	1131	0.0000000
zheyou73v0_A08	12457811	12460297	BnaA08T0079000ZY	0	+	0	0	2486	0.0000000
zheyou73v0_A08	12460671	12463662	BnaA08T0079100ZY	0	-	0	0	2991	0.0000000
zheyou73v0_A08	12465585	12467328	BnaA08T0079200ZY	0	+	0	0	1743	0.0000000
zheyou73v0_A08	12478102	12479158	BnaA08T0079300ZY	0	+	0	0	1056	0.0000000
zheyou73v0_A08	12482878	12483356	BnaA08T0079400ZY	0	+	0	0	478	0.0000000
zheyou73v0_A08	12495172	12496372	BnaA08T0079500ZY	0	-	0	0	1200	0.0000000
zheyou73v0_A08	12505161	12510272	BnaA08T0079600ZY	0	-	0	0	5111	0.0000000
zheyou73v0_A08	12510327	12510644	BnaA08T0079700ZY	0	-	0	0	317	0.0000000
zheyou73v0_A08	12530108	12535664	BnaA08T0079800ZY	0	-	0	0	5556	0.0000000
zheyou73v0_A08	12537312	12537813	BnaA08T0079900ZY	0	-	0	0	501	0.0000000
zheyou73v0_A08	12537817	12538225	BnaA08T0080000ZY	0	-	0	0	408	0.0000000
zheyou73v0_A08	12538324	12538642	BnaA08T0080100ZY	0	-	0	0	318	0.0000000
zheyou73v0_A08	12543617	12543896	BnaA08T0080200ZY	0	-	0	0	279	0.0000000
zheyou73v0_A08	12564191	12566249	BnaA08T0080300ZY	0	+	0	0	2058	0.0000000
zheyou73v0_A08	12566649	12573200	BnaA08T0080400ZY	0	-	0	0	6551	0.0000000
zheyou73v0_A08	12573686	12574085	BnaA08T0080500ZY	0	-	0	0	399	0.0000000
zheyou73v0_A08	12581687	12586828	BnaA08T0080600ZY	0	+	0	0	5141	0.0000000
zheyou73v0_A08	12588267	12593155	BnaA08T0080700ZY	0	-	0	0	4888	0.0000000
zheyou73v0_A08	12599673	12601884	BnaA08T0080800ZY	0	+	0	0	2211	0.0000000
zheyou73v0_A08	12603253	12604937	BnaA08T0080900ZY	0	+	0	0	1684	0.0000000
zheyou73v0_A08	12605815	12610348	BnaA08T0081000ZY	0	-	0	0	4533	0.0000000
zheyou73v0_A08	12606977	12610348	BnaA08T0081000ZY.1	0	-	0	0	3371	0.0000000
zheyou73v0_A08	12623309	12624860	BnaA08T0081100ZY	0	+	0	0	1551	0.0000000
zheyou73v0_A08	12627723	12627927	BnaA08T0081200ZY	0	-	0	0	204	0.0000000
zheyou73v0_A08	12650390	12651274	BnaA08T0081300ZY	0	-	0	0	884	0.0000000
zheyou73v0_A08	12658379	12663407	BnaA08T0081400ZY	0	+	0	0	5028	0.0000000
zheyou73v0_A08	12668931	12671112	BnaA08T0081500ZY	0	-	0	0	2181	0.0000000
zheyou73v0_A08	12683191	12684263	BnaA08T0081600ZY	0	-	0	0	1072	0.0000000
zheyou73v0_A08	12702178	12709287	BnaA08T0081700ZY	0	-	0	0	7109	0.0000000
zheyou73v0_A08	12725427	12738863	BnaA08T0081800ZY	0	-	0	0	13436	0.0000000
zheyou73v0_A08	12752159	12753110	BnaA08T0081900ZY	0	-	0	0	951	0.0000000
zheyou73v0_A08	12752159	12753110	BnaA08T0081900ZY.1	0	-	0	0	951	0.0000000
zheyou73v0_A08	12754678	12755866	BnaA08T0082000ZY	0	+	0	0	1188	0.0000000
zheyou73v0_A08	12783814	12787186	BnaA08T0082100ZY	0	+	0	0	3372	0.0000000
zheyou73v0_A08	12788474	12788993	BnaA08T0082200ZY	0	-	0	0	519	0.0000000
zheyou73v0_A08	12790668	12791860	BnaA08T0082300ZY	0	+	0	0	1192	0.0000000
zheyou73v0_A08	12792595	12794258	BnaA08T0082400ZY	0	-	0	0	1663	0.0000000
zheyou73v0_A08	12802243	12804066	BnaA08T0082500ZY	0	+	0	0	1823	0.0000000
zheyou73v0_A08	12805157	12809004	BnaA08T0082600ZY	0	-	0	0	3847	0.0000000
zheyou73v0_A08	12827500	12833141	BnaA08T0082700ZY	0	+	0	0	5641	0.0000000
zheyou73v0_A08	12853744	12855957	BnaA08T0082800ZY	0	+	0	0	2213	0.0000000
zheyou73v0_A08	12887878	12888629	BnaA08T0082900ZY	0	+	0	0	751	0.0000000
zheyou73v0_A08	12889392	12892288	BnaA08T0083000ZY.1	0	+	0	0	2896	0.0000000
zheyou73v0_A08	12889476	12891763	BnaA08T0083000ZY	0	+	0	0	2287	0.0000000
zheyou73v0_A08	12893332	12894673	BnaA08T0083100ZY	0	-	0	0	1341	0.0000000
zheyou73v0_A08	12905521	12907433	BnaA08T0083200ZY	0	-	0	0	1912	0.0000000
zheyou73v0_A08	12910611	12912252	BnaA08T0083300ZY	0	-	0	0	1641	0.0000000
zheyou73v0_A08	12912470	12913620	BnaA08T0083400ZY	0	+	0	0	1150	0.0000000
zheyou73v0_A08	12912470	12913620	BnaA08T0083400ZY.1	0	+	0	0	1150	0.0000000
zheyou73v0_A08	12913580	12916640	BnaA08T0083500ZY	0	-	0	0	3060	0.0000000
zheyou73v0_A08	12917977	12920519	BnaA08T0083600ZY	0	+	0	0	2542	0.0000000
zheyou73v0_A08	12922786	12923549	BnaA08T0083700ZY	0	+	0	0	763	0.0000000
zheyou73v0_A08	12926418	12927123	BnaA08T0083800ZY	0	-	0	0	705	0.0000000
zheyou73v0_A08	12934361	12934562	BnaA08T0083900ZY	0	+	0	0	201	0.0000000
zheyou73v0_A08	12935001	12936045	BnaA08T0084000ZY	0	+	0	0	1044	0.0000000
zheyou73v0_A08	12945338	12948485	BnaA08T0084100ZY	0	+	0	0	3147	0.0000000
zheyou73v0_A08	12948674	12949367	BnaA08T0084200ZY	0	-	0	0	693	0.0000000
zheyou73v0_A08	12954992	12959158	BnaA08T0084300ZY	0	+	0	0	4166	0.0000000
zheyou73v0_A08	12962633	12962898	BnaA08T0084400ZY	0	+	0	0	265	0.0000000
zheyou73v0_A08	12970860	12971723	BnaA08T0084500ZY	0	-	0	0	863	0.0000000
zheyou73v0_A08	12973252	12975688	BnaA08T0084600ZY	0	+	0	0	2436	0.0000000
zheyou73v0_A08	12983989	12985332	BnaA08T0084700ZY	0	+	0	0	1343	0.0000000
zheyou73v0_A08	13002005	13003538	BnaA08T0084800ZY	0	-	0	0	1533	0.0000000
zheyou73v0_A08	13008985	13010269	BnaA08T0084900ZY	0	-	0	0	1284	0.0000000
zheyou73v0_A08	13016698	13017762	BnaA08T0085000ZY	0	-	0	0	1064	0.0000000
zheyou73v0_A08	13018918	13019851	BnaA08T0085100ZY	0	+	0	0	933	0.0000000
zheyou73v0_A08	13026236	13027891	BnaA08T0085200ZY	0	-	0	0	1655	0.0000000
zheyou73v0_A08	13033063	13034920	BnaA08T0085300ZY	0	+	0	0	1857	0.0000000
zheyou73v0_A08	13033063	13034921	BnaA08T0085300ZY.1	0	+	0	0	1858	0.0000000
zheyou73v0_A08	13039563	13042267	BnaA08T0085400ZY	0	+	0	0	2704	0.0000000
zheyou73v0_A08	13040259	13042267	BnaA08T0085400ZY.1	0	+	0	0	2008	0.0000000
zheyou73v0_A08	13045714	13048395	BnaA08T0085500ZY	0	-	0	0	2681	0.0000000
zheyou73v0_A08	13057099	13058514	BnaA08T0085600ZY	0	+	0	0	1415	0.0000000
zheyou73v0_A08	13065188	13067822	BnaA08T0085700ZY	0	-	0	0	2634	0.0000000
zheyou73v0_A08	13083598	13084529	BnaA08T0085800ZY	0	+	0	0	931	0.0000000
zheyou73v0_A08	13085593	13089710	BnaA08T0085900ZY	0	+	0	0	4117	0.0000000
zheyou73v0_A08	13095007	13095649	BnaA08T0086000ZY	0	+	0	0	642	0.0000000
zheyou73v0_A08	13108779	13109520	BnaA08T0086100ZY	0	+	0	0	741	0.0000000
zheyou73v0_A08	13120793	13122025	BnaA08T0086200ZY	0	+	0	0	1232	0.0000000
zheyou73v0_A08	13131161	13133427	BnaA08T0086300ZY	0	+	0	0	2266	0.0000000
zheyou73v0_A08	13133732	13136117	BnaA08T0086400ZY	0	-	0	0	2385	0.0000000
zheyou73v0_A08	13137893	13139314	BnaA08T0086500ZY	0	-	0	0	1421	0.0000000
zheyou73v0_A08	13139701	13142054	BnaA08T0086600ZY	0	-	0	0	2353	0.0000000
zheyou73v0_A08	13165627	13169421	BnaA08T0086700ZY	0	-	0	0	3794	0.0000000
zheyou73v0_A08	13184414	13184795	BnaA08T0086800ZY	0	+	0	0	381	0.0000000
zheyou73v0_A08	13185451	13186540	BnaA08T0086900ZY	0	-	0	0	1089	0.0000000
zheyou73v0_A08	13196547	13197257	BnaA08T0087000ZY	0	+	0	0	710	0.0000000
zheyou73v0_A08	13218085	13219770	BnaA08T0087100ZY	0	+	0	0	1685	0.0000000
zheyou73v0_A08	13220783	13222229	BnaA08T0087200ZY	0	+	0	0	1446	0.0000000
zheyou73v0_A08	13222295	13223069	BnaA08T0087300ZY	0	-	0	0	774	0.0000000
zheyou73v0_A08	13227427	13227640	BnaA08T0087400ZY	0	+	0	0	213	0.0000000
zheyou73v0_A08	13234706	13237380	BnaA08T0087500ZY	0	-	0	0	2674	0.0000000
zheyou73v0_A08	13256743	13257254	BnaA08T0087600ZY	0	+	0	0	511	0.0000000
zheyou73v0_A08	13264709	13265980	BnaA08T0087700ZY	0	-	0	0	1271	0.0000000
zheyou73v0_A08	13265988	13266371	BnaA08T0087800ZY	0	-	0	0	383	0.0000000
zheyou73v0_A08	13267360	13269478	BnaA08T0087900ZY	0	-	0	0	2118	0.0000000
zheyou73v0_A08	13275964	13278415	BnaA08T0088000ZY	0	+	0	0	2451	0.0000000
zheyou73v0_A08	13275964	13278415	BnaA08T0088000ZY.1	0	+	0	0	2451	0.0000000
zheyou73v0_A08	13275964	13278030	BnaA08T0088000ZY.2	0	+	0	0	2066	0.0000000
zheyou73v0_A08	13279840	13282280	BnaA08T0088100ZY	0	+	0	0	2440	0.0000000
zheyou73v0_A08	13279840	13282280	BnaA08T0088100ZY.1	0	+	0	0	2440	0.0000000
zheyou73v0_A08	13279840	13282280	BnaA08T0088100ZY.2	0	+	0	0	2440	0.0000000
zheyou73v0_A08	13279840	13282280	BnaA08T0088100ZY.3	0	+	0	0	2440	0.0000000
zheyou73v0_A08	13311976	13319586	BnaA08T0088200ZY	0	+	0	0	7610	0.0000000
zheyou73v0_A08	13324893	13325675	BnaA08T0088300ZY	0	+	0	0	782	0.0000000
zheyou73v0_A08	13333081	13337301	BnaA08T0088400ZY	0	-	0	0	4220	0.0000000
zheyou73v0_A08	13343775	13344030	BnaA08T0088500ZY	0	+	0	0	255	0.0000000
zheyou73v0_A08	13349530	13350546	BnaA08T0088600ZY	0	+	0	0	1016	0.0000000
zheyou73v0_A08	13388587	13389769	BnaA08T0088700ZY	0	+	0	0	1182	0.0000000
zheyou73v0_A08	13390579	13393777	BnaA08T0088800ZY	0	-	0	0	3198	0.0000000
zheyou73v0_A08	13394284	13395052	BnaA08T0088900ZY	0	-	0	0	768	0.0000000
zheyou73v0_A08	13408473	13409391	BnaA08T0089000ZY	0	+	0	0	918	0.0000000
zheyou73v0_A08	13412312	13415098	BnaA08T0089100ZY	0	-	0	0	2786	0.0000000
zheyou73v0_A08	13423036	13423694	BnaA08T0089200ZY	0	+	0	0	658	0.0000000
zheyou73v0_A08	13437340	13437916	BnaA08T0089300ZY	0	-	0	0	576	0.0000000
zheyou73v0_A08	13441090	13442681	BnaA08T0089400ZY	0	+	0	0	1591	0.0000000
zheyou73v0_A08	13448075	13450267	BnaA08T0089500ZY	0	+	0	0	2192	0.0000000
zheyou73v0_A08	13460044	13463270	BnaA08T0089600ZY	0	+	0	0	3226	0.0000000
zheyou73v0_A08	13463856	13465418	BnaA08T0089700ZY	0	+	0	0	1562	0.0000000
zheyou73v0_A08	13465546	13466748	BnaA08T0089800ZY	0	+	0	0	1202	0.0000000
zheyou73v0_A08	13468499	13471077	BnaA08T0089900ZY	0	-	0	0	2578	0.0000000
zheyou73v0_A08	13478825	13480244	BnaA08T0090000ZY	0	-	0	0	1419	0.0000000
zheyou73v0_A08	13491478	13493976	BnaA08T0090100ZY	0	+	0	0	2498	0.0000000
zheyou73v0_A08	13501412	13503356	BnaA08T0090200ZY	0	+	0	0	1944	0.0000000
zheyou73v0_A08	13546771	13548182	BnaA08T0090300ZY	0	-	0	0	1411	0.0000000
zheyou73v0_A08	13551197	13552544	BnaA08T0090400ZY	0	-	0	0	1347	0.0000000
zheyou73v0_A08	13560297	13567059	BnaA08T0090500ZY.1	0	-	0	0	6762	0.0000000
zheyou73v0_A08	13560535	13567235	BnaA08T0090500ZY	0	-	0	0	6700	0.0000000
zheyou73v0_A08	13560535	13567059	BnaA08T0090500ZY.2	0	-	0	0	6524	0.0000000
zheyou73v0_A08	13583445	13584336	BnaA08T0090600ZY	0	-	0	0	891	0.0000000
zheyou73v0_A08	13596378	13603181	BnaA08T0090700ZY	0	-	0	0	6803	0.0000000
zheyou73v0_A08	13596378	13603181	BnaA08T0090700ZY.1	0	-	0	0	6803	0.0000000
zheyou73v0_A08	13630098	13630908	BnaA08T0090800ZY	0	+	0	0	810	0.0000000
zheyou73v0_A08	13631457	13632332	BnaA08T0090900ZY	0	-	0	0	875	0.0000000
zheyou73v0_A08	13638442	13643050	BnaA08T0091000ZY	0	+	0	0	4608	0.0000000
zheyou73v0_A08	13643715	13645081	BnaA08T0091100ZY	0	-	0	0	1366	0.0000000
zheyou73v0_A08	13645866	13647067	BnaA08T0091200ZY	0	-	0	0	1201	0.0000000
zheyou73v0_A08	13647406	13651233	BnaA08T0091300ZY	0	+	0	0	3827	0.0000000
zheyou73v0_A08	13647406	13651233	BnaA08T0091300ZY.1	0	+	0	0	3827	0.0000000
zheyou73v0_A08	13661033	13661207	BnaA08T0091400ZY	0	+	0	0	174	0.0000000
zheyou73v0_A08	13662436	13663493	BnaA08T0091500ZY	0	-	0	0	1057	0.0000000
zheyou73v0_A08	13663937	13682080	BnaA08T0091600ZY	0	-	0	0	18143	0.0000000
zheyou73v0_A08	13691142	13692266	BnaA08T0091700ZY	0	+	0	0	1124	0.0000000
zheyou73v0_A08	13692691	13694218	BnaA08T0091800ZY	0	+	0	0	1527	0.0000000
zheyou73v0_A08	13694916	13696565	BnaA08T0091900ZY	0	+	0	0	1649	0.0000000
zheyou73v0_A08	13700694	13703619	BnaA08T0092000ZY	0	+	0	0	2925	0.0000000
zheyou73v0_A08	13708477	13709477	BnaA08T0092100ZY	0	+	0	0	1000	0.0000000
zheyou73v0_A08	13713246	13716571	BnaA08T0092200ZY	0	-	0	0	3325	0.0000000
zheyou73v0_A08	13719627	13720331	BnaA08T0092300ZY	0	-	0	0	704	0.0000000
zheyou73v0_A08	13742963	13744463	BnaA08T0092400ZY	0	+	0	0	1500	0.0000000
zheyou73v0_A08	13743069	13744463	BnaA08T0092400ZY.1	0	+	0	0	1394	0.0000000
zheyou73v0_A08	13748164	13749384	BnaA08T0092500ZY	0	+	0	0	1220	0.0000000
zheyou73v0_A08	13751916	13755252	BnaA08T0092600ZY	0	+	0	0	3336	0.0000000
zheyou73v0_A08	13751916	13755252	BnaA08T0092600ZY.1	0	+	0	0	3336	0.0000000
zheyou73v0_A08	13754860	13756131	BnaA08T0092700ZY	0	-	0	0	1271	0.0000000
zheyou73v0_A08	13756419	13758622	BnaA08T0092800ZY	0	-	0	0	2203	0.0000000
zheyou73v0_A08	13772553	13774645	BnaA08T0092900ZY	0	+	0	0	2092	0.0000000
zheyou73v0_A08	13775904	13779046	BnaA08T0093000ZY	0	+	0	0	3142	0.0000000
zheyou73v0_A08	13779438	13780800	BnaA08T0093100ZY	0	-	0	0	1362	0.0000000
zheyou73v0_A08	13782715	13788649	BnaA08T0093200ZY	0	-	0	0	5934	0.0000000
zheyou73v0_A08	13794155	13794563	BnaA08T0093300ZY	0	-	0	0	408	0.0000000
zheyou73v0_A08	13801794	13802811	BnaA08T0093400ZY	0	-	0	0	1017	0.0000000
zheyou73v0_A08	13821425	13821920	BnaA08T0093500ZY	0	+	0	0	495	0.0000000
zheyou73v0_A08	13835722	13836421	BnaA08T0093600ZY	0	+	0	0	699	0.0000000
zheyou73v0_A08	13840024	13847710	BnaA08T0093700ZY	0	-	0	0	7686	0.0000000
zheyou73v0_A08	13852665	13853308	BnaA08T0093800ZY	0	+	0	0	643	0.0000000
zheyou73v0_A08	13856052	13856673	BnaA08T0093900ZY	0	-	0	0	621	0.0000000
zheyou73v0_A08	13859697	13863264	BnaA08T0094000ZY	0	-	0	0	3567	0.0000000
zheyou73v0_A08	13865604	13866192	BnaA08T0094100ZY	0	-	0	0	588	0.0000000
zheyou73v0_A08	13878664	13882945	BnaA08T0094200ZY	0	-	0	0	4281	0.0000000
zheyou73v0_A08	13878664	13882945	BnaA08T0094200ZY.1	0	-	0	0	4281	0.0000000
zheyou73v0_A08	13891141	13894580	BnaA08T0094300ZY	0	+	0	0	3439	0.0000000
zheyou73v0_A08	13894825	13895353	BnaA08T0094400ZY	0	+	0	0	528	0.0000000
zheyou73v0_A08	13897143	13897557	BnaA08T0094500ZY	0	-	0	0	414	0.0000000
zheyou73v0_A08	13920377	13920884	BnaA08T0094600ZY	0	-	0	0	507	0.0000000
zheyou73v0_A08	13923145	13924178	BnaA08T0094700ZY	0	-	0	0	1033	0.0000000
zheyou73v0_A08	13927287	13929695	BnaA08T0094800ZY	0	-	0	0	2408	0.0000000
zheyou73v0_A08	13942394	13943040	BnaA08T0094900ZY	0	+	0	0	646	0.0000000
zheyou73v0_A08	13957551	13958437	BnaA08T0095000ZY	0	-	0	0	886	0.0000000
zheyou73v0_A08	13964358	13964703	BnaA08T0095100ZY	0	-	0	0	345	0.0000000
zheyou73v0_A08	13972471	13974284	BnaA08T0095200ZY	0	-	0	0	1813	0.0000000
zheyou73v0_A08	13985213	13987116	BnaA08T0095300ZY	0	+	0	0	1903	0.0000000
zheyou73v0_A08	13987231	13987549	BnaA08T0095400ZY	0	-	0	0	318	0.0000000
zheyou73v0_A08	13988520	13989793	BnaA08T0095500ZY	0	-	0	0	1273	0.0000000
zheyou73v0_A08	13991527	13992740	BnaA08T0095600ZY	0	-	0	0	1213	0.0000000
zheyou73v0_A08	13997045	13998003	BnaA08T0095700ZY	0	-	0	0	958	0.0000000
zheyou73v0_A08	14002002	14004348	BnaA08T0095800ZY	0	-	0	0	2346	0.0000000
zheyou73v0_A08	14002002	14004348	BnaA08T0095800ZY.1	0	-	0	0	2346	0.0000000
zheyou73v0_A08	14002002	14004348	BnaA08T0095800ZY.2	0	-	0	0	2346	0.0000000
zheyou73v0_A08	14014419	14015323	BnaA08T0095900ZY	0	-	0	0	904	0.0000000
zheyou73v0_A08	14018185	14018362	BnaA08T0096000ZY	0	-	0	0	177	0.0000000
zheyou73v0_A08	14019496	14022649	BnaA08T0096100ZY	0	+	0	0	3153	0.0000000
zheyou73v0_A08	14022961	14024099	BnaA08T0096200ZY	0	-	0	0	1138	0.0000000
zheyou73v0_A08	14026011	14027014	BnaA08T0096300ZY	0	-	0	0	1003	0.0000000
zheyou73v0_A08	14034343	14036344	BnaA08T0096400ZY	0	-	0	0	2001	0.0000000
zheyou73v0_A08	14038523	14038682	BnaA08T0096500ZY	0	+	0	0	159	0.0000000
zheyou73v0_A08	14049910	14054422	BnaA08T0096600ZY	0	+	0	0	4512	0.0000000
zheyou73v0_A08	14066058	14068187	BnaA08T0096700ZY	0	-	0	0	2129	0.0000000
zheyou73v0_A08	14072740	14074291	BnaA08T0096800ZY	0	-	0	0	1551	0.0000000
zheyou73v0_A08	14080501	14084868	BnaA08T0096900ZY	0	-	0	0	4367	0.0000000
zheyou73v0_A08	14099806	14102790	BnaA08T0097000ZY	0	-	0	0	2984	0.0000000
zheyou73v0_A08	14099806	14102790	BnaA08T0097000ZY.1	0	-	0	0	2984	0.0000000
zheyou73v0_A08	14109124	14115693	BnaA08T0097100ZY	0	+	0	0	6569	0.0000000
zheyou73v0_A08	14115869	14116144	BnaA08T0097200ZY	0	-	0	0	275	0.0000000
zheyou73v0_A08	14120462	14121067	BnaA08T0097300ZY	0	+	0	0	605	0.0000000
zheyou73v0_A08	14122549	14133601	BnaA08T0097400ZY	0	-	0	0	11052	0.0000000
zheyou73v0_A08	14144623	14147094	BnaA08T0097500ZY	0	-	0	0	2471	0.0000000
zheyou73v0_A08	14144623	14147094	BnaA08T0097500ZY.1	0	-	0	0	2471	0.0000000
zheyou73v0_A08	14156424	14157454	BnaA08T0097600ZY	0	-	0	0	1030	0.0000000
zheyou73v0_A08	14157850	14159050	BnaA08T0097700ZY	0	-	0	0	1200	0.0000000
zheyou73v0_A08	14174302	14176896	BnaA08T0097800ZY	0	+	0	0	2594	0.0000000
zheyou73v0_A08	14177309	14177831	BnaA08T0097900ZY	0	+	0	0	522	0.0000000
zheyou73v0_A08	14178696	14179417	BnaA08T0098000ZY	0	-	0	0	721	0.0000000
zheyou73v0_A08	14182674	14205755	BnaA08T0098100ZY	0	-	0	0	23081	0.0000000
zheyou73v0_A08	14222362	14227175	BnaA08T0098200ZY	0	+	0	0	4813	0.0000000
zheyou73v0_A08	14227500	14228740	BnaA08T0098300ZY	0	-	0	0	1240	0.0000000
zheyou73v0_A08	14235347	14236987	BnaA08T0098400ZY	0	-	0	0	1640	0.0000000
zheyou73v0_A08	14237783	14240416	BnaA08T0098500ZY	0	-	0	0	2633	0.0000000
zheyou73v0_A08	14237783	14240430	BnaA08T0098500ZY.1	0	-	0	0	2647	0.0000000
zheyou73v0_A08	14245469	14247591	BnaA08T0098600ZY	0	+	0	0	2122	0.0000000
zheyou73v0_A08	14248096	14249007	BnaA08T0098700ZY	0	+	0	0	911	0.0000000
zheyou73v0_A08	14250783	14254530	BnaA08T0098800ZY	0	-	0	0	3747	0.0000000
zheyou73v0_A08	14255096	14258350	BnaA08T0098900ZY	0	+	0	0	3254	0.0000000
zheyou73v0_A08	14263808	14268354	BnaA08T0099000ZY	0	+	0	0	4546	0.0000000
zheyou73v0_A08	14268374	14321505	BnaA08T0099100ZY	0	-	0	0	53131	0.0000000
zheyou73v0_A08	14330321	14331226	BnaA08T0099200ZY	0	+	0	0	905	0.0000000
zheyou73v0_A08	14346269	14350965	BnaA08T0099300ZY	0	-	0	0	4696	0.0000000
zheyou73v0_A08	14346269	14350965	BnaA08T0099300ZY.1	0	-	0	0	4696	0.0000000
zheyou73v0_A08	14357276	14362691	BnaA08T0099400ZY	0	+	0	0	5415	0.0000000
zheyou73v0_A08	14362624	14364158	BnaA08T0099500ZY	0	-	0	0	1534	0.0000000
zheyou73v0_A08	14366580	14369298	BnaA08T0099600ZY	0	-	0	0	2718	0.0000000
zheyou73v0_A08	14370082	14372280	BnaA08T0099700ZY	0	+	0	0	2198	0.0000000
zheyou73v0_A08	14380716	14381661	BnaA08T0099800ZY	0	-	0	0	945	0.0000000
zheyou73v0_A08	14387940	14388817	BnaA08T0099900ZY	0	+	0	0	877	0.0000000
zheyou73v0_A08	14397474	14398613	BnaA08T0100000ZY	0	+	0	0	1139	0.0000000
zheyou73v0_A08	14404764	14406617	BnaA08T0100100ZY	0	+	0	0	1853	0.0000000
zheyou73v0_A08	14406804	14408424	BnaA08T0100200ZY	0	-	0	0	1620	0.0000000
zheyou73v0_A08	14409995	14412165	BnaA08T0100300ZY	0	-	0	0	2170	0.0000000
zheyou73v0_A08	14413670	14414997	BnaA08T0100400ZY	0	+	0	0	1327	0.0000000
zheyou73v0_A08	14415288	14418060	BnaA08T0100500ZY	0	-	0	0	2772	0.0000000
zheyou73v0_A08	14415288	14417746	BnaA08T0100500ZY.1	0	-	0	0	2458	0.0000000
zheyou73v0_A08	14415288	14417828	BnaA08T0100500ZY.2	0	-	0	0	2540	0.0000000
zheyou73v0_A08	14425991	14427721	BnaA08T0100600ZY	0	+	0	0	1730	0.0000000
zheyou73v0_A08	14430422	14431901	BnaA08T0100700ZY	0	+	0	0	1479	0.0000000
zheyou73v0_A08	14436132	14438586	BnaA08T0100800ZY	0	-	0	0	2454	0.0000000
zheyou73v0_A08	14447176	14448613	BnaA08T0100900ZY	0	-	0	0	1437	0.0000000
zheyou73v0_A08	14450510	14453860	BnaA08T0101000ZY	0	-	0	0	3350	0.0000000
zheyou73v0_A08	14462180	14463929	BnaA08T0101100ZY	0	-	0	0	1749	0.0000000
zheyou73v0_A08	14473634	14475422	BnaA08T0101200ZY	0	-	0	0	1788	0.0000000
zheyou73v0_A08	14483165	14483449	BnaA08T0101300ZY	0	+	0	0	284	0.0000000
zheyou73v0_A08	14489578	14491356	BnaA08T0101400ZY	0	+	0	0	1778	0.0000000
zheyou73v0_A08	14499481	14502118	BnaA08T0101500ZY	0	+	0	0	2637	0.0000000
zheyou73v0_A08	14507985	14509779	BnaA08T0101600ZY	0	+	0	0	1794	0.0000000
zheyou73v0_A08	14512329	14514308	BnaA08T0101700ZY	0	+	0	0	1979	0.0000000
zheyou73v0_A08	14512329	14514308	BnaA08T0101700ZY.1	0	+	0	0	1979	0.0000000
zheyou73v0_A08	14513536	14515667	BnaA08T0101800ZY	0	-	0	0	2131	0.0000000
zheyou73v0_A08	14517103	14517913	BnaA08T0101900ZY	0	-	0	0	810	0.0000000
zheyou73v0_A08	14520450	14522018	BnaA08T0102000ZY	0	-	0	0	1568	0.0000000
zheyou73v0_A08	14523300	14524654	BnaA08T0102100ZY	0	+	0	0	1354	0.0000000
zheyou73v0_A08	14526091	14526908	BnaA08T0102200ZY	0	-	0	0	817	0.0000000
zheyou73v0_A08	14530539	14535157	BnaA08T0102300ZY	0	+	0	0	4618	0.0000000
zheyou73v0_A08	14553376	14555868	BnaA08T0102400ZY	0	+	0	0	2492	0.0000000
zheyou73v0_A08	14556989	14558630	BnaA08T0102500ZY	0	+	0	0	1641	0.0000000
zheyou73v0_A08	14579909	14580778	BnaA08T0102600ZY	0	+	0	0	869	0.0000000
zheyou73v0_A08	14589634	14590704	BnaA08T0102700ZY	0	+	0	0	1070	0.0000000
zheyou73v0_A08	14590789	14590951	BnaA08T0102800ZY	0	+	0	0	162	0.0000000
zheyou73v0_A08	14609397	14611144	BnaA08T0102900ZY.1	0	+	0	0	1747	0.0000000
zheyou73v0_A08	14609432	14611144	BnaA08T0102900ZY	0	+	0	0	1712	0.0000000
zheyou73v0_A08	14612259	14614218	BnaA08T0103000ZY	0	+	0	0	1959	0.0000000
zheyou73v0_A08	14618088	14619405	BnaA08T0103100ZY	0	+	0	0	1317	0.0000000
zheyou73v0_A08	14619679	14620126	BnaA08T0103200ZY	0	-	0	0	447	0.0000000
zheyou73v0_A08	14620488	14625440	BnaA08T0103300ZY	0	+	0	0	4952	0.0000000
zheyou73v0_A08	14620488	14625440	BnaA08T0103300ZY.1	0	+	0	0	4952	0.0000000
zheyou73v0_A08	14625372	14626239	BnaA08T0103400ZY	0	-	0	0	867	0.0000000
zheyou73v0_A08	14632647	14633342	BnaA08T0103500ZY	0	+	0	0	695	0.0000000
zheyou73v0_A08	14633657	14633840	BnaA08T0103600ZY	0	-	0	0	183	0.0000000
zheyou73v0_A08	14642130	14642451	BnaA08T0103700ZY	0	-	0	0	321	0.0000000
zheyou73v0_A08	14645718	14649838	BnaA08T0103800ZY	0	+	0	0	4120	0.0000000
zheyou73v0_A08	14650432	14652375	BnaA08T0103900ZY	0	-	0	0	1943	0.0000000
zheyou73v0_A08	14655992	14656331	BnaA08T0104000ZY	0	+	0	0	339	0.0000000
zheyou73v0_A08	14658682	14659125	BnaA08T0104100ZY	0	+	0	0	443	0.0000000
zheyou73v0_A08	14659396	14659663	BnaA08T0104200ZY	0	-	0	0	267	0.0000000
zheyou73v0_A08	14665582	14666227	BnaA08T0104300ZY	0	-	0	0	645	0.0000000
zheyou73v0_A08	14668305	14669129	BnaA08T0104400ZY	0	-	0	0	824	0.0000000
zheyou73v0_A08	14671682	14674089	BnaA08T0104500ZY	0	-	0	0	2407	0.0000000
zheyou73v0_A08	14671682	14674050	BnaA08T0104500ZY.1	0	-	0	0	2368	0.0000000
zheyou73v0_A08	14684397	14684700	BnaA08T0104600ZY	0	+	0	0	303	0.0000000
zheyou73v0_A08	14688088	14688606	BnaA08T0104700ZY	0	+	0	0	518	0.0000000
zheyou73v0_A08	14704256	14705721	BnaA08T0104800ZY	0	-	0	0	1465	0.0000000
zheyou73v0_A08	14711191	14713569	BnaA08T0104900ZY	0	+	0	0	2378	0.0000000
zheyou73v0_A08	14715987	14722757	BnaA08T0105000ZY	0	-	0	0	6770	0.0000000
zheyou73v0_A08	14729318	14732644	BnaA08T0105100ZY	0	-	0	0	3326	0.0000000
zheyou73v0_A08	14738433	14739027	BnaA08T0105200ZY	0	-	0	0	594	0.0000000
zheyou73v0_A08	14753701	14757084	BnaA08T0105300ZY	0	+	0	0	3383	0.0000000
zheyou73v0_A08	14758572	14759500	BnaA08T0105400ZY	0	+	0	0	928	0.0000000
zheyou73v0_A08	14760561	14765969	BnaA08T0105500ZY	0	+	0	0	5408	0.0000000
zheyou73v0_A08	14769998	14770641	BnaA08T0105600ZY	0	+	0	0	643	0.0000000
zheyou73v0_A08	14807344	14808208	BnaA08T0105700ZY	0	+	0	0	864	0.0000000
zheyou73v0_A08	14817352	14819117	BnaA08T0105800ZY	0	-	0	0	1765	0.0000000
zheyou73v0_A08	14825173	14825877	BnaA08T0105900ZY	0	-	0	0	704	0.0000000
zheyou73v0_A08	14832508	14834675	BnaA08T0106000ZY	0	+	0	0	2167	0.0000000
zheyou73v0_A08	14836549	14838086	BnaA08T0106100ZY	0	-	0	0	1537	0.0000000
zheyou73v0_A08	14846216	14847739	BnaA08T0106200ZY	0	+	0	0	1523	0.0000000
zheyou73v0_A08	14853249	14853516	BnaA08T0106300ZY	0	+	0	0	267	0.0000000
zheyou73v0_A08	14864082	14865090	BnaA08T0106400ZY	0	+	0	0	1008	0.0000000
zheyou73v0_A08	14865442	14867121	BnaA08T0106500ZY	0	-	0	0	1679	0.0000000
zheyou73v0_A08	14865442	14867143	BnaA08T0106500ZY.1	0	-	0	0	1701	0.0000000
zheyou73v0_A08	14865442	14867143	BnaA08T0106500ZY.2	0	-	0	0	1701	0.0000000
zheyou73v0_A08	14896721	14899066	BnaA08T0106600ZY	0	+	0	0	2345	0.0000000
zheyou73v0_A08	14906175	14908929	BnaA08T0106700ZY	0	+	0	0	2754	0.0000000
zheyou73v0_A08	14911827	14914454	BnaA08T0106800ZY	0	+	0	0	2627	0.0000000
zheyou73v0_A08	14925851	14926188	BnaA08T0106900ZY	0	+	0	0	337	0.0000000
zheyou73v0_A08	14930747	14933571	BnaA08T0107000ZY	0	+	0	0	2824	0.0000000
zheyou73v0_A08	14936990	14938955	BnaA08T0107100ZY	0	+	0	0	1965	0.0000000
zheyou73v0_A08	14949060	14949574	BnaA08T0107200ZY	0	+	0	0	514	0.0000000
zheyou73v0_A08	14954514	14956596	BnaA08T0107300ZY	0	-	0	0	2082	0.0000000
zheyou73v0_A08	14968490	14969488	BnaA08T0107400ZY	0	+	0	0	998	0.0000000
zheyou73v0_A08	14969805	14972404	BnaA08T0107500ZY	0	-	0	0	2599	0.0000000
zheyou73v0_A08	14973231	14973735	BnaA08T0107600ZY	0	-	0	0	504	0.0000000
zheyou73v0_A08	14983815	14985310	BnaA08T0107700ZY	0	+	0	0	1495	0.0000000
zheyou73v0_A08	14986026	14989561	BnaA08T0107800ZY	0	-	0	0	3535	0.0000000
zheyou73v0_A08	15005140	15030764	BnaA08T0107900ZY	0	-	0	0	25624	0.0000000
zheyou73v0_A08	15036074	15038525	BnaA08T0108000ZY	0	+	0	0	2451	0.0000000
zheyou73v0_A08	15036074	15038525	BnaA08T0108000ZY.1	0	+	0	0	2451	0.0000000
zheyou73v0_A08	15036074	15038525	BnaA08T0108000ZY.2	0	+	0	0	2451	0.0000000
zheyou73v0_A08	15036074	15038525	BnaA08T0108000ZY.3	0	+	0	0	2451	0.0000000
zheyou73v0_A08	15036074	15038525	BnaA08T0108000ZY.4	0	+	0	0	2451	0.0000000
zheyou73v0_A08	15036074	15038525	BnaA08T0108000ZY.5	0	+	0	0	2451	0.0000000
zheyou73v0_A08	15036074	15038525	BnaA08T0108000ZY.6	0	+	0	0	2451	0.0000000
zheyou73v0_A08	15048731	15049115	BnaA08T0108100ZY	0	-	0	0	384	0.0000000
zheyou73v0_A08	15050311	15050704	BnaA08T0108200ZY	0	-	0	0	393	0.0000000
zheyou73v0_A08	15052486	15054267	BnaA08T0108300ZY	0	+	0	0	1781	0.0000000
zheyou73v0_A08	15061706	15063879	BnaA08T0108400ZY	0	-	0	0	2173	0.0000000
zheyou73v0_A08	15061706	15063879	BnaA08T0108400ZY.1	0	-	0	0	2173	0.0000000
zheyou73v0_A08	15064442	15066399	BnaA08T0108500ZY	0	+	0	0	1957	0.0000000
zheyou73v0_A08	15068474	15070109	BnaA08T0108600ZY	0	+	0	0	1635	0.0000000
zheyou73v0_A08	15073239	15075982	BnaA08T0108700ZY	0	+	0	0	2743	0.0000000
zheyou73v0_A08	15082002	15083030	BnaA08T0108800ZY	0	+	0	0	1028	0.0000000
zheyou73v0_A08	15085744	15086449	BnaA08T0108900ZY	0	+	0	0	705	0.0000000
zheyou73v0_A08	15091436	15102932	BnaA08T0109000ZY	0	-	0	0	11496	0.0000000
zheyou73v0_A08	15104629	15106173	BnaA08T0109100ZY	0	+	0	0	1544	0.0000000
zheyou73v0_A08	15108146	15111056	BnaA08T0109200ZY	0	-	0	0	2910	0.0000000
zheyou73v0_A08	15119802	15145163	BnaA08T0109300ZY	0	-	0	0	25361	0.0000000
zheyou73v0_A08	15178872	15180222	BnaA08T0109400ZY	0	-	0	0	1350	0.0000000
zheyou73v0_A08	15187116	15199784	BnaA08T0109500ZY	0	+	0	0	12668	0.0000000
zheyou73v0_A08	15206558	15210909	BnaA08T0109600ZY	0	+	0	0	4351	0.0000000
zheyou73v0_A08	15211552	15216247	BnaA08T0109700ZY	0	+	0	0	4695	0.0000000
zheyou73v0_A08	15217574	15217784	BnaA08T0109800ZY	0	-	0	0	210	0.0000000
zheyou73v0_A08	15222024	15223539	BnaA08T0109900ZY	0	+	0	0	1515	0.0000000
zheyou73v0_A08	15223810	15225296	BnaA08T0110000ZY	0	-	0	0	1486	0.0000000
zheyou73v0_A08	15228548	15228857	BnaA08T0110100ZY	0	+	0	0	309	0.0000000
zheyou73v0_A08	15229533	15230154	BnaA08T0110200ZY	0	+	0	0	621	0.0000000
zheyou73v0_A08	15232442	15233492	BnaA08T0110300ZY	0	+	0	0	1050	0.0000000
zheyou73v0_A08	15234921	15235770	BnaA08T0110400ZY	0	+	0	0	849	0.0000000
zheyou73v0_A08	15240023	15240233	BnaA08T0110500ZY	0	-	0	0	210	0.0000000
zheyou73v0_A08	15242696	15246200	BnaA08T0110600ZY	0	+	0	0	3504	0.0000000
zheyou73v0_A08	15246475	15249701	BnaA08T0110700ZY	0	-	0	0	3226	0.0000000
zheyou73v0_A08	15254827	15256171	BnaA08T0110800ZY	0	-	0	0	1344	0.0000000
zheyou73v0_A08	15258233	15264630	BnaA08T0110900ZY	0	-	0	0	6397	0.0000000
zheyou73v0_A08	15269773	15271206	BnaA08T0111000ZY	0	-	0	0	1433	0.0000000
zheyou73v0_A08	15272937	15274483	BnaA08T0111100ZY	0	+	0	0	1546	0.0000000
zheyou73v0_A08	15276132	15276465	BnaA08T0111200ZY	0	-	0	0	333	0.0000000
zheyou73v0_A08	15276800	15277329	BnaA08T0111300ZY	0	-	0	0	529	0.0000000
zheyou73v0_A08	15278453	15287669	BnaA08T0111400ZY	0	-	0	0	9216	0.0000000
zheyou73v0_A08	15287722	15288154	BnaA08T0111500ZY	0	-	0	0	432	0.0000000
zheyou73v0_A08	15292216	15293396	BnaA08T0111600ZY	0	-	0	0	1180	0.0000000
zheyou73v0_A08	15296159	15298627	BnaA08T0111700ZY	0	-	0	0	2468	0.0000000
zheyou73v0_A08	15296159	15298627	BnaA08T0111700ZY.1	0	-	0	0	2468	0.0000000
zheyou73v0_A08	15296159	15298627	BnaA08T0111700ZY.2	0	-	0	0	2468	0.0000000
zheyou73v0_A08	15303811	15303970	BnaA08T0111800ZY	0	+	0	0	159	0.0000000
zheyou73v0_A08	15310167	15311358	BnaA08T0111900ZY	0	+	0	0	1191	0.0000000
zheyou73v0_A08	15331545	15334338	BnaA08T0112000ZY	0	+	0	0	2793	0.0000000
zheyou73v0_A08	15337187	15340788	BnaA08T0112100ZY	0	-	0	0	3601	0.0000000
zheyou73v0_A08	15354684	15355506	BnaA08T0112200ZY	0	+	0	0	822	0.0000000
zheyou73v0_A08	15356346	15356916	BnaA08T0112300ZY	0	-	0	0	570	0.0000000
zheyou73v0_A08	15362867	15367079	BnaA08T0112400ZY	0	+	0	0	4212	0.0000000
zheyou73v0_A08	15373374	15376053	BnaA08T0112500ZY	0	+	0	0	2679	0.0000000
zheyou73v0_A08	15376109	15377257	BnaA08T0112600ZY	0	-	0	0	1148	0.0000000
zheyou73v0_A08	15380782	15382953	BnaA08T0112700ZY	0	+	0	0	2171	0.0000000
zheyou73v0_A08	15385558	15386722	BnaA08T0112800ZY	0	-	0	0	1164	0.0000000
zheyou73v0_A08	15388162	15388619	BnaA08T0112900ZY	0	-	0	0	457	0.0000000
zheyou73v0_A08	15400462	15401444	BnaA08T0113000ZY	0	+	0	0	982	0.0000000
zheyou73v0_A08	15405176	15408642	BnaA08T0113100ZY	0	-	0	0	3466	0.0000000
zheyou73v0_A08	15419936	15423608	BnaA08T0113200ZY	0	+	0	0	3672	0.0000000
zheyou73v0_A08	15424711	15430340	BnaA08T0113300ZY	0	+	0	0	5629	0.0000000
zheyou73v0_A08	15426353	15429943	BnaA08T0113300ZY.1	0	+	0	0	3590	0.0000000
zheyou73v0_A08	15432296	15433790	BnaA08T0113400ZY	0	+	0	0	1494	0.0000000
zheyou73v0_A08	15434662	15436972	BnaA08T0113500ZY	0	-	0	0	2310	0.0000000
zheyou73v0_A08	15438086	15439333	BnaA08T0113600ZY	0	+	0	0	1247	0.0000000
zheyou73v0_A08	15439471	15440965	BnaA08T0113700ZY	0	+	0	0	1494	0.0000000
zheyou73v0_A08	15439471	15440965	BnaA08T0113700ZY.1	0	+	0	0	1494	0.0000000
zheyou73v0_A08	15450663	15451445	BnaA08T0113800ZY	0	-	0	0	782	0.0000000
zheyou73v0_A08	15454391	15457705	BnaA08T0113900ZY	0	+	0	0	3314	0.0000000
zheyou73v0_A08	15458968	15459370	BnaA08T0114000ZY	0	+	0	0	402	0.0000000
zheyou73v0_A08	15459807	15461215	BnaA08T0114100ZY	0	-	0	0	1408	0.0000000
zheyou73v0_A08	15461841	15467700	BnaA08T0114200ZY	0	-	0	0	5859	0.0000000
zheyou73v0_A08	15474158	15475996	BnaA08T0114300ZY	0	-	0	0	1838	0.0000000
zheyou73v0_A08	15479520	15480235	BnaA08T0114400ZY	0	-	0	0	715	0.0000000
zheyou73v0_A08	15492168	15494459	BnaA08T0114500ZY	0	+	0	0	2291	0.0000000
zheyou73v0_A08	15498065	15498672	BnaA08T0114600ZY	0	+	0	0	607	0.0000000
zheyou73v0_A08	15500422	15505023	BnaA08T0114700ZY	0	-	0	0	4601	0.0000000
zheyou73v0_A08	15508239	15512122	BnaA08T0114800ZY	0	+	0	0	3883	0.0000000
zheyou73v0_A08	15514640	15517002	BnaA08T0114900ZY	0	+	0	0	2362	0.0000000
zheyou73v0_A08	15527619	15533599	BnaA08T0115000ZY	0	+	0	0	5980	0.0000000
zheyou73v0_A08	15535723	15536314	BnaA08T0115100ZY	0	-	0	0	591	0.0000000
zheyou73v0_A08	15539328	15541333	BnaA08T0115200ZY	0	-	0	0	2005	0.0000000
zheyou73v0_A08	15555605	15559419	BnaA08T0115300ZY	0	-	0	0	3814	0.0000000
zheyou73v0_A08	15565490	15569993	BnaA08T0115400ZY	0	+	0	0	4503	0.0000000
zheyou73v0_A08	15570698	15571473	BnaA08T0115500ZY	0	-	0	0	775	0.0000000
zheyou73v0_A08	15575752	15577082	BnaA08T0115600ZY	0	-	0	0	1330	0.0000000
zheyou73v0_A08	15576052	15577082	BnaA08T0115600ZY.1	0	-	0	0	1030	0.0000000
zheyou73v0_A08	15576366	15577082	BnaA08T0115600ZY.2	0	-	0	0	716	0.0000000
zheyou73v0_A08	15577690	15578713	BnaA08T0115700ZY	0	-	0	0	1023	0.0000000
zheyou73v0_A08	15583307	15585103	BnaA08T0115800ZY	0	-	0	0	1796	0.0000000
zheyou73v0_A08	15588752	15591280	BnaA08T0115900ZY	0	-	0	0	2528	0.0000000
zheyou73v0_A08	15594383	15596233	BnaA08T0116000ZY	0	+	0	0	1850	0.0000000
zheyou73v0_A08	15596652	15598159	BnaA08T0116100ZY	0	+	0	0	1507	0.0000000
zheyou73v0_A08	15596652	15598159	BnaA08T0116100ZY.1	0	+	0	0	1507	0.0000000
zheyou73v0_A08	15598518	15601053	BnaA08T0116200ZY	0	-	0	0	2535	0.0000000
zheyou73v0_A08	15601435	15601649	BnaA08T0116300ZY	0	+	0	0	214	0.0000000
zheyou73v0_A08	15604043	15604312	BnaA08T0116400ZY	0	-	0	0	269	0.0000000
zheyou73v0_A08	15604559	15607091	BnaA08T0116500ZY	0	-	0	0	2532	0.0000000
zheyou73v0_A08	15622512	15623242	BnaA08T0116600ZY	0	+	0	0	730	0.0000000
zheyou73v0_A08	15631982	15633199	BnaA08T0116700ZY	0	+	0	0	1217	0.0000000
zheyou73v0_A08	15641375	15642656	BnaA08T0116800ZY	0	+	0	0	1281	0.0000000
zheyou73v0_A08	15646287	15651534	BnaA08T0116900ZY	0	+	0	0	5247	0.0000000
zheyou73v0_A08	15659050	15671360	BnaA08T0117000ZY	0	-	0	0	12310	0.0000000
zheyou73v0_A08	15693949	15694881	BnaA08T0117100ZY	0	-	0	0	932	0.0000000
zheyou73v0_A08	15695392	15697934	BnaA08T0117200ZY	0	-	0	0	2542	0.0000000
zheyou73v0_A08	15709394	15712877	BnaA08T0117300ZY	0	-	0	0	3483	0.0000000
zheyou73v0_A08	15716309	15717374	BnaA08T0117400ZY	0	-	0	0	1065	0.0000000
zheyou73v0_A08	15717965	15719061	BnaA08T0117500ZY	0	-	0	0	1096	0.0000000
zheyou73v0_A08	15719413	15725735	BnaA08T0117600ZY	0	+	0	0	6322	0.0000000
zheyou73v0_A08	15726066	15728010	BnaA08T0117700ZY	0	+	0	0	1944	0.0000000
zheyou73v0_A08	15726066	15728010	BnaA08T0117700ZY.1	0	+	0	0	1944	0.0000000
zheyou73v0_A08	15728684	15733652	BnaA08T0117800ZY	0	-	0	0	4968	0.0000000
zheyou73v0_A08	15734430	15734604	BnaA08T0117900ZY	0	+	0	0	174	0.0000000
zheyou73v0_A08	15735381	15736270	BnaA08T0118000ZY	0	-	0	0	889	0.0000000
zheyou73v0_A08	15740124	15740563	BnaA08T0118100ZY	0	-	0	0	439	0.0000000
zheyou73v0_A08	15756606	15757923	BnaA08T0118200ZY	0	-	0	0	1317	0.0000000
zheyou73v0_A08	15767184	15767694	BnaA08T0118300ZY	0	-	0	0	510	0.0000000
zheyou73v0_A08	15772161	15773313	BnaA08T0118400ZY	0	-	0	0	1152	0.0000000
zheyou73v0_A08	15783963	15784347	BnaA08T0118500ZY	0	-	0	0	384	0.0000000
zheyou73v0_A08	15785242	15786564	BnaA08T0118600ZY	0	-	0	0	1322	0.0000000
zheyou73v0_A08	15787023	15788069	BnaA08T0118700ZY	0	-	0	0	1046	0.0000000
zheyou73v0_A08	15794872	15796853	BnaA08T0118800ZY	0	-	0	0	1981	0.0000000
zheyou73v0_A08	15798203	15802581	BnaA08T0118900ZY	0	-	0	0	4378	0.0000000
zheyou73v0_A08	15803915	15806326	BnaA08T0119000ZY	0	+	0	0	2411	0.0000000
zheyou73v0_A08	15806522	15806796	BnaA08T0119100ZY	0	+	0	0	274	0.0000000
zheyou73v0_A08	15807298	15813355	BnaA08T0119200ZY	0	-	0	0	6057	0.0000000
zheyou73v0_A08	15824777	15825135	BnaA08T0119300ZY	0	+	0	0	358	0.0000000
zheyou73v0_A08	15825230	15825824	BnaA08T0119400ZY	0	+	0	0	594	0.0000000
zheyou73v0_A08	15825932	15826322	BnaA08T0119500ZY	0	+	0	0	390	0.0000000
zheyou73v0_A08	15826646	15828106	BnaA08T0119600ZY	0	-	0	0	1460	0.0000000
zheyou73v0_A08	15831576	15832377	BnaA08T0119700ZY	0	-	0	0	801	0.0000000
zheyou73v0_A08	15838284	15839103	BnaA08T0119800ZY	0	+	0	0	819	0.0000000
zheyou73v0_A08	15853707	15856278	BnaA08T0119900ZY	0	+	0	0	2571	0.0000000
zheyou73v0_A08	15857585	15858080	BnaA08T0120000ZY	0	-	0	0	495	0.0000000
zheyou73v0_A08	15859797	15861510	BnaA08T0120100ZY	0	-	0	0	1713	0.0000000
zheyou73v0_A08	15866179	15866845	BnaA08T0120200ZY	0	-	0	0	666	0.0000000
zheyou73v0_A08	15868371	15876440	BnaA08T0120300ZY	0	-	0	0	8069	0.0000000
zheyou73v0_A08	15880765	15886349	BnaA08T0120400ZY	0	-	0	0	5584	0.0000000
zheyou73v0_A08	15880765	15886349	BnaA08T0120400ZY.1	0	-	0	0	5584	0.0000000
zheyou73v0_A08	15913340	15915101	BnaA08T0120500ZY	0	-	0	0	1761	0.0000000
zheyou73v0_A08	15925757	15929460	BnaA08T0120600ZY	0	-	0	0	3703	0.0000000
zheyou73v0_A08	15925757	15929315	BnaA08T0120600ZY.1	0	-	0	0	3558	0.0000000
zheyou73v0_A08	15942312	15945839	BnaA08T0120700ZY	0	+	0	0	3527	0.0000000
zheyou73v0_A08	15942312	15945839	BnaA08T0120700ZY.1	0	+	0	0	3527	0.0000000
zheyou73v0_A08	15945857	15948162	BnaA08T0120800ZY	0	-	0	0	2305	0.0000000
zheyou73v0_A08	15951411	15952763	BnaA08T0120900ZY	0	-	0	0	1352	0.0000000
zheyou73v0_A08	15954498	15956313	BnaA08T0121000ZY	0	+	0	0	1815	0.0000000
zheyou73v0_A08	15954498	15956313	BnaA08T0121000ZY.1	0	+	0	0	1815	0.0000000
zheyou73v0_A08	15956864	15958070	BnaA08T0121100ZY	0	-	0	0	1206	0.0000000
zheyou73v0_A08	15962519	15963728	BnaA08T0121200ZY	0	-	0	0	1209	0.0000000
zheyou73v0_A08	15964183	15964582	BnaA08T0121300ZY	0	+	0	0	399	0.0000000
zheyou73v0_A08	15965157	15966992	BnaA08T0121400ZY	0	+	0	0	1835	0.0000000
zheyou73v0_A08	15967630	15969683	BnaA08T0121500ZY	0	+	0	0	2053	0.0000000
zheyou73v0_A08	15979411	15980738	BnaA08T0121600ZY	0	-	0	0	1327	0.0000000
zheyou73v0_A08	15984525	15986036	BnaA08T0121700ZY	0	+	0	0	1511	0.0000000
zheyou73v0_A08	16002653	16004398	BnaA08T0121800ZY	0	-	0	0	1745	0.0000000
zheyou73v0_A08	16002653	16004398	BnaA08T0121800ZY.1	0	-	0	0	1745	0.0000000
zheyou73v0_A08	16016793	16017147	BnaA08T0121900ZY	0	+	0	0	354	0.0000000
zheyou73v0_A08	16018874	16024100	BnaA08T0122000ZY	0	-	0	0	5226	0.0000000
zheyou73v0_A08	16052102	16053069	BnaA08T0122100ZY	0	+	0	0	967	0.0000000
zheyou73v0_A08	16075989	16076469	BnaA08T0122200ZY	0	+	0	0	480	0.0000000
zheyou73v0_A08	16081611	16082446	BnaA08T0122300ZY	0	+	0	0	835	0.0000000
zheyou73v0_A08	16088965	16089859	BnaA08T0122400ZY	0	+	0	0	894	0.0000000
zheyou73v0_A08	16090985	16093282	BnaA08T0122500ZY	0	+	0	0	2297	0.0000000
zheyou73v0_A08	16098349	16099147	BnaA08T0122600ZY	0	-	0	0	798	0.0000000
zheyou73v0_A08	16101282	16102719	BnaA08T0122700ZY	0	-	0	0	1437	0.0000000
zheyou73v0_A08	16117006	16118627	BnaA08T0122800ZY	0	+	0	0	1621	0.0000000
zheyou73v0_A08	16128529	16129177	BnaA08T0122900ZY	0	+	0	0	648	0.0000000
zheyou73v0_A08	16136486	16137904	BnaA08T0123000ZY	0	+	0	0	1418	0.0000000
zheyou73v0_A08	16144443	16147230	BnaA08T0123100ZY	0	+	0	0	2787	0.0000000
zheyou73v0_A08	16148982	16152533	BnaA08T0123200ZY	0	+	0	0	3551	0.0000000
zheyou73v0_A08	16166502	16170712	BnaA08T0123300ZY	0	-	0	0	4210	0.0000000
zheyou73v0_A08	16166502	16170752	BnaA08T0123300ZY.1	0	-	0	0	4250	0.0000000
zheyou73v0_A08	16192576	16194267	BnaA08T0123400ZY	0	-	0	0	1691	0.0000000
zheyou73v0_A08	16208665	16209427	BnaA08T0123500ZY	0	+	0	0	762	0.0000000
zheyou73v0_A08	16209716	16211688	BnaA08T0123600ZY	0	-	0	0	1972	0.0000000
zheyou73v0_A08	16227807	16230383	BnaA08T0123700ZY	0	+	0	0	2576	0.0000000
zheyou73v0_A08	16230513	16243058	BnaA08T0123800ZY	0	-	0	0	12545	0.0000000
zheyou73v0_A08	16244109	16246657	BnaA08T0123900ZY	0	-	0	0	2548	0.0000000
zheyou73v0_A08	16249802	16251789	BnaA08T0124000ZY	0	+	0	0	1987	0.0000000
zheyou73v0_A08	16252409	16252766	BnaA08T0124100ZY	0	-	0	0	357	0.0000000
zheyou73v0_A08	16253753	16254328	BnaA08T0124200ZY	0	-	0	0	575	0.0000000
zheyou73v0_A08	16280617	16281800	BnaA08T0124300ZY	0	+	0	0	1183	0.0000000
zheyou73v0_A08	16308480	16309323	BnaA08T0124400ZY	0	+	0	0	843	0.0000000
zheyou73v0_A08	16312638	16314325	BnaA08T0124500ZY	0	+	0	0	1687	0.0000000
zheyou73v0_A08	16316924	16318957	BnaA08T0124600ZY	0	+	0	0	2033	0.0000000
zheyou73v0_A08	16319521	16324732	BnaA08T0124700ZY	0	-	0	0	5211	0.0000000
zheyou73v0_A08	16329929	16332142	BnaA08T0124800ZY	0	+	0	0	2213	0.0000000
zheyou73v0_A08	16339817	16342201	BnaA08T0124900ZY	0	+	0	0	2384	0.0000000
zheyou73v0_A08	16356298	16359335	BnaA08T0125000ZY	0	+	0	0	3037	0.0000000
zheyou73v0_A08	16356298	16359512	BnaA08T0125000ZY.1	0	+	0	0	3214	0.0000000
zheyou73v0_A08	16356298	16359512	BnaA08T0125000ZY.2	0	+	0	0	3214	0.0000000
zheyou73v0_A08	16362658	16365658	BnaA08T0125100ZY	0	+	0	0	3000	0.0000000
zheyou73v0_A08	16362658	16365658	BnaA08T0125100ZY.1	0	+	0	0	3000	0.0000000
zheyou73v0_A08	16366455	16367214	BnaA08T0125200ZY	0	-	0	0	759	0.0000000
zheyou73v0_A08	16368101	16368875	BnaA08T0125300ZY	0	-	0	0	774	0.0000000
zheyou73v0_A08	16376035	16376835	BnaA08T0125400ZY	0	+	0	0	800	0.0000000
zheyou73v0_A08	16381345	16384122	BnaA08T0125500ZY	0	-	0	0	2777	0.0000000
zheyou73v0_A08	16386096	16386375	BnaA08T0125600ZY	0	+	0	0	279	0.0000000
zheyou73v0_A08	16386635	16387709	BnaA08T0125700ZY	0	+	0	0	1074	0.0000000
zheyou73v0_A08	16400456	16405806	BnaA08T0125800ZY	0	+	0	0	5350	0.0000000
zheyou73v0_A08	16418960	16420490	BnaA08T0125900ZY	0	+	0	0	1530	0.0000000
zheyou73v0_A08	16423494	16425188	BnaA08T0126000ZY	0	-	0	0	1694	0.0000000
zheyou73v0_A08	16435179	16437429	BnaA08T0126100ZY	0	+	0	0	2250	0.0000000
zheyou73v0_A08	16443089	16443655	BnaA08T0126200ZY	0	-	0	0	566	0.0000000
zheyou73v0_A08	16448487	16449512	BnaA08T0126300ZY	0	-	0	0	1025	0.0000000
zheyou73v0_A08	16462970	16463705	BnaA08T0126400ZY	0	+	0	0	735	0.0000000
zheyou73v0_A08	16465807	16465969	BnaA08T0126500ZY	0	+	0	0	162	0.0000000
zheyou73v0_A08	16467674	16468409	BnaA08T0126600ZY	0	+	0	0	735	0.0000000
zheyou73v0_A08	16470510	16470672	BnaA08T0126700ZY	0	+	0	0	162	0.0000000
zheyou73v0_A08	16482247	16482942	BnaA08T0126800ZY	0	-	0	0	695	0.0000000
zheyou73v0_A08	16484588	16485228	BnaA08T0126900ZY	0	+	0	0	640	0.0000000
zheyou73v0_A08	16486770	16488277	BnaA08T0127000ZY	0	-	0	0	1507	0.0000000
zheyou73v0_A08	16489404	16491166	BnaA08T0127100ZY	0	-	0	0	1762	0.0000000
zheyou73v0_A08	16496303	16498934	BnaA08T0127200ZY	0	+	0	0	2631	0.0000000
zheyou73v0_A08	16499642	16501788	BnaA08T0127300ZY	0	-	0	0	2146	0.0000000
zheyou73v0_A08	16505227	16506249	BnaA08T0127400ZY	0	-	0	0	1022	0.0000000
zheyou73v0_A08	16514514	16520509	BnaA08T0127500ZY	0	-	0	0	5995	0.0000000
zheyou73v0_A08	16522283	16525420	BnaA08T0127600ZY	0	-	0	0	3137	0.0000000
zheyou73v0_A08	16531484	16533504	BnaA08T0127700ZY	0	+	0	0	2020	0.0000000
zheyou73v0_A08	16533669	16535006	BnaA08T0127800ZY	0	-	0	0	1337	0.0000000
zheyou73v0_A08	16535366	16537072	BnaA08T0127900ZY	0	-	0	0	1706	0.0000000
zheyou73v0_A08	16541371	16541659	BnaA08T0128000ZY	0	-	0	0	288	0.0000000
zheyou73v0_A08	16541873	16543485	BnaA08T0128100ZY	0	-	0	0	1612	0.0000000
zheyou73v0_A08	16553279	16553804	BnaA08T0128200ZY	0	-	0	0	525	0.0000000
zheyou73v0_A08	16559522	16559843	BnaA08T0128300ZY	0	+	0	0	321	0.0000000
zheyou73v0_A08	16560309	16560624	BnaA08T0128400ZY	0	-	0	0	315	0.0000000
zheyou73v0_A08	16586590	16587270	BnaA08T0128500ZY	0	+	0	0	680	0.0000000
zheyou73v0_A08	16599437	16600911	BnaA08T0128600ZY	0	+	0	0	1474	0.0000000
zheyou73v0_A08	16599437	16600911	BnaA08T0128600ZY.1	0	+	0	0	1474	0.0000000
zheyou73v0_A08	16608705	16612099	BnaA08T0128700ZY	0	+	0	0	3394	0.0000000
zheyou73v0_A08	16613578	16614640	BnaA08T0128800ZY	0	-	0	0	1062	0.0000000
zheyou73v0_A08	16615221	16615806	BnaA08T0128900ZY	0	+	0	0	585	0.0000000
zheyou73v0_A08	16616208	16617727	BnaA08T0129000ZY	0	-	0	0	1519	0.0000000
zheyou73v0_A08	16618892	16620337	BnaA08T0129100ZY	0	-	0	0	1445	0.0000000
zheyou73v0_A08	16618892	16620337	BnaA08T0129100ZY.1	0	-	0	0	1445	0.0000000
zheyou73v0_A08	16624008	16625430	BnaA08T0129200ZY	0	-	0	0	1422	0.0000000
zheyou73v0_A08	16626067	16628642	BnaA08T0129300ZY	0	+	0	0	2575	0.0000000
zheyou73v0_A08	16628749	16632079	BnaA08T0129400ZY	0	-	0	0	3330	0.0000000
zheyou73v0_A08	16636842	16637479	BnaA08T0129500ZY	0	-	0	0	637	0.0000000
zheyou73v0_A08	16647846	16648832	BnaA08T0129600ZY	0	-	0	0	986	0.0000000
zheyou73v0_A08	16654780	16658379	BnaA08T0129700ZY	0	-	0	0	3599	0.0000000
zheyou73v0_A08	16660379	16662800	BnaA08T0129800ZY	0	-	0	0	2421	0.0000000
zheyou73v0_A08	16669636	16670839	BnaA08T0129900ZY	0	-	0	0	1203	0.0000000
zheyou73v0_A08	16676104	16677625	BnaA08T0130000ZY	0	-	0	0	1521	0.0000000
zheyou73v0_A08	16679397	16680822	BnaA08T0130100ZY	0	-	0	0	1425	0.0000000
zheyou73v0_A08	16687545	16688342	BnaA08T0130200ZY	0	-	0	0	797	0.0000000
zheyou73v0_A08	16689921	16692770	BnaA08T0130300ZY	0	+	0	0	2849	0.0000000
zheyou73v0_A08	16712525	16714935	BnaA08T0130400ZY	0	+	0	0	2410	0.0000000
zheyou73v0_A08	16715641	16718245	BnaA08T0130500ZY	0	+	0	0	2604	0.0000000
zheyou73v0_A08	16718089	16723015	BnaA08T0130600ZY	0	-	0	0	4926	0.0000000
zheyou73v0_A08	16719207	16722863	BnaA08T0130600ZY.1	0	-	0	0	3656	0.0000000
zheyou73v0_A08	16730804	16733485	BnaA08T0130700ZY	0	-	0	0	2681	0.0000000
zheyou73v0_A08	16733951	16738370	BnaA08T0130800ZY	0	-	0	0	4419	0.0000000
zheyou73v0_A08	16744066	16744447	BnaA08T0130900ZY	0	-	0	0	381	0.0000000
zheyou73v0_A08	16759045	16762687	BnaA08T0131000ZY	0	-	0	0	3642	0.0000000
zheyou73v0_A08	16764357	16765827	BnaA08T0131100ZY	0	-	0	0	1470	0.0000000
zheyou73v0_A08	16768828	16770111	BnaA08T0131200ZY	0	-	0	0	1283	0.0000000
zheyou73v0_A08	16768828	16770141	BnaA08T0131200ZY.1	0	-	0	0	1313	0.0000000
zheyou73v0_A08	16768828	16770156	BnaA08T0131200ZY.2	0	-	0	0	1328	0.0000000
zheyou73v0_A08	16770163	16771178	BnaA08T0131300ZY	0	-	0	0	1015	0.0000000
zheyou73v0_A08	16771747	16772008	BnaA08T0131400ZY	0	-	0	0	261	0.0000000
zheyou73v0_A08	16772984	16775448	BnaA08T0131500ZY	0	+	0	0	2464	0.0000000
zheyou73v0_A08	16778149	16780801	BnaA08T0131600ZY	0	-	0	0	2652	0.0000000
zheyou73v0_A08	16793073	16793864	BnaA08T0131700ZY	0	-	0	0	791	0.0000000
zheyou73v0_A08	16802205	16802955	BnaA08T0131800ZY	0	-	0	0	750	0.0000000
zheyou73v0_A08	16807371	16809722	BnaA08T0131900ZY	0	+	0	0	2351	0.0000000
zheyou73v0_A08	16809876	16810953	BnaA08T0132000ZY	0	-	0	0	1077	0.0000000
zheyou73v0_A08	16811763	16815213	BnaA08T0132100ZY	0	-	0	0	3450	0.0000000
zheyou73v0_A08	16825987	16827609	BnaA08T0132200ZY	0	-	0	0	1622	0.0000000
zheyou73v0_A08	16828462	16830553	BnaA08T0132300ZY	0	-	0	0	2091	0.0000000
zheyou73v0_A08	16840348	16842158	BnaA08T0132400ZY	0	+	0	0	1810	0.0000000
zheyou73v0_A08	16843554	16845275	BnaA08T0132500ZY	0	+	0	0	1721	0.0000000
zheyou73v0_A08	16845938	16847473	BnaA08T0132600ZY	0	+	0	0	1535	0.0000000
zheyou73v0_A08	16847853	16849782	BnaA08T0132700ZY	0	-	0	0	1929	0.0000000
zheyou73v0_A08	16858500	16859124	BnaA08T0132800ZY	0	+	0	0	624	0.0000000
zheyou73v0_A08	16864390	16865987	BnaA08T0132900ZY	0	-	0	0	1597	0.0000000
zheyou73v0_A08	16866326	16867543	BnaA08T0133000ZY	0	-	0	0	1217	0.0000000
zheyou73v0_A08	16867848	16871021	BnaA08T0133100ZY	0	-	0	0	3173	0.0000000
zheyou73v0_A08	16867848	16871021	BnaA08T0133100ZY.1	0	-	0	0	3173	0.0000000
zheyou73v0_A08	16872091	16875335	BnaA08T0133200ZY	0	-	0	0	3244	0.0000000
zheyou73v0_A08	16884312	16885478	BnaA08T0133300ZY	0	-	0	0	1166	0.0000000
zheyou73v0_A08	16889012	16891773	BnaA08T0133400ZY	0	-	0	0	2761	0.0000000
zheyou73v0_A08	16896021	16898953	BnaA08T0133500ZY	0	+	0	0	2932	0.0000000
zheyou73v0_A08	16900862	16903992	BnaA08T0133600ZY	0	+	0	0	3130	0.0000000
zheyou73v0_A08	16904948	16907340	BnaA08T0133700ZY	0	+	0	0	2392	0.0000000
zheyou73v0_A08	16912758	16913531	BnaA08T0133800ZY	0	-	0	0	773	0.0000000
zheyou73v0_A08	16928437	16930342	BnaA08T0133900ZY	0	-	0	0	1905	0.0000000
zheyou73v0_A08	16933627	16935708	BnaA08T0134000ZY	0	+	0	0	2081	0.0000000
zheyou73v0_A08	16936494	16937079	BnaA08T0134100ZY	0	-	0	0	585	0.0000000
zheyou73v0_A08	16951433	16952920	BnaA08T0134200ZY	0	+	0	0	1487	0.0000000
zheyou73v0_A08	16965936	16969966	BnaA08T0134300ZY	0	+	0	0	4030	0.0000000
zheyou73v0_A08	16970287	16972923	BnaA08T0134400ZY	0	+	0	0	2636	0.0000000
zheyou73v0_A08	16977744	16981332	BnaA08T0134500ZY	0	+	0	0	3588	0.0000000
zheyou73v0_A08	16987804	16997206	BnaA08T0134600ZY	0	+	0	0	9402	0.0000000
zheyou73v0_A08	16987804	16995586	BnaA08T0134600ZY.1	0	+	0	0	7782	0.0000000
zheyou73v0_A08	17003478	17005915	BnaA08T0134700ZY	0	+	0	0	2437	0.0000000
zheyou73v0_A08	17006726	17010367	BnaA08T0134800ZY	0	+	0	0	3641	0.0000000
zheyou73v0_A08	17014587	17015100	BnaA08T0134900ZY	0	-	0	0	513	0.0000000
zheyou73v0_A08	17020644	17023569	BnaA08T0135000ZY	0	+	0	0	2925	0.0000000
zheyou73v0_A08	17023728	17025540	BnaA08T0135100ZY	0	+	0	0	1812	0.0000000
zheyou73v0_A08	17025685	17031189	BnaA08T0135200ZY	0	-	0	0	5504	0.0000000
zheyou73v0_A08	17025685	17031140	BnaA08T0135200ZY.1	0	-	0	0	5455	0.0000000
zheyou73v0_A08	17031650	17035627	BnaA08T0135300ZY	0	-	0	0	3977	0.0000000
zheyou73v0_A08	17038440	17039196	BnaA08T0135400ZY	0	+	0	0	756	0.0000000
zheyou73v0_A08	17040088	17041480	BnaA08T0135500ZY	0	+	0	0	1392	0.0000000
zheyou73v0_A08	17042169	17043570	BnaA08T0135600ZY	0	+	0	0	1401	0.0000000
zheyou73v0_A08	17048974	17053171	BnaA08T0135700ZY	0	-	0	0	4197	0.0000000
zheyou73v0_A08	17056394	17056942	BnaA08T0135800ZY	0	-	0	0	548	0.0000000
zheyou73v0_A08	17063079	17065971	BnaA08T0135900ZY	0	-	0	0	2892	0.0000000
zheyou73v0_A08	17066613	17067444	BnaA08T0136000ZY	0	+	0	0	831	0.0000000
zheyou73v0_A08	17071014	17072837	BnaA08T0136100ZY	0	-	0	0	1823	0.0000000
zheyou73v0_A08	17073285	17074838	BnaA08T0136200ZY	0	-	0	0	1553	0.0000000
zheyou73v0_A08	17077636	17078882	BnaA08T0136300ZY	0	+	0	0	1246	0.0000000
zheyou73v0_A08	17081191	17084807	BnaA08T0136400ZY	0	+	0	0	3616	0.0000000
zheyou73v0_A08	17086111	17087903	BnaA08T0136500ZY	0	-	0	0	1792	0.0000000
zheyou73v0_A08	17097184	17100041	BnaA08T0136600ZY	0	+	0	0	2857	0.0000000
zheyou73v0_A08	17100122	17102582	BnaA08T0136700ZY	0	-	0	0	2460	0.0000000
zheyou73v0_A08	17103716	17104730	BnaA08T0136800ZY	0	-	0	0	1014	0.0000000
zheyou73v0_A08	17107547	17111026	BnaA08T0136900ZY	0	+	0	0	3479	0.0000000
zheyou73v0_A08	17107547	17111217	BnaA08T0136900ZY.1	0	+	0	0	3670	0.0000000
zheyou73v0_A08	17116815	17120197	BnaA08T0137000ZY	0	+	0	0	3382	0.0000000
zheyou73v0_A08	17116815	17120197	BnaA08T0137000ZY.1	0	+	0	0	3382	0.0000000
zheyou73v0_A08	17128351	17129881	BnaA08T0137100ZY	0	+	0	0	1530	0.0000000
zheyou73v0_A08	17130153	17138364	BnaA08T0137200ZY	0	-	0	0	8211	0.0000000
zheyou73v0_A08	17130153	17138364	BnaA08T0137200ZY.2	0	-	0	0	8211	0.0000000
zheyou73v0_A08	17131893	17138364	BnaA08T0137200ZY.1	0	-	0	0	6471	0.0000000
zheyou73v0_A08	17140432	17145052	BnaA08T0137300ZY	0	+	0	0	4620	0.0000000
zheyou73v0_A08	17153508	17156475	BnaA08T0137400ZY	0	+	0	0	2967	0.0000000
zheyou73v0_A08	17158771	17159383	BnaA08T0137500ZY	0	-	0	0	612	0.0000000
zheyou73v0_A08	17160098	17164317	BnaA08T0137600ZY	0	+	0	0	4219	0.0000000
zheyou73v0_A08	17166131	17169306	BnaA08T0137700ZY	0	+	0	0	3175	0.0000000
zheyou73v0_A08	17174221	17174913	BnaA08T0137800ZY	0	+	0	0	692	0.0000000
zheyou73v0_A08	17180534	17181192	BnaA08T0137900ZY	0	-	0	0	658	0.0000000
zheyou73v0_A08	17185329	17186978	BnaA08T0138000ZY	0	-	0	0	1649	0.0000000
zheyou73v0_A08	17185329	17186978	BnaA08T0138000ZY.1	0	-	0	0	1649	0.0000000
zheyou73v0_A08	17185508	17186978	BnaA08T0138000ZY.2	0	-	0	0	1470	0.0000000
zheyou73v0_A08	17194293	17201118	BnaA08T0138100ZY	0	+	0	0	6825	0.0000000
zheyou73v0_A08	17202169	17203707	BnaA08T0138200ZY	0	-	0	0	1538	0.0000000
zheyou73v0_A08	17202169	17203707	BnaA08T0138200ZY.1	0	-	0	0	1538	0.0000000
zheyou73v0_A08	17226975	17233410	BnaA08T0138300ZY	0	+	0	0	6435	0.0000000
zheyou73v0_A08	17226975	17233179	BnaA08T0138300ZY.1	0	+	0	0	6204	0.0000000
zheyou73v0_A08	17236139	17236710	BnaA08T0138400ZY	0	-	0	0	571	0.0000000
zheyou73v0_A08	17248486	17249482	BnaA08T0138500ZY	0	+	0	0	996	0.0000000
zheyou73v0_A08	17256634	17258436	BnaA08T0138600ZY	0	-	0	0	1802	0.0000000
zheyou73v0_A08	17286100	17286956	BnaA08T0138700ZY	0	-	0	0	856	0.0000000
zheyou73v0_A08	17298950	17301670	BnaA08T0138800ZY	0	-	0	0	2720	0.0000000
zheyou73v0_A08	17304247	17311438	BnaA08T0138900ZY	0	-	0	0	7191	0.0000000
zheyou73v0_A08	17312475	17314755	BnaA08T0139000ZY	0	+	0	0	2280	0.0000000
zheyou73v0_A08	17314970	17319161	BnaA08T0139100ZY	0	-	0	0	4191	0.0000000
zheyou73v0_A08	17320221	17322954	BnaA08T0139200ZY	0	-	0	0	2733	0.0000000
zheyou73v0_A08	17354100	17357161	BnaA08T0139300ZY	0	-	0	0	3061	0.0000000
zheyou73v0_A08	17360941	17363468	BnaA08T0139400ZY	0	+	0	0	2527	0.0000000
zheyou73v0_A08	17363906	17374479	BnaA08T0139500ZY	0	-	0	0	10573	0.0000000
zheyou73v0_A08	17378491	17380197	BnaA08T0139600ZY	0	-	0	0	1706	0.0000000
zheyou73v0_A08	17383619	17383811	BnaA08T0139700ZY	0	-	0	0	192	0.0000000
zheyou73v0_A08	17383894	17385211	BnaA08T0139800ZY	0	-	0	0	1317	0.0000000
zheyou73v0_A08	17385230	17385827	BnaA08T0139900ZY	0	-	0	0	597	0.0000000
zheyou73v0_A08	17390384	17390699	BnaA08T0140000ZY	0	+	0	0	315	0.0000000
zheyou73v0_A08	17390737	17391416	BnaA08T0140100ZY	0	+	0	0	679	0.0000000
zheyou73v0_A08	17392878	17394202	BnaA08T0140200ZY	0	+	0	0	1324	0.0000000
zheyou73v0_A08	17394319	17397552	BnaA08T0140300ZY	0	-	0	0	3233	0.0000000
zheyou73v0_A08	17402663	17404705	BnaA08T0140400ZY	0	+	0	0	2042	0.0000000
zheyou73v0_A08	17405978	17407493	BnaA08T0140500ZY	0	-	0	0	1515	0.0000000
zheyou73v0_A08	17413939	17416002	BnaA08T0140600ZY	0	+	0	0	2063	0.0000000
zheyou73v0_A08	17416896	17422124	BnaA08T0140700ZY	0	-	0	0	5228	0.0000000
zheyou73v0_A08	17431725	17433545	BnaA08T0140800ZY	0	-	0	0	1820	0.0000000
zheyou73v0_A08	17449421	17451266	BnaA08T0140900ZY	0	+	0	0	1845	0.0000000
zheyou73v0_A08	17451915	17454444	BnaA08T0141000ZY	0	+	0	0	2529	0.0000000
zheyou73v0_A08	17454914	17455821	BnaA08T0141100ZY	0	+	0	0	907	0.0000000
zheyou73v0_A08	17456327	17459763	BnaA08T0141200ZY	0	-	0	0	3436	0.0000000
zheyou73v0_A08	17456327	17459763	BnaA08T0141200ZY.1	0	-	0	0	3436	0.0000000
zheyou73v0_A08	17456327	17459763	BnaA08T0141200ZY.2	0	-	0	0	3436	0.0000000
zheyou73v0_A08	17456327	17459763	BnaA08T0141200ZY.3	0	-	0	0	3436	0.0000000
zheyou73v0_A08	17456327	17459763	BnaA08T0141200ZY.4	0	-	0	0	3436	0.0000000
zheyou73v0_A08	17456327	17459763	BnaA08T0141200ZY.5	0	-	0	0	3436	0.0000000
zheyou73v0_A08	17460954	17463369	BnaA08T0141300ZY	0	-	0	0	2415	0.0000000
zheyou73v0_A08	17478142	17481197	BnaA08T0141400ZY	0	-	0	0	3055	0.0000000
zheyou73v0_A08	17489620	17492284	BnaA08T0141500ZY	0	-	0	0	2664	0.0000000
zheyou73v0_A08	17509948	17511962	BnaA08T0141600ZY	0	+	0	0	2014	0.0000000
zheyou73v0_A08	17512727	17513920	BnaA08T0141700ZY	0	+	0	0	1193	0.0000000
zheyou73v0_A08	17514227	17516281	BnaA08T0141800ZY	0	-	0	0	2054	0.0000000
zheyou73v0_A08	17518285	17520863	BnaA08T0141900ZY	0	-	0	0	2578	0.0000000
zheyou73v0_A08	17525519	17531205	BnaA08T0142000ZY	0	+	0	0	5686	0.0000000
zheyou73v0_A08	17525519	17531205	BnaA08T0142000ZY.1	0	+	0	0	5686	0.0000000
zheyou73v0_A08	17531564	17533460	BnaA08T0142100ZY	0	-	0	0	1896	0.0000000
zheyou73v0_A08	17535259	17536560	BnaA08T0142200ZY	0	+	0	0	1301	0.0000000
zheyou73v0_A08	17538601	17540820	BnaA08T0142300ZY	0	+	0	0	2219	0.0000000
zheyou73v0_A08	17545486	17547554	BnaA08T0142400ZY	0	-	0	0	2068	0.0000000
zheyou73v0_A08	17597594	17599872	BnaA08T0142500ZY	0	-	0	0	2278	0.0000000
zheyou73v0_A08	17604153	17606597	BnaA08T0142600ZY	0	+	0	0	2444	0.0000000
zheyou73v0_A08	17614730	17615363	BnaA08T0142700ZY	0	+	0	0	633	0.0000000
zheyou73v0_A08	17615968	17616707	BnaA08T0142800ZY	0	-	0	0	739	0.0000000
zheyou73v0_A08	17617360	17617735	BnaA08T0142900ZY	0	+	0	0	375	0.0000000
zheyou73v0_A08	17618772	17621940	BnaA08T0143000ZY	0	+	0	0	3168	0.0000000
zheyou73v0_A08	17618772	17621940	BnaA08T0143000ZY.1	0	+	0	0	3168	0.0000000
zheyou73v0_A08	17623723	17625654	BnaA08T0143100ZY	0	-	0	0	1931	0.0000000
zheyou73v0_A08	17623723	17625654	BnaA08T0143100ZY.1	0	-	0	0	1931	0.0000000
zheyou73v0_A08	17648964	17651268	BnaA08T0143200ZY	0	+	0	0	2304	0.0000000
zheyou73v0_A08	17651270	17651671	BnaA08T0143300ZY	0	+	0	0	401	0.0000000
zheyou73v0_A08	17652711	17655061	BnaA08T0143400ZY	0	+	0	0	2350	0.0000000
zheyou73v0_A08	17656393	17658103	BnaA08T0143500ZY	0	+	0	0	1710	0.0000000
zheyou73v0_A08	17658641	17660725	BnaA08T0143600ZY	0	+	0	0	2084	0.0000000
zheyou73v0_A08	17660975	17664521	BnaA08T0143700ZY	0	+	0	0	3546	0.0000000
zheyou73v0_A08	17666011	17667790	BnaA08T0143800ZY	0	-	0	0	1779	0.0000000
zheyou73v0_A08	17676754	17677403	BnaA08T0143900ZY	0	-	0	0	649	0.0000000
zheyou73v0_A08	17678176	17679849	BnaA08T0144000ZY	0	+	0	0	1673	0.0000000
zheyou73v0_A08	17682906	17684906	BnaA08T0144100ZY	0	+	0	0	2000	0.0000000
zheyou73v0_A08	17696268	17697780	BnaA08T0144200ZY	0	+	0	0	1512	0.0000000
zheyou73v0_A08	17706701	17709436	BnaA08T0144300ZY	0	+	0	0	2735	0.0000000
zheyou73v0_A08	17710233	17712520	BnaA08T0144400ZY	0	+	0	0	2287	0.0000000
zheyou73v0_A08	17721706	17725333	BnaA08T0144500ZY	0	-	0	0	3627	0.0000000
zheyou73v0_A08	17728730	17730187	BnaA08T0144600ZY	0	+	0	0	1457	0.0000000
zheyou73v0_A08	17730665	17731709	BnaA08T0144700ZY	0	-	0	0	1044	0.0000000
zheyou73v0_A08	17732618	17736293	BnaA08T0144800ZY	0	-	0	0	3675	0.0000000
zheyou73v0_A08	17736953	17738716	BnaA08T0144900ZY	0	-	0	0	1763	0.0000000
zheyou73v0_A08	17736953	17738737	BnaA08T0144900ZY.1	0	-	0	0	1784	0.0000000
zheyou73v0_A08	17739335	17741101	BnaA08T0145000ZY	0	-	0	0	1766	0.0000000
zheyou73v0_A08	17745130	17745797	BnaA08T0145100ZY	0	-	0	0	667	0.0000000
zheyou73v0_A08	17751928	17752762	BnaA08T0145200ZY	0	+	0	0	834	0.0000000
zheyou73v0_A08	17753268	17760064	BnaA08T0145300ZY	0	-	0	0	6796	0.0000000
zheyou73v0_A08	17761161	17763269	BnaA08T0145400ZY	0	-	0	0	2108	0.0000000
zheyou73v0_A08	17773312	17773786	BnaA08T0145500ZY	0	+	0	0	474	0.0000000
zheyou73v0_A08	17774204	17774846	BnaA08T0145600ZY	0	+	0	0	642	0.0000000
zheyou73v0_A08	17775686	17776055	BnaA08T0145700ZY	0	+	0	0	369	0.0000000
zheyou73v0_A08	17776184	17777215	BnaA08T0145800ZY	0	-	0	0	1031	0.0000000
zheyou73v0_A08	17783134	17784433	BnaA08T0145900ZY	0	-	0	0	1299	0.0000000
zheyou73v0_A08	17784922	17785228	BnaA08T0146000ZY	0	-	0	0	306	0.0000000
zheyou73v0_A08	17786198	17787524	BnaA08T0146100ZY	0	+	0	0	1326	0.0000000
zheyou73v0_A08	17788003	17790325	BnaA08T0146200ZY	0	+	0	0	2322	0.0000000
zheyou73v0_A08	17790416	17797290	BnaA08T0146300ZY	0	-	0	0	6874	0.0000000
zheyou73v0_A08	17800158	17801454	BnaA08T0146400ZY	0	+	0	0	1296	0.0000000
zheyou73v0_A08	17804456	17805574	BnaA08T0146500ZY	0	-	0	0	1118	0.0000000
zheyou73v0_A08	17810438	17811640	BnaA08T0146600ZY	0	+	0	0	1202	0.0000000
zheyou73v0_A08	17816585	17817819	BnaA08T0146700ZY	0	+	0	0	1234	0.0000000
zheyou73v0_A08	17823130	17823572	BnaA08T0146800ZY	0	+	0	0	442	0.0000000
zheyou73v0_A08	17848957	17853646	BnaA08T0146900ZY	0	+	0	0	4689	0.0000000
zheyou73v0_A08	17853750	17856084	BnaA08T0147000ZY	0	-	0	0	2334	0.0000000
zheyou73v0_A08	17856715	17858246	BnaA08T0147100ZY	0	-	0	0	1531	0.0000000
zheyou73v0_A08	17858868	17860188	BnaA08T0147200ZY	0	-	0	0	1320	0.0000000
zheyou73v0_A08	17861073	17862783	BnaA08T0147300ZY	0	+	0	0	1710	0.0000000
zheyou73v0_A08	17864653	17866192	BnaA08T0147400ZY	0	+	0	0	1539	0.0000000
zheyou73v0_A08	17866253	17867926	BnaA08T0147500ZY	0	-	0	0	1673	0.0000000
zheyou73v0_A08	17869188	17872071	BnaA08T0147600ZY	0	+	0	0	2883	0.0000000
zheyou73v0_A08	17872829	17873571	BnaA08T0147700ZY	0	-	0	0	742	0.0000000
zheyou73v0_A08	17880956	17881778	BnaA08T0147800ZY	0	-	0	0	822	0.0000000
zheyou73v0_A08	17895651	17897317	BnaA08T0147900ZY	0	-	0	0	1666	0.0000000
zheyou73v0_A08	17910739	17913242	BnaA08T0148000ZY	0	+	0	0	2503	0.0000000
zheyou73v0_A08	17918475	17926181	BnaA08T0148100ZY	0	+	0	0	7706	0.0000000
zheyou73v0_A08	17931779	17933438	BnaA08T0148200ZY	0	+	0	0	1659	0.0000000
zheyou73v0_A08	17934026	17936895	BnaA08T0148300ZY	0	+	0	0	2869	0.0000000
zheyou73v0_A08	17934026	17936895	BnaA08T0148300ZY.1	0	+	0	0	2869	0.0000000
zheyou73v0_A08	17938453	17939851	BnaA08T0148400ZY	0	-	0	0	1398	0.0000000
zheyou73v0_A08	17940262	17943025	BnaA08T0148500ZY	0	-	0	0	2763	0.0000000
zheyou73v0_A08	17943270	17945296	BnaA08T0148600ZY	0	-	0	0	2026	0.0000000
zheyou73v0_A08	17943270	17945296	BnaA08T0148600ZY.1	0	-	0	0	2026	0.0000000
zheyou73v0_A08	17943270	17945296	BnaA08T0148600ZY.2	0	-	0	0	2026	0.0000000
zheyou73v0_A08	17956699	17961187	BnaA08T0148700ZY	0	+	0	0	4488	0.0000000
zheyou73v0_A08	17961233	17963483	BnaA08T0148800ZY	0	-	0	0	2250	0.0000000
zheyou73v0_A08	17967316	17972716	BnaA08T0148900ZY	0	+	0	0	5400	0.0000000
zheyou73v0_A08	17979114	17984603	BnaA08T0149000ZY	0	-	0	0	5489	0.0000000
zheyou73v0_A08	17985601	17986818	BnaA08T0149100ZY	0	-	0	0	1217	0.0000000
zheyou73v0_A08	17985601	17986818	BnaA08T0149100ZY.1	0	-	0	0	1217	0.0000000
zheyou73v0_A08	17990956	17991426	BnaA08T0149200ZY	0	+	0	0	470	0.0000000
zheyou73v0_A08	17991746	17993315	BnaA08T0149300ZY	0	-	0	0	1569	0.0000000
zheyou73v0_A08	17994423	17996094	BnaA08T0149400ZY	0	+	0	0	1671	0.0000000
zheyou73v0_A08	17997895	17998984	BnaA08T0149500ZY	0	+	0	0	1089	0.0000000
zheyou73v0_A08	17999713	18001984	BnaA08T0149600ZY	0	-	0	0	2271	0.0000000
zheyou73v0_A08	18002607	18004612	BnaA08T0149700ZY	0	-	0	0	2005	0.0000000
zheyou73v0_A08	18015629	18017613	BnaA08T0149800ZY	0	-	0	0	1984	0.0000000
zheyou73v0_A08	18046646	18047801	BnaA08T0149900ZY	0	+	0	0	1155	0.0000000
zheyou73v0_A08	18052898	18053938	BnaA08T0150000ZY	0	+	0	0	1040	0.0000000
zheyou73v0_A08	18055239	18055692	BnaA08T0150100ZY	0	+	0	0	453	0.0000000
zheyou73v0_A08	18057566	18058603	BnaA08T0150200ZY	0	+	0	0	1037	0.0000000
zheyou73v0_A08	18065515	18066675	BnaA08T0150300ZY	0	+	0	0	1160	0.0000000
zheyou73v0_A08	18071016	18072737	BnaA08T0150400ZY	0	+	0	0	1721	0.0000000
zheyou73v0_A08	18073142	18075659	BnaA08T0150500ZY	0	+	0	0	2517	0.0000000
zheyou73v0_A08	18076224	18078069	BnaA08T0150600ZY	0	+	0	0	1845	0.0000000
zheyou73v0_A08	18078498	18079738	BnaA08T0150700ZY	0	+	0	0	1240	0.0000000
zheyou73v0_A08	18080605	18084336	BnaA08T0150800ZY	0	-	0	0	3731	0.0000000
zheyou73v0_A08	18088763	18092106	BnaA08T0150900ZY	0	+	0	0	3343	0.0000000
zheyou73v0_A08	18095586	18097258	BnaA08T0151000ZY	0	-	0	0	1672	0.0000000
zheyou73v0_A08	18100359	18102409	BnaA08T0151100ZY	0	+	0	0	2050	0.0000000
zheyou73v0_A08	18111582	18116293	BnaA08T0151200ZY	0	+	0	0	4711	0.0000000
zheyou73v0_A08	18118025	18118508	BnaA08T0151300ZY	0	-	0	0	483	0.0000000
zheyou73v0_A08	18124461	18129019	BnaA08T0151400ZY	0	-	0	0	4558	0.0000000
zheyou73v0_A08	18137462	18144766	BnaA08T0151500ZY	0	+	0	0	7304	0.0000000
zheyou73v0_A08	18140071	18141776	BnaA08T0151600ZY	0	-	0	0	1705	0.0000000
zheyou73v0_A08	18157663	18159277	BnaA08T0151700ZY	0	+	0	0	1614	0.0000000
zheyou73v0_A08	18162038	18162554	BnaA08T0151800ZY	0	-	0	0	516	0.0000000
zheyou73v0_A08	18165279	18168314	BnaA08T0151900ZY	0	+	0	0	3035	0.0000000
zheyou73v0_A08	18169480	18170661	BnaA08T0152000ZY	0	-	0	0	1181	0.0000000
zheyou73v0_A08	18171219	18172991	BnaA08T0152100ZY	0	+	0	0	1772	0.0000000
zheyou73v0_A08	18175601	18178958	BnaA08T0152200ZY	0	+	0	0	3357	0.0000000
zheyou73v0_A08	18193590	18196879	BnaA08T0152300ZY	0	+	0	0	3289	0.0000000
zheyou73v0_A08	18229875	18231347	BnaA08T0152400ZY	0	-	0	0	1472	0.0000000
zheyou73v0_A08	18232994	18233186	BnaA08T0152500ZY	0	-	0	0	192	0.0000000
zheyou73v0_A08	18234901	18235570	BnaA08T0152600ZY	0	-	0	0	669	0.0000000
zheyou73v0_A08	18237465	18243483	BnaA08T0152700ZY	0	-	0	0	6018	0.0000000
zheyou73v0_A08	18245927	18249471	BnaA08T0152800ZY	0	-	0	0	3544	0.0000000
zheyou73v0_A08	18245954	18247532	BnaA08T0152900ZY	0	+	0	0	1578	0.0000000
zheyou73v0_A08	18250672	18254655	BnaA08T0153000ZY	0	+	0	0	3983	0.0000000
zheyou73v0_A08	18257775	18259964	BnaA08T0153100ZY	0	+	0	0	2189	0.0000000
zheyou73v0_A08	18267946	18269446	BnaA08T0153200ZY	0	+	0	0	1500	0.0000000
zheyou73v0_A08	18271050	18272127	BnaA08T0153300ZY	0	-	0	0	1077	0.0000000
zheyou73v0_A08	18272418	18274034	BnaA08T0153400ZY	0	+	0	0	1616	0.0000000
zheyou73v0_A08	18278254	18279992	BnaA08T0153500ZY	0	+	0	0	1738	0.0000000
zheyou73v0_A08	18280323	18280897	BnaA08T0153600ZY	0	-	0	0	574	0.0000000
zheyou73v0_A08	18280963	18281646	BnaA08T0153700ZY	0	-	0	0	683	0.0000000
zheyou73v0_A08	18287995	18289157	BnaA08T0153800ZY	0	+	0	0	1162	0.0000000
zheyou73v0_A08	18287995	18289157	BnaA08T0153800ZY.1	0	+	0	0	1162	0.0000000
zheyou73v0_A08	18289520	18290819	BnaA08T0153900ZY	0	+	0	0	1299	0.0000000
zheyou73v0_A08	18291606	18292803	BnaA08T0154000ZY	0	+	0	0	1197	0.0000000
zheyou73v0_A08	18295071	18296618	BnaA08T0154100ZY	0	+	0	0	1547	0.0000000
zheyou73v0_A08	18297330	18300137	BnaA08T0154200ZY	0	+	0	0	2807	0.0000000
zheyou73v0_A08	18300688	18301616	BnaA08T0154300ZY	0	-	0	0	928	0.0000000
zheyou73v0_A08	18302224	18302677	BnaA08T0154400ZY	0	-	0	0	453	0.0000000
zheyou73v0_A08	18315879	18317697	BnaA08T0154500ZY	0	+	0	0	1818	0.0000000
zheyou73v0_A08	18318316	18319022	BnaA08T0154600ZY	0	+	0	0	706	0.0000000
zheyou73v0_A08	18319331	18319754	BnaA08T0154700ZY	0	+	0	0	423	0.0000000
zheyou73v0_A08	18328677	18329764	BnaA08T0154800ZY	0	+	0	0	1087	0.0000000
zheyou73v0_A08	18343801	18345412	BnaA08T0154900ZY	0	-	0	0	1611	0.0000000
zheyou73v0_A08	18354520	18357917	BnaA08T0155000ZY	0	-	0	0	3397	0.0000000
zheyou73v0_A08	18377165	18380501	BnaA08T0155100ZY	0	-	0	0	3336	0.0000000
zheyou73v0_A08	18380768	18382755	BnaA08T0155200ZY	0	+	0	0	1987	0.0000000
zheyou73v0_A08	18383605	18384658	BnaA08T0155300ZY	0	+	0	0	1053	0.0000000
zheyou73v0_A08	18384969	18388103	BnaA08T0155400ZY	0	-	0	0	3134	0.0000000
zheyou73v0_A08	18392092	18392475	BnaA08T0155500ZY	0	+	0	0	383	0.0000000
zheyou73v0_A08	18396231	18410467	BnaA08T0155600ZY	0	+	0	0	14236	0.0000000
zheyou73v0_A08	18412500	18412905	BnaA08T0155700ZY	0	+	0	0	405	0.0000000
zheyou73v0_A08	18417710	18418127	BnaA08T0155800ZY	0	-	0	0	417	0.0000000
zheyou73v0_A08	18420658	18421179	BnaA08T0155900ZY	0	-	0	0	521	0.0000000
zheyou73v0_A08	18422977	18426933	BnaA08T0156000ZY	0	+	0	0	3956	0.0000000
zheyou73v0_A08	18427597	18430234	BnaA08T0156100ZY	0	-	0	0	2637	0.0000000
zheyou73v0_A08	18432449	18433709	BnaA08T0156200ZY	0	+	0	0	1260	0.0000000
zheyou73v0_A08	18438450	18440018	BnaA08T0156300ZY	0	+	0	0	1568	0.0000000
zheyou73v0_A08	18440102	18440452	BnaA08T0156400ZY	0	-	0	0	350	0.0000000
zheyou73v0_A08	18441027	18442155	BnaA08T0156500ZY	0	-	0	0	1128	0.0000000
zheyou73v0_A08	18445948	18446669	BnaA08T0156600ZY	0	-	0	0	721	0.0000000
zheyou73v0_A08	18451197	18452672	BnaA08T0156700ZY	0	-	0	0	1475	0.0000000
zheyou73v0_A08	18472704	18474807	BnaA08T0156800ZY	0	+	0	0	2103	0.0000000
zheyou73v0_A08	18472704	18474807	BnaA08T0156800ZY.1	0	+	0	0	2103	0.0000000
zheyou73v0_A08	18475091	18476568	BnaA08T0156900ZY	0	-	0	0	1477	0.0000000
zheyou73v0_A08	18483524	18486022	BnaA08T0157000ZY	0	-	0	0	2498	0.0000000
zheyou73v0_A08	18492876	18496162	BnaA08T0157100ZY	0	-	0	0	3286	0.0000000
zheyou73v0_A08	18502608	18504414	BnaA08T0157200ZY	0	+	0	0	1806	0.0000000
zheyou73v0_A08	18512341	18514926	BnaA08T0157300ZY	0	-	0	0	2585	0.0000000
zheyou73v0_A08	18515295	18518256	BnaA08T0157400ZY	0	-	0	0	2961	0.0000000
zheyou73v0_A08	18547541	18550299	BnaA08T0157500ZY	0	+	0	0	2758	0.0000000
zheyou73v0_A08	18551199	18553418	BnaA08T0157600ZY	0	-	0	0	2219	0.0000000
zheyou73v0_A08	18554338	18556118	BnaA08T0157700ZY	0	+	0	0	1780	0.0000000
zheyou73v0_A08	18556749	18558280	BnaA08T0157800ZY	0	-	0	0	1531	0.0000000
zheyou73v0_A08	18564551	18569407	BnaA08T0157900ZY	0	+	0	0	4856	0.0000000
zheyou73v0_A08	18570171	18570959	BnaA08T0158000ZY	0	-	0	0	788	0.0000000
zheyou73v0_A08	18572570	18574195	BnaA08T0158100ZY	0	-	0	0	1625	0.0000000
zheyou73v0_A08	18575277	18577002	BnaA08T0158200ZY	0	+	0	0	1725	0.0000000
zheyou73v0_A08	18577891	18581313	BnaA08T0158300ZY	0	-	0	0	3422	0.0000000
zheyou73v0_A08	18589232	18589469	BnaA08T0158400ZY	0	+	0	0	237	0.0000000
zheyou73v0_A08	18589912	18592177	BnaA08T0158500ZY	0	-	0	0	2265	0.0000000
zheyou73v0_A08	18595238	18595707	BnaA08T0158600ZY	0	+	0	0	469	0.0000000
zheyou73v0_A08	18595953	18596666	BnaA08T0158700ZY	0	-	0	0	713	0.0000000
zheyou73v0_A08	18598793	18599426	BnaA08T0158800ZY	0	-	0	0	633	0.0000000
zheyou73v0_A08	18600725	18602729	BnaA08T0158900ZY	0	-	0	0	2004	0.0000000
zheyou73v0_A08	18606284	18606869	BnaA08T0159000ZY	0	+	0	0	585	0.0000000
zheyou73v0_A08	18607220	18612554	BnaA08T0159100ZY	0	-	0	0	5334	0.0000000
zheyou73v0_A08	18612489	18613942	BnaA08T0159200ZY	0	+	0	0	1453	0.0000000
zheyou73v0_A08	18612489	18613942	BnaA08T0159200ZY.1	0	+	0	0	1453	0.0000000
zheyou73v0_A08	18614353	18616213	BnaA08T0159300ZY	0	-	0	0	1860	0.0000000
zheyou73v0_A08	18617106	18618412	BnaA08T0159400ZY	0	-	0	0	1306	0.0000000
zheyou73v0_A08	18619530	18620312	BnaA08T0159500ZY	0	+	0	0	782	0.0000000
zheyou73v0_A08	18621728	18624947	BnaA08T0159600ZY	0	+	0	0	3219	0.0000000
zheyou73v0_A08	18627986	18628282	BnaA08T0159700ZY	0	-	0	0	296	0.0000000
zheyou73v0_A08	18628855	18637611	BnaA08T0159800ZY	0	+	0	0	8756	0.0000000
zheyou73v0_A08	18638012	18641084	BnaA08T0159900ZY	0	-	0	0	3072	0.0000000
zheyou73v0_A08	18641529	18643612	BnaA08T0160000ZY	0	+	0	0	2083	0.0000000
zheyou73v0_A08	18643759	18644350	BnaA08T0160100ZY	0	-	0	0	591	0.0000000
zheyou73v0_A08	18645615	18653034	BnaA08T0160200ZY	0	+	0	0	7419	0.0000000
zheyou73v0_A08	18657281	18658548	BnaA08T0160300ZY	0	+	0	0	1267	0.0000000
zheyou73v0_A08	18674714	18676097	BnaA08T0160400ZY	0	+	0	0	1383	0.0000000
zheyou73v0_A08	18686821	18689000	BnaA08T0160500ZY	0	-	0	0	2179	0.0000000
zheyou73v0_A08	18695558	18704656	BnaA08T0160600ZY	0	-	0	0	9098	0.0000000
zheyou73v0_A08	18712109	18714266	BnaA08T0160700ZY	0	-	0	0	2157	0.0000000
zheyou73v0_A08	18712109	18714266	BnaA08T0160700ZY.2	0	-	0	0	2157	0.0000000
zheyou73v0_A08	18712505	18714266	BnaA08T0160700ZY.1	0	-	0	0	1761	0.0000000
zheyou73v0_A08	18716358	18718389	BnaA08T0160800ZY	0	-	0	0	2031	0.0000000
zheyou73v0_A08	18719217	18722186	BnaA08T0160900ZY	0	-	0	0	2969	0.0000000
zheyou73v0_A08	18732278	18733281	BnaA08T0161000ZY.1	0	-	0	0	1003	0.0000000
zheyou73v0_A08	18732521	18733281	BnaA08T0161000ZY	0	-	0	0	760	0.0000000
zheyou73v0_A08	18735065	18735677	BnaA08T0161100ZY	0	-	0	0	612	0.0000000
zheyou73v0_A08	18736442	18737029	BnaA08T0161200ZY	0	-	0	0	587	0.0000000
zheyou73v0_A08	18737818	18738273	BnaA08T0161300ZY	0	-	0	0	455	0.0000000
zheyou73v0_A08	18743513	18743717	BnaA08T0161400ZY	0	-	0	0	204	0.0000000
zheyou73v0_A08	18757282	18762156	BnaA08T0161500ZY	0	+	0	0	4874	0.0000000
zheyou73v0_A08	18762851	18763332	BnaA08T0161600ZY	0	-	0	0	481	0.0000000
zheyou73v0_A08	18763850	18764269	BnaA08T0161700ZY	0	-	0	0	419	0.0000000
zheyou73v0_A08	18776668	18780636	BnaA08T0161800ZY	0	+	0	0	3968	0.0000000
zheyou73v0_A08	18781468	18781954	BnaA08T0161900ZY	0	-	0	0	486	0.0000000
zheyou73v0_A08	18782238	18785172	BnaA08T0162000ZY	0	-	0	0	2934	0.0000000
zheyou73v0_A08	18782238	18785172	BnaA08T0162000ZY.1	0	-	0	0	2934	0.0000000
zheyou73v0_A08	18790006	18792287	BnaA08T0162100ZY	0	+	0	0	2281	0.0000000
zheyou73v0_A08	18790563	18792287	BnaA08T0162100ZY.1	0	+	0	0	1724	0.0000000
zheyou73v0_A08	18792385	18793498	BnaA08T0162200ZY	0	-	0	0	1113	0.0000000
zheyou73v0_A08	18798829	18800130	BnaA08T0162300ZY	0	+	0	0	1301	0.0000000
zheyou73v0_A08	18805889	18807156	BnaA08T0162400ZY	0	+	0	0	1267	0.0000000
zheyou73v0_A08	18818198	18819464	BnaA08T0162500ZY	0	-	0	0	1266	0.0000000
zheyou73v0_A08	18823093	18823830	BnaA08T0162600ZY	0	+	0	0	737	0.0000000
zheyou73v0_A08	18825736	18826547	BnaA08T0162700ZY	0	-	0	0	811	0.0000000
zheyou73v0_A08	18831738	18832251	BnaA08T0162800ZY	0	-	0	0	513	0.0000000
zheyou73v0_A08	18833612	18835171	BnaA08T0162900ZY	0	+	0	0	1559	0.0000000
zheyou73v0_A08	18835557	18839023	BnaA08T0163000ZY	0	+	0	0	3466	0.0000000
zheyou73v0_A08	18841384	18845269	BnaA08T0163100ZY	0	-	0	0	3885	0.0000000
zheyou73v0_A08	18849185	18850266	BnaA08T0163200ZY	0	+	0	0	1081	0.0000000
zheyou73v0_A08	18852249	18853512	BnaA08T0163300ZY	0	+	0	0	1263	0.0000000
zheyou73v0_A08	18854028	18854916	BnaA08T0163400ZY	0	-	0	0	888	0.0000000
zheyou73v0_A08	18867728	18868586	BnaA08T0163500ZY	0	-	0	0	858	0.0000000
zheyou73v0_A08	18885981	18888897	BnaA08T0163600ZY	0	+	0	0	2916	0.0000000
zheyou73v0_A08	18889405	18894858	BnaA08T0163700ZY	0	-	0	0	5453	0.0000000
zheyou73v0_A08	18895370	18897926	BnaA08T0163800ZY	0	-	0	0	2556	0.0000000
zheyou73v0_A08	18895370	18897926	BnaA08T0163800ZY.1	0	-	0	0	2556	0.0000000
zheyou73v0_A08	18899612	18900106	BnaA08T0163900ZY	0	+	0	0	494	0.0000000
zheyou73v0_A08	18902230	18904867	BnaA08T0164000ZY	0	+	0	0	2637	0.0000000
zheyou73v0_A08	18905292	18906660	BnaA08T0164100ZY	0	-	0	0	1368	0.0000000
zheyou73v0_A08	18911867	18913799	BnaA08T0164200ZY	0	+	0	0	1932	0.0000000
zheyou73v0_A08	18913902	18915258	BnaA08T0164300ZY	0	-	0	0	1356	0.0000000
zheyou73v0_A08	18915498	18916273	BnaA08T0164400ZY	0	+	0	0	775	0.0000000
zheyou73v0_A08	18916560	18918128	BnaA08T0164500ZY	0	+	0	0	1568	0.0000000
zheyou73v0_A08	18918603	18921516	BnaA08T0164600ZY	0	+	0	0	2913	0.0000000
zheyou73v0_A08	18918603	18921516	BnaA08T0164600ZY.1	0	+	0	0	2913	0.0000000
zheyou73v0_A08	18924503	18925685	BnaA08T0164700ZY	0	+	0	0	1182	0.0000000
zheyou73v0_A08	18930759	18932604	BnaA08T0164800ZY	0	+	0	0	1845	0.0000000
zheyou73v0_A08	18936410	18937756	BnaA08T0164900ZY	0	+	0	0	1346	0.0000000
zheyou73v0_A08	18938858	18939044	BnaA08T0165000ZY	0	+	0	0	186	0.0000000
zheyou73v0_A08	18940307	18941477	BnaA08T0165100ZY	0	+	0	0	1170	0.0000000
zheyou73v0_A08	18946420	18949773	BnaA08T0165200ZY	0	+	0	0	3353	0.0000000
zheyou73v0_A08	18950376	18955199	BnaA08T0165300ZY	0	+	0	0	4823	0.0000000
zheyou73v0_A08	18950376	18955199	BnaA08T0165300ZY.1	0	+	0	0	4823	0.0000000
zheyou73v0_A08	18965840	18967852	BnaA08T0165400ZY	0	+	0	0	2012	0.0000000
zheyou73v0_A08	18965840	18967852	BnaA08T0165400ZY.1	0	+	0	0	2012	0.0000000
zheyou73v0_A08	18970169	18970898	BnaA08T0165500ZY	0	+	0	0	729	0.0000000
zheyou73v0_A08	18974637	18978004	BnaA08T0165600ZY	0	+	0	0	3367	0.0000000
zheyou73v0_A08	18978477	18979284	BnaA08T0165700ZY	0	-	0	0	807	0.0000000
zheyou73v0_A08	18980097	18980672	BnaA08T0165800ZY	0	-	0	0	575	0.0000000
zheyou73v0_A08	18980685	18981297	BnaA08T0165900ZY	0	-	0	0	612	0.0000000
zheyou73v0_A08	18983726	18985039	BnaA08T0166000ZY	0	-	0	0	1313	0.0000000
zheyou73v0_A08	18990688	18993325	BnaA08T0166100ZY	0	-	0	0	2637	0.0000000
zheyou73v0_A08	18999959	19000817	BnaA08T0166200ZY	0	-	0	0	858	0.0000000
zheyou73v0_A08	19001392	19001773	BnaA08T0166300ZY	0	+	0	0	381	0.0000000
zheyou73v0_A08	19010930	19013013	BnaA08T0166400ZY	0	+	0	0	2083	0.0000000
zheyou73v0_A08	19014014	19015826	BnaA08T0166500ZY	0	+	0	0	1812	0.0000000
zheyou73v0_A08	19014014	19015826	BnaA08T0166500ZY.1	0	+	0	0	1812	0.0000000
zheyou73v0_A08	19014014	19015826	BnaA08T0166500ZY.2	0	+	0	0	1812	0.0000000
zheyou73v0_A08	19016045	19016537	BnaA08T0166600ZY	0	+	0	0	492	0.0000000
zheyou73v0_A08	19020489	19021575	BnaA08T0166700ZY	0	+	0	0	1086	0.0000000
zheyou73v0_A08	19024800	19026703	BnaA08T0166800ZY	0	+	0	0	1903	0.0000000
zheyou73v0_A08	19027821	19028612	BnaA08T0166900ZY	0	-	0	0	791	0.0000000
zheyou73v0_A08	19029360	19031090	BnaA08T0167000ZY	0	+	0	0	1730	0.0000000
zheyou73v0_A08	19033142	19036896	BnaA08T0167100ZY	0	+	0	0	3754	0.0000000
zheyou73v0_A08	19037465	19038901	BnaA08T0167200ZY	0	-	0	0	1436	0.0000000
zheyou73v0_A08	19041695	19045070	BnaA08T0167300ZY	0	+	0	0	3375	0.0000000
zheyou73v0_A08	19041695	19045070	BnaA08T0167300ZY.1	0	+	0	0	3375	0.0000000
zheyou73v0_A08	19046660	19050388	BnaA08T0167400ZY	0	-	0	0	3728	0.0000000
zheyou73v0_A08	19053458	19055579	BnaA08T0167500ZY	0	-	0	0	2121	0.0000000
zheyou73v0_A08	19063240	19064983	BnaA08T0167600ZY	0	+	0	0	1743	0.0000000
zheyou73v0_A08	19065428	19069242	BnaA08T0167700ZY	0	-	0	0	3814	0.0000000
zheyou73v0_A08	19070677	19074525	BnaA08T0167800ZY	0	-	0	0	3848	0.0000000
zheyou73v0_A08	19076513	19078919	BnaA08T0167900ZY	0	-	0	0	2406	0.0000000
zheyou73v0_A08	19083309	19084161	BnaA08T0168000ZY	0	+	0	0	852	0.0000000
zheyou73v0_A08	19094127	19094883	BnaA08T0168100ZY	0	+	0	0	756	0.0000000
zheyou73v0_A08	19097431	19098187	BnaA08T0168200ZY	0	+	0	0	756	0.0000000
zheyou73v0_A08	19098723	19103678	BnaA08T0168300ZY	0	+	0	0	4955	0.0000000
zheyou73v0_A08	19099487	19103678	BnaA08T0168300ZY.1	0	+	0	0	4191	0.0000000
zheyou73v0_A08	19105844	19108904	BnaA08T0168400ZY	0	+	0	0	3060	0.0000000
zheyou73v0_A08	19109831	19111581	BnaA08T0168500ZY	0	-	0	0	1750	0.0000000
zheyou73v0_A08	19121468	19122337	BnaA08T0168600ZY	0	-	0	0	869	0.0000000
zheyou73v0_A08	19139060	19142303	BnaA08T0168700ZY	0	+	0	0	3243	0.0000000
zheyou73v0_A08	19143354	19147042	BnaA08T0168800ZY	0	-	0	0	3688	0.0000000
zheyou73v0_A08	19160335	19172846	BnaA08T0168900ZY	0	-	0	0	12511	0.0000000
zheyou73v0_A08	19173915	19181498	BnaA08T0169000ZY	0	-	0	0	7583	0.0000000
zheyou73v0_A08	19182600	19183477	BnaA08T0169100ZY	0	-	0	0	877	0.0000000
zheyou73v0_A08	19184414	19185268	BnaA08T0169200ZY	0	-	0	0	854	0.0000000
zheyou73v0_A08	19185895	19187159	BnaA08T0169300ZY	0	-	0	0	1264	0.0000000
zheyou73v0_A08	19192580	19194371	BnaA08T0169400ZY	0	+	0	0	1791	0.0000000
zheyou73v0_A08	19195690	19197271	BnaA08T0169500ZY	0	+	0	0	1581	0.0000000
zheyou73v0_A08	19207566	19217689	BnaA08T0169600ZY	0	-	0	0	10123	0.0000000
zheyou73v0_A08	19224478	19229563	BnaA08T0169700ZY	0	+	0	0	5085	0.0000000
zheyou73v0_A08	19232014	19233736	BnaA08T0169800ZY	0	+	0	0	1722	0.0000000
zheyou73v0_A08	19236603	19239047	BnaA08T0169900ZY	0	-	0	0	2444	0.0000000
zheyou73v0_A08	19246140	19247024	BnaA08T0170000ZY	0	+	0	0	884	0.0000000
zheyou73v0_A08	19248669	19249974	BnaA08T0170100ZY	0	-	0	0	1305	0.0000000
zheyou73v0_A08	19250780	19253422	BnaA08T0170200ZY	0	-	0	0	2642	0.0000000
zheyou73v0_A08	19254224	19255330	BnaA08T0170300ZY	0	-	0	0	1106	0.0000000
zheyou73v0_A08	19256705	19261864	BnaA08T0170400ZY	0	+	0	0	5159	0.0000000
zheyou73v0_A08	19263120	19265983	BnaA08T0170500ZY	0	-	0	0	2863	0.0000000
zheyou73v0_A08	19266667	19268044	BnaA08T0170600ZY	0	-	0	0	1377	0.0000000
zheyou73v0_A08	19278448	19279936	BnaA08T0170700ZY	0	-	0	0	1488	0.0000000
zheyou73v0_A08	19281418	19282180	BnaA08T0170800ZY	0	-	0	0	762	0.0000000
zheyou73v0_A08	19282783	19285645	BnaA08T0170900ZY	0	-	0	0	2862	0.0000000
zheyou73v0_A08	19297835	19298267	BnaA08T0171000ZY	0	+	0	0	432	0.0000000
zheyou73v0_A08	19302309	19303835	BnaA08T0171100ZY	0	-	0	0	1526	0.0000000
zheyou73v0_A08	19304141	19304640	BnaA08T0171200ZY	0	+	0	0	499	0.0000000
zheyou73v0_A08	19304892	19306453	BnaA08T0171300ZY	0	-	0	0	1561	0.0000000
zheyou73v0_A08	19312378	19316200	BnaA08T0171400ZY	0	+	0	0	3822	0.0000000
zheyou73v0_A08	19323538	19324333	BnaA08T0171500ZY	0	-	0	0	795	0.0000000
zheyou73v0_A08	19344662	19345397	BnaA08T0171600ZY	0	+	0	0	735	0.0000000
zheyou73v0_A08	19358343	19360161	BnaA08T0171700ZY	0	+	0	0	1818	0.0000000
zheyou73v0_A08	19362351	19363427	BnaA08T0171800ZY	0	-	0	0	1076	0.0000000
zheyou73v0_A08	19366337	19367429	BnaA08T0171900ZY	0	-	0	0	1092	0.0000000
zheyou73v0_A08	19368499	19370230	BnaA08T0172000ZY	0	-	0	0	1731	0.0000000
zheyou73v0_A08	19372186	19374863	BnaA08T0172100ZY	0	-	0	0	2677	0.0000000
zheyou73v0_A08	19377795	19382964	BnaA08T0172200ZY	0	+	0	0	5169	0.0000000
zheyou73v0_A08	19386344	19386638	BnaA08T0172300ZY	0	-	0	0	294	0.0000000
zheyou73v0_A08	19388749	19396203	BnaA08T0172400ZY	0	+	0	0	7454	0.0000000
zheyou73v0_A08	19388749	19396203	BnaA08T0172400ZY.1	0	+	0	0	7454	0.0000000
zheyou73v0_A08	19401410	19405808	BnaA08T0172500ZY	0	+	0	0	4398	0.0000000
zheyou73v0_A08	19410743	19414664	BnaA08T0172600ZY	0	+	0	0	3921	0.0000000
zheyou73v0_A08	19415176	19420164	BnaA08T0172700ZY	0	-	0	0	4988	0.0000000
zheyou73v0_A08	19422597	19426598	BnaA08T0172800ZY	0	+	0	0	4001	0.0000000
zheyou73v0_A08	19426926	19434254	BnaA08T0172900ZY	0	+	0	0	7328	0.0000000
zheyou73v0_A08	19434604	19435530	BnaA08T0173000ZY	0	+	0	0	926	0.0000000
zheyou73v0_A08	19435309	19439868	BnaA08T0173100ZY	0	-	0	0	4559	0.0000000
zheyou73v0_A08	19442463	19443534	BnaA08T0173200ZY	0	-	0	0	1071	0.0000000
zheyou73v0_A08	19445163	19447228	BnaA08T0173300ZY	0	-	0	0	2065	0.0000000
zheyou73v0_A08	19447933	19448711	BnaA08T0173400ZY	0	+	0	0	778	0.0000000
zheyou73v0_A08	19449856	19450998	BnaA08T0173500ZY	0	-	0	0	1142	0.0000000
zheyou73v0_A08	19452322	19452736	BnaA08T0173600ZY	0	-	0	0	414	0.0000000
zheyou73v0_A08	19457528	19457822	BnaA08T0173700ZY	0	-	0	0	294	0.0000000
zheyou73v0_A08	19460739	19462708	BnaA08T0173800ZY	0	-	0	0	1969	0.0000000
zheyou73v0_A08	19464724	19466224	BnaA08T0173900ZY	0	-	0	0	1500	0.0000000
zheyou73v0_A08	19466871	19468991	BnaA08T0174000ZY	0	-	0	0	2120	0.0000000
zheyou73v0_A08	19470694	19471757	BnaA08T0174100ZY	0	-	0	0	1063	0.0000000
zheyou73v0_A08	19472620	19475598	BnaA08T0174200ZY	0	-	0	0	2978	0.0000000
zheyou73v0_A08	19472620	19475598	BnaA08T0174200ZY.1	0	-	0	0	2978	0.0000000
zheyou73v0_A08	19483268	19484254	BnaA08T0174300ZY	0	+	0	0	986	0.0000000
zheyou73v0_A08	19487504	19488694	BnaA08T0174400ZY	0	+	0	0	1190	0.0000000
zheyou73v0_A08	19496544	19498831	BnaA08T0174500ZY	0	-	0	0	2287	0.0000000
zheyou73v0_A08	19496544	19498831	BnaA08T0174500ZY.1	0	-	0	0	2287	0.0000000
zheyou73v0_A08	19499964	19501373	BnaA08T0174600ZY	0	+	0	0	1409	0.0000000
zheyou73v0_A08	19501266	19504019	BnaA08T0174700ZY	0	-	0	0	2753	0.0000000
zheyou73v0_A08	19506570	19507023	BnaA08T0174800ZY	0	+	0	0	453	0.0000000
zheyou73v0_A08	19515500	19517263	BnaA08T0174900ZY	0	-	0	0	1763	0.0000000
zheyou73v0_A08	19521107	19522555	BnaA08T0175000ZY	0	+	0	0	1448	0.0000000
zheyou73v0_A08	19523526	19525071	BnaA08T0175100ZY	0	-	0	0	1545	0.0000000
zheyou73v0_A08	19530566	19531713	BnaA08T0175200ZY	0	-	0	0	1147	0.0000000
zheyou73v0_A08	19535861	19536608	BnaA08T0175300ZY	0	-	0	0	747	0.0000000
zheyou73v0_A08	19540953	19544348	BnaA08T0175400ZY	0	-	0	0	3395	0.0000000
zheyou73v0_A08	19550371	19550548	BnaA08T0175500ZY	0	+	0	0	177	0.0000000
zheyou73v0_A08	19551036	19552047	BnaA08T0175600ZY	0	-	0	0	1011	0.0000000
zheyou73v0_A08	19564795	19565092	BnaA08T0175700ZY	0	+	0	0	297	0.0000000
zheyou73v0_A08	19565570	19566173	BnaA08T0175800ZY	0	-	0	0	603	0.0000000
zheyou73v0_A08	19567882	19568840	BnaA08T0175900ZY	0	+	0	0	958	0.0000000
zheyou73v0_A08	19578949	19580376	BnaA08T0176000ZY	0	+	0	0	1427	0.0000000
zheyou73v0_A08	19592216	19594958	BnaA08T0176100ZY	0	+	0	0	2742	0.0000000
zheyou73v0_A08	19595799	19596884	BnaA08T0176200ZY	0	+	0	0	1085	0.0000000
zheyou73v0_A08	19596897	19604692	BnaA08T0176300ZY	0	-	0	0	7795	0.0000000
zheyou73v0_A08	19606577	19611556	BnaA08T0176400ZY	0	+	0	0	4979	0.0000000
zheyou73v0_A08	19634843	19637268	BnaA08T0176500ZY	0	+	0	0	2425	0.0000000
zheyou73v0_A08	19637689	19639577	BnaA08T0176600ZY	0	-	0	0	1888	0.0000000
zheyou73v0_A08	19641708	19643190	BnaA08T0176700ZY	0	+	0	0	1482	0.0000000
zheyou73v0_A08	19644280	19645810	BnaA08T0176800ZY	0	+	0	0	1530	0.0000000
zheyou73v0_A08	19646066	19646559	BnaA08T0176900ZY	0	-	0	0	493	0.0000000
zheyou73v0_A08	19648881	19650478	BnaA08T0177000ZY	0	+	0	0	1597	0.0000000
zheyou73v0_A08	19648881	19650478	BnaA08T0177000ZY.1	0	+	0	0	1597	0.0000000
zheyou73v0_A08	19648881	19650478	BnaA08T0177000ZY.2	0	+	0	0	1597	0.0000000
zheyou73v0_A08	19650484	19653173	BnaA08T0177100ZY	0	-	0	0	2689	0.0000000
zheyou73v0_A08	19670817	19672628	BnaA08T0177200ZY	0	+	0	0	1811	0.0000000
zheyou73v0_A08	19672935	19674315	BnaA08T0177300ZY	0	-	0	0	1380	0.0000000
zheyou73v0_A08	19675707	19676519	BnaA08T0177400ZY	0	-	0	0	812	0.0000000
zheyou73v0_A08	19698154	19700137	BnaA08T0177500ZY	0	-	0	0	1983	0.0000000
zheyou73v0_A08	19698154	19700019	BnaA08T0177500ZY.1	0	-	0	0	1865	0.0000000
zheyou73v0_A08	19709310	19711357	BnaA08T0177600ZY	0	-	0	0	2047	0.0000000
zheyou73v0_A08	19713343	19715583	BnaA08T0177700ZY	0	-	0	0	2240	0.0000000
zheyou73v0_A08	19719413	19720637	BnaA08T0177800ZY	0	-	0	0	1224	0.0000000
zheyou73v0_A08	19721548	19724988	BnaA08T0177900ZY	0	-	0	0	3440	0.0000000
zheyou73v0_A08	19726527	19729278	BnaA08T0178000ZY	0	-	0	0	2751	0.0000000
zheyou73v0_A08	19731364	19733545	BnaA08T0178100ZY	0	+	0	0	2181	0.0000000
zheyou73v0_A08	19733414	19735544	BnaA08T0178200ZY	0	-	0	0	2130	0.0000000
zheyou73v0_A08	19733414	19735721	BnaA08T0178200ZY.1	0	-	0	0	2307	0.0000000
zheyou73v0_A08	19733414	19735721	BnaA08T0178200ZY.2	0	-	0	0	2307	0.0000000
zheyou73v0_A08	19733414	19735721	BnaA08T0178200ZY.3	0	-	0	0	2307	0.0000000
zheyou73v0_A08	19733414	19735721	BnaA08T0178200ZY.4	0	-	0	0	2307	0.0000000
zheyou73v0_A08	19744460	19745886	BnaA08T0178300ZY	0	-	0	0	1426	0.0000000
zheyou73v0_A08	19753535	19756529	BnaA08T0178400ZY	0	+	0	0	2994	0.0000000
zheyou73v0_A08	19756977	19758518	BnaA08T0178500ZY	0	-	0	0	1541	0.0000000
zheyou73v0_A08	19763798	19764893	BnaA08T0178600ZY	0	+	0	0	1095	0.0000000
zheyou73v0_A08	19776940	19781931	BnaA08T0178700ZY	0	+	0	0	4991	0.0000000
zheyou73v0_A08	19792916	19793438	BnaA08T0178800ZY	0	-	0	0	522	0.0000000
zheyou73v0_A08	19804045	19805294	BnaA08T0178900ZY	0	-	0	0	1249	0.0000000
zheyou73v0_A08	19805781	19808070	BnaA08T0179000ZY	0	-	0	0	2289	0.0000000
zheyou73v0_A08	19809812	19811380	BnaA08T0179100ZY	0	-	0	0	1568	0.0000000
zheyou73v0_A08	19815861	19817700	BnaA08T0179200ZY	0	-	0	0	1839	0.0000000
zheyou73v0_A08	19817966	19818962	BnaA08T0179300ZY	0	-	0	0	996	0.0000000
zheyou73v0_A08	19820074	19823070	BnaA08T0179400ZY	0	-	0	0	2996	0.0000000
zheyou73v0_A08	19825660	19829715	BnaA08T0179500ZY	0	-	0	0	4055	0.0000000
zheyou73v0_A08	19832044	19834112	BnaA08T0179600ZY	0	-	0	0	2068	0.0000000
zheyou73v0_A08	19836812	19853575	BnaA08T0179700ZY	0	+	0	0	16763	0.0000000
zheyou73v0_A08	19854214	19855870	BnaA08T0179800ZY	0	-	0	0	1656	0.0000000
zheyou73v0_A08	19871432	19873181	BnaA08T0179900ZY	0	+	0	0	1749	0.0000000
zheyou73v0_A08	19897138	19898402	BnaA08T0180000ZY	0	+	0	0	1264	0.0000000
zheyou73v0_A08	19901746	19902001	BnaA08T0180100ZY	0	-	0	0	255	0.0000000
zheyou73v0_A08	19905781	19906195	BnaA08T0180200ZY	0	+	0	0	414	0.0000000
zheyou73v0_A08	19907704	19909704	BnaA08T0180300ZY	0	-	0	0	2000	0.0000000
zheyou73v0_A08	19923585	19924819	BnaA08T0180400ZY	0	+	0	0	1234	0.0000000
zheyou73v0_A08	19935252	19935879	BnaA08T0180500ZY	0	+	0	0	627	0.0000000
zheyou73v0_A08	19944771	19947259	BnaA08T0180600ZY	0	+	0	0	2488	0.0000000
zheyou73v0_A08	19948364	19949811	BnaA08T0180700ZY	0	-	0	0	1447	0.0000000
zheyou73v0_A08	19950790	19953263	BnaA08T0180800ZY	0	+	0	0	2473	0.0000000
zheyou73v0_A08	19976874	19978464	BnaA08T0180900ZY	0	+	0	0	1590	0.0000000
zheyou73v0_A08	19981420	19984793	BnaA08T0181000ZY	0	-	0	0	3373	0.0000000
zheyou73v0_A08	19987196	19988642	BnaA08T0181100ZY	0	+	0	0	1446	0.0000000
zheyou73v0_A08	19987196	19988642	BnaA08T0181100ZY.1	0	+	0	0	1446	0.0000000
zheyou73v0_A08	19988686	19993733	BnaA08T0181200ZY	0	-	0	0	5047	0.0000000
zheyou73v0_A08	20003540	20004301	BnaA08T0181300ZY	0	+	0	0	761	0.0000000
zheyou73v0_A08	20006690	20008536	BnaA08T0181400ZY	0	+	0	0	1846	0.0000000
zheyou73v0_A08	20010523	20011066	BnaA08T0181500ZY	0	+	0	0	543	0.0000000
zheyou73v0_A08	20013958	20014327	BnaA08T0181600ZY	0	+	0	0	369	0.0000000
zheyou73v0_A08	20014790	20015169	BnaA08T0181700ZY	0	-	0	0	379	0.0000000
zheyou73v0_A08	20022201	20023302	BnaA08T0181800ZY	0	-	0	0	1101	0.0000000
zheyou73v0_A08	20029271	20030544	BnaA08T0181900ZY	0	-	0	0	1273	0.0000000
zheyou73v0_A08	20030891	20033286	BnaA08T0182000ZY	0	+	0	0	2395	0.0000000
zheyou73v0_A08	20045596	20047418	BnaA08T0182100ZY	0	+	0	0	1822	0.0000000
zheyou73v0_A08	20067546	20068857	BnaA08T0182200ZY	0	+	0	0	1311	0.0000000
zheyou73v0_A08	20079528	20080829	BnaA08T0182300ZY	0	+	0	0	1301	0.0000000
zheyou73v0_A08	20086350	20087137	BnaA08T0182400ZY	0	+	0	0	787	0.0000000
zheyou73v0_A08	20091068	20091561	BnaA08T0182500ZY	0	-	0	0	493	0.0000000
zheyou73v0_A08	20104208	20106030	BnaA08T0182600ZY	0	+	0	0	1822	0.0000000
zheyou73v0_A08	20106398	20107317	BnaA08T0182700ZY	0	-	0	0	919	0.0000000
zheyou73v0_A08	20108648	20111034	BnaA08T0182800ZY	0	-	0	0	2386	0.0000000
zheyou73v0_A08	20116124	20117385	BnaA08T0182900ZY	0	-	0	0	1261	0.0000000
zheyou73v0_A08	20120061	20121573	BnaA08T0183000ZY	0	+	0	0	1512	0.0000000
zheyou73v0_A08	20122073	20124963	BnaA08T0183100ZY	0	-	0	0	2890	0.0000000
zheyou73v0_A08	20125682	20128485	BnaA08T0183200ZY	0	-	0	0	2803	0.0000000
zheyou73v0_A08	20128660	20129763	BnaA08T0183300ZY	0	-	0	0	1103	0.0000000
zheyou73v0_A08	20129958	20133025	BnaA08T0183400ZY	0	-	0	0	3067	0.0000000
zheyou73v0_A08	20134014	20137547	BnaA08T0183500ZY	0	-	0	0	3533	0.0000000
zheyou73v0_A08	20140107	20141040	BnaA08T0183600ZY	0	-	0	0	933	0.0000000
zheyou73v0_A08	20154611	20165291	BnaA08T0183700ZY	0	+	0	0	10680	0.0000000
zheyou73v0_A08	20186805	20188605	BnaA08T0183800ZY	0	-	0	0	1800	0.0000000
zheyou73v0_A08	20191238	20197669	BnaA08T0183900ZY	0	-	0	0	6431	0.0000000
zheyou73v0_A08	20199929	20202084	BnaA08T0184000ZY	0	+	0	0	2155	0.0000000
zheyou73v0_A08	20202856	20203818	BnaA08T0184100ZY	0	-	0	0	962	0.0000000
zheyou73v0_A08	20210170	20213395	BnaA08T0184200ZY	0	+	0	0	3225	0.0000000
zheyou73v0_A08	20214851	20216671	BnaA08T0184300ZY	0	+	0	0	1820	0.0000000
zheyou73v0_A08	20216759	20218129	BnaA08T0184400ZY	0	-	0	0	1370	0.0000000
zheyou73v0_A08	20224654	20227214	BnaA08T0184500ZY	0	-	0	0	2560	0.0000000
zheyou73v0_A08	20229076	20229884	BnaA08T0184600ZY	0	+	0	0	808	0.0000000
zheyou73v0_A08	20230741	20231413	BnaA08T0184700ZY	0	+	0	0	672	0.0000000
zheyou73v0_A08	20231554	20232993	BnaA08T0184800ZY	0	-	0	0	1439	0.0000000
zheyou73v0_A08	20234751	20235911	BnaA08T0184900ZY	0	-	0	0	1160	0.0000000
zheyou73v0_A08	20237887	20238889	BnaA08T0185000ZY	0	+	0	0	1002	0.0000000
zheyou73v0_A08	20248378	20250209	BnaA08T0185100ZY	0	+	0	0	1831	0.0000000
zheyou73v0_A08	20251343	20253523	BnaA08T0185200ZY	0	-	0	0	2180	0.0000000
zheyou73v0_A08	20257406	20258783	BnaA08T0185300ZY	0	-	0	0	1377	0.0000000
zheyou73v0_A08	20260184	20260855	BnaA08T0185400ZY	0	-	0	0	671	0.0000000
zheyou73v0_A08	20261835	20262048	BnaA08T0185500ZY	0	-	0	0	213	0.0000000
zheyou73v0_A08	20262510	20262967	BnaA08T0185600ZY	0	-	0	0	457	0.0000000
zheyou73v0_A08	20267538	20270083	BnaA08T0185700ZY	0	+	0	0	2545	0.0000000
zheyou73v0_A08	20271362	20273159	BnaA08T0185800ZY	0	+	0	0	1797	0.0000000
zheyou73v0_A08	20271362	20273159	BnaA08T0185800ZY.1	0	+	0	0	1797	0.0000000
zheyou73v0_A08	20278292	20280837	BnaA08T0185900ZY	0	+	0	0	2545	0.0000000
zheyou73v0_A08	20284844	20285996	BnaA08T0186000ZY	0	-	0	0	1152	0.0000000
zheyou73v0_A08	20286105	20294612	BnaA08T0186100ZY	0	-	0	0	8507	0.0000000
zheyou73v0_A08	20295539	20297165	BnaA08T0186200ZY	0	-	0	0	1626	0.0000000
zheyou73v0_A08	20299500	20300343	BnaA08T0186300ZY.2	0	+	0	0	843	0.0000000
zheyou73v0_A08	20299603	20300343	BnaA08T0186300ZY.1	0	+	0	0	740	0.0000000
zheyou73v0_A08	20299680	20300343	BnaA08T0186300ZY	0	+	0	0	663	0.0000000
zheyou73v0_A08	20301791	20302997	BnaA08T0186400ZY	0	+	0	0	1206	0.0000000
zheyou73v0_A08	20303800	20305042	BnaA08T0186500ZY	0	+	0	0	1242	0.0000000
zheyou73v0_A08	20307982	20309039	BnaA08T0186600ZY	0	+	0	0	1057	0.0000000
zheyou73v0_A08	20319674	20321751	BnaA08T0186700ZY	0	+	0	0	2077	0.0000000
zheyou73v0_A08	20328250	20328658	BnaA08T0186800ZY	0	-	0	0	408	0.0000000
zheyou73v0_A08	20332170	20333104	BnaA08T0186900ZY	0	-	0	0	934	0.0000000
zheyou73v0_A08	20333855	20335019	BnaA08T0187000ZY	0	+	0	0	1164	0.0000000
zheyou73v0_A08	20336179	20345387	BnaA08T0187100ZY	0	+	0	0	9208	0.0000000
zheyou73v0_A08	20336179	20337930	BnaA08T0187100ZY.1	0	+	0	0	1751	0.0000000
zheyou73v0_A08	20345860	20346584	BnaA08T0187200ZY	0	-	0	0	724	0.0000000
zheyou73v0_A08	20349861	20350995	BnaA08T0187300ZY	0	+	0	0	1134	0.0000000
zheyou73v0_A08	20352591	20357169	BnaA08T0187400ZY	0	-	0	0	4578	0.0000000
zheyou73v0_A08	20352994	20357169	BnaA08T0187400ZY.1	0	-	0	0	4175	0.0000000
zheyou73v0_A08	20357385	20360793	BnaA08T0187500ZY	0	+	0	0	3408	0.0000000
zheyou73v0_A08	20360500	20360722	BnaA08T0187600ZY	0	-	0	0	222	0.0000000
zheyou73v0_A08	20363419	20372117	BnaA08T0187700ZY	0	-	0	0	8698	0.0000000
zheyou73v0_A08	20373352	20376554	BnaA08T0187800ZY	0	-	0	0	3202	0.0000000
zheyou73v0_A08	20380196	20380991	BnaA08T0187900ZY	0	+	0	0	795	0.0000000
zheyou73v0_A08	20381130	20381814	BnaA08T0188000ZY	0	-	0	0	684	0.0000000
zheyou73v0_A08	20384794	20389294	BnaA08T0188100ZY	0	-	0	0	4500	0.0000000
zheyou73v0_A08	20416998	20419531	BnaA08T0188200ZY	0	+	0	0	2533	0.0000000
zheyou73v0_A08	20429004	20436773	BnaA08T0188300ZY	0	+	0	0	7769	0.0000000
zheyou73v0_A08	20440896	20445266	BnaA08T0188400ZY	0	-	0	0	4370	0.0000000
zheyou73v0_A08	20441322	20445266	BnaA08T0188400ZY.1	0	-	0	0	3944	0.0000000
zheyou73v0_A08	20453346	20455269	BnaA08T0188500ZY	0	-	0	0	1923	0.0000000
zheyou73v0_A08	20460617	20463210	BnaA08T0188600ZY	0	+	0	0	2593	0.0000000
zheyou73v0_A08	20464607	20466617	BnaA08T0188700ZY	0	-	0	0	2010	0.0000000
zheyou73v0_A08	20469764	20470169	BnaA08T0188800ZY	0	-	0	0	405	0.0000000
zheyou73v0_A08	20473858	20477972	BnaA08T0188900ZY	0	-	0	0	4114	0.0000000
zheyou73v0_A08	20479121	20479484	BnaA08T0189000ZY	0	-	0	0	363	0.0000000
zheyou73v0_A08	20486203	20487325	BnaA08T0189100ZY	0	-	0	0	1122	0.0000000
zheyou73v0_A08	20488365	20489116	BnaA08T0189200ZY	0	+	0	0	751	0.0000000
zheyou73v0_A08	20490188	20492069	BnaA08T0189300ZY	0	+	0	0	1881	0.0000000
zheyou73v0_A08	20492024	20493028	BnaA08T0189400ZY	0	-	0	0	1004	0.0000000
zheyou73v0_A08	20495524	20496546	BnaA08T0189500ZY	0	-	0	0	1022	0.0000000
zheyou73v0_A08	20500039	20500885	BnaA08T0189600ZY	0	+	0	0	846	0.0000000
zheyou73v0_A08	20502098	20502763	BnaA08T0189700ZY	0	+	0	0	665	0.0000000
zheyou73v0_A08	20504875	20507340	BnaA08T0189800ZY	0	+	0	0	2465	0.0000000
zheyou73v0_A08	20507761	20510255	BnaA08T0189900ZY	0	-	0	0	2494	0.0000000
zheyou73v0_A08	20511507	20514354	BnaA08T0190000ZY	0	-	0	0	2847	0.0000000
zheyou73v0_A08	20515435	20517976	BnaA08T0190100ZY	0	+	0	0	2541	0.0000000
zheyou73v0_A08	20515435	20517976	BnaA08T0190100ZY.1	0	+	0	0	2541	0.0000000
zheyou73v0_A08	20518497	20520790	BnaA08T0190200ZY	0	+	0	0	2293	0.0000000
zheyou73v0_A08	20521226	20523866	BnaA08T0190300ZY	0	+	0	0	2640	0.0000000
zheyou73v0_A08	20525133	20527959	BnaA08T0190400ZY	0	+	0	0	2826	0.0000000
zheyou73v0_A08	20528939	20531084	BnaA08T0190500ZY	0	+	0	0	2145	0.0000000
zheyou73v0_A08	20531968	20532505	BnaA08T0190600ZY	0	+	0	0	537	0.0000000
zheyou73v0_A08	20532553	20533474	BnaA08T0190700ZY	0	+	0	0	921	0.0000000
zheyou73v0_A08	20533566	20538889	BnaA08T0190800ZY	0	-	0	0	5323	0.0000000
zheyou73v0_A08	20544130	20545451	BnaA08T0190900ZY	0	+	0	0	1321	0.0000000
zheyou73v0_A08	20545659	20552614	BnaA08T0191000ZY	0	-	0	0	6955	0.0000000
zheyou73v0_A08	20556167	20558453	BnaA08T0191100ZY	0	-	0	0	2286	0.0000000
zheyou73v0_A08	20565251	20566627	BnaA08T0191200ZY	0	+	0	0	1376	0.0000000
zheyou73v0_A08	20567443	20569760	BnaA08T0191300ZY	0	+	0	0	2317	0.0000000
zheyou73v0_A08	20570011	20571720	BnaA08T0191400ZY	0	-	0	0	1709	0.0000000
zheyou73v0_A08	20573174	20574261	BnaA08T0191500ZY	0	-	0	0	1087	0.0000000
zheyou73v0_A08	20574637	20576297	BnaA08T0191600ZY	0	+	0	0	1660	0.0000000
zheyou73v0_A08	20576478	20577024	BnaA08T0191700ZY	0	+	0	0	546	0.0000000
zheyou73v0_A08	20580031	20581858	BnaA08T0191800ZY	0	+	0	0	1827	0.0000000
zheyou73v0_A08	20585368	20586218	BnaA08T0191900ZY	0	-	0	0	850	0.0000000
zheyou73v0_A08	20593946	20601020	BnaA08T0192000ZY	0	-	0	0	7074	0.0000000
zheyou73v0_A08	20603911	20605546	BnaA08T0192100ZY	0	+	0	0	1635	0.0000000
zheyou73v0_A08	20606192	20607274	BnaA08T0192200ZY	0	-	0	0	1082	0.0000000
zheyou73v0_A08	20612281	20614134	BnaA08T0192300ZY	0	+	0	0	1853	0.0000000
zheyou73v0_A08	20617643	20618504	BnaA08T0192400ZY	0	+	0	0	861	0.0000000
zheyou73v0_A08	20619786	20621823	BnaA08T0192500ZY	0	+	0	0	2037	0.0000000
zheyou73v0_A08	20622954	20624935	BnaA08T0192600ZY	0	+	0	0	1981	0.0000000
zheyou73v0_A08	20625713	20627167	BnaA08T0192700ZY	0	+	0	0	1454	0.0000000
zheyou73v0_A08	20628234	20630288	BnaA08T0192800ZY	0	+	0	0	2054	0.0000000
zheyou73v0_A08	20631032	20633604	BnaA08T0192900ZY	0	-	0	0	2572	0.0000000
zheyou73v0_A08	20634496	20636621	BnaA08T0193000ZY	0	+	0	0	2125	0.0000000
zheyou73v0_A08	20638454	20640791	BnaA08T0193100ZY	0	+	0	0	2337	0.0000000
zheyou73v0_A08	20642562	20644287	BnaA08T0193200ZY	0	-	0	0	1725	0.0000000
zheyou73v0_A08	20651025	20659512	BnaA08T0193300ZY	0	+	0	0	8487	0.0000000
zheyou73v0_A08	20659703	20661408	BnaA08T0193400ZY	0	-	0	0	1705	0.0000000
zheyou73v0_A08	20662754	20665354	BnaA08T0193500ZY	0	+	0	0	2600	0.0000000
zheyou73v0_A08	20664712	20666419	BnaA08T0193600ZY	0	-	0	0	1707	0.0000000
zheyou73v0_A08	20666819	20670285	BnaA08T0193700ZY	0	-	0	0	3466	0.0000000
zheyou73v0_A08	20666819	20670285	BnaA08T0193700ZY.1	0	-	0	0	3466	0.0000000
zheyou73v0_A08	20666819	20670285	BnaA08T0193700ZY.2	0	-	0	0	3466	0.0000000
zheyou73v0_A08	20666819	20670285	BnaA08T0193700ZY.3	0	-	0	0	3466	0.0000000
zheyou73v0_A08	20676547	20678438	BnaA08T0193800ZY	0	+	0	0	1891	0.0000000
zheyou73v0_A08	20677806	20679543	BnaA08T0193900ZY	0	-	0	0	1737	0.0000000
zheyou73v0_A08	20679761	20682032	BnaA08T0194000ZY	0	-	0	0	2271	0.0000000
zheyou73v0_A08	20679761	20682032	BnaA08T0194000ZY.1	0	-	0	0	2271	0.0000000
zheyou73v0_A08	20682833	20686388	BnaA08T0194100ZY	0	-	0	0	3555	0.0000000
zheyou73v0_A08	20682833	20686388	BnaA08T0194100ZY.1	0	-	0	0	3555	0.0000000
zheyou73v0_A08	20691818	20697485	BnaA08T0194200ZY	0	+	0	0	5667	0.0000000
zheyou73v0_A08	20698252	20706402	BnaA08T0194300ZY	0	+	0	0	8150	0.0000000
zheyou73v0_A08	20706486	20706973	BnaA08T0194400ZY	0	-	0	0	487	0.0000000
zheyou73v0_A08	20708027	20713161	BnaA08T0194500ZY	0	+	0	0	5134	0.0000000
zheyou73v0_A08	20714909	20717426	BnaA08T0194600ZY	0	-	0	0	2517	0.0000000
zheyou73v0_A08	20717984	20720590	BnaA08T0194700ZY	0	-	0	0	2606	0.0000000
zheyou73v0_A08	20722019	20725604	BnaA08T0194800ZY	0	-	0	0	3585	0.0000000
zheyou73v0_A08	20727391	20728947	BnaA08T0194900ZY	0	+	0	0	1556	0.0000000
zheyou73v0_A08	20729945	20730338	BnaA08T0195000ZY	0	+	0	0	393	0.0000000
zheyou73v0_A08	20731612	20733645	BnaA08T0195100ZY	0	-	0	0	2033	0.0000000
zheyou73v0_A08	20737043	20740724	BnaA08T0195200ZY	0	-	0	0	3681	0.0000000
zheyou73v0_A08	20742255	20744208	BnaA08T0195300ZY	0	+	0	0	1953	0.0000000
zheyou73v0_A08	20744584	20745017	BnaA08T0195400ZY	0	-	0	0	433	0.0000000
zheyou73v0_A08	20746329	20749332	BnaA08T0195500ZY	0	-	0	0	3003	0.0000000
zheyou73v0_A08	20749802	20749985	BnaA08T0195600ZY	0	+	0	0	183	0.0000000
zheyou73v0_A08	20750975	20752348	BnaA08T0195700ZY.1	0	-	0	0	1373	0.0000000
zheyou73v0_A08	20751176	20752348	BnaA08T0195700ZY	0	-	0	0	1172	0.0000000
zheyou73v0_A08	20753465	20756663	BnaA08T0195800ZY	0	+	0	0	3198	0.0000000
zheyou73v0_A08	20756998	20759355	BnaA08T0195900ZY	0	-	0	0	2357	0.0000000
zheyou73v0_A08	20759467	20763947	BnaA08T0196000ZY	0	-	0	0	4480	0.0000000
zheyou73v0_A08	20759467	20764005	BnaA08T0196000ZY.1	0	-	0	0	4538	0.0000000
zheyou73v0_A08	20766518	20768814	BnaA08T0196100ZY	0	-	0	0	2296	0.0000000
zheyou73v0_A08	20768065	20770999	BnaA08T0196200ZY	0	+	0	0	2934	0.0000000
zheyou73v0_A08	20769187	20770999	BnaA08T0196200ZY.1	0	+	0	0	1812	0.0000000
zheyou73v0_A08	20770869	20776579	BnaA08T0196300ZY	0	-	0	0	5710	0.0000000
zheyou73v0_A08	20778042	20782461	BnaA08T0196400ZY	0	+	0	0	4419	0.0000000
zheyou73v0_A08	20790812	20800580	BnaA08T0196500ZY	0	-	0	0	9768	0.0000000
zheyou73v0_A08	20802133	20804071	BnaA08T0196600ZY	0	-	0	0	1938	0.0000000
zheyou73v0_A08	20807022	20815851	BnaA08T0196700ZY	0	-	0	0	8829	0.0000000
zheyou73v0_A08	20807022	20813483	BnaA08T0196700ZY.1	0	-	0	0	6461	0.0000000
zheyou73v0_A08	20820357	20821309	BnaA08T0196800ZY	0	-	0	0	952	0.0000000
zheyou73v0_A08	20822067	20825528	BnaA08T0196900ZY	0	-	0	0	3461	0.0000000
zheyou73v0_A08	20852253	20857459	BnaA08T0197000ZY	0	+	0	0	5206	0.0000000
zheyou73v0_A08	20852253	20857459	BnaA08T0197000ZY.1	0	+	0	0	5206	0.0000000
zheyou73v0_A08	20861256	20864106	BnaA08T0197100ZY	0	-	0	0	2850	0.0000000
zheyou73v0_A08	20869087	20871355	BnaA08T0197200ZY	0	-	0	0	2268	0.0000000
zheyou73v0_A08	20878411	20880309	BnaA08T0197300ZY	0	+	0	0	1898	0.0000000
zheyou73v0_A08	20878411	20880309	BnaA08T0197300ZY.1	0	+	0	0	1898	0.0000000
zheyou73v0_A08	20901108	20904631	BnaA08T0197400ZY	0	-	0	0	3523	0.0000000
zheyou73v0_A08	20901108	20904485	BnaA08T0197400ZY.1	0	-	0	0	3377	0.0000000
zheyou73v0_A08	20913309	20914184	BnaA08T0197500ZY	0	-	0	0	875	0.0000000
zheyou73v0_A08	20915683	20921594	BnaA08T0197600ZY	0	+	0	0	5911	0.0000000
zheyou73v0_A08	20922553	20923934	BnaA08T0197700ZY	0	-	0	0	1381	0.0000000
zheyou73v0_A08	20926830	20929575	BnaA08T0197800ZY	0	+	0	0	2745	0.0000000
zheyou73v0_A08	20926830	20929575	BnaA08T0197800ZY.1	0	+	0	0	2745	0.0000000
zheyou73v0_A08	20933017	20934155	BnaA08T0197900ZY	0	+	0	0	1138	0.0000000
zheyou73v0_A08	20940071	20940827	BnaA08T0198000ZY	0	+	0	0	756	0.0000000
zheyou73v0_A08	20943017	20944647	BnaA08T0198100ZY	0	+	0	0	1630	0.0000000
zheyou73v0_A08	20946632	20947538	BnaA08T0198200ZY	0	-	0	0	906	0.0000000
zheyou73v0_A08	20950130	20951060	BnaA08T0198300ZY	0	-	0	0	930	0.0000000
zheyou73v0_A08	20956177	20958506	BnaA08T0198400ZY	0	+	0	0	2329	0.0000000
zheyou73v0_A08	20958594	20958920	BnaA08T0198500ZY	0	-	0	0	326	0.0000000
zheyou73v0_A08	20958925	20959880	BnaA08T0198600ZY	0	-	0	0	955	0.0000000
zheyou73v0_A08	20970723	20972698	BnaA08T0198700ZY	0	+	0	0	1975	0.0000000
zheyou73v0_A08	20976157	20977291	BnaA08T0198800ZY	0	-	0	0	1134	0.0000000
zheyou73v0_A08	20983449	20985318	BnaA08T0198900ZY	0	-	0	0	1869	0.0000000
zheyou73v0_A08	21005966	21006389	BnaA08T0199000ZY	0	+	0	0	423	0.0000000
zheyou73v0_A08	21007684	21010405	BnaA08T0199100ZY	0	+	0	0	2721	0.0000000
zheyou73v0_A08	21013238	21019878	BnaA08T0199200ZY	0	+	0	0	6640	0.0000000
zheyou73v0_A08	21020525	21021532	BnaA08T0199300ZY	0	-	0	0	1007	0.0000000
zheyou73v0_A08	21026410	21028300	BnaA08T0199400ZY	0	+	0	0	1890	0.0000000
zheyou73v0_A08	21036032	21037239	BnaA08T0199500ZY	0	-	0	0	1207	0.0000000
zheyou73v0_A08	21037522	21039541	BnaA08T0199600ZY	0	-	0	0	2019	0.0000000
zheyou73v0_A08	21041626	21042225	BnaA08T0199700ZY	0	+	0	0	599	0.0000000
zheyou73v0_A08	21042684	21044654	BnaA08T0199800ZY	0	-	0	0	1970	0.0000000
zheyou73v0_A08	21045320	21045869	BnaA08T0199900ZY	0	+	0	0	549	0.0000000
zheyou73v0_A08	21046589	21047303	BnaA08T0200000ZY	0	-	0	0	714	0.0000000
zheyou73v0_A08	21048577	21049423	BnaA08T0200100ZY	0	-	0	0	846	0.0000000
zheyou73v0_A08	21049828	21051714	BnaA08T0200200ZY	0	-	0	0	1886	0.0000000
zheyou73v0_A08	21053246	21056519	BnaA08T0200300ZY	0	+	0	0	3273	0.0000000
zheyou73v0_A08	21078049	21079597	BnaA08T0200400ZY	0	+	0	0	1548	0.0000000
zheyou73v0_A08	21082027	21085217	BnaA08T0200500ZY	0	+	0	0	3190	0.0000000
zheyou73v0_A08	21086045	21087715	BnaA08T0200600ZY	0	-	0	0	1670	0.0000000
zheyou73v0_A08	21090916	21093129	BnaA08T0200700ZY	0	-	0	0	2213	0.0000000
zheyou73v0_A08	21108881	21109547	BnaA08T0200800ZY	0	-	0	0	666	0.0000000
zheyou73v0_A08	21116487	21117198	BnaA08T0200900ZY	0	+	0	0	711	0.0000000
zheyou73v0_A08	21120699	21122592	BnaA08T0201000ZY	0	+	0	0	1893	0.0000000
zheyou73v0_A08	21120963	21122592	BnaA08T0201000ZY.1	0	+	0	0	1629	0.0000000
zheyou73v0_A08	21123060	21123584	BnaA08T0201100ZY	0	-	0	0	524	0.0000000
zheyou73v0_A08	21124038	21124504	BnaA08T0201200ZY	0	-	0	0	466	0.0000000
zheyou73v0_A08	21127171	21127588	BnaA08T0201300ZY	0	-	0	0	417	0.0000000
zheyou73v0_A08	21128425	21128908	BnaA08T0201400ZY	0	-	0	0	483	0.0000000
zheyou73v0_A08	21130288	21130769	BnaA08T0201500ZY	0	-	0	0	481	0.0000000
zheyou73v0_A08	21131829	21132846	BnaA08T0201600ZY	0	-	0	0	1017	0.0000000
zheyou73v0_A08	21135287	21138969	BnaA08T0201700ZY	0	+	0	0	3682	0.0000000
zheyou73v0_A08	21142078	21144031	BnaA08T0201800ZY	0	-	0	0	1953	0.0000000
zheyou73v0_A08	21146015	21149781	BnaA08T0201900ZY	0	+	0	0	3766	0.0000000
zheyou73v0_A08	21151007	21151391	BnaA08T0202000ZY	0	+	0	0	384	0.0000000
zheyou73v0_A08	21157471	21160243	BnaA08T0202100ZY	0	-	0	0	2772	0.0000000
zheyou73v0_A08	21165819	21167801	BnaA08T0202200ZY	0	+	0	0	1982	0.0000000
zheyou73v0_A08	21168135	21170384	BnaA08T0202300ZY	0	-	0	0	2249	0.0000000
zheyou73v0_A08	21173189	21175253	BnaA08T0202400ZY	0	+	0	0	2064	0.0000000
zheyou73v0_A08	21179686	21180266	BnaA08T0202500ZY	0	-	0	0	580	0.0000000
zheyou73v0_A08	21191152	21192495	BnaA08T0202600ZY	0	-	0	0	1343	0.0000000
zheyou73v0_A08	21207449	21209403	BnaA08T0202700ZY	0	+	0	0	1954	0.0000000
zheyou73v0_A08	21210610	21212529	BnaA08T0202800ZY	0	-	0	0	1919	0.0000000
zheyou73v0_A08	21213904	21215261	BnaA08T0202900ZY	0	-	0	0	1357	0.0000000
zheyou73v0_A08	21215365	21216676	BnaA08T0203000ZY	0	+	0	0	1311	0.0000000
zheyou73v0_A08	21217915	21218858	BnaA08T0203100ZY	0	-	0	0	943	0.0000000
zheyou73v0_A08	21224609	21228906	BnaA08T0203200ZY	0	+	0	0	4297	0.0000000
zheyou73v0_A08	21235027	21237437	BnaA08T0203300ZY	0	+	0	0	2410	0.0000000
zheyou73v0_A08	21238517	21240665	BnaA08T0203400ZY	0	-	0	0	2148	0.0000000
zheyou73v0_A08	21241242	21242436	BnaA08T0203500ZY	0	-	0	0	1194	0.0000000
zheyou73v0_A08	21242828	21246175	BnaA08T0203600ZY	0	-	0	0	3347	0.0000000
zheyou73v0_A08	21247003	21248157	BnaA08T0203700ZY	0	-	0	0	1154	0.0000000
zheyou73v0_A08	21248394	21250154	BnaA08T0203800ZY	0	-	0	0	1760	0.0000000
zheyou73v0_A08	21248394	21250165	BnaA08T0203800ZY.1	0	-	0	0	1771	0.0000000
zheyou73v0_A08	21250575	21252152	BnaA08T0203900ZY	0	+	0	0	1577	0.0000000
zheyou73v0_A08	21254334	21254779	BnaA08T0204000ZY	0	-	0	0	445	0.0000000
zheyou73v0_A08	21256809	21257443	BnaA08T0204100ZY	0	-	0	0	634	0.0000000
zheyou73v0_A08	21260403	21261891	BnaA08T0204200ZY	0	-	0	0	1488	0.0000000
zheyou73v0_A08	21263630	21264207	BnaA08T0204300ZY	0	-	0	0	577	0.0000000
zheyou73v0_A08	21268142	21269957	BnaA08T0204400ZY	0	+	0	0	1815	0.0000000
zheyou73v0_A08	21274221	21276113	BnaA08T0204500ZY	0	+	0	0	1892	0.0000000
zheyou73v0_A08	21276609	21278519	BnaA08T0204600ZY	0	+	0	0	1910	0.0000000
zheyou73v0_A08	21287241	21289810	BnaA08T0204700ZY	0	+	0	0	2569	0.0000000
zheyou73v0_A08	21290162	21290873	BnaA08T0204800ZY	0	+	0	0	711	0.0000000
zheyou73v0_A08	21290861	21291683	BnaA08T0204900ZY	0	-	0	0	822	0.0000000
zheyou73v0_A08	21292130	21294952	BnaA08T0205000ZY	0	+	0	0	2822	0.0000000
zheyou73v0_A08	21295318	21297120	BnaA08T0205100ZY	0	-	0	0	1802	0.0000000
zheyou73v0_A08	21298443	21299727	BnaA08T0205200ZY	0	-	0	0	1284	0.0000000
zheyou73v0_A08	21301176	21302743	BnaA08T0205300ZY	0	-	0	0	1567	0.0000000
zheyou73v0_A08	21305012	21308601	BnaA08T0205400ZY	0	-	0	0	3589	0.0000000
zheyou73v0_A08	21321463	21327670	BnaA08T0205500ZY	0	-	0	0	6207	0.0000000
zheyou73v0_A08	21332593	21333760	BnaA08T0205600ZY	0	-	0	0	1167	0.0000000
zheyou73v0_A08	21337508	21338078	BnaA08T0205700ZY	0	-	0	0	570	0.0000000
zheyou73v0_A08	21363558	21364395	BnaA08T0205800ZY	0	+	0	0	837	0.0000000
zheyou73v0_A08	21366330	21367691	BnaA08T0205900ZY	0	+	0	0	1361	0.0000000
zheyou73v0_A08	21366330	21367691	BnaA08T0205900ZY.1	0	+	0	0	1361	0.0000000
zheyou73v0_A08	21366330	21367691	BnaA08T0205900ZY.2	0	+	0	0	1361	0.0000000
zheyou73v0_A08	21366330	21367691	BnaA08T0205900ZY.3	0	+	0	0	1361	0.0000000
zheyou73v0_A08	21368594	21370262	BnaA08T0206000ZY	0	+	0	0	1668	0.0000000
zheyou73v0_A08	21372286	21374846	BnaA08T0206100ZY	0	-	0	0	2560	0.0000000
zheyou73v0_A08	21379497	21379710	BnaA08T0206200ZY	0	-	0	0	213	0.0000000
zheyou73v0_A08	21386073	21386967	BnaA08T0206300ZY	0	+	0	0	894	0.0000000
zheyou73v0_A08	21391856	21392411	BnaA08T0206400ZY	0	-	0	0	555	0.0000000
zheyou73v0_A08	21395832	21400724	BnaA08T0206500ZY	0	-	0	0	4892	0.0000000
zheyou73v0_A08	21400983	21401214	BnaA08T0206600ZY	0	+	0	0	231	0.0000000
zheyou73v0_A08	21405996	21407281	BnaA08T0206700ZY	0	+	0	0	1285	0.0000000
zheyou73v0_A08	21409168	21409894	BnaA08T0206800ZY	0	+	0	0	726	0.0000000
zheyou73v0_A08	21413058	21413577	BnaA08T0206900ZY	0	-	0	0	519	0.0000000
zheyou73v0_A08	21419129	21422209	BnaA08T0207000ZY	0	+	0	0	3080	0.0000000
zheyou73v0_A08	21422396	21422636	BnaA08T0207100ZY	0	-	0	0	240	0.0000000
zheyou73v0_A08	21425670	21428862	BnaA08T0207200ZY	0	+	0	0	3192	0.0000000
zheyou73v0_A08	21433112	21434960	BnaA08T0207300ZY	0	+	0	0	1848	0.0000000
zheyou73v0_A08	21437279	21439006	BnaA08T0207400ZY	0	+	0	0	1727	0.0000000
zheyou73v0_A08	21440176	21444146	BnaA08T0207500ZY	0	-	0	0	3970	0.0000000
zheyou73v0_A08	21444258	21445988	BnaA08T0207600ZY	0	-	0	0	1730	0.0000000
zheyou73v0_A08	21447937	21449095	BnaA08T0207700ZY	0	-	0	0	1158	0.0000000
zheyou73v0_A08	21455103	21455325	BnaA08T0207800ZY	0	-	0	0	222	0.0000000
zheyou73v0_A08	21458519	21459886	BnaA08T0207900ZY	0	+	0	0	1367	0.0000000
zheyou73v0_A08	21458519	21459886	BnaA08T0207900ZY.1	0	+	0	0	1367	0.0000000
zheyou73v0_A08	21460382	21460910	BnaA08T0208000ZY	0	-	0	0	528	0.0000000
zheyou73v0_A08	21461119	21461498	BnaA08T0208100ZY	0	-	0	0	379	0.0000000
zheyou73v0_A08	21462468	21463690	BnaA08T0208200ZY	0	+	0	0	1222	0.0000000
zheyou73v0_A08	21467694	21468790	BnaA08T0208300ZY	0	+	0	0	1096	0.0000000
zheyou73v0_A08	21473078	21473477	BnaA08T0208400ZY	0	-	0	0	399	0.0000000
zheyou73v0_A08	21474411	21475116	BnaA08T0208500ZY	0	-	0	0	705	0.0000000
zheyou73v0_A08	21479932	21482158	BnaA08T0208600ZY	0	+	0	0	2226	0.0000000
zheyou73v0_A08	21488779	21491679	BnaA08T0208700ZY	0	+	0	0	2900	0.0000000
zheyou73v0_A08	21488779	21491679	BnaA08T0208700ZY.1	0	+	0	0	2900	0.0000000
zheyou73v0_A08	21496248	21497400	BnaA08T0208800ZY	0	-	0	0	1152	0.0000000
zheyou73v0_A08	21503408	21504422	BnaA08T0208900ZY	0	-	0	0	1014	0.0000000
zheyou73v0_A08	21505675	21509132	BnaA08T0209000ZY	0	-	0	0	3457	0.0000000
zheyou73v0_A08	21509953	21512291	BnaA08T0209100ZY	0	+	0	0	2338	0.0000000
zheyou73v0_A08	21509953	21512291	BnaA08T0209100ZY.1	0	+	0	0	2338	0.0000000
zheyou73v0_A08	21512330	21515985	BnaA08T0209200ZY	0	-	0	0	3655	0.0000000
zheyou73v0_A08	21512330	21515985	BnaA08T0209200ZY.1	0	-	0	0	3655	0.0000000
zheyou73v0_A08	21512330	21515985	BnaA08T0209200ZY.2	0	-	0	0	3655	0.0000000
zheyou73v0_A08	21516369	21517400	BnaA08T0209300ZY	0	-	0	0	1031	0.0000000
zheyou73v0_A08	21519008	21521944	BnaA08T0209400ZY	0	+	0	0	2936	0.0000000
zheyou73v0_A08	21522062	21524148	BnaA08T0209500ZY	0	-	0	0	2086	0.0000000
zheyou73v0_A08	21529471	21537449	BnaA08T0209600ZY	0	+	0	0	7978	0.0000000
zheyou73v0_A08	21538967	21543107	BnaA08T0209700ZY	0	+	0	0	4140	0.0000000
zheyou73v0_A08	21543547	21547452	BnaA08T0209800ZY	0	-	0	0	3905	0.0000000
zheyou73v0_A08	21550792	21551040	BnaA08T0209900ZY	0	+	0	0	248	0.0000000
zheyou73v0_A08	21551307	21556228	BnaA08T0210000ZY	0	+	0	0	4921	0.0000000
zheyou73v0_A08	21559116	21561237	BnaA08T0210100ZY	0	-	0	0	2121	0.0000000
zheyou73v0_A08	21567842	21572788	BnaA08T0210200ZY	0	-	0	0	4946	0.0000000
zheyou73v0_A08	21568422	21572788	BnaA08T0210200ZY.1	0	-	0	0	4366	0.0000000
zheyou73v0_A08	21578550	21579624	BnaA08T0210300ZY	0	-	0	0	1074	0.0000000
zheyou73v0_A08	21594939	21595888	BnaA08T0210400ZY	0	+	0	0	949	0.0000000
zheyou73v0_A08	21597101	21597659	BnaA08T0210500ZY	0	-	0	0	558	0.0000000
zheyou73v0_A08	21598347	21599556	BnaA08T0210600ZY	0	+	0	0	1209	0.0000000
zheyou73v0_A08	21599937	21600583	BnaA08T0210700ZY	0	-	0	0	646	0.0000000
zheyou73v0_A08	21608510	21610370	BnaA08T0210800ZY	0	-	0	0	1860	0.0000000
zheyou73v0_A08	21624338	21626999	BnaA08T0210900ZY	0	-	0	0	2661	0.0000000
zheyou73v0_A08	21635050	21636290	BnaA08T0211000ZY	0	-	0	0	1240	0.0000000
zheyou73v0_A08	21637949	21640376	BnaA08T0211100ZY	0	-	0	0	2427	0.0000000
zheyou73v0_A08	21637949	21640376	BnaA08T0211100ZY.1	0	-	0	0	2427	0.0000000
zheyou73v0_A08	21637949	21640376	BnaA08T0211100ZY.2	0	-	0	0	2427	0.0000000
zheyou73v0_A08	21640932	21643188	BnaA08T0211200ZY	0	-	0	0	2256	0.0000000
zheyou73v0_A08	21645534	21647280	BnaA08T0211300ZY	0	+	0	0	1746	0.0000000
zheyou73v0_A08	21648817	21649236	BnaA08T0211400ZY	0	+	0	0	419	0.0000000
zheyou73v0_A08	21653654	21664777	BnaA08T0211500ZY	0	-	0	0	11123	0.0000000
zheyou73v0_A08	21665847	21667191	BnaA08T0211600ZY	0	+	0	0	1344	0.0000000
zheyou73v0_A08	21668861	21672639	BnaA08T0211700ZY	0	+	0	0	3778	0.0000000
zheyou73v0_A08	21672790	21673299	BnaA08T0211800ZY	0	+	0	0	509	0.0000000
zheyou73v0_A08	21673966	21678022	BnaA08T0211900ZY	0	+	0	0	4056	0.0000000
zheyou73v0_A08	21678857	21679949	BnaA08T0212000ZY	0	+	0	0	1092	0.0000000
zheyou73v0_A08	21680925	21683350	BnaA08T0212100ZY	0	-	0	0	2425	0.0000000
zheyou73v0_A08	21683649	21685715	BnaA08T0212200ZY	0	+	0	0	2066	0.0000000
zheyou73v0_A08	21689994	21690244	BnaA08T0212300ZY	0	+	0	0	250	0.0000000
zheyou73v0_A08	21693931	21695651	BnaA08T0212400ZY	0	-	0	0	1720	0.0000000
zheyou73v0_A08	21696617	21698987	BnaA08T0212500ZY	0	+	0	0	2370	0.0000000
zheyou73v0_A08	21700555	21701415	BnaA08T0212600ZY	0	+	0	0	860	0.0000000
zheyou73v0_A08	21703281	21705064	BnaA08T0212700ZY	0	-	0	0	1783	0.0000000
zheyou73v0_A08	21705217	21706078	BnaA08T0212800ZY	0	+	0	0	861	0.0000000
zheyou73v0_A08	21706893	21708459	BnaA08T0212900ZY	0	+	0	0	1566	0.0000000
zheyou73v0_A08	21712482	21713756	BnaA08T0213000ZY	0	+	0	0	1274	0.0000000
zheyou73v0_A08	21720676	21721227	BnaA08T0213100ZY	0	+	0	0	551	0.0000000
zheyou73v0_A08	21721700	21723122	BnaA08T0213200ZY	0	+	0	0	1422	0.0000000
zheyou73v0_A08	21724412	21728870	BnaA08T0213300ZY	0	+	0	0	4458	0.0000000
zheyou73v0_A08	21729227	21729490	BnaA08T0213400ZY	0	+	0	0	263	0.0000000
zheyou73v0_A08	21741357	21745963	BnaA08T0213500ZY	0	+	0	0	4606	0.0000000
zheyou73v0_A08	21746092	21746587	BnaA08T0213600ZY	0	+	0	0	495	0.0000000
zheyou73v0_A08	21747478	21748149	BnaA08T0213700ZY	0	-	0	0	671	0.0000000
zheyou73v0_A08	21748962	21750245	BnaA08T0213800ZY	0	+	0	0	1283	0.0000000
zheyou73v0_A08	21754804	21756062	BnaA08T0213900ZY	0	-	0	0	1258	0.0000000
zheyou73v0_A08	21757237	21759540	BnaA08T0214000ZY	0	-	0	0	2303	0.0000000
zheyou73v0_A08	21757237	21759540	BnaA08T0214000ZY.1	0	-	0	0	2303	0.0000000
zheyou73v0_A08	21757237	21759540	BnaA08T0214000ZY.2	0	-	0	0	2303	0.0000000
zheyou73v0_A08	21765177	21768507	BnaA08T0214100ZY	0	-	0	0	3330	0.0000000
zheyou73v0_A08	21769479	21770124	BnaA08T0214200ZY	0	-	0	0	645	0.0000000
zheyou73v0_A08	21772515	21774808	BnaA08T0214300ZY	0	+	0	0	2293	0.0000000
zheyou73v0_A08	21787972	21789949	BnaA08T0214400ZY	0	+	0	0	1977	0.0000000
zheyou73v0_A08	21790512	21794050	BnaA08T0214500ZY	0	+	0	0	3538	0.0000000
zheyou73v0_A08	21794271	21795814	BnaA08T0214600ZY	0	-	0	0	1543	0.0000000
zheyou73v0_A08	21796074	21798224	BnaA08T0214700ZY	0	+	0	0	2150	0.0000000
zheyou73v0_A08	21800870	21802676	BnaA08T0214800ZY	0	+	0	0	1806	0.0000000
zheyou73v0_A08	21804232	21810552	BnaA08T0214900ZY	0	+	0	0	6320	0.0000000
zheyou73v0_A08	21811138	21814166	BnaA08T0215000ZY	0	-	0	0	3028	0.0000000
zheyou73v0_A08	21817317	21820034	BnaA08T0215100ZY	0	-	0	0	2717	0.0000000
zheyou73v0_A08	21824840	21825597	BnaA08T0215200ZY	0	+	0	0	757	0.0000000
zheyou73v0_A08	21829803	21831120	BnaA08T0215300ZY	0	+	0	0	1317	0.0000000
zheyou73v0_A08	21834889	21836877	BnaA08T0215400ZY	0	+	0	0	1988	0.0000000
zheyou73v0_A08	21837534	21838117	BnaA08T0215500ZY	0	+	0	0	583	0.0000000
zheyou73v0_A08	21843099	21843647	BnaA08T0215600ZY	0	-	0	0	548	0.0000000
zheyou73v0_A08	21845632	21846838	BnaA08T0215700ZY	0	-	0	0	1206	0.0000000
zheyou73v0_A08	21848893	21849793	BnaA08T0215800ZY	0	-	0	0	900	0.0000000
zheyou73v0_A08	21859352	21859574	BnaA08T0215900ZY	0	+	0	0	222	0.0000000
zheyou73v0_A08	21860556	21861248	BnaA08T0216000ZY	0	-	0	0	692	0.0000000
zheyou73v0_A08	21867715	21869101	BnaA08T0216100ZY	0	-	0	0	1386	0.0000000
zheyou73v0_A08	21876033	21876422	BnaA08T0216200ZY	0	+	0	0	389	0.0000000
zheyou73v0_A08	21884015	21896571	BnaA08T0216300ZY	0	+	0	0	12556	0.0000000
zheyou73v0_A08	21909997	21912105	BnaA08T0216400ZY	0	+	0	0	2108	0.0000000
zheyou73v0_A08	21912162	21915877	BnaA08T0216500ZY	0	-	0	0	3715	0.0000000
zheyou73v0_A08	21919616	21925984	BnaA08T0216600ZY	0	+	0	0	6368	0.0000000
zheyou73v0_A08	21927794	21929678	BnaA08T0216700ZY	0	+	0	0	1884	0.0000000
zheyou73v0_A08	21930412	21932263	BnaA08T0216800ZY	0	-	0	0	1851	0.0000000
zheyou73v0_A08	21946324	21948439	BnaA08T0216900ZY	0	+	0	0	2115	0.0000000
zheyou73v0_A08	21950387	21952083	BnaA08T0217000ZY	0	-	0	0	1696	0.0000000
zheyou73v0_A08	21953199	21955168	BnaA08T0217100ZY	0	-	0	0	1969	0.0000000
zheyou73v0_A08	21958974	21959862	BnaA08T0217200ZY	0	+	0	0	888	0.0000000
zheyou73v0_A08	21958974	21959862	BnaA08T0217200ZY.1	0	+	0	0	888	0.0000000
zheyou73v0_A08	21961334	21964370	BnaA08T0217300ZY	0	+	0	0	3036	0.0000000
zheyou73v0_A08	21966641	21967082	BnaA08T0217400ZY	0	+	0	0	441	0.0000000
zheyou73v0_A08	21967793	21969689	BnaA08T0217500ZY	0	+	0	0	1896	0.0000000
zheyou73v0_A08	21970373	21972161	BnaA08T0217600ZY	0	+	0	0	1788	0.0000000
zheyou73v0_A08	21975112	21975892	BnaA08T0217700ZY	0	+	0	0	780	0.0000000
zheyou73v0_A08	21978365	21980518	BnaA08T0217800ZY	0	-	0	0	2153	0.0000000
zheyou73v0_A08	21982289	21985443	BnaA08T0217900ZY	0	-	0	0	3154	0.0000000
zheyou73v0_A08	21995246	21997205	BnaA08T0218000ZY	0	+	0	0	1959	0.0000000
zheyou73v0_A08	22004455	22005417	BnaA08T0218100ZY	0	+	0	0	962	0.0000000
zheyou73v0_A08	22007385	22009895	BnaA08T0218200ZY	0	-	0	0	2510	0.0000000
zheyou73v0_A08	22010197	22011199	BnaA08T0218300ZY	0	+	0	0	1002	0.0000000
zheyou73v0_A08	22011360	22013292	BnaA08T0218400ZY	0	+	0	0	1932	0.0000000
zheyou73v0_A08	22015879	22018887	BnaA08T0218500ZY	0	+	0	0	3008	0.0000000
zheyou73v0_A08	22015879	22017938	BnaA08T0218500ZY.1	0	+	0	0	2059	0.0000000
zheyou73v0_A08	22018023	22021801	BnaA08T0218600ZY	0	-	0	0	3778	0.0000000
zheyou73v0_A08	22025027	22027615	BnaA08T0218700ZY	0	+	0	0	2588	0.0000000
zheyou73v0_A08	22030167	22033612	BnaA08T0218800ZY	0	+	0	0	3445	0.0000000
zheyou73v0_A08	22035041	22037608	BnaA08T0218900ZY	0	-	0	0	2567	0.0000000
zheyou73v0_A08	22035041	22037608	BnaA08T0218900ZY.1	0	-	0	0	2567	0.0000000
zheyou73v0_A08	22035041	22037608	BnaA08T0218900ZY.2	0	-	0	0	2567	0.0000000
zheyou73v0_A08	22039099	22041026	BnaA08T0219000ZY	0	-	0	0	1927	0.0000000
zheyou73v0_A08	22042309	22044689	BnaA08T0219100ZY	0	+	0	0	2380	0.0000000
zheyou73v0_A08	22046029	22049428	BnaA08T0219200ZY	0	-	0	0	3399	0.0000000
zheyou73v0_A08	22051765	22056440	BnaA08T0219300ZY	0	-	0	0	4675	0.0000000
zheyou73v0_A08	22058833	22060124	BnaA08T0219400ZY	0	-	0	0	1291	0.0000000
zheyou73v0_A08	22075753	22076480	BnaA08T0219500ZY	0	+	0	0	727	0.0000000
zheyou73v0_A08	22082992	22084886	BnaA08T0219600ZY	0	+	0	0	1894	0.0000000
zheyou73v0_A08	22087654	22091432	BnaA08T0219700ZY	0	+	0	0	3778	0.0000000
zheyou73v0_A08	22093639	22095463	BnaA08T0219800ZY	0	+	0	0	1824	0.0000000
zheyou73v0_A08	22095525	22097722	BnaA08T0219900ZY	0	-	0	0	2197	0.0000000
zheyou73v0_A08	22098283	22100210	BnaA08T0220000ZY	0	+	0	0	1927	0.0000000
zheyou73v0_A08	22100255	22101664	BnaA08T0220100ZY	0	-	0	0	1409	0.0000000
zheyou73v0_A08	22102132	22104927	BnaA08T0220200ZY	0	-	0	0	2795	0.0000000
zheyou73v0_A08	22105564	22108339	BnaA08T0220300ZY	0	-	0	0	2775	0.0000000
zheyou73v0_A08	22105564	22108339	BnaA08T0220300ZY.1	0	-	0	0	2775	0.0000000
zheyou73v0_A08	22109185	22109545	BnaA08T0220400ZY	0	-	0	0	360	0.0000000
zheyou73v0_A08	22110026	22112546	BnaA08T0220500ZY	0	-	0	0	2520	0.0000000
zheyou73v0_A08	22110026	22112546	BnaA08T0220500ZY.1	0	-	0	0	2520	0.0000000
zheyou73v0_A08	22112843	22114667	BnaA08T0220600ZY	0	+	0	0	1824	0.0000000
zheyou73v0_A08	22114883	22117704	BnaA08T0220700ZY	0	-	0	0	2821	0.0000000
zheyou73v0_A08	22120966	22122459	BnaA08T0220800ZY	0	-	0	0	1493	0.0000000
zheyou73v0_A08	22127810	22129494	BnaA08T0220900ZY	0	-	0	0	1684	0.0000000
zheyou73v0_A08	22127810	22129494	BnaA08T0220900ZY.1	0	-	0	0	1684	0.0000000
zheyou73v0_A08	22132044	22132580	BnaA08T0221000ZY	0	+	0	0	536	0.0000000
zheyou73v0_A08	22134894	22135473	BnaA08T0221100ZY	0	+	0	0	579	0.0000000
zheyou73v0_A08	22135624	22135954	BnaA08T0221200ZY	0	+	0	0	330	0.0000000
zheyou73v0_A08	22142048	22144198	BnaA08T0221300ZY	0	-	0	0	2150	0.0000000
zheyou73v0_A08	22152175	22156371	BnaA08T0221400ZY	0	-	0	0	4196	0.0000000
zheyou73v0_A08	22164760	22165393	BnaA08T0221500ZY	0	-	0	0	633	0.0000000
zheyou73v0_A08	22167430	22169253	BnaA08T0221600ZY	0	+	0	0	1823	0.0000000
zheyou73v0_A08	22169669	22171923	BnaA08T0221700ZY	0	-	0	0	2254	0.0000000
zheyou73v0_A08	22175117	22176836	BnaA08T0221800ZY	0	-	0	0	1719	0.0000000
zheyou73v0_A08	22179465	22180638	BnaA08T0221900ZY	0	+	0	0	1173	0.0000000
zheyou73v0_A08	22183380	22186831	BnaA08T0222000ZY	0	+	0	0	3451	0.0000000
zheyou73v0_A08	22187885	22190014	BnaA08T0222100ZY	0	+	0	0	2129	0.0000000
zheyou73v0_A08	22187885	22190014	BnaA08T0222100ZY.1	0	+	0	0	2129	0.0000000
zheyou73v0_A08	22191236	22192356	BnaA08T0222200ZY	0	+	0	0	1120	0.0000000
zheyou73v0_A08	22193931	22194282	BnaA08T0222300ZY	0	+	0	0	351	0.0000000
zheyou73v0_A08	22195974	22197613	BnaA08T0222400ZY	0	+	0	0	1639	0.0000000
zheyou73v0_A08	22197721	22199942	BnaA08T0222500ZY	0	-	0	0	2221	0.0000000
zheyou73v0_A08	22202618	22204047	BnaA08T0222600ZY	0	+	0	0	1429	0.0000000
zheyou73v0_A08	22204603	22206037	BnaA08T0222700ZY	0	-	0	0	1434	0.0000000
zheyou73v0_A08	22210142	22211259	BnaA08T0222800ZY	0	-	0	0	1117	0.0000000
zheyou73v0_A08	22216440	22220533	BnaA08T0222900ZY	0	+	0	0	4093	0.0000000
zheyou73v0_A08	22235011	22236441	BnaA08T0223000ZY	0	+	0	0	1430	0.0000000
zheyou73v0_A08	22241613	22242080	BnaA08T0223100ZY	0	-	0	0	467	0.0000000
zheyou73v0_A08	22245336	22245792	BnaA08T0223200ZY	0	+	0	0	456	0.0000000
zheyou73v0_A08	22246859	22248787	BnaA08T0223300ZY	0	+	0	0	1928	0.0000000
zheyou73v0_A08	22249747	22250483	BnaA08T0223400ZY	0	-	0	0	736	0.0000000
zheyou73v0_A08	22256804	22259427	BnaA08T0223500ZY	0	+	0	0	2623	0.0000000
zheyou73v0_A08	22256804	22259427	BnaA08T0223500ZY.1	0	+	0	0	2623	0.0000000
zheyou73v0_A08	22256804	22259427	BnaA08T0223500ZY.2	0	+	0	0	2623	0.0000000
zheyou73v0_A08	22260075	22261905	BnaA08T0223600ZY	0	+	0	0	1830	0.0000000
zheyou73v0_A08	22262128	22265750	BnaA08T0223700ZY	0	-	0	0	3622	0.0000000
zheyou73v0_A08	22273674	22275723	BnaA08T0223800ZY	0	+	0	0	2049	0.0000000
zheyou73v0_A08	22276446	22277391	BnaA08T0223900ZY	0	-	0	0	945	0.0000000
zheyou73v0_A08	22284227	22285101	BnaA08T0224000ZY	0	+	0	0	874	0.0000000
zheyou73v0_A08	22290290	22291571	BnaA08T0224100ZY	0	-	0	0	1281	0.0000000
zheyou73v0_A08	22306941	22308778	BnaA08T0224200ZY	0	+	0	0	1837	0.0000000
zheyou73v0_A08	22320224	22321495	BnaA08T0224300ZY	0	+	0	0	1271	0.0000000
zheyou73v0_A08	22326250	22328517	BnaA08T0224400ZY	0	+	0	0	2267	0.0000000
zheyou73v0_A08	22344630	22347120	BnaA08T0224500ZY	0	+	0	0	2490	0.0000000
zheyou73v0_A08	22344630	22347120	BnaA08T0224500ZY.1	0	+	0	0	2490	0.0000000
zheyou73v0_A08	22348802	22350687	BnaA08T0224600ZY	0	+	0	0	1885	0.0000000
zheyou73v0_A08	22357015	22358623	BnaA08T0224700ZY	0	+	0	0	1608	0.0000000
zheyou73v0_A08	22358870	22360914	BnaA08T0224800ZY	0	-	0	0	2044	0.0000000
zheyou73v0_A08	22363221	22364107	BnaA08T0224900ZY	0	-	0	0	886	0.0000000
zheyou73v0_A08	22364985	22368589	BnaA08T0225000ZY	0	-	0	0	3604	0.0000000
zheyou73v0_A08	22364985	22368589	BnaA08T0225000ZY.1	0	-	0	0	3604	0.0000000
zheyou73v0_A08	22372854	22373127	BnaA08T0225100ZY	0	+	0	0	273	0.0000000
zheyou73v0_A08	22373234	22375174	BnaA08T0225200ZY	0	+	0	0	1940	0.0000000
zheyou73v0_A08	22376313	22376694	BnaA08T0225300ZY	0	-	0	0	381	0.0000000
zheyou73v0_A08	22378829	22379450	BnaA08T0225400ZY	0	+	0	0	621	0.0000000
zheyou73v0_A08	22380969	22388369	BnaA08T0225500ZY	0	-	0	0	7400	0.0000000
zheyou73v0_A08	22397678	22398158	BnaA08T0225600ZY	0	+	0	0	480	0.0000000
zheyou73v0_A08	22399320	22402547	BnaA08T0225700ZY	0	+	0	0	3227	0.0000000
zheyou73v0_A08	22403179	22405306	BnaA08T0225800ZY	0	-	0	0	2127	0.0000000
zheyou73v0_A08	22408126	22411217	BnaA08T0225900ZY	0	-	0	0	3091	0.0000000
zheyou73v0_A08	22408895	22411153	BnaA08T0225900ZY.1	0	-	0	0	2258	0.0000000
zheyou73v0_A08	22409175	22411153	BnaA08T0225900ZY.2	0	-	0	0	1978	0.0000000
zheyou73v0_A08	22414009	22414300	BnaA08T0226000ZY	0	+	0	0	291	0.0000000
zheyou73v0_A08	22418047	22420661	BnaA08T0226100ZY	0	+	0	0	2614	0.0000000
zheyou73v0_A08	22422246	22424350	BnaA08T0226200ZY	0	-	0	0	2104	0.0000000
zheyou73v0_A08	22426004	22426788	BnaA08T0226300ZY	0	+	0	0	784	0.0000000
zheyou73v0_A08	22426833	22427770	BnaA08T0226400ZY	0	+	0	0	937	0.0000000
zheyou73v0_A08	22426833	22427770	BnaA08T0226400ZY.1	0	+	0	0	937	0.0000000
zheyou73v0_A08	22429242	22429659	BnaA08T0226500ZY	0	+	0	0	417	0.0000000
zheyou73v0_A08	22444884	22445910	BnaA08T0226600ZY	0	+	0	0	1026	0.0000000
zheyou73v0_A08	22449345	22450494	BnaA08T0226700ZY	0	+	0	0	1149	0.0000000
zheyou73v0_A08	22477573	22478125	BnaA08T0226800ZY	0	+	0	0	552	0.0000000
zheyou73v0_A08	22480340	22481023	BnaA08T0226900ZY	0	+	0	0	683	0.0000000
zheyou73v0_A08	22482926	22483169	BnaA08T0227000ZY	0	+	0	0	243	0.0000000
zheyou73v0_A08	22484028	22485348	BnaA08T0227100ZY	0	+	0	0	1320	0.0000000
zheyou73v0_A08	22486725	22490299	BnaA08T0227200ZY	0	-	0	0	3574	0.0000000
zheyou73v0_A08	22494346	22496314	BnaA08T0227300ZY	0	-	0	0	1968	0.0000000
zheyou73v0_A08	22499532	22501312	BnaA08T0227400ZY	0	+	0	0	1780	0.0000000
zheyou73v0_A08	22501508	22503565	BnaA08T0227500ZY	0	-	0	0	2057	0.0000000
zheyou73v0_A08	22504487	22505215	BnaA08T0227600ZY	0	+	0	0	728	0.0000000
zheyou73v0_A08	22513233	22514258	BnaA08T0227700ZY	0	+	0	0	1025	0.0000000
zheyou73v0_A08	22515792	22519151	BnaA08T0227800ZY	0	+	0	0	3359	0.0000000
zheyou73v0_A08	22519694	22519880	BnaA08T0227900ZY	0	+	0	0	186	0.0000000
zheyou73v0_A08	22529578	22538941	BnaA08T0228000ZY	0	+	0	0	9363	0.0000000
zheyou73v0_A08	22542255	22545015	BnaA08T0228100ZY	0	+	0	0	2760	0.0000000
zheyou73v0_A08	22545416	22545974	BnaA08T0228200ZY	0	-	0	0	558	0.0000000
zheyou73v0_A08	22549917	22552139	BnaA08T0228300ZY	0	-	0	0	2222	0.0000000
zheyou73v0_A08	22553214	22553478	BnaA08T0228400ZY	0	-	0	0	264	0.0000000
zheyou73v0_A08	22568951	22575573	BnaA08T0228500ZY	0	+	0	0	6622	0.0000000
zheyou73v0_A08	22576744	22578480	BnaA08T0228600ZY	0	+	0	0	1736	0.0000000
zheyou73v0_A08	22579112	22579610	BnaA08T0228700ZY	0	+	0	0	498	0.0000000
zheyou73v0_A08	22583344	22586225	BnaA08T0228800ZY	0	+	0	0	2881	0.0000000
zheyou73v0_A08	22587014	22589437	BnaA08T0228900ZY	0	+	0	0	2423	0.0000000
zheyou73v0_A08	22592672	22595088	BnaA08T0229000ZY	0	+	0	0	2416	0.0000000
zheyou73v0_A08	22596465	22597287	BnaA08T0229100ZY	0	+	0	0	822	0.0000000
zheyou73v0_A08	22598182	22598808	BnaA08T0229200ZY	0	-	0	0	626	0.0000000
zheyou73v0_A08	22600972	22602575	BnaA08T0229300ZY	0	+	0	0	1603	0.0000000
zheyou73v0_A08	22602625	22604033	BnaA08T0229400ZY	0	-	0	0	1408	0.0000000
zheyou73v0_A08	22604626	22608851	BnaA08T0229500ZY	0	-	0	0	4225	0.0000000
zheyou73v0_A08	22609723	22613702	BnaA08T0229600ZY	0	-	0	0	3979	0.0000000
zheyou73v0_A08	22617191	22617959	BnaA08T0229700ZY	0	-	0	0	768	0.0000000
zheyou73v0_A08	22620416	22620725	BnaA08T0229800ZY	0	-	0	0	309	0.0000000
zheyou73v0_A08	22622569	22623170	BnaA08T0229900ZY	0	-	0	0	601	0.0000000
zheyou73v0_A08	22623435	22624547	BnaA08T0230000ZY	0	-	0	0	1112	0.0000000
zheyou73v0_A08	22625416	22625973	BnaA08T0230100ZY	0	-	0	0	557	0.0000000
zheyou73v0_A08	22627453	22628501	BnaA08T0230200ZY	0	-	0	0	1048	0.0000000
zheyou73v0_A08	22631560	22634071	BnaA08T0230300ZY	0	+	0	0	2511	0.0000000
zheyou73v0_A08	22639723	22640413	BnaA08T0230400ZY	0	+	0	0	690	0.0000000
zheyou73v0_A08	22644209	22645873	BnaA08T0230500ZY	0	+	0	0	1664	0.0000000
zheyou73v0_A08	22652577	22669880	BnaA08T0230600ZY	0	-	0	0	17303	0.0000000
zheyou73v0_A08	22674898	22678088	BnaA08T0230700ZY	0	+	0	0	3190	0.0000000
zheyou73v0_A08	22680926	22681616	BnaA08T0230800ZY	0	-	0	0	690	0.0000000
zheyou73v0_A08	22685114	22688047	BnaA08T0230900ZY	0	-	0	0	2933	0.0000000
zheyou73v0_A08	22698343	22701645	BnaA08T0231000ZY	0	-	0	0	3302	0.0000000
zheyou73v0_A08	22705176	22708052	BnaA08T0231100ZY	0	-	0	0	2876	0.0000000
zheyou73v0_A08	22711053	22715961	BnaA08T0231200ZY	0	+	0	0	4908	0.0000000
zheyou73v0_A08	22716690	22718401	BnaA08T0231300ZY	0	+	0	0	1711	0.0000000
zheyou73v0_A08	22722683	22725250	BnaA08T0231400ZY	0	+	0	0	2567	0.0000000
zheyou73v0_A08	22726687	22729593	BnaA08T0231500ZY	0	+	0	0	2906	0.0000000
zheyou73v0_A08	22735801	22737837	BnaA08T0231600ZY	0	+	0	0	2036	0.0000000
zheyou73v0_A08	22739155	22740436	BnaA08T0231700ZY	0	-	0	0	1281	0.0000000
zheyou73v0_A08	22740620	22742731	BnaA08T0231800ZY	0	-	0	0	2111	0.0000000
zheyou73v0_A08	22743867	22744626	BnaA08T0231900ZY	0	+	0	0	759	0.0000000
zheyou73v0_A08	22745281	22747051	BnaA08T0232000ZY	0	-	0	0	1770	0.0000000
zheyou73v0_A08	22747253	22748052	BnaA08T0232100ZY	0	-	0	0	799	0.0000000
zheyou73v0_A08	22752132	22754771	BnaA08T0232200ZY	0	-	0	0	2639	0.0000000
zheyou73v0_A08	22763143	22765108	BnaA08T0232300ZY	0	+	0	0	1965	0.0000000
zheyou73v0_A08	22767332	22768755	BnaA08T0232400ZY	0	-	0	0	1423	0.0000000
zheyou73v0_A08	22773656	22774844	BnaA08T0232500ZY	0	-	0	0	1188	0.0000000
zheyou73v0_A08	22776980	22779346	BnaA08T0232600ZY	0	+	0	0	2366	0.0000000
zheyou73v0_A08	22779396	22779731	BnaA08T0232700ZY	0	+	0	0	335	0.0000000
zheyou73v0_A08	22780349	22782567	BnaA08T0232800ZY	0	+	0	0	2218	0.0000000
zheyou73v0_A08	22794084	22796527	BnaA08T0232900ZY	0	+	0	0	2443	0.0000000
zheyou73v0_A08	22796940	22798531	BnaA08T0233000ZY	0	-	0	0	1591	0.0000000
zheyou73v0_A08	22802446	22802662	BnaA08T0233100ZY	0	-	0	0	216	0.0000000
zheyou73v0_A08	22813569	22815189	BnaA08T0233200ZY	0	+	0	0	1620	0.0000000
zheyou73v0_A08	22817029	22819333	BnaA08T0233300ZY	0	-	0	0	2304	0.0000000
zheyou73v0_A08	22817029	22819163	BnaA08T0233300ZY.1	0	-	0	0	2134	0.0000000
zheyou73v0_A08	22820371	22823015	BnaA08T0233400ZY	0	+	0	0	2644	0.0000000
zheyou73v0_A08	22825504	22826383	BnaA08T0233500ZY	0	+	0	0	879	0.0000000
zheyou73v0_A08	22828019	22828979	BnaA08T0233600ZY	0	+	0	0	960	0.0000000
zheyou73v0_A08	22837851	22841536	BnaA08T0233700ZY	0	-	0	0	3685	0.0000000
zheyou73v0_A08	22851255	22851803	BnaA08T0233800ZY	0	+	0	0	548	0.0000000
zheyou73v0_A08	22852384	22852864	BnaA08T0233900ZY	0	+	0	0	480	0.0000000
zheyou73v0_A08	22856025	22858157	BnaA08T0234000ZY	0	+	0	0	2132	0.0000000
zheyou73v0_A08	22864004	22864742	BnaA08T0234100ZY	0	-	0	0	738	0.0000000
zheyou73v0_A08	22867578	22868509	BnaA08T0234200ZY	0	+	0	0	931	0.0000000
zheyou73v0_A08	22869148	22871383	BnaA08T0234300ZY	0	-	0	0	2235	0.0000000
zheyou73v0_A08	22877873	22879369	BnaA08T0234400ZY	0	+	0	0	1496	0.0000000
zheyou73v0_A08	22879458	22879638	BnaA08T0234500ZY	0	+	0	0	180	0.0000000
zheyou73v0_A08	22885336	22885686	BnaA08T0234600ZY	0	+	0	0	350	0.0000000
zheyou73v0_A08	22885995	22888647	BnaA08T0234700ZY	0	-	0	0	2652	0.0000000
zheyou73v0_A08	22890598	22891582	BnaA08T0234800ZY	0	-	0	0	984	0.0000000
zheyou73v0_A08	22903734	22905521	BnaA08T0234900ZY	0	-	0	0	1787	0.0000000
zheyou73v0_A08	22906051	22909877	BnaA08T0235000ZY	0	+	0	0	3826	0.0000000
zheyou73v0_A08	22910823	22913721	BnaA08T0235100ZY	0	-	0	0	2898	0.0000000
zheyou73v0_A08	22917792	22919113	BnaA08T0235200ZY	0	-	0	0	1321	0.0000000
zheyou73v0_A08	22919439	22926730	BnaA08T0235300ZY	0	+	0	0	7291	0.0000000
zheyou73v0_A08	22930173	22936709	BnaA08T0235400ZY	0	-	0	0	6536	0.0000000
zheyou73v0_A08	22936850	22937785	BnaA08T0235500ZY	0	+	0	0	935	0.0000000
zheyou73v0_A08	22939588	22942954	BnaA08T0235600ZY	0	+	0	0	3366	0.0000000
zheyou73v0_A08	22943514	22950273	BnaA08T0235700ZY	0	+	0	0	6759	0.0000000
zheyou73v0_A08	22943514	22950273	BnaA08T0235700ZY.1	0	+	0	0	6759	0.0000000
zheyou73v0_A08	22952238	22952454	BnaA08T0235800ZY	0	+	0	0	216	0.0000000
zheyou73v0_A08	22957169	22957385	BnaA08T0235900ZY	0	+	0	0	216	0.0000000
zheyou73v0_A08	22961222	22963748	BnaA08T0236000ZY	0	+	0	0	2526	0.0000000
zheyou73v0_A08	22964122	22966319	BnaA08T0236100ZY	0	+	0	0	2197	0.0000000
zheyou73v0_A08	22969005	22970566	BnaA08T0236200ZY	0	+	0	0	1561	0.0000000
zheyou73v0_A08	22969005	22970566	BnaA08T0236200ZY.1	0	+	0	0	1561	0.0000000
zheyou73v0_A08	22969005	22970566	BnaA08T0236200ZY.2	0	+	0	0	1561	0.0000000
zheyou73v0_A08	22971088	22973431	BnaA08T0236300ZY	0	-	0	0	2343	0.0000000
zheyou73v0_A08	22975477	22978849	BnaA08T0236400ZY	0	-	0	0	3372	0.0000000
zheyou73v0_A08	22975477	22978725	BnaA08T0236400ZY.1	0	-	0	0	3248	0.0000000
zheyou73v0_A08	22980876	22982994	BnaA08T0236500ZY	0	+	0	0	2118	0.0000000
zheyou73v0_A08	22983156	22983622	BnaA08T0236600ZY	0	+	0	0	466	0.0000000
zheyou73v0_A08	23019640	23020915	BnaA08T0236700ZY	0	-	0	0	1275	0.0000000
zheyou73v0_A08	23022627	23026711	BnaA08T0236800ZY	0	+	0	0	4084	0.0000000
zheyou73v0_A08	23040774	23041573	BnaA08T0236900ZY	0	+	0	0	799	0.0000000
zheyou73v0_A08	23043681	23047159	BnaA08T0237000ZY	0	+	0	0	3478	0.0000000
zheyou73v0_A08	23044007	23047159	BnaA08T0237000ZY.1	0	+	0	0	3152	0.0000000
zheyou73v0_A08	23047786	23049433	BnaA08T0237100ZY	0	+	0	0	1647	0.0000000
zheyou73v0_A08	23049886	23051130	BnaA08T0237200ZY	0	-	0	0	1244	0.0000000
zheyou73v0_A08	23053746	23054634	BnaA08T0237300ZY	0	-	0	0	888	0.0000000
zheyou73v0_A08	23062386	23063393	BnaA08T0237400ZY	0	-	0	0	1007	0.0000000
zheyou73v0_A08	23067032	23069040	BnaA08T0237500ZY	0	-	0	0	2008	0.0000000
zheyou73v0_A08	23072145	23076011	BnaA08T0237600ZY	0	+	0	0	3866	0.0000000
zheyou73v0_A08	23076171	23079942	BnaA08T0237700ZY	0	+	0	0	3771	0.0000000
zheyou73v0_A08	23082835	23083771	BnaA08T0237800ZY	0	-	0	0	936	0.0000000
zheyou73v0_A08	23097562	23099803	BnaA08T0237900ZY	0	+	0	0	2241	0.0000000
zheyou73v0_A08	23110367	23113513	BnaA08T0238000ZY	0	+	0	0	3146	0.0000000
zheyou73v0_A08	23116599	23117240	BnaA08T0238100ZY	0	-	0	0	641	0.0000000
zheyou73v0_A08	23120924	23121567	BnaA08T0238200ZY	0	-	0	0	643	0.0000000
zheyou73v0_A08	23123517	23124006	BnaA08T0238300ZY	0	+	0	0	489	0.0000000
zheyou73v0_A08	23125401	23126538	BnaA08T0238400ZY	0	+	0	0	1137	0.0000000
zheyou73v0_A08	23127613	23131250	BnaA08T0238500ZY	0	-	0	0	3637	0.0000000
zheyou73v0_A08	23132413	23133544	BnaA08T0238600ZY	0	+	0	0	1131	0.0000000
zheyou73v0_A08	23132413	23133692	BnaA08T0238600ZY.1	0	+	0	0	1279	0.0000000
zheyou73v0_A08	23133858	23135132	BnaA08T0238700ZY	0	-	0	0	1274	0.0000000
zheyou73v0_A08	23135147	23140244	BnaA08T0238800ZY	0	-	0	0	5097	0.0000000
zheyou73v0_A08	23143028	23146678	BnaA08T0238900ZY	0	+	0	0	3650	0.0000000
zheyou73v0_A08	23148825	23150861	BnaA08T0239000ZY	0	+	0	0	2036	0.0000000
zheyou73v0_A08	23151574	23154624	BnaA08T0239100ZY	0	-	0	0	3050	0.0000000
zheyou73v0_A08	23158042	23161814	BnaA08T0239200ZY	0	-	0	0	3772	0.0000000
zheyou73v0_A08	23167992	23170236	BnaA08T0239300ZY	0	+	0	0	2244	0.0000000
zheyou73v0_A08	23173665	23174361	BnaA08T0239400ZY	0	+	0	0	696	0.0000000
zheyou73v0_A08	23175453	23177559	BnaA08T0239500ZY	0	+	0	0	2106	0.0000000
zheyou73v0_A08	23178012	23180900	BnaA08T0239600ZY	0	+	0	0	2888	0.0000000
zheyou73v0_A08	23181326	23184363	BnaA08T0239700ZY	0	+	0	0	3037	0.0000000
zheyou73v0_A08	23181326	23184363	BnaA08T0239700ZY.1	0	+	0	0	3037	0.0000000
zheyou73v0_A08	23181326	23184363	BnaA08T0239700ZY.2	0	+	0	0	3037	0.0000000
zheyou73v0_A08	23181326	23184363	BnaA08T0239700ZY.3	0	+	0	0	3037	0.0000000
zheyou73v0_A08	23185207	23187162	BnaA08T0239800ZY	0	+	0	0	1955	0.0000000
zheyou73v0_A08	23187344	23188001	BnaA08T0239900ZY	0	-	0	0	657	0.0000000
zheyou73v0_A08	23190428	23191082	BnaA08T0240000ZY	0	-	0	0	654	0.0000000
zheyou73v0_A08	23192161	23192785	BnaA08T0240100ZY	0	-	0	0	624	0.0000000
zheyou73v0_A08	23194355	23196169	BnaA08T0240200ZY	0	+	0	0	1814	0.0000000
zheyou73v0_A08	23197014	23198919	BnaA08T0240300ZY	0	+	0	0	1905	0.0000000
zheyou73v0_A08	23197014	23198919	BnaA08T0240300ZY.1	0	+	0	0	1905	0.0000000
zheyou73v0_A08	23197014	23198919	BnaA08T0240300ZY.2	0	+	0	0	1905	0.0000000
zheyou73v0_A08	23199050	23202666	BnaA08T0240400ZY	0	-	0	0	3616	0.0000000
zheyou73v0_A08	23203483	23206813	BnaA08T0240500ZY	0	+	0	0	3330	0.0000000
zheyou73v0_A08	23208105	23209392	BnaA08T0240600ZY	0	+	0	0	1287	0.0000000
zheyou73v0_A08	23213934	23215340	BnaA08T0240700ZY	0	-	0	0	1406	0.0000000
zheyou73v0_A08	23219651	23221710	BnaA08T0240800ZY	0	-	0	0	2059	0.0000000
zheyou73v0_A08	23222291	23225206	BnaA08T0240900ZY	0	-	0	0	2915	0.0000000
zheyou73v0_A08	23226085	23227190	BnaA08T0241000ZY	0	-	0	0	1105	0.0000000
zheyou73v0_A08	23228358	23231285	BnaA08T0241100ZY	0	-	0	0	2927	0.0000000
zheyou73v0_A08	23232861	23233679	BnaA08T0241200ZY	0	+	0	0	818	0.0000000
zheyou73v0_A08	23234844	23237060	BnaA08T0241300ZY	0	-	0	0	2216	0.0000000
zheyou73v0_A08	23234844	23237060	BnaA08T0241300ZY.1	0	-	0	0	2216	0.0000000
zheyou73v0_A08	23237253	23238934	BnaA08T0241400ZY	0	-	0	0	1681	0.0000000
zheyou73v0_A08	23237253	23238934	BnaA08T0241400ZY.1	0	-	0	0	1681	0.0000000
zheyou73v0_A08	23239988	23241767	BnaA08T0241500ZY	0	+	0	0	1779	0.0000000
zheyou73v0_A08	23242178	23242601	BnaA08T0241600ZY	0	-	0	0	423	0.0000000
zheyou73v0_A08	23244263	23244639	BnaA08T0241700ZY	0	-	0	0	376	0.0000000
zheyou73v0_A08	23248230	23250527	BnaA08T0241800ZY	0	-	0	0	2297	0.0000000
zheyou73v0_A08	23251571	23253807	BnaA08T0241900ZY	0	+	0	0	2236	0.0000000
zheyou73v0_A08	23257568	23259984	BnaA08T0242000ZY	0	+	0	0	2416	0.0000000
zheyou73v0_A08	23260280	23261279	BnaA08T0242100ZY	0	-	0	0	999	0.0000000
zheyou73v0_A08	23264189	23265833	BnaA08T0242200ZY	0	+	0	0	1644	0.0000000
zheyou73v0_A08	23269058	23272316	BnaA08T0242300ZY	0	+	0	0	3258	0.0000000
zheyou73v0_A08	23275308	23278232	BnaA08T0242400ZY	0	+	0	0	2924	0.0000000
zheyou73v0_A08	23278663	23282114	BnaA08T0242500ZY	0	-	0	0	3451	0.0000000
zheyou73v0_A08	23285311	23286710	BnaA08T0242600ZY	0	+	0	0	1399	0.0000000
zheyou73v0_A08	23297151	23297592	BnaA08T0242700ZY	0	+	0	0	441	0.0000000
zheyou73v0_A08	23317761	23320734	BnaA08T0242800ZY	0	+	0	0	2973	0.0000000
zheyou73v0_A08	23321812	23323065	BnaA08T0242900ZY	0	-	0	0	1253	0.0000000
zheyou73v0_A08	23323640	23329587	BnaA08T0243000ZY	0	+	0	0	5947	0.0000000
zheyou73v0_A08	23330739	23334047	BnaA08T0243100ZY	0	+	0	0	3308	0.0000000
zheyou73v0_A08	23338838	23341509	BnaA08T0243200ZY	0	+	0	0	2671	0.0000000
zheyou73v0_A08	23342459	23345528	BnaA08T0243300ZY	0	+	0	0	3069	0.0000000
zheyou73v0_A08	23342459	23345528	BnaA08T0243300ZY.1	0	+	0	0	3069	0.0000000
zheyou73v0_A08	23349082	23350111	BnaA08T0243400ZY	0	-	0	0	1029	0.0000000
zheyou73v0_A08	23351969	23352290	BnaA08T0243500ZY	0	+	0	0	321	0.0000000
zheyou73v0_A08	23352979	23355325	BnaA08T0243600ZY	0	-	0	0	2346	0.0000000
zheyou73v0_A08	23352979	23355325	BnaA08T0243600ZY.1	0	-	0	0	2346	0.0000000
zheyou73v0_A08	23355936	23357165	BnaA08T0243700ZY	0	+	0	0	1229	0.0000000
zheyou73v0_A08	23357760	23358467	BnaA08T0243800ZY	0	+	0	0	707	0.0000000
zheyou73v0_A08	23358575	23363392	BnaA08T0243900ZY	0	-	0	0	4817	0.0000000
zheyou73v0_A08	23369782	23374067	BnaA08T0244000ZY	0	+	0	0	4285	0.0000000
zheyou73v0_A08	23375217	23376060	BnaA08T0244100ZY	0	-	0	0	843	0.0000000
zheyou73v0_A08	23378142	23379632	BnaA08T0244200ZY	0	+	0	0	1490	0.0000000
zheyou73v0_A08	23379711	23381330	BnaA08T0244300ZY	0	-	0	0	1619	0.0000000
zheyou73v0_A08	23389675	23393627	BnaA08T0244400ZY	0	+	0	0	3952	0.0000000
zheyou73v0_A08	23394196	23395369	BnaA08T0244500ZY	0	-	0	0	1173	0.0000000
zheyou73v0_A08	23398979	23400048	BnaA08T0244600ZY	0	-	0	0	1069	0.0000000
zheyou73v0_A08	23404838	23406431	BnaA08T0244700ZY	0	+	0	0	1593	0.0000000
zheyou73v0_A08	23407975	23411155	BnaA08T0244800ZY	0	-	0	0	3180	0.0000000
zheyou73v0_A08	23412121	23415094	BnaA08T0244900ZY	0	-	0	0	2973	0.0000000
zheyou73v0_A08	23419790	23422597	BnaA08T0245000ZY	0	+	0	0	2807	0.0000000
zheyou73v0_A08	23433719	23438071	BnaA08T0245100ZY	0	+	0	0	4352	0.0000000
zheyou73v0_A08	23438592	23439123	BnaA08T0245200ZY	0	+	0	0	531	0.0000000
zheyou73v0_A08	23441517	23443066	BnaA08T0245300ZY	0	-	0	0	1549	0.0000000
zheyou73v0_A08	23446016	23448594	BnaA08T0245400ZY	0	-	0	0	2578	0.0000000
zheyou73v0_A08	23450385	23451472	BnaA08T0245500ZY	0	-	0	0	1087	0.0000000
zheyou73v0_A08	23451847	23453381	BnaA08T0245600ZY	0	+	0	0	1534	0.0000000
zheyou73v0_A08	23453607	23454801	BnaA08T0245700ZY	0	+	0	0	1194	0.0000000
zheyou73v0_A08	23455574	23459339	BnaA08T0245800ZY	0	-	0	0	3765	0.0000000
zheyou73v0_A08	23464414	23465803	BnaA08T0245900ZY	0	+	0	0	1389	0.0000000
zheyou73v0_A08	23468821	23469493	BnaA08T0246000ZY	0	+	0	0	672	0.0000000
zheyou73v0_A08	23470235	23470460	BnaA08T0246100ZY	0	-	0	0	225	0.0000000
zheyou73v0_A08	23473072	23474736	BnaA08T0246200ZY	0	-	0	0	1664	0.0000000
zheyou73v0_A08	23478554	23479968	BnaA08T0246300ZY	0	+	0	0	1414	0.0000000
zheyou73v0_A08	23482033	23483135	BnaA08T0246400ZY	0	-	0	0	1102	0.0000000
zheyou73v0_A08	23483704	23488150	BnaA08T0246500ZY	0	-	0	0	4446	0.0000000
zheyou73v0_A08	23489594	23492610	BnaA08T0246600ZY	0	-	0	0	3016	0.0000000
zheyou73v0_A08	23496982	23500009	BnaA08T0246700ZY	0	-	0	0	3027	0.0000000
zheyou73v0_A08	23501753	23504368	BnaA08T0246800ZY	0	-	0	0	2615	0.0000000
zheyou73v0_A08	23505628	23510213	BnaA08T0246900ZY	0	+	0	0	4585	0.0000000
zheyou73v0_A08	23506677	23510213	BnaA08T0246900ZY.1	0	+	0	0	3536	0.0000000
zheyou73v0_A08	23506677	23510213	BnaA08T0246900ZY.2	0	+	0	0	3536	0.0000000
zheyou73v0_A08	23511491	23511955	BnaA08T0247000ZY	0	+	0	0	464	0.0000000
zheyou73v0_A08	23515816	23516083	BnaA08T0247100ZY	0	+	0	0	267	0.0000000
zheyou73v0_A08	23518067	23522105	BnaA08T0247200ZY	0	-	0	0	4038	0.0000000
zheyou73v0_A08	23518067	23521171	BnaA08T0247200ZY.1	0	-	0	0	3104	0.0000000
zheyou73v0_A08	23522717	23524804	BnaA08T0247300ZY	0	-	0	0	2087	0.0000000
zheyou73v0_A08	23527143	23528525	BnaA08T0247400ZY	0	+	0	0	1382	0.0000000
zheyou73v0_A08	23532023	23534227	BnaA08T0247500ZY	0	+	0	0	2204	0.0000000
zheyou73v0_A08	23536534	23537813	BnaA08T0247600ZY	0	+	0	0	1279	0.0000000
zheyou73v0_A08	23544965	23546200	BnaA08T0247700ZY	0	+	0	0	1235	0.0000000
zheyou73v0_A08	23551629	23552753	BnaA08T0247800ZY	0	-	0	0	1124	0.0000000
zheyou73v0_A08	23561001	23570595	BnaA08T0247900ZY	0	-	0	0	9594	0.0000000
zheyou73v0_A08	23577151	23580653	BnaA08T0248000ZY	0	+	0	0	3502	0.0000000
zheyou73v0_A08	23577151	23579719	BnaA08T0248000ZY.1	0	+	0	0	2568	0.0000000
zheyou73v0_A08	23582941	23586978	BnaA08T0248100ZY	0	+	0	0	4037	0.0000000
zheyou73v0_A08	23587047	23588724	BnaA08T0248200ZY	0	-	0	0	1677	0.0000000
zheyou73v0_A08	23588780	23591898	BnaA08T0248300ZY	0	-	0	0	3118	0.0000000
zheyou73v0_A08	23592822	23595920	BnaA08T0248400ZY	0	-	0	0	3098	0.0000000
zheyou73v0_A08	23592822	23595920	BnaA08T0248400ZY.1	0	-	0	0	3098	0.0000000
zheyou73v0_A08	23596390	23598969	BnaA08T0248500ZY	0	-	0	0	2579	0.0000000
zheyou73v0_A08	23601678	23604319	BnaA08T0248600ZY	0	-	0	0	2641	0.0000000
zheyou73v0_A08	23607087	23609842	BnaA08T0248700ZY	0	-	0	0	2755	0.0000000
zheyou73v0_A08	23613941	23615149	BnaA08T0248800ZY	0	+	0	0	1208	0.0000000
zheyou73v0_A08	23615663	23616640	BnaA08T0248900ZY	0	-	0	0	977	0.0000000
zheyou73v0_A08	23617460	23618798	BnaA08T0249000ZY	0	-	0	0	1338	0.0000000
zheyou73v0_A08	23636724	23640845	BnaA08T0249100ZY	0	+	0	0	4121	0.0000000
zheyou73v0_A08	23636724	23640279	BnaA08T0249100ZY.1	0	+	0	0	3555	0.0000000
zheyou73v0_A08	23640921	23644447	BnaA08T0249200ZY	0	-	0	0	3526	0.0000000
zheyou73v0_A08	23645046	23648749	BnaA08T0249300ZY	0	-	0	0	3703	0.0000000
zheyou73v0_A08	23650945	23653638	BnaA08T0249400ZY	0	+	0	0	2693	0.0000000
zheyou73v0_A08	23654733	23656906	BnaA08T0249500ZY	0	+	0	0	2173	0.0000000
zheyou73v0_A08	23657384	23658798	BnaA08T0249600ZY	0	+	0	0	1414	0.0000000
zheyou73v0_A08	23659783	23660696	BnaA08T0249700ZY	0	-	0	0	913	0.0000000
zheyou73v0_A08	23661346	23662673	BnaA08T0249800ZY	0	-	0	0	1327	0.0000000
zheyou73v0_A08	23664684	23665182	BnaA08T0249900ZY	0	-	0	0	498	0.0000000
zheyou73v0_A08	23668002	23669205	BnaA08T0250000ZY	0	-	0	0	1203	0.0000000
zheyou73v0_A08	23672282	23673290	BnaA08T0250100ZY	0	+	0	0	1008	0.0000000
zheyou73v0_A08	23682395	23683757	BnaA08T0250200ZY	0	+	0	0	1362	0.0000000
zheyou73v0_A08	23684154	23688049	BnaA08T0250300ZY	0	+	0	0	3895	0.0000000
zheyou73v0_A08	23689100	23690972	BnaA08T0250400ZY	0	+	0	0	1872	0.0000000
zheyou73v0_A08	23699923	23703061	BnaA08T0250500ZY	0	+	0	0	3138	0.0000000
zheyou73v0_A08	23703207	23706158	BnaA08T0250600ZY	0	-	0	0	2951	0.0000000
zheyou73v0_A08	23707261	23708891	BnaA08T0250700ZY	0	-	0	0	1630	0.0000000
zheyou73v0_A08	23708864	23714326	BnaA08T0250800ZY	0	+	0	0	5462	0.0000000
zheyou73v0_A08	23715225	23716658	BnaA08T0250900ZY	0	+	0	0	1433	0.0000000
zheyou73v0_A08	23718111	23720491	BnaA08T0251000ZY	0	+	0	0	2380	0.0000000
zheyou73v0_A08	23722174	23726256	BnaA08T0251100ZY	0	+	0	0	4082	0.0000000
zheyou73v0_A08	23726430	23728530	BnaA08T0251200ZY	0	-	0	0	2100	0.0000000
zheyou73v0_A08	23731293	23732835	BnaA08T0251300ZY	0	-	0	0	1542	0.0000000
zheyou73v0_A08	23731936	23732835	BnaA08T0251300ZY.1	0	-	0	0	899	0.0000000
zheyou73v0_A08	23735312	23736312	BnaA08T0251400ZY	0	-	0	0	1000	0.0000000
zheyou73v0_A08	23736691	23737274	BnaA08T0251500ZY	0	+	0	0	583	0.0000000
zheyou73v0_A08	23738446	23741726	BnaA08T0251600ZY	0	+	0	0	3280	0.0000000
zheyou73v0_A08	23741778	23745700	BnaA08T0251700ZY	0	+	0	0	3922	0.0000000
zheyou73v0_A08	23745787	23746375	BnaA08T0251800ZY	0	-	0	0	588	0.0000000
zheyou73v0_A08	23747641	23750883	BnaA08T0251900ZY	0	+	0	0	3242	0.0000000
zheyou73v0_A08	23751061	23751721	BnaA08T0252000ZY	0	-	0	0	660	0.0000000
zheyou73v0_A08	23752071	23754986	BnaA08T0252100ZY	0	-	0	0	2915	0.0000000
zheyou73v0_A08	23759257	23761334	BnaA08T0252200ZY	0	+	0	0	2077	0.0000000
zheyou73v0_A08	23759257	23761334	BnaA08T0252200ZY.1	0	+	0	0	2077	0.0000000
zheyou73v0_A08	23769919	23775465	BnaA08T0252300ZY	0	+	0	0	5546	0.0000000
zheyou73v0_A08	23771359	23775465	BnaA08T0252300ZY.1	0	+	0	0	4106	0.0000000
zheyou73v0_A08	23776297	23782065	BnaA08T0252400ZY	0	-	0	0	5768	0.0000000
zheyou73v0_A08	23784212	23788878	BnaA08T0252500ZY	0	+	0	0	4666	0.0000000
zheyou73v0_A08	23791128	23792542	BnaA08T0252600ZY	0	+	0	0	1414	0.0000000
zheyou73v0_A08	23793414	23798982	BnaA08T0252700ZY	0	+	0	0	5568	0.0000000
zheyou73v0_A08	23801517	23802542	BnaA08T0252800ZY	0	-	0	0	1025	0.0000000
zheyou73v0_A08	23803900	23808112	BnaA08T0252900ZY	0	-	0	0	4212	0.0000000
zheyou73v0_A08	23810738	23812898	BnaA08T0253000ZY	0	-	0	0	2160	0.0000000
zheyou73v0_A08	23813405	23817133	BnaA08T0253100ZY	0	+	0	0	3728	0.0000000
zheyou73v0_A08	23817545	23818246	BnaA08T0253200ZY	0	-	0	0	701	0.0000000
zheyou73v0_A08	23818528	23820966	BnaA08T0253300ZY	0	+	0	0	2438	0.0000000
zheyou73v0_A08	23818528	23820966	BnaA08T0253300ZY.1	0	+	0	0	2438	0.0000000
zheyou73v0_A08	23821532	23824221	BnaA08T0253400ZY	0	-	0	0	2689	0.0000000
zheyou73v0_A08	23827682	23828132	BnaA08T0253500ZY	0	-	0	0	450	0.0000000
zheyou73v0_A08	23831959	23833749	BnaA08T0253600ZY	0	-	0	0	1790	0.0000000
zheyou73v0_A08	23831959	23833749	BnaA08T0253600ZY.1	0	-	0	0	1790	0.0000000
zheyou73v0_A08	23831959	23833749	BnaA08T0253600ZY.2	0	-	0	0	1790	0.0000000
zheyou73v0_A08	23836174	23840506	BnaA08T0253700ZY	0	-	0	0	4332	0.0000000
zheyou73v0_A08	23847005	23853326	BnaA08T0253800ZY	0	+	0	0	6321	0.0000000
zheyou73v0_A08	23856794	23858317	BnaA08T0253900ZY	0	+	0	0	1523	0.0000000
zheyou73v0_A08	23856794	23858317	BnaA08T0253900ZY.1	0	+	0	0	1523	0.0000000
zheyou73v0_A08	23860914	23863594	BnaA08T0254000ZY	0	+	0	0	2680	0.0000000
zheyou73v0_A08	23864076	23864887	BnaA08T0254100ZY	0	-	0	0	811	0.0000000
zheyou73v0_A08	23865753	23869023	BnaA08T0254200ZY	0	-	0	0	3270	0.0000000
zheyou73v0_A08	23869544	23872665	BnaA08T0254300ZY	0	+	0	0	3121	0.0000000
zheyou73v0_A08	23873282	23875428	BnaA08T0254400ZY	0	+	0	0	2146	0.0000000
zheyou73v0_A08	23875764	23880435	BnaA08T0254500ZY	0	-	0	0	4671	0.0000000
zheyou73v0_A08	23880924	23883176	BnaA08T0254600ZY	0	+	0	0	2252	0.0000000
zheyou73v0_A08	23882740	23888221	BnaA08T0254700ZY	0	-	0	0	5481	0.0000000
zheyou73v0_A08	23888792	23892699	BnaA08T0254800ZY	0	+	0	0	3907	0.0000000
zheyou73v0_A08	23893253	23894449	BnaA08T0254900ZY	0	-	0	0	1196	0.0000000
zheyou73v0_A08	23896633	23897532	BnaA08T0255000ZY	0	-	0	0	899	0.0000000
zheyou73v0_A08	23898810	23899229	BnaA08T0255100ZY	0	+	0	0	419	0.0000000
zheyou73v0_A08	23906527	23907032	BnaA08T0255200ZY	0	+	0	0	505	0.0000000
zheyou73v0_A08	23910632	23914503	BnaA08T0255300ZY	0	+	0	0	3871	0.0000000
zheyou73v0_A08	23910632	23911828	BnaA08T0255300ZY.1	0	+	0	0	1196	0.0000000
zheyou73v0_A08	23915276	23919375	BnaA08T0255400ZY	0	+	0	0	4099	0.0000000
zheyou73v0_A08	23919829	23920530	BnaA08T0255500ZY	0	+	0	0	701	0.0000000
zheyou73v0_A08	23921244	23927351	BnaA08T0255600ZY	0	+	0	0	6107	0.0000000
zheyou73v0_A08	23927681	23928919	BnaA08T0255700ZY	0	-	0	0	1238	0.0000000
zheyou73v0_A08	23930881	23931427	BnaA08T0255800ZY	0	-	0	0	546	0.0000000
zheyou73v0_A08	23933043	23934605	BnaA08T0255900ZY	0	+	0	0	1562	0.0000000
zheyou73v0_A08	23934918	23935226	BnaA08T0256000ZY	0	+	0	0	308	0.0000000
zheyou73v0_A08	23936521	23939368	BnaA08T0256100ZY	0	+	0	0	2847	0.0000000
zheyou73v0_A08	23939928	23942246	BnaA08T0256200ZY	0	+	0	0	2318	0.0000000
zheyou73v0_A08	23939928	23942246	BnaA08T0256200ZY.1	0	+	0	0	2318	0.0000000
zheyou73v0_A08	23941842	23943619	BnaA08T0256300ZY	0	-	0	0	1777	0.0000000
zheyou73v0_A08	23943657	23944671	BnaA08T0256400ZY	0	+	0	0	1014	0.0000000
zheyou73v0_A08	23945287	23947355	BnaA08T0256500ZY	0	-	0	0	2068	0.0000000
zheyou73v0_A08	23949551	23952230	BnaA08T0256600ZY	0	-	0	0	2679	0.0000000
zheyou73v0_A08	23952376	23956140	BnaA08T0256700ZY	0	-	0	0	3764	0.0000000
zheyou73v0_A08	23958491	23961054	BnaA08T0256800ZY	0	+	0	0	2563	0.0000000
zheyou73v0_A08	23958491	23961054	BnaA08T0256800ZY.1	0	+	0	0	2563	0.0000000
zheyou73v0_A08	23961305	23962102	BnaA08T0256900ZY	0	-	0	0	797	0.0000000
zheyou73v0_A08	23962535	23963170	BnaA08T0257000ZY	0	+	0	0	635	0.0000000
zheyou73v0_A08	23963803	23977558	BnaA08T0257100ZY	0	-	0	0	13755	0.0000000
zheyou73v0_A08	23978358	23981545	BnaA08T0257200ZY	0	+	0	0	3187	0.0000000
zheyou73v0_A08	23982397	23985258	BnaA08T0257300ZY	0	+	0	0	2861	0.0000000
zheyou73v0_A08	23986153	23987743	BnaA08T0257400ZY	0	-	0	0	1590	0.0000000
zheyou73v0_A08	23989990	23998555	BnaA08T0257500ZY	0	+	0	0	8565	0.0000000
zheyou73v0_A08	24001436	24004060	BnaA08T0257600ZY	0	+	0	0	2624	0.0000000
zheyou73v0_A08	24005287	24008974	BnaA08T0257700ZY	0	-	0	0	3687	0.0000000
zheyou73v0_A08	24009847	24010947	BnaA08T0257800ZY	0	+	0	0	1100	0.0000000
zheyou73v0_A08	24011164	24012922	BnaA08T0257900ZY	0	-	0	0	1758	0.0000000
zheyou73v0_A08	24013296	24015473	BnaA08T0258000ZY	0	+	0	0	2177	0.0000000
zheyou73v0_A08	24016316	24018455	BnaA08T0258100ZY	0	+	0	0	2139	0.0000000
zheyou73v0_A08	24018064	24027828	BnaA08T0258200ZY	0	-	0	0	9764	0.0000000
zheyou73v0_A08	24028456	24029299	BnaA08T0258300ZY	0	-	0	0	843	0.0000000
zheyou73v0_A08	24030005	24031264	BnaA08T0258400ZY	0	+	0	0	1259	0.0000000
zheyou73v0_A08	24031672	24035147	BnaA08T0258500ZY	0	-	0	0	3475	0.0000000
zheyou73v0_A08	24035918	24037334	BnaA08T0258600ZY	0	-	0	0	1416	0.0000000
zheyou73v0_A08	24037930	24039092	BnaA08T0258700ZY	0	+	0	0	1162	0.0000000
zheyou73v0_A08	24040939	24046394	BnaA08T0258800ZY	0	+	0	0	5455	0.0000000
zheyou73v0_A08	24040939	24046394	BnaA08T0258800ZY.1	0	+	0	0	5455	0.0000000
zheyou73v0_A08	24046710	24047850	BnaA08T0258900ZY	0	+	0	0	1140	0.0000000
zheyou73v0_A08	24046720	24051598	BnaA08T0259000ZY	0	-	0	0	4878	0.0000000
zheyou73v0_A08	24058077	24060059	BnaA08T0259100ZY	0	-	0	0	1982	0.0000000
zheyou73v0_A08	24062887	24063469	BnaA08T0259200ZY	0	+	0	0	582	0.0000000
zheyou73v0_A08	24065970	24068502	BnaA08T0259300ZY	0	-	0	0	2532	0.0000000
zheyou73v0_A08	24069645	24073449	BnaA08T0259400ZY	0	+	0	0	3804	0.0000000
zheyou73v0_A08	24073129	24073879	BnaA08T0259500ZY	0	-	0	0	750	0.0000000
zheyou73v0_A08	24076780	24078333	BnaA08T0259600ZY	0	+	0	0	1553	0.0000000
zheyou73v0_A08	24078706	24079191	BnaA08T0259700ZY	0	+	0	0	485	0.0000000
zheyou73v0_A08	24088173	24088395	BnaA08T0259800ZY	0	+	0	0	222	0.0000000
zheyou73v0_A08	24088917	24093785	BnaA08T0259900ZY	0	-	0	0	4868	0.0000000
zheyou73v0_A08	24092563	24093785	BnaA08T0259900ZY.1	0	-	0	0	1222	0.0000000
zheyou73v0_A08	24096780	24097906	BnaA08T0260000ZY	0	-	0	0	1126	0.0000000
zheyou73v0_A08	24099929	24102305	BnaA08T0260100ZY	0	+	0	0	2376	0.0000000
zheyou73v0_A08	24103056	24104994	BnaA08T0260200ZY	0	+	0	0	1938	0.0000000
zheyou73v0_A08	24103056	24104994	BnaA08T0260200ZY.1	0	+	0	0	1938	0.0000000
zheyou73v0_A08	24108961	24113030	BnaA08T0260300ZY	0	-	0	0	4069	0.0000000
zheyou73v0_A08	24108961	24113030	BnaA08T0260300ZY.1	0	-	0	0	4069	0.0000000
zheyou73v0_A08	24110283	24113030	BnaA08T0260300ZY.2	0	-	0	0	2747	0.0000000
zheyou73v0_A08	24113529	24114301	BnaA08T0260400ZY	0	+	0	0	772	0.0000000
zheyou73v0_A08	24115457	24116733	BnaA08T0260500ZY	0	+	0	0	1276	0.0000000
zheyou73v0_A08	24118120	24123941	BnaA08T0260600ZY	0	+	0	0	5821	0.0000000
zheyou73v0_A08	24124232	24124967	BnaA08T0260700ZY	0	-	0	0	735	0.0000000
zheyou73v0_A08	24125564	24127827	BnaA08T0260800ZY	0	-	0	0	2263	0.0000000
zheyou73v0_A08	24128736	24130667	BnaA08T0260900ZY	0	+	0	0	1931	0.0000000
zheyou73v0_A08	24130999	24131701	BnaA08T0261000ZY	0	-	0	0	702	0.0000000
zheyou73v0_A08	24132294	24135971	BnaA08T0261100ZY	0	+	0	0	3677	0.0000000
zheyou73v0_A08	24135559	24135979	BnaA08T0261200ZY	0	-	0	0	420	0.0000000
zheyou73v0_A08	24136129	24139060	BnaA08T0261300ZY	0	-	0	0	2931	0.0000000
zheyou73v0_A08	24145849	24146761	BnaA08T0261400ZY	0	-	0	0	912	0.0000000
zheyou73v0_A08	24154347	24157967	BnaA08T0261500ZY	0	+	0	0	3620	0.0000000
zheyou73v0_A08	24158583	24160705	BnaA08T0261600ZY	0	+	0	0	2122	0.0000000
zheyou73v0_A08	24161109	24163617	BnaA08T0261700ZY	0	+	0	0	2508	0.0000000
zheyou73v0_A08	24164769	24167546	BnaA08T0261800ZY	0	+	0	0	2777	0.0000000
zheyou73v0_A08	24169406	24172013	BnaA08T0261900ZY	0	-	0	0	2607	0.0000000
zheyou73v0_A08	24175075	24177050	BnaA08T0262000ZY	0	+	0	0	1975	0.0000000
zheyou73v0_A08	24179569	24181022	BnaA08T0262100ZY	0	+	0	0	1453	0.0000000
zheyou73v0_A08	24181663	24183116	BnaA08T0262200ZY	0	-	0	0	1453	0.0000000
zheyou73v0_A08	24181663	24183116	BnaA08T0262200ZY.1	0	-	0	0	1453	0.0000000
zheyou73v0_A08	24184069	24186437	BnaA08T0262300ZY	0	-	0	0	2368	0.0000000
zheyou73v0_A08	24188131	24193294	BnaA08T0262400ZY	0	-	0	0	5163	0.0000000
zheyou73v0_A08	24193926	24196386	BnaA08T0262500ZY	0	-	0	0	2460	0.0000000
zheyou73v0_A08	24197249	24202317	BnaA08T0262600ZY	0	+	0	0	5068	0.0000000
zheyou73v0_A08	24205321	24208223	BnaA08T0262700ZY	0	-	0	0	2902	0.0000000
zheyou73v0_A08	24211649	24213632	BnaA08T0262800ZY	0	-	0	0	1983	0.0000000
zheyou73v0_A08	24215205	24216886	BnaA08T0262900ZY	0	-	0	0	1681	0.0000000
zheyou73v0_A08	24226093	24228129	BnaA08T0263000ZY	0	+	0	0	2036	0.0000000
zheyou73v0_A08	24229931	24230771	BnaA08T0263100ZY	0	+	0	0	840	0.0000000
zheyou73v0_A08	24233456	24235683	BnaA08T0263200ZY	0	+	0	0	2227	0.0000000
zheyou73v0_A08	24239474	24240116	BnaA08T0263300ZY	0	+	0	0	642	0.0000000
zheyou73v0_A08	24240268	24242324	BnaA08T0263400ZY	0	+	0	0	2056	0.0000000
zheyou73v0_A08	24243341	24244162	BnaA08T0263500ZY	0	+	0	0	821	0.0000000
zheyou73v0_A08	24244405	24246231	BnaA08T0263600ZY	0	-	0	0	1826	0.0000000
zheyou73v0_A08	24246550	24247216	BnaA08T0263700ZY	0	-	0	0	666	0.0000000
zheyou73v0_A08	24248734	24250957	BnaA08T0263800ZY	0	+	0	0	2223	0.0000000
zheyou73v0_A08	24248734	24250957	BnaA08T0263800ZY.1	0	+	0	0	2223	0.0000000
zheyou73v0_A08	24251637	24252775	BnaA08T0263900ZY	0	+	0	0	1138	0.0000000
zheyou73v0_A08	24253141	24253808	BnaA08T0264000ZY	0	+	0	0	667	0.0000000
zheyou73v0_A08	24254645	24256678	BnaA08T0264100ZY	0	+	0	0	2033	0.0000000
zheyou73v0_A08	24254645	24256678	BnaA08T0264100ZY.1	0	+	0	0	2033	0.0000000
zheyou73v0_A08	24257054	24258812	BnaA08T0264200ZY	0	-	0	0	1758	0.0000000
zheyou73v0_A08	24259843	24261513	BnaA08T0264300ZY	0	-	0	0	1670	0.0000000
zheyou73v0_A08	24261889	24263564	BnaA08T0264400ZY	0	-	0	0	1675	0.0000000
zheyou73v0_A08	24265068	24266417	BnaA08T0264500ZY	0	-	0	0	1349	0.0000000
zheyou73v0_A08	24268334	24269532	BnaA08T0264600ZY	0	+	0	0	1198	0.0000000
zheyou73v0_A08	24269649	24272190	BnaA08T0264700ZY	0	-	0	0	2541	0.0000000
zheyou73v0_A08	24269649	24272190	BnaA08T0264700ZY.1	0	-	0	0	2541	0.0000000
zheyou73v0_A08	24273133	24275082	BnaA08T0264800ZY	0	+	0	0	1949	0.0000000
zheyou73v0_A08	24275209	24277476	BnaA08T0264900ZY	0	-	0	0	2267	0.0000000
zheyou73v0_A08	24282064	24285689	BnaA08T0265000ZY	0	+	0	0	3625	0.0000000
zheyou73v0_A08	24286058	24286772	BnaA08T0265100ZY	0	-	0	0	714	0.0000000
zheyou73v0_A08	24290996	24296211	BnaA08T0265200ZY	0	-	0	0	5215	0.0000000
zheyou73v0_A08	24297215	24299913	BnaA08T0265300ZY	0	+	0	0	2698	0.0000000
zheyou73v0_A08	24300274	24302414	BnaA08T0265400ZY	0	-	0	0	2140	0.0000000
zheyou73v0_A08	24302935	24303918	BnaA08T0265500ZY	0	+	0	0	983	0.0000000
zheyou73v0_A08	24305265	24306134	BnaA08T0265600ZY	0	+	0	0	869	0.0000000
zheyou73v0_A08	24306608	24308487	BnaA08T0265700ZY	0	-	0	0	1879	0.0000000
zheyou73v0_A08	24309895	24310873	BnaA08T0265800ZY	0	+	0	0	978	0.0000000
zheyou73v0_A08	24313761	24315605	BnaA08T0265900ZY	0	+	0	0	1844	0.0000000
zheyou73v0_A08	24315668	24317328	BnaA08T0266000ZY	0	-	0	0	1660	0.0000000
zheyou73v0_A08	24318576	24321029	BnaA08T0266100ZY	0	+	0	0	2453	0.0000000
zheyou73v0_A08	24321127	24323039	BnaA08T0266200ZY	0	-	0	0	1912	0.0000000
zheyou73v0_A08	24325917	24327368	BnaA08T0266300ZY	0	-	0	0	1451	0.0000000
zheyou73v0_A08	24328815	24330730	BnaA08T0266400ZY	0	+	0	0	1915	0.0000000
zheyou73v0_A08	24329543	24330730	BnaA08T0266400ZY.1	0	+	0	0	1187	0.0000000
zheyou73v0_A08	24342134	24343040	BnaA08T0266500ZY	0	+	0	0	906	0.0000000
zheyou73v0_A08	24345815	24347297	BnaA08T0266600ZY	0	+	0	0	1482	0.0000000
zheyou73v0_A08	24348835	24350795	BnaA08T0266700ZY	0	+	0	0	1960	0.0000000
zheyou73v0_A08	24353134	24354828	BnaA08T0266800ZY	0	-	0	0	1694	0.0000000
zheyou73v0_A08	24357447	24358279	BnaA08T0266900ZY	0	-	0	0	832	0.0000000
zheyou73v0_A08	24358912	24361223	BnaA08T0267000ZY	0	-	0	0	2311	0.0000000
zheyou73v0_A08	24367224	24369100	BnaA08T0267100ZY	0	-	0	0	1876	0.0000000
zheyou73v0_A08	24370314	24374677	BnaA08T0267200ZY	0	+	0	0	4363	0.0000000
zheyou73v0_A08	24375127	24377812	BnaA08T0267300ZY	0	-	0	0	2685	0.0000000
zheyou73v0_A08	24379168	24380632	BnaA08T0267400ZY	0	+	0	0	1464	0.0000000
zheyou73v0_A08	24394632	24396640	BnaA08T0267500ZY	0	-	0	0	2008	0.0000000
zheyou73v0_A08	24398144	24399107	BnaA08T0267600ZY	0	-	0	0	963	0.0000000
zheyou73v0_A08	24400184	24401802	BnaA08T0267700ZY	0	-	0	0	1618	0.0000000
zheyou73v0_A08	24402271	24404683	BnaA08T0267800ZY	0	+	0	0	2412	0.0000000
zheyou73v0_A08	24404795	24406886	BnaA08T0267900ZY	0	-	0	0	2091	0.0000000
zheyou73v0_A08	24408692	24411607	BnaA08T0268000ZY	0	-	0	0	2915	0.0000000
zheyou73v0_A08	24413071	24415071	BnaA08T0268100ZY	0	-	0	0	2000	0.0000000
zheyou73v0_A08	24421937	24423724	BnaA08T0268200ZY	0	+	0	0	1787	0.0000000
zheyou73v0_A08	24423744	24426116	BnaA08T0268300ZY	0	-	0	0	2372	0.0000000
zheyou73v0_A08	24427087	24428897	BnaA08T0268400ZY	0	+	0	0	1810	0.0000000
zheyou73v0_A08	24429195	24429522	BnaA08T0268500ZY	0	+	0	0	327	0.0000000
zheyou73v0_A08	24429797	24432320	BnaA08T0268600ZY	0	-	0	0	2523	0.0000000
zheyou73v0_A08	24432643	24433171	BnaA08T0268700ZY	0	+	0	0	528	0.0000000
zheyou73v0_A08	24436559	24439364	BnaA08T0268800ZY	0	+	0	0	2805	0.0000000
zheyou73v0_A08	24439740	24440916	BnaA08T0268900ZY	0	-	0	0	1176	0.0000000
zheyou73v0_A08	24442796	24443612	BnaA08T0269000ZY	0	-	0	0	816	0.0000000
zheyou73v0_A08	24446082	24448172	BnaA08T0269100ZY	0	+	0	0	2090	0.0000000
zheyou73v0_A08	24450441	24452726	BnaA08T0269200ZY	0	-	0	0	2285	0.0000000
zheyou73v0_A08	24456054	24458757	BnaA08T0269300ZY	0	-	0	0	2703	0.0000000
zheyou73v0_A08	24460701	24462159	BnaA08T0269400ZY	0	+	0	0	1458	0.0000000
zheyou73v0_A08	24462406	24462835	BnaA08T0269500ZY	0	-	0	0	429	0.0000000
zheyou73v0_A08	24466238	24466979	BnaA08T0269600ZY	0	-	0	0	741	0.0000000
zheyou73v0_A08	24475320	24476090	BnaA08T0269700ZY	0	+	0	0	770	0.0000000
zheyou73v0_A08	24477444	24479976	BnaA08T0269800ZY	0	+	0	0	2532	0.0000000
zheyou73v0_A08	24477930	24479976	BnaA08T0269800ZY.1	0	+	0	0	2046	0.0000000
zheyou73v0_A08	24480281	24483141	BnaA08T0269900ZY	0	-	0	0	2860	0.0000000
zheyou73v0_A08	24486050	24488639	BnaA08T0270000ZY	0	+	0	0	2589	0.0000000
zheyou73v0_A08	24488818	24489854	BnaA08T0270100ZY	0	-	0	0	1036	0.0000000
zheyou73v0_A08	24491622	24493344	BnaA08T0270200ZY	0	+	0	0	1722	0.0000000
zheyou73v0_A08	24502864	24508861	BnaA08T0270300ZY	0	-	0	0	5997	0.0000000
zheyou73v0_A08	24509287	24510974	BnaA08T0270400ZY	0	-	0	0	1687	0.0000000
zheyou73v0_A08	24516576	24519062	BnaA08T0270500ZY	0	+	0	0	2486	0.0000000
zheyou73v0_A08	24521003	24522367	BnaA08T0270600ZY	0	-	0	0	1364	0.0000000
zheyou73v0_A08	24524703	24527363	BnaA08T0270700ZY	0	+	0	0	2660	0.0000000
zheyou73v0_A08	24533140	24535553	BnaA08T0270800ZY	0	+	0	0	2413	0.0000000
zheyou73v0_A08	24533140	24535561	BnaA08T0270800ZY.1	0	+	0	0	2421	0.0000000
zheyou73v0_A08	24533140	24535553	BnaA08T0270800ZY.2	0	+	0	0	2413	0.0000000
zheyou73v0_A08	24533140	24535561	BnaA08T0270800ZY.3	0	+	0	0	2421	0.0000000
zheyou73v0_A08	24537152	24539045	BnaA08T0270900ZY	0	-	0	0	1893	0.0000000
zheyou73v0_A08	24541782	24542712	BnaA08T0271000ZY	0	-	0	0	930	0.0000000
zheyou73v0_A08	24543986	24544920	BnaA08T0271100ZY	0	+	0	0	934	0.0000000
zheyou73v0_A08	24549261	24549993	BnaA08T0271200ZY	0	+	0	0	732	0.0000000
zheyou73v0_A08	24556107	24559810	BnaA08T0271300ZY	0	+	0	0	3703	0.0000000
zheyou73v0_A08	24566808	24571140	BnaA08T0271400ZY	0	+	0	0	4332	0.0000000
zheyou73v0_A08	24574403	24575910	BnaA08T0271500ZY	0	-	0	0	1507	0.0000000
zheyou73v0_A08	24574403	24575910	BnaA08T0271500ZY.1	0	-	0	0	1507	0.0000000
zheyou73v0_A08	24578846	24580591	BnaA08T0271600ZY	0	+	0	0	1745	0.0000000
zheyou73v0_A08	24580673	24583625	BnaA08T0271700ZY	0	-	0	0	2952	0.0000000
zheyou73v0_A08	24589163	24590562	BnaA08T0271800ZY	0	+	0	0	1399	0.0000000
zheyou73v0_A08	24593212	24596902	BnaA08T0271900ZY	0	-	0	0	3690	0.0000000
zheyou73v0_A08	24609100	24609778	BnaA08T0272000ZY	0	-	0	0	678	0.0000000
zheyou73v0_A08	24613336	24614230	BnaA08T0272100ZY	0	+	0	0	894	0.0000000
zheyou73v0_A08	24618930	24633574	BnaA08T0272200ZY	0	+	0	0	14644	0.0000000
zheyou73v0_A08	24634216	24634558	BnaA08T0272300ZY	0	+	0	0	342	0.0000000
zheyou73v0_A08	24636687	24637329	BnaA08T0272400ZY	0	-	0	0	642	0.0000000
zheyou73v0_A08	24637802	24640284	BnaA08T0272500ZY	0	-	0	0	2482	0.0000000
zheyou73v0_A08	24642696	24644674	BnaA08T0272600ZY	0	+	0	0	1978	0.0000000
zheyou73v0_A08	24645376	24646284	BnaA08T0272700ZY	0	+	0	0	908	0.0000000
zheyou73v0_A08	24647287	24657118	BnaA08T0272800ZY	0	+	0	0	9831	0.0000000
zheyou73v0_A08	24659404	24661502	BnaA08T0272900ZY	0	-	0	0	2098	0.0000000
zheyou73v0_A08	24662750	24667209	BnaA08T0273000ZY	0	+	0	0	4459	0.0000000
zheyou73v0_A08	24667508	24669946	BnaA08T0273100ZY	0	+	0	0	2438	0.0000000
zheyou73v0_A08	24670271	24672019	BnaA08T0273200ZY	0	-	0	0	1748	0.0000000
zheyou73v0_A08	24676427	24679181	BnaA08T0273300ZY	0	+	0	0	2754	0.0000000
zheyou73v0_A08	24680841	24682482	BnaA08T0273400ZY	0	-	0	0	1641	0.0000000
zheyou73v0_A08	24683137	24685213	BnaA08T0273500ZY	0	+	0	0	2076	0.0000000
zheyou73v0_A08	24685512	24688052	BnaA08T0273600ZY	0	-	0	0	2540	0.0000000
zheyou73v0_A08	24688379	24691626	BnaA08T0273700ZY	0	+	0	0	3247	0.0000000
zheyou73v0_A08	24691329	24695571	BnaA08T0273800ZY	0	-	0	0	4242	0.0000000
zheyou73v0_A08	24697743	24699604	BnaA08T0273900ZY	0	+	0	0	1861	0.0000000
zheyou73v0_A08	24700280	24703184	BnaA08T0274000ZY	0	-	0	0	2904	0.0000000
zheyou73v0_A08	24704847	24707237	BnaA08T0274100ZY	0	+	0	0	2390	0.0000000
zheyou73v0_A08	24707346	24709463	BnaA08T0274200ZY	0	-	0	0	2117	0.0000000
zheyou73v0_A08	24710313	24712355	BnaA08T0274300ZY	0	+	0	0	2042	0.0000000
zheyou73v0_A08	24725315	24738530	BnaA08T0274400ZY	0	-	0	0	13215	0.0000000
zheyou73v0_A08	24747551	24748532	BnaA08T0274500ZY	0	-	0	0	981	0.0000000
zheyou73v0_A08	24748997	24753499	BnaA08T0274600ZY	0	-	0	0	4502	0.0000000
zheyou73v0_A08	24768541	24771906	BnaA08T0274700ZY	0	+	0	0	3365	0.0000000
zheyou73v0_A08	24774702	24775470	BnaA08T0274800ZY	0	-	0	0	768	0.0000000
zheyou73v0_A08	24775868	24777096	BnaA08T0274900ZY	0	+	0	0	1228	0.0000000
zheyou73v0_A08	24777080	24777389	BnaA08T0275000ZY	0	-	0	0	309	0.0000000
zheyou73v0_A08	24777706	24779483	BnaA08T0275100ZY	0	-	0	0	1777	0.0000000
zheyou73v0_A08	24791404	24791763	BnaA08T0275200ZY	0	+	0	0	359	0.0000000
zheyou73v0_A08	24804037	24804307	BnaA08T0275300ZY	0	-	0	0	270	0.0000000
zheyou73v0_A08	24804518	24805474	BnaA08T0275400ZY	0	-	0	0	956	0.0000000
zheyou73v0_A08	24806043	24807346	BnaA08T0275500ZY	0	-	0	0	1303	0.0000000
zheyou73v0_A08	24807755	24809351	BnaA08T0275600ZY	0	-	0	0	1596	0.0000000
zheyou73v0_A08	24810039	24810987	BnaA08T0275700ZY	0	-	0	0	948	0.0000000
zheyou73v0_A08	24811539	24813121	BnaA08T0275800ZY	0	-	0	0	1582	0.0000000
zheyou73v0_A08	24818299	24820548	BnaA08T0275900ZY	0	-	0	0	2249	0.0000000
zheyou73v0_A08	24834412	24835981	BnaA08T0276000ZY	0	+	0	0	1569	0.0000000
zheyou73v0_A08	24849553	24851102	BnaA08T0276100ZY	0	-	0	0	1549	0.0000000
zheyou73v0_A08	24858986	24863174	BnaA08T0276200ZY	0	+	0	0	4188	0.0000000
zheyou73v0_A08	24878164	24878425	BnaA08T0276300ZY	0	-	0	0	261	0.0000000
zheyou73v0_A08	24885553	24886768	BnaA08T0276400ZY	0	+	0	0	1215	0.0000000
zheyou73v0_A08	24887815	24888961	BnaA08T0276500ZY	0	-	0	0	1146	0.0000000
zheyou73v0_A08	24894059	24895121	BnaA08T0276600ZY	0	-	0	0	1062	0.0000000
zheyou73v0_A08	24896309	24898595	BnaA08T0276700ZY	0	+	0	0	2286	0.0000000
zheyou73v0_A08	24899041	24899221	BnaA08T0276800ZY	0	-	0	0	180	0.0000000
zheyou73v0_A08	24900631	24903557	BnaA08T0276900ZY	0	-	0	0	2926	0.0000000
zheyou73v0_A08	24904370	24906249	BnaA08T0277000ZY	0	-	0	0	1879	0.0000000
zheyou73v0_A08	24907671	24908038	BnaA08T0277100ZY	0	+	0	0	367	0.0000000
zheyou73v0_A08	24909311	24910544	BnaA08T0277200ZY	0	-	0	0	1233	0.0000000
zheyou73v0_A08	24922211	24925445	BnaA08T0277300ZY	0	+	0	0	3234	0.0000000
zheyou73v0_A08	24926280	24928079	BnaA08T0277400ZY	0	+	0	0	1799	0.0000000
zheyou73v0_A08	24928749	24930591	BnaA08T0277500ZY	0	-	0	0	1842	0.0000000
zheyou73v0_A08	24931135	24931710	BnaA08T0277600ZY	0	-	0	0	575	0.0000000
zheyou73v0_A08	24932298	24936214	BnaA08T0277700ZY	0	-	0	0	3916	0.0000000
zheyou73v0_A08	24937461	24940034	BnaA08T0277800ZY	0	+	0	0	2573	0.0000000
zheyou73v0_A08	24937461	24939752	BnaA08T0277800ZY.1	0	+	0	0	2291	0.0000000
zheyou73v0_A08	24940561	24947996	BnaA08T0277900ZY	0	+	0	0	7435	0.0000000
zheyou73v0_A08	24948562	24952148	BnaA08T0278000ZY	0	+	0	0	3586	0.0000000
zheyou73v0_A08	24954559	24956969	BnaA08T0278100ZY	0	+	0	0	2410	0.0000000
zheyou73v0_A08	24959282	24962298	BnaA08T0278200ZY	0	+	0	0	3016	0.0000000
zheyou73v0_A08	24959282	24962298	BnaA08T0278200ZY.1	0	+	0	0	3016	0.0000000
zheyou73v0_A08	24964408	24972073	BnaA08T0278300ZY	0	+	0	0	7665	0.0000000
zheyou73v0_A08	24975008	24977440	BnaA08T0278400ZY	0	+	0	0	2432	0.0000000
zheyou73v0_A08	24975008	24977440	BnaA08T0278400ZY.1	0	+	0	0	2432	0.0000000
zheyou73v0_A08	24984883	24987196	BnaA08T0278500ZY	0	-	0	0	2313	0.0000000
zheyou73v0_A08	24987200	24991188	BnaA08T0278600ZY	0	-	0	0	3988	0.0000000
zheyou73v0_A08	24995194	24997691	BnaA08T0278700ZY	0	+	0	0	2497	0.0000000
zheyou73v0_A08	24995194	24997510	BnaA08T0278700ZY.1	0	+	0	0	2316	0.0000000
zheyou73v0_A08	25002908	25005243	BnaA08T0278800ZY	0	+	0	0	2335	0.0000000
zheyou73v0_A08	25005457	25007081	BnaA08T0278900ZY	0	-	0	0	1624	0.0000000
zheyou73v0_A08	25009319	25012585	BnaA08T0279000ZY	0	+	0	0	3266	0.0000000
zheyou73v0_A08	25013096	25014290	BnaA08T0279100ZY	0	+	0	0	1194	0.0000000
zheyou73v0_A08	25013096	25014290	BnaA08T0279100ZY.1	0	+	0	0	1194	0.0000000
zheyou73v0_A08	25014883	25015265	BnaA08T0279200ZY	0	-	0	0	382	0.0000000
zheyou73v0_A08	25018379	25019313	BnaA08T0279300ZY	0	+	0	0	934	0.0000000
zheyou73v0_A08	25022761	25024839	BnaA08T0279400ZY	0	+	0	0	2078	0.0000000
zheyou73v0_A08	25025426	25032777	BnaA08T0279500ZY	0	-	0	0	7351	0.0000000
zheyou73v0_A08	25033622	25034900	BnaA08T0279600ZY	0	+	0	0	1278	0.0000000
zheyou73v0_A08	25035138	25040659	BnaA08T0279700ZY	0	-	0	0	5521	0.0000000
zheyou73v0_A08	25044590	25045403	BnaA08T0279800ZY	0	-	0	0	813	0.0000000
zheyou73v0_A08	25053556	25054903	BnaA08T0279900ZY	0	+	0	0	1347	0.0000000
zheyou73v0_A08	25058371	25060164	BnaA08T0280000ZY	0	+	0	0	1793	0.0000000
zheyou73v0_A08	25061876	25067473	BnaA08T0280100ZY	0	+	0	0	5597	0.0000000
zheyou73v0_A08	25061985	25067264	BnaA08T0280100ZY.1	0	+	0	0	5279	0.0000000
zheyou73v0_A08	25067577	25070837	BnaA08T0280200ZY	0	-	0	0	3260	0.0000000
zheyou73v0_A08	25071844	25073999	BnaA08T0280300ZY	0	+	0	0	2155	0.0000000
zheyou73v0_A08	25075371	25087337	BnaA08T0280400ZY	0	+	0	0	11966	0.0000000
zheyou73v0_A08	25090605	25091404	BnaA08T0280500ZY	0	-	0	0	799	0.0000000
zheyou73v0_A08	25096296	25102574	BnaA08T0280600ZY	0	-	0	0	6278	0.0000000
zheyou73v0_A08	25103715	25106065	BnaA08T0280700ZY	0	+	0	0	2350	0.0000000
zheyou73v0_A08	25103715	25106065	BnaA08T0280700ZY.1	0	+	0	0	2350	0.0000000
zheyou73v0_A08	25106189	25108705	BnaA08T0280800ZY	0	-	0	0	2516	0.0000000
zheyou73v0_A08	25111590	25112232	BnaA08T0280900ZY	0	-	0	0	642	0.0000000
zheyou73v0_A08	25114139	25115626	BnaA08T0281000ZY	0	+	0	0	1487	0.0000000
zheyou73v0_A08	25116404	25116905	BnaA08T0281100ZY	0	+	0	0	501	0.0000000
zheyou73v0_A08	25117994	25118808	BnaA08T0281200ZY	0	-	0	0	814	0.0000000
zheyou73v0_A08	25120519	25124592	BnaA08T0281300ZY	0	+	0	0	4073	0.0000000
zheyou73v0_A08	25124730	25128831	BnaA08T0281400ZY	0	+	0	0	4101	0.0000000
zheyou73v0_A08	25128876	25130586	BnaA08T0281500ZY	0	-	0	0	1710	0.0000000
zheyou73v0_A08	25131992	25132531	BnaA08T0281600ZY	0	+	0	0	539	0.0000000
zheyou73v0_A08	25139034	25141120	BnaA08T0281700ZY	0	+	0	0	2086	0.0000000
zheyou73v0_A08	25147697	25150962	BnaA08T0281800ZY	0	+	0	0	3265	0.0000000
zheyou73v0_A08	25151216	25153405	BnaA08T0281900ZY	0	-	0	0	2189	0.0000000
zheyou73v0_A08	25154705	25158472	BnaA08T0282000ZY	0	-	0	0	3767	0.0000000
zheyou73v0_A08	25160706	25163041	BnaA08T0282100ZY	0	+	0	0	2335	0.0000000
zheyou73v0_A08	25162999	25165031	BnaA08T0282200ZY	0	-	0	0	2032	0.0000000
zheyou73v0_A08	25167276	25169183	BnaA08T0282300ZY	0	+	0	0	1907	0.0000000
zheyou73v0_A08	25170545	25172133	BnaA08T0282400ZY	0	-	0	0	1588	0.0000000
zheyou73v0_A08	25172768	25175990	BnaA08T0282500ZY	0	-	0	0	3222	0.0000000
zheyou73v0_A08	25184129	25188096	BnaA08T0282600ZY	0	+	0	0	3967	0.0000000
zheyou73v0_A08	25189502	25192304	BnaA08T0282700ZY	0	+	0	0	2802	0.0000000
zheyou73v0_A08	25192814	25194521	BnaA08T0282800ZY	0	+	0	0	1707	0.0000000
zheyou73v0_A08	25196000	25198826	BnaA08T0282900ZY	0	+	0	0	2826	0.0000000
zheyou73v0_A08	25204876	25208583	BnaA08T0283000ZY	0	+	0	0	3707	0.0000000
zheyou73v0_A08	25209055	25211709	BnaA08T0283100ZY	0	+	0	0	2654	0.0000000
zheyou73v0_A08	25212215	25212994	BnaA08T0283200ZY	0	-	0	0	779	0.0000000
zheyou73v0_A08	25215116	25217790	BnaA08T0283300ZY	0	+	0	0	2674	0.0000000
zheyou73v0_A08	25219913	25222698	BnaA08T0283400ZY	0	+	0	0	2785	0.0000000
zheyou73v0_A08	25222862	25225912	BnaA08T0283500ZY	0	-	0	0	3050	0.0000000
zheyou73v0_A08	25226264	25228195	BnaA08T0283600ZY	0	+	0	0	1931	0.0000000
zheyou73v0_A08	25228206	25229784	BnaA08T0283700ZY	0	-	0	0	1578	0.0000000
zheyou73v0_A08	25231601	25233802	BnaA08T0283800ZY	0	-	0	0	2201	0.0000000
zheyou73v0_A08	25234077	25240211	BnaA08T0283900ZY	0	+	0	0	6134	0.0000000
zheyou73v0_A08	25240507	25242335	BnaA08T0284000ZY	0	+	0	0	1828	0.0000000
zheyou73v0_A08	25242591	25243593	BnaA08T0284100ZY	0	+	0	0	1002	0.0000000
zheyou73v0_A08	25244371	25246616	BnaA08T0284200ZY	0	+	0	0	2245	0.0000000
zheyou73v0_A08	25246721	25247783	BnaA08T0284300ZY	0	-	0	0	1062	0.0000000
zheyou73v0_A08	25248366	25250053	BnaA08T0284400ZY	0	-	0	0	1687	0.0000000
zheyou73v0_A08	25251168	25252160	BnaA08T0284500ZY	0	-	0	0	992	0.0000000
zheyou73v0_A08	25252274	25255279	BnaA08T0284600ZY	0	-	0	0	3005	0.0000000
zheyou73v0_A08	25255942	25256783	BnaA08T0284700ZY	0	-	0	0	841	0.0000000
zheyou73v0_A08	25257265	25258769	BnaA08T0284800ZY	0	-	0	0	1504	0.0000000
zheyou73v0_A08	25259243	25260278	BnaA08T0284900ZY	0	-	0	0	1035	0.0000000
zheyou73v0_A08	25261349	25265131	BnaA08T0285000ZY	0	+	0	0	3782	0.0000000
zheyou73v0_A08	25266034	25267672	BnaA08T0285100ZY	0	-	0	0	1638	0.0000000
zheyou73v0_A08	25272895	25273564	BnaA08T0285200ZY	0	+	0	0	669	0.0000000
zheyou73v0_A08	25275310	25275952	BnaA08T0285300ZY	0	+	0	0	642	0.0000000
zheyou73v0_A08	25276377	25277729	BnaA08T0285400ZY	0	-	0	0	1352	0.0000000
zheyou73v0_A08	25278586	25282142	BnaA08T0285500ZY	0	-	0	0	3556	0.0000000
zheyou73v0_A08	25294567	25295850	BnaA08T0285600ZY	0	-	0	0	1283	0.0000000
zheyou73v0_A08	25296776	25299725	BnaA08T0285700ZY	0	+	0	0	2949	0.0000000
zheyou73v0_A08	25300032	25302665	BnaA08T0285800ZY	0	-	0	0	2633	0.0000000
zheyou73v0_A08	25302859	25306247	BnaA08T0285900ZY	0	+	0	0	3388	0.0000000
zheyou73v0_A08	25310799	25312555	BnaA08T0286000ZY	0	+	0	0	1756	0.0000000
zheyou73v0_A08	25328340	25328678	BnaA08T0286100ZY	0	-	0	0	338	0.0000000
zheyou73v0_A08	25329393	25331668	BnaA08T0286200ZY	0	-	0	0	2275	0.0000000
zheyou73v0_A08	25336448	25339248	BnaA08T0286300ZY	0	+	0	0	2800	0.0000000
zheyou73v0_A08	25336448	25339248	BnaA08T0286300ZY.1	0	+	0	0	2800	0.0000000
zheyou73v0_A08	25338686	25339196	BnaA08T0286400ZY	0	-	0	0	510	0.0000000
zheyou73v0_A08	25339774	25342796	BnaA08T0286500ZY	0	-	0	0	3022	0.0000000
zheyou73v0_A08	25343187	25344938	BnaA08T0286600ZY	0	+	0	0	1751	0.0000000
zheyou73v0_A08	25345040	25348090	BnaA08T0286700ZY	0	-	0	0	3050	0.0000000
zheyou73v0_A08	25345040	25348090	BnaA08T0286700ZY.1	0	-	0	0	3050	0.0000000
zheyou73v0_A08	25350694	25352164	BnaA08T0286800ZY	0	+	0	0	1470	0.0000000
zheyou73v0_A08	25357185	25358584	BnaA08T0286900ZY	0	+	0	0	1399	0.0000000
zheyou73v0_A08	25359250	25361928	BnaA08T0287000ZY	0	-	0	0	2678	0.0000000
zheyou73v0_A08	25369442	25374648	BnaA08T0287100ZY	0	+	0	0	5206	0.0000000
zheyou73v0_A08	25375832	25378180	BnaA08T0287200ZY	0	+	0	0	2348	0.0000000
zheyou73v0_A08	25379102	25380351	BnaA08T0287300ZY	0	+	0	0	1249	0.0000000
zheyou73v0_A08	25382554	25384825	BnaA08T0287400ZY	0	-	0	0	2271	0.0000000
zheyou73v0_A08	25385278	25388051	BnaA08T0287500ZY	0	+	0	0	2773	0.0000000
zheyou73v0_A08	25389464	25390424	BnaA08T0287600ZY	0	-	0	0	960	0.0000000
zheyou73v0_A08	25392258	25398436	BnaA08T0287700ZY	0	+	0	0	6178	0.0000000
zheyou73v0_A08	25392258	25398436	BnaA08T0287700ZY.1	0	+	0	0	6178	0.0000000
zheyou73v0_A08	25397145	25399707	BnaA08T0287800ZY	0	-	0	0	2562	0.0000000
zheyou73v0_A08	25403181	25407844	BnaA08T0287900ZY	0	+	0	0	4663	0.0000000
zheyou73v0_A08	25415548	25416836	BnaA08T0288000ZY	0	+	0	0	1288	0.0000000
zheyou73v0_A08	25415548	25416836	BnaA08T0288000ZY.1	0	+	0	0	1288	0.0000000
zheyou73v0_A08	25417651	25420137	BnaA08T0288100ZY	0	+	0	0	2486	0.0000000
zheyou73v0_A08	25420458	25424644	BnaA08T0288200ZY	0	-	0	0	4186	0.0000000
zheyou73v0_A08	25426823	25431685	BnaA08T0288300ZY	0	-	0	0	4862	0.0000000
zheyou73v0_A08	25434748	25437691	BnaA08T0288400ZY	0	-	0	0	2943	0.0000000
zheyou73v0_A08	25441968	25446350	BnaA08T0288500ZY	0	-	0	0	4382	0.0000000
zheyou73v0_A08	25447090	25447948	BnaA08T0288600ZY	0	+	0	0	858	0.0000000
zheyou73v0_A08	25449621	25457197	BnaA08T0288700ZY	0	+	0	0	7576	0.0000000
zheyou73v0_A08	25458364	25462554	BnaA08T0288800ZY	0	+	0	0	4190	0.0000000
zheyou73v0_A08	25458364	25462554	BnaA08T0288800ZY.1	0	+	0	0	4190	0.0000000
zheyou73v0_A08	25462914	25463876	BnaA08T0288900ZY	0	-	0	0	962	0.0000000
zheyou73v0_A08	25464900	25465902	BnaA08T0289000ZY	0	+	0	0	1002	0.0000000
zheyou73v0_A08	25466234	25468737	BnaA08T0289100ZY	0	-	0	0	2503	0.0000000
zheyou73v0_A08	25475140	25475643	BnaA08T0289200ZY	0	-	0	0	503	0.0000000
zheyou73v0_A08	25475676	25476688	BnaA08T0289300ZY	0	-	0	0	1012	0.0000000
zheyou73v0_A08	25480650	25481083	BnaA08T0289400ZY	0	+	0	0	433	0.0000000
zheyou73v0_A08	25493011	25494529	BnaA08T0289500ZY	0	-	0	0	1518	0.0000000
zheyou73v0_A08	25496607	25506210	BnaA08T0289600ZY	0	-	0	0	9603	0.0000000
zheyou73v0_A08	25507277	25510869	BnaA08T0289700ZY	0	-	0	0	3592	0.0000000
zheyou73v0_A08	25513049	25514107	BnaA08T0289800ZY	0	+	0	0	1058	0.0000000
zheyou73v0_A08	25514603	25517355	BnaA08T0289900ZY	0	-	0	0	2752	0.0000000
zheyou73v0_A08	25519432	25522345	BnaA08T0290000ZY	0	+	0	0	2913	0.0000000
zheyou73v0_A08	25528694	25529740	BnaA08T0290100ZY	0	-	0	0	1046	0.0000000
zheyou73v0_A08	25530856	25532029	BnaA08T0290200ZY	0	-	0	0	1173	0.0000000
zheyou73v0_A08	25534535	25538470	BnaA08T0290300ZY	0	-	0	0	3935	0.0000000
zheyou73v0_A08	25540168	25548483	BnaA08T0290400ZY	0	+	0	0	8315	0.0000000
zheyou73v0_A08	25540168	25548483	BnaA08T0290400ZY.1	0	+	0	0	8315	0.0000000
zheyou73v0_A08	25558039	25565178	BnaA08T0290500ZY	0	-	0	0	7139	0.0000000
zheyou73v0_A08	25565818	25568857	BnaA08T0290600ZY	0	-	0	0	3039	0.0000000
zheyou73v0_A08	25573879	25575668	BnaA08T0290700ZY	0	+	0	0	1789	0.0000000
zheyou73v0_A08	25575959	25576638	BnaA08T0290800ZY	0	+	0	0	679	0.0000000
zheyou73v0_A08	25576662	25577040	BnaA08T0290900ZY	0	+	0	0	378	0.0000000
zheyou73v0_A08	25577834	25580128	BnaA08T0291000ZY	0	-	0	0	2294	0.0000000
zheyou73v0_A08	25581472	25582068	BnaA08T0291100ZY	0	+	0	0	596	0.0000000
zheyou73v0_A08	25582318	25584553	BnaA08T0291200ZY	0	-	0	0	2235	0.0000000
zheyou73v0_A08	25585465	25586760	BnaA08T0291300ZY	0	-	0	0	1295	0.0000000
zheyou73v0_A08	25587857	25590934	BnaA08T0291400ZY	0	+	0	0	3077	0.0000000
zheyou73v0_A08	25587857	25590934	BnaA08T0291400ZY.1	0	+	0	0	3077	0.0000000
zheyou73v0_A08	25591547	25593203	BnaA08T0291500ZY	0	+	0	0	1656	0.0000000
zheyou73v0_A08	25593871	25597061	BnaA08T0291600ZY	0	+	0	0	3190	0.0000000
zheyou73v0_A08	25597608	25600132	BnaA08T0291700ZY	0	+	0	0	2524	0.0000000
zheyou73v0_A08	25603929	25604780	BnaA08T0291800ZY	0	+	0	0	851	0.0000000
zheyou73v0_A08	25609472	25611748	BnaA08T0291900ZY	0	-	0	0	2276	0.0000000
zheyou73v0_A08	25615536	25617808	BnaA08T0292000ZY	0	+	0	0	2272	0.0000000
zheyou73v0_A08	25618117	25620079	BnaA08T0292100ZY	0	-	0	0	1962	0.0000000
zheyou73v0_A08	25623428	25626307	BnaA08T0292200ZY	0	+	0	0	2879	0.0000000
zheyou73v0_A08	25627618	25628228	BnaA08T0292300ZY	0	+	0	0	610	0.0000000
zheyou73v0_A08	25628775	25634204	BnaA08T0292400ZY	0	-	0	0	5429	0.0000000
zheyou73v0_A08	25635129	25638024	BnaA08T0292500ZY	0	-	0	0	2895	0.0000000
zheyou73v0_A08	25639681	25641419	BnaA08T0292600ZY	0	-	0	0	1738	0.0000000
zheyou73v0_A08	25648323	25650128	BnaA08T0292700ZY	0	+	0	0	1805	0.0000000
zheyou73v0_A08	25650917	25651477	BnaA08T0292800ZY	0	+	0	0	560	0.0000000
zheyou73v0_A08	25654673	25657560	BnaA08T0292900ZY	0	+	0	0	2887	0.0000000
zheyou73v0_A08	25661247	25663127	BnaA08T0293000ZY.1	0	-	0	0	1880	0.0000000
zheyou73v0_A08	25661381	25663127	BnaA08T0293000ZY	0	-	0	0	1746	0.0000000
zheyou73v0_A08	25672275	25675210	BnaA08T0293100ZY	0	-	0	0	2935	0.0000000
zheyou73v0_A08	25675559	25677392	BnaA08T0293200ZY	0	-	0	0	1833	0.0000000
zheyou73v0_A08	25682225	25683888	BnaA08T0293300ZY	0	-	0	0	1663	0.0000000
zheyou73v0_A08	25685732	25686839	BnaA08T0293400ZY	0	-	0	0	1107	0.0000000
zheyou73v0_A08	25691373	25692978	BnaA08T0293500ZY	0	+	0	0	1605	0.0000000
zheyou73v0_A08	25694673	25696942	BnaA08T0293600ZY	0	-	0	0	2269	0.0000000
zheyou73v0_A08	25699971	25701689	BnaA08T0293700ZY	0	+	0	0	1718	0.0000000
zheyou73v0_A08	25704481	25706551	BnaA08T0293800ZY	0	+	0	0	2070	0.0000000
zheyou73v0_A08	25707389	25714456	BnaA08T0293900ZY	0	+	0	0	7067	0.0000000
zheyou73v0_A08	25715120	25716876	BnaA08T0294000ZY	0	-	0	0	1756	0.0000000
zheyou73v0_A08	25717613	25720422	BnaA08T0294100ZY	0	+	0	0	2809	0.0000000
zheyou73v0_A08	25717613	25720422	BnaA08T0294100ZY.1	0	+	0	0	2809	0.0000000
zheyou73v0_A08	25721529	25724216	BnaA08T0294200ZY	0	+	0	0	2687	0.0000000
zheyou73v0_A08	25725187	25725638	BnaA08T0294300ZY	0	+	0	0	451	0.0000000
zheyou73v0_A08	25727984	25728571	BnaA08T0294400ZY	0	+	0	0	587	0.0000000
zheyou73v0_A08	25730629	25731120	BnaA08T0294500ZY	0	+	0	0	491	0.0000000
zheyou73v0_A08	25731229	25733722	BnaA08T0294600ZY	0	-	0	0	2493	0.0000000
zheyou73v0_A08	25737639	25739231	BnaA08T0294700ZY	0	+	0	0	1592	0.0000000
zheyou73v0_A08	25739252	25740227	BnaA08T0294800ZY	0	-	0	0	975	0.0000000
zheyou73v0_A08	25742205	25746584	BnaA08T0294900ZY	0	-	0	0	4379	0.0000000
zheyou73v0_A08	25748664	25755250	BnaA08T0295000ZY	0	+	0	0	6586	0.0000000
zheyou73v0_A08	25756938	25758054	BnaA08T0295100ZY	0	-	0	0	1116	0.0000000
zheyou73v0_A08	25759121	25761538	BnaA08T0295200ZY	0	-	0	0	2417	0.0000000
zheyou73v0_A08	25762017	25764995	BnaA08T0295300ZY	0	-	0	0	2978	0.0000000
zheyou73v0_A08	25762017	25764995	BnaA08T0295300ZY.1	0	-	0	0	2978	0.0000000
zheyou73v0_A08	25762017	25764995	BnaA08T0295300ZY.2	0	-	0	0	2978	0.0000000
zheyou73v0_A08	25762017	25764995	BnaA08T0295300ZY.3	0	-	0	0	2978	0.0000000
zheyou73v0_A08	25765770	25766331	BnaA08T0295400ZY	0	-	0	0	561	0.0000000
zheyou73v0_A08	25767806	25769475	BnaA08T0295500ZY	0	+	0	0	1669	0.0000000
zheyou73v0_A08	25769916	25770508	BnaA08T0295600ZY	0	+	0	0	592	0.0000000
zheyou73v0_A08	25771106	25772008	BnaA08T0295700ZY	0	+	0	0	902	0.0000000
zheyou73v0_A08	25773155	25773632	BnaA08T0295800ZY	0	-	0	0	477	0.0000000
zheyou73v0_A08	25776499	25777123	BnaA08T0295900ZY	0	+	0	0	624	0.0000000
zheyou73v0_A08	25778122	25783717	BnaA08T0296000ZY	0	+	0	0	5595	0.0000000
zheyou73v0_A08	25778122	25783717	BnaA08T0296000ZY.1	0	+	0	0	5595	0.0000000
zheyou73v0_A08	25784872	25787053	BnaA08T0296100ZY	0	-	0	0	2181	0.0000000
zheyou73v0_A08	25788088	25791596	BnaA08T0296200ZY	0	+	0	0	3508	0.0000000
zheyou73v0_A08	25799035	25799767	BnaA08T0296300ZY	0	+	0	0	732	0.0000000
zheyou73v0_A08	25802204	25805464	BnaA08T0296400ZY	0	-	0	0	3260	0.0000000
zheyou73v0_A08	25807057	25812361	BnaA08T0296500ZY	0	+	0	0	5304	0.0000000
zheyou73v0_A08	25812576	25817854	BnaA08T0296600ZY	0	+	0	0	5278	0.0000000
zheyou73v0_A08	25819120	25821571	BnaA08T0296700ZY	0	+	0	0	2451	0.0000000
zheyou73v0_A08	25822924	25824703	BnaA08T0296800ZY	0	-	0	0	1779	0.0000000
zheyou73v0_A08	25825768	25827049	BnaA08T0296900ZY	0	-	0	0	1281	0.0000000
zheyou73v0_A08	25825768	25827095	BnaA08T0296900ZY.1	0	-	0	0	1327	0.0000000
zheyou73v0_A08	25827381	25829866	BnaA08T0297000ZY	0	+	0	0	2485	0.0000000
zheyou73v0_A08	25830353	25831592	BnaA08T0297100ZY	0	-	0	0	1239	0.0000000
zheyou73v0_A08	25832159	25834603	BnaA08T0297200ZY	0	+	0	0	2444	0.0000000
zheyou73v0_A08	25835289	25839086	BnaA08T0297300ZY	0	-	0	0	3797	0.0000000
zheyou73v0_A08	25840026	25844876	BnaA08T0297400ZY	0	+	0	0	4850	0.0000000
zheyou73v0_A08	25854281	25857154	BnaA08T0297500ZY	0	-	0	0	2873	0.0000000
zheyou73v0_A08	25858659	25859550	BnaA08T0297600ZY	0	+	0	0	891	0.0000000
zheyou73v0_A08	25860796	25863215	BnaA08T0297700ZY	0	+	0	0	2419	0.0000000
zheyou73v0_A08	25863246	25866837	BnaA08T0297800ZY	0	-	0	0	3591	0.0000000
zheyou73v0_A08	25877318	25877977	BnaA08T0297900ZY	0	-	0	0	659	0.0000000
zheyou73v0_A08	25879229	25879820	BnaA08T0298000ZY	0	+	0	0	591	0.0000000
zheyou73v0_A08	25881368	25881926	BnaA08T0298100ZY	0	-	0	0	558	0.0000000
zheyou73v0_A08	25882159	25883856	BnaA08T0298200ZY	0	+	0	0	1697	0.0000000
zheyou73v0_A08	25884270	25889848	BnaA08T0298300ZY	0	-	0	0	5578	0.0000000
zheyou73v0_A08	25890967	25895577	BnaA08T0298400ZY	0	-	0	0	4610	0.0000000
zheyou73v0_A08	25896476	25897151	BnaA08T0298500ZY	0	-	0	0	675	0.0000000
zheyou73v0_A08	25897775	25899679	BnaA08T0298600ZY	0	+	0	0	1904	0.0000000
zheyou73v0_A08	25902174	25903901	BnaA08T0298700ZY	0	+	0	0	1727	0.0000000
zheyou73v0_A08	25903932	25905729	BnaA08T0298800ZY	0	-	0	0	1797	0.0000000
zheyou73v0_A08	25903932	25905729	BnaA08T0298800ZY.1	0	-	0	0	1797	0.0000000
zheyou73v0_A08	25908614	25909550	BnaA08T0298900ZY	0	+	0	0	936	0.0000000
zheyou73v0_A08	25909984	25911739	BnaA08T0299000ZY	0	-	0	0	1755	0.0000000
zheyou73v0_A08	25912373	25913569	BnaA08T0299100ZY	0	-	0	0	1196	0.0000000
zheyou73v0_A08	25917119	25922174	BnaA08T0299200ZY	0	+	0	0	5055	0.0000000
zheyou73v0_A08	25922422	25923646	BnaA08T0299300ZY	0	-	0	0	1224	0.0000000
zheyou73v0_A08	25926022	25929813	BnaA08T0299400ZY	0	-	0	0	3791	0.0000000
zheyou73v0_A08	25930514	25931777	BnaA08T0299500ZY	0	-	0	0	1263	0.0000000
zheyou73v0_A08	25932157	25934724	BnaA08T0299600ZY.1	0	+	0	0	2567	0.0000000
zheyou73v0_A08	25932302	25934724	BnaA08T0299600ZY	0	+	0	0	2422	0.0000000
zheyou73v0_A08	25934911	25936431	BnaA08T0299700ZY	0	-	0	0	1520	0.0000000
zheyou73v0_A08	25938523	25941341	BnaA08T0299800ZY	0	-	0	0	2818	0.0000000
zheyou73v0_A08	25943685	25947516	BnaA08T0299900ZY	0	-	0	0	3831	0.0000000
zheyou73v0_A08	25947995	25949847	BnaA08T0300000ZY	0	-	0	0	1852	0.0000000
zheyou73v0_A08	25950049	25951624	BnaA08T0300100ZY	0	+	0	0	1575	0.0000000
zheyou73v0_A08	25951730	25953748	BnaA08T0300200ZY	0	-	0	0	2018	0.0000000
zheyou73v0_A08	25955543	25959288	BnaA08T0300300ZY	0	-	0	0	3745	0.0000000
zheyou73v0_A08	25959591	25961629	BnaA08T0300400ZY	0	-	0	0	2038	0.0000000
zheyou73v0_A08	25959591	25961443	BnaA08T0300400ZY.1	0	-	0	0	1852	0.0000000
zheyou73v0_A08	25964813	25966884	BnaA08T0300500ZY	0	+	0	0	2071	0.0000000
zheyou73v0_A08	25970558	25973330	BnaA08T0300600ZY	0	+	0	0	2772	0.0000000
zheyou73v0_A08	25977144	25981150	BnaA08T0300700ZY	0	+	0	0	4006	0.0000000
zheyou73v0_A08	25981016	25986466	BnaA08T0300800ZY	0	-	0	0	5450	0.0000000
zheyou73v0_A08	25987272	25989313	BnaA08T0300900ZY	0	-	0	0	2041	0.0000000
zheyou73v0_A08	25992798	25994231	BnaA08T0301000ZY	0	+	0	0	1433	0.0000000
zheyou73v0_A08	25994671	25996119	BnaA08T0301100ZY	0	-	0	0	1448	0.0000000
zheyou73v0_A08	25996948	26000949	BnaA08T0301200ZY	0	+	0	0	4001	0.0000000
zheyou73v0_A08	26001509	26005326	BnaA08T0301300ZY	0	-	0	0	3817	0.0000000
zheyou73v0_A08	26012900	26016545	BnaA08T0301400ZY	0	+	0	0	3645	0.0000000
zheyou73v0_A08	26012900	26016545	BnaA08T0301400ZY.1	0	+	0	0	3645	0.0000000
zheyou73v0_A08	26018550	26022912	BnaA08T0301500ZY	0	+	0	0	4362	0.0000000
zheyou73v0_A08	26029088	26031473	BnaA08T0301600ZY	0	+	0	0	2385	0.0000000
zheyou73v0_A08	26032478	26033871	BnaA08T0301700ZY	0	+	0	0	1393	0.0000000
zheyou73v0_A08	26035054	26036073	BnaA08T0301800ZY	0	+	0	0	1019	0.0000000
zheyou73v0_A08	26037659	26038901	BnaA08T0301900ZY	0	-	0	0	1242	0.0000000
zheyou73v0_A08	26039513	26040345	BnaA08T0302000ZY	0	-	0	0	832	0.0000000
zheyou73v0_A08	26042053	26044908	BnaA08T0302100ZY	0	+	0	0	2855	0.0000000
zheyou73v0_A08	26047171	26048548	BnaA08T0302200ZY	0	+	0	0	1377	0.0000000
zheyou73v0_A08	26050017	26054080	BnaA08T0302300ZY	0	+	0	0	4063	0.0000000
zheyou73v0_A08	26054146	26056549	BnaA08T0302400ZY	0	-	0	0	2403	0.0000000
zheyou73v0_A08	26057300	26059884	BnaA08T0302500ZY	0	+	0	0	2584	0.0000000
zheyou73v0_A08	26062970	26065071	BnaA08T0302600ZY	0	+	0	0	2101	0.0000000
zheyou73v0_A08	26066413	26072441	BnaA08T0302700ZY	0	+	0	0	6028	0.0000000
zheyou73v0_A08	26066413	26072441	BnaA08T0302700ZY.1	0	+	0	0	6028	0.0000000
zheyou73v0_A08	26072862	26074449	BnaA08T0302800ZY	0	-	0	0	1587	0.0000000
zheyou73v0_A08	26084663	26086260	BnaA08T0302900ZY	0	+	0	0	1597	0.0000000
zheyou73v0_A08	26087209	26090893	BnaA08T0303000ZY	0	+	0	0	3684	0.0000000
zheyou73v0_A08	26091155	26094524	BnaA08T0303100ZY	0	+	0	0	3369	0.0000000
zheyou73v0_A08	26095063	26101553	BnaA08T0303200ZY	0	+	0	0	6490	0.0000000
zheyou73v0_A08	26098825	26101857	BnaA08T0303200ZY.1	0	+	0	0	3032	0.0000000
zheyou73v0_A08	26102549	26104217	BnaA08T0303300ZY	0	+	0	0	1668	0.0000000
zheyou73v0_A08	26110380	26111963	BnaA08T0303400ZY	0	+	0	0	1583	0.0000000
zheyou73v0_A08	26113423	26116022	BnaA08T0303500ZY	0	-	0	0	2599	0.0000000
zheyou73v0_A08	26117059	26119930	BnaA08T0303600ZY	0	+	0	0	2871	0.0000000
zheyou73v0_A08	26122696	26125183	BnaA08T0303700ZY	0	-	0	0	2487	0.0000000
zheyou73v0_A08	26128476	26130939	BnaA08T0303800ZY	0	+	0	0	2463	0.0000000
zheyou73v0_A08	26132550	26133132	BnaA08T0303900ZY	0	+	0	0	582	0.0000000
zheyou73v0_A08	26144067	26149397	BnaA08T0304000ZY	0	+	0	0	5330	0.0000000
zheyou73v0_A08	26151492	26152121	BnaA08T0304100ZY	0	-	0	0	629	0.0000000
zheyou73v0_A08	26155168	26155363	BnaA08T0304200ZY	0	+	0	0	195	0.0000000
zheyou73v0_A08	26155991	26157285	BnaA08T0304300ZY	0	+	0	0	1294	0.0000000
zheyou73v0_A08	26159254	26168900	BnaA08T0304400ZY	0	-	0	0	9646	0.0000000
zheyou73v0_A08	26171815	26172803	BnaA08T0304500ZY	0	-	0	0	988	0.0000000
zheyou73v0_A08	26173670	26177592	BnaA08T0304600ZY	0	-	0	0	3922	0.0000000
zheyou73v0_A08	26179926	26182899	BnaA08T0304700ZY	0	+	0	0	2973	0.0000000
zheyou73v0_A08	26179926	26182555	BnaA08T0304700ZY.1	0	+	0	0	2629	0.0000000
zheyou73v0_A08	26185267	26185768	BnaA08T0304800ZY	0	-	0	0	501	0.0000000
zheyou73v0_A08	26187159	26187612	BnaA08T0304900ZY	0	-	0	0	453	0.0000000
zheyou73v0_A08	26188415	26191875	BnaA08T0305000ZY	0	-	0	0	3460	0.0000000
zheyou73v0_A08	26194409	26196897	BnaA08T0305100ZY	0	+	0	0	2488	0.0000000
zheyou73v0_A08	26197170	26200251	BnaA08T0305200ZY	0	+	0	0	3081	0.0000000
zheyou73v0_A08	26197170	26200251	BnaA08T0305200ZY.1	0	+	0	0	3081	0.0000000
zheyou73v0_A08	26202276	26204047	BnaA08T0305300ZY	0	-	0	0	1771	0.0000000
zheyou73v0_A08	26206049	26207175	BnaA08T0305400ZY	0	+	0	0	1126	0.0000000
zheyou73v0_A08	26209618	26218197	BnaA08T0305500ZY	0	+	0	0	8579	0.0000000
zheyou73v0_A08	26218446	26219320	BnaA08T0305600ZY	0	+	0	0	874	0.0000000
zheyou73v0_A08	26220381	26226335	BnaA08T0305700ZY	0	+	0	0	5954	0.0000000
zheyou73v0_A08	26227302	26228603	BnaA08T0305800ZY	0	+	0	0	1301	0.0000000
zheyou73v0_A08	26228891	26229428	BnaA08T0305900ZY	0	+	0	0	537	0.0000000
zheyou73v0_A08	26231565	26233379	BnaA08T0306000ZY	0	-	0	0	1814	0.0000000
zheyou73v0_A08	26231565	26233379	BnaA08T0306000ZY.1	0	-	0	0	1814	0.0000000
zheyou73v0_A08	26243963	26244509	BnaA08T0306100ZY	0	+	0	0	546	0.0000000
zheyou73v0_A08	26244641	26249011	BnaA08T0306200ZY	0	-	0	0	4370	0.0000000
zheyou73v0_A08	26249766	26252038	BnaA08T0306300ZY	0	-	0	0	2272	0.0000000
zheyou73v0_A08	26252706	26254876	BnaA08T0306400ZY	0	-	0	0	2170	0.0000000
zheyou73v0_A08	26255814	26260136	BnaA08T0306500ZY	0	+	0	0	4322	0.0000000
zheyou73v0_A08	26256137	26260136	BnaA08T0306500ZY.1	0	+	0	0	3999	0.0000000
zheyou73v0_A08	26260219	26260561	BnaA08T0306600ZY	0	+	0	0	342	0.0000000
zheyou73v0_A08	26260987	26265712	BnaA08T0306700ZY	0	-	0	0	4725	0.0000000
zheyou73v0_A08	26266865	26268380	BnaA08T0306800ZY	0	+	0	0	1515	0.0000000
zheyou73v0_A08	26272308	26272926	BnaA08T0306900ZY	0	-	0	0	618	0.0000000
zheyou73v0_A08	26274016	26277420	BnaA08T0307000ZY	0	-	0	0	3404	0.0000000
zheyou73v0_A08	26278629	26281418	BnaA08T0307100ZY	0	+	0	0	2789	0.0000000
zheyou73v0_A08	26282307	26284046	BnaA08T0307200ZY	0	-	0	0	1739	0.0000000
zheyou73v0_A08	26284548	26286273	BnaA08T0307300ZY	0	-	0	0	1725	0.0000000
zheyou73v0_A08	26286976	26289543	BnaA08T0307400ZY	0	+	0	0	2567	0.0000000
zheyou73v0_A08	26289842	26292220	BnaA08T0307500ZY	0	+	0	0	2378	0.0000000
zheyou73v0_A08	26289842	26292220	BnaA08T0307500ZY.1	0	+	0	0	2378	0.0000000
zheyou73v0_A08	26293210	26293826	BnaA08T0307600ZY	0	+	0	0	616	0.0000000
zheyou73v0_A08	26294081	26298392	BnaA08T0307700ZY	0	+	0	0	4311	0.0000000
zheyou73v0_A08	26295098	26298392	BnaA08T0307700ZY.1	0	+	0	0	3294	0.0000000
zheyou73v0_A08	26300884	26301787	BnaA08T0307800ZY	0	+	0	0	903	0.0000000
zheyou73v0_A08	26303257	26304457	BnaA08T0307900ZY	0	-	0	0	1200	0.0000000
zheyou73v0_A08	26306046	26307297	BnaA08T0308000ZY	0	+	0	0	1251	0.0000000
zheyou73v0_A08	26307328	26307865	BnaA08T0308100ZY	0	+	0	0	537	0.0000000
zheyou73v0_A08	26314431	26316103	BnaA08T0308200ZY	0	+	0	0	1672	0.0000000
zheyou73v0_A08	26316508	26318238	BnaA08T0308300ZY	0	-	0	0	1730	0.0000000
zheyou73v0_A08	26318678	26321051	BnaA08T0308400ZY	0	+	0	0	2373	0.0000000
zheyou73v0_A08	26328006	26329363	BnaA08T0308500ZY	0	-	0	0	1357	0.0000000
zheyou73v0_A08	26329753	26330532	BnaA08T0308600ZY	0	-	0	0	779	0.0000000
zheyou73v0_A08	26335398	26337794	BnaA08T0308700ZY	0	+	0	0	2396	0.0000000
zheyou73v0_A08	26338807	26340624	BnaA08T0308800ZY	0	+	0	0	1817	0.0000000
zheyou73v0_A08	26340863	26342681	BnaA08T0308900ZY	0	-	0	0	1818	0.0000000
zheyou73v0_A08	26345796	26347110	BnaA08T0309000ZY	0	+	0	0	1314	0.0000000
zheyou73v0_A08	26347447	26348646	BnaA08T0309100ZY	0	-	0	0	1199	0.0000000
zheyou73v0_A08	26352968	26353151	BnaA08T0309200ZY	0	-	0	0	183	0.0000000
zheyou73v0_A08	26353804	26355443	BnaA08T0309300ZY	0	+	0	0	1639	0.0000000
zheyou73v0_A08	26355694	26356497	BnaA08T0309400ZY	0	+	0	0	803	0.0000000
zheyou73v0_A08	26356887	26359449	BnaA08T0309500ZY	0	-	0	0	2562	0.0000000
zheyou73v0_A08	26363335	26364640	BnaA08T0309600ZY	0	+	0	0	1305	0.0000000
zheyou73v0_A08	26367804	26369209	BnaA08T0309700ZY	0	+	0	0	1405	0.0000000
zheyou73v0_A08	26369497	26375241	BnaA08T0309800ZY	0	-	0	0	5744	0.0000000
zheyou73v0_A08	26376869	26378028	BnaA08T0309900ZY	0	-	0	0	1159	0.0000000
zheyou73v0_A08	26380685	26385043	BnaA08T0310000ZY	0	-	0	0	4358	0.0000000
zheyou73v0_A08	26385123	26386560	BnaA08T0310100ZY	0	-	0	0	1437	0.0000000
zheyou73v0_A08	26386792	26388584	BnaA08T0310200ZY	0	+	0	0	1792	0.0000000
zheyou73v0_A08	26388186	26393459	BnaA08T0310300ZY	0	-	0	0	5273	0.0000000
zheyou73v0_A08	26393884	26399141	BnaA08T0310400ZY	0	-	0	0	5257	0.0000000
zheyou73v0_A08	26400625	26403935	BnaA08T0310500ZY	0	+	0	0	3310	0.0000000
zheyou73v0_A08	26405376	26406190	BnaA08T0310600ZY	0	+	0	0	814	0.0000000
zheyou73v0_A08	26407144	26409543	BnaA08T0310700ZY	0	+	0	0	2399	0.0000000
zheyou73v0_A08	26407144	26409543	BnaA08T0310700ZY.1	0	+	0	0	2399	0.0000000
zheyou73v0_A08	26410121	26411053	BnaA08T0310800ZY	0	+	0	0	932	0.0000000
zheyou73v0_A08	26411407	26412927	BnaA08T0310900ZY	0	+	0	0	1520	0.0000000
zheyou73v0_A08	26413832	26416039	BnaA08T0311000ZY	0	-	0	0	2207	0.0000000
zheyou73v0_A08	26418769	26420489	BnaA08T0311100ZY	0	+	0	0	1720	0.0000000
zheyou73v0_A08	26421485	26422638	BnaA08T0311200ZY	0	+	0	0	1153	0.0000000
zheyou73v0_A08	26423396	26424200	BnaA08T0311300ZY	0	-	0	0	804	0.0000000
zheyou73v0_A08	26424569	26425838	BnaA08T0311400ZY	0	-	0	0	1269	0.0000000
zheyou73v0_A08	26424569	26425838	BnaA08T0311400ZY.1	0	-	0	0	1269	0.0000000
zheyou73v0_A08	26424569	26425838	BnaA08T0311400ZY.2	0	-	0	0	1269	0.0000000
zheyou73v0_A08	26428485	26430955	BnaA08T0311500ZY	0	+	0	0	2470	0.0000000
zheyou73v0_A08	26431394	26432872	BnaA08T0311600ZY	0	+	0	0	1478	0.0000000
zheyou73v0_A08	26433527	26440026	BnaA08T0311700ZY	0	+	0	0	6499	0.0000000
zheyou73v0_A08	26441034	26443597	BnaA08T0311800ZY	0	-	0	0	2563	0.0000000
zheyou73v0_A08	26441034	26443597	BnaA08T0311800ZY.1	0	-	0	0	2563	0.0000000
zheyou73v0_A08	26442041	26443597	BnaA08T0311800ZY.2	0	-	0	0	1556	0.0000000
zheyou73v0_A08	26442041	26443597	BnaA08T0311800ZY.3	0	-	0	0	1556	0.0000000
zheyou73v0_A08	26443626	26447015	BnaA08T0311900ZY	0	-	0	0	3389	0.0000000
zheyou73v0_A08	26447016	26448566	BnaA08T0312000ZY	0	-	0	0	1550	0.0000000
zheyou73v0_A08	26453732	26456012	BnaA08T0312100ZY	0	-	0	0	2280	0.0000000
zheyou73v0_A08	26456120	26458120	BnaA08T0312200ZY	0	-	0	0	2000	0.0000000
zheyou73v0_A08	26456120	26457928	BnaA08T0312200ZY.1	0	-	0	0	1808	0.0000000
zheyou73v0_A08	26458563	26464501	BnaA08T0312300ZY	0	-	0	0	5938	0.0000000
zheyou73v0_A08	26470326	26471321	BnaA08T0312400ZY	0	-	0	0	995	0.0000000
zheyou73v0_A08	26472922	26475075	BnaA08T0312500ZY	0	-	0	0	2153	0.0000000
zheyou73v0_A08	26484011	26486024	BnaA08T0312600ZY	0	-	0	0	2013	0.0000000
zheyou73v0_A08	26490108	26507116	BnaA08T0312700ZY	0	-	0	0	17008	0.0000000
zheyou73v0_A09	1633	3783	BnaA09T0000100ZY	0	-	0	0	2150	0.0000000
zheyou73v0_A09	1633	3783	BnaA09T0000100ZY.1	0	-	0	0	2150	0.0000000
zheyou73v0_A09	5035	5454	BnaA09T0000200ZY	0	+	0	0	419	0.0000000
zheyou73v0_A09	5647	6334	BnaA09T0000300ZY	0	-	0	0	687	0.0000000
zheyou73v0_A09	6696	12030	BnaA09T0000400ZY	0	+	0	0	5334	0.0000000
zheyou73v0_A09	14085	15768	BnaA09T0000500ZY	0	-	0	0	1683	0.0000000
zheyou73v0_A09	16300	18083	BnaA09T0000600ZY	0	+	0	0	1783	0.0000000
zheyou73v0_A09	18461	20969	BnaA09T0000700ZY	0	-	0	0	2508	0.0000000
zheyou73v0_A09	32369	32898	BnaA09T0000800ZY	0	-	0	0	529	0.0000000
zheyou73v0_A09	34049	35620	BnaA09T0000900ZY	0	-	0	0	1571	0.0000000
zheyou73v0_A09	45166	46835	BnaA09T0001000ZY	0	-	0	0	1669	0.0000000
zheyou73v0_A09	48010	49042	BnaA09T0001100ZY	0	-	0	0	1032	0.0000000
zheyou73v0_A09	51981	54251	BnaA09T0001200ZY	0	+	0	0	2270	0.0000000
zheyou73v0_A09	56395	56836	BnaA09T0001300ZY	0	+	0	0	441	0.0000000
zheyou73v0_A09	56948	58547	BnaA09T0001400ZY	0	-	0	0	1599	0.0000000
zheyou73v0_A09	56948	58547	BnaA09T0001400ZY.1	0	-	0	0	1599	0.0000000
zheyou73v0_A09	56948	58547	BnaA09T0001400ZY.2	0	-	0	0	1599	0.0000000
zheyou73v0_A09	56948	58547	BnaA09T0001400ZY.3	0	-	0	0	1599	0.0000000
zheyou73v0_A09	59300	62572	BnaA09T0001500ZY	0	+	0	0	3272	0.0000000
zheyou73v0_A09	68678	70367	BnaA09T0001600ZY	0	+	0	0	1689	0.0000000
zheyou73v0_A09	72130	74720	BnaA09T0001700ZY	0	+	0	0	2590	0.0000000
zheyou73v0_A09	76706	79763	BnaA09T0001800ZY	0	+	0	0	3057	0.0000000
zheyou73v0_A09	82562	84285	BnaA09T0001900ZY	0	+	0	0	1723	0.0000000
zheyou73v0_A09	86810	88767	BnaA09T0002000ZY	0	-	0	0	1957	0.0000000
zheyou73v0_A09	89940	92240	BnaA09T0002100ZY	0	+	0	0	2300	0.0000000
zheyou73v0_A09	93112	96073	BnaA09T0002200ZY	0	+	0	0	2961	0.0000000
zheyou73v0_A09	96753	98912	BnaA09T0002300ZY	0	+	0	0	2159	0.0000000
zheyou73v0_A09	99360	99885	BnaA09T0002400ZY	0	-	0	0	525	0.0000000
zheyou73v0_A09	104500	106524	BnaA09T0002500ZY	0	+	0	0	2024	0.0000000
zheyou73v0_A09	106915	109990	BnaA09T0002600ZY	0	-	0	0	3075	0.0000000
zheyou73v0_A09	167928	168704	BnaA09T0002700ZY	0	-	0	0	776	0.0000000
zheyou73v0_A09	180770	182235	BnaA09T0002800ZY	0	-	0	0	1465	0.0000000
zheyou73v0_A09	181371	182235	BnaA09T0002800ZY.1	0	-	0	0	864	0.0000000
zheyou73v0_A09	184569	185270	BnaA09T0002900ZY	0	-	0	0	701	0.0000000
zheyou73v0_A09	190387	193260	BnaA09T0003000ZY	0	+	0	0	2873	0.0000000
zheyou73v0_A09	211586	214460	BnaA09T0003100ZY	0	+	0	0	2874	0.0000000
zheyou73v0_A09	214698	216601	BnaA09T0003200ZY	0	-	0	0	1903	0.0000000
zheyou73v0_A09	219591	221397	BnaA09T0003300ZY	0	-	0	0	1806	0.0000000
zheyou73v0_A09	221437	224083	BnaA09T0003400ZY	0	-	0	0	2646	0.0000000
zheyou73v0_A09	225880	227894	BnaA09T0003500ZY	0	+	0	0	2014	0.0000000
zheyou73v0_A09	229826	232117	BnaA09T0003600ZY	0	-	0	0	2291	0.0000000
zheyou73v0_A09	244567	246389	BnaA09T0003700ZY	0	-	0	0	1822	0.0000000
zheyou73v0_A09	246726	249667	BnaA09T0003800ZY	0	-	0	0	2941	0.0000000
zheyou73v0_A09	249750	251605	BnaA09T0003900ZY	0	-	0	0	1855	0.0000000
zheyou73v0_A09	252084	254484	BnaA09T0004000ZY	0	+	0	0	2400	0.0000000
zheyou73v0_A09	257472	257932	BnaA09T0004100ZY	0	+	0	0	460	0.0000000
zheyou73v0_A09	261076	262575	BnaA09T0004200ZY	0	-	0	0	1499	0.0000000
zheyou73v0_A09	264731	266344	BnaA09T0004300ZY	0	-	0	0	1613	0.0000000
zheyou73v0_A09	268072	270786	BnaA09T0004400ZY	0	-	0	0	2714	0.0000000
zheyou73v0_A09	273186	275381	BnaA09T0004500ZY	0	+	0	0	2195	0.0000000
zheyou73v0_A09	275993	278847	BnaA09T0004600ZY	0	-	0	0	2854	0.0000000
zheyou73v0_A09	275993	278847	BnaA09T0004600ZY.1	0	-	0	0	2854	0.0000000
zheyou73v0_A09	283780	284986	BnaA09T0004700ZY	0	-	0	0	1206	0.0000000
zheyou73v0_A09	286454	287555	BnaA09T0004800ZY	0	+	0	0	1101	0.0000000
zheyou73v0_A09	292043	299734	BnaA09T0004900ZY	0	-	0	0	7691	0.0000000
zheyou73v0_A09	306279	306968	BnaA09T0005000ZY	0	+	0	0	689	0.0000000
zheyou73v0_A09	307558	308863	BnaA09T0005100ZY	0	-	0	0	1305	0.0000000
zheyou73v0_A09	309390	311008	BnaA09T0005200ZY	0	-	0	0	1618	0.0000000
zheyou73v0_A09	314489	317268	BnaA09T0005300ZY	0	+	0	0	2779	0.0000000
zheyou73v0_A09	317646	318702	BnaA09T0005400ZY	0	+	0	0	1056	0.0000000
zheyou73v0_A09	319549	321764	BnaA09T0005500ZY	0	+	0	0	2215	0.0000000
zheyou73v0_A09	324679	331032	BnaA09T0005600ZY	0	-	0	0	6353	0.0000000
zheyou73v0_A09	331320	334495	BnaA09T0005700ZY	0	+	0	0	3175	0.0000000
zheyou73v0_A09	341837	348929	BnaA09T0005800ZY	0	+	0	0	7092	0.0000000
zheyou73v0_A09	349210	350910	BnaA09T0005900ZY	0	-	0	0	1700	0.0000000
zheyou73v0_A09	389705	392211	BnaA09T0006000ZY	0	+	0	0	2506	0.0000000
zheyou73v0_A09	395003	396326	BnaA09T0006100ZY	0	+	0	0	1323	0.0000000
zheyou73v0_A09	396580	403969	BnaA09T0006200ZY	0	-	0	0	7389	0.0000000
zheyou73v0_A09	404326	405014	BnaA09T0006300ZY	0	+	0	0	688	0.0000000
zheyou73v0_A09	405212	405631	BnaA09T0006400ZY	0	-	0	0	419	0.0000000
zheyou73v0_A09	406886	408901	BnaA09T0006500ZY	0	+	0	0	2015	0.0000000
zheyou73v0_A09	415621	416257	BnaA09T0006600ZY	0	+	0	0	636	0.0000000
zheyou73v0_A09	416760	419282	BnaA09T0006700ZY	0	+	0	0	2522	0.0000000
zheyou73v0_A09	416760	419282	BnaA09T0006700ZY.1	0	+	0	0	2522	0.0000000
zheyou73v0_A09	419647	420940	BnaA09T0006800ZY	0	-	0	0	1293	0.0000000
zheyou73v0_A09	421707	423111	BnaA09T0006900ZY	0	-	0	0	1404	0.0000000
zheyou73v0_A09	421707	423111	BnaA09T0006900ZY.1	0	-	0	0	1404	0.0000000
zheyou73v0_A09	421707	423111	BnaA09T0006900ZY.2	0	-	0	0	1404	0.0000000
zheyou73v0_A09	421707	423111	BnaA09T0006900ZY.3	0	-	0	0	1404	0.0000000
zheyou73v0_A09	426735	428834	BnaA09T0007000ZY	0	-	0	0	2099	0.0000000
zheyou73v0_A09	434822	437867	BnaA09T0007100ZY	0	-	0	0	3045	0.0000000
zheyou73v0_A09	476461	478188	BnaA09T0007200ZY	0	+	0	0	1727	0.0000000
zheyou73v0_A09	476551	478188	BnaA09T0007200ZY.1	0	+	0	0	1637	0.0000000
zheyou73v0_A09	479268	488099	BnaA09T0007300ZY	0	+	0	0	8831	0.0000000
zheyou73v0_A09	488711	490620	BnaA09T0007400ZY	0	-	0	0	1909	0.0000000
zheyou73v0_A09	500779	503204	BnaA09T0007500ZY	0	+	0	0	2425	0.0000000
zheyou73v0_A09	503352	506384	BnaA09T0007600ZY	0	-	0	0	3032	0.0000000
zheyou73v0_A09	507955	510448	BnaA09T0007700ZY	0	-	0	0	2493	0.0000000
zheyou73v0_A09	511536	515128	BnaA09T0007800ZY	0	-	0	0	3592	0.0000000
zheyou73v0_A09	520488	521330	BnaA09T0007900ZY	0	-	0	0	842	0.0000000
zheyou73v0_A09	521866	524044	BnaA09T0008000ZY	0	+	0	0	2178	0.0000000
zheyou73v0_A09	524300	525683	BnaA09T0008100ZY	0	-	0	0	1383	0.0000000
zheyou73v0_A09	527422	531270	BnaA09T0008200ZY	0	+	0	0	3848	0.0000000
zheyou73v0_A09	531103	534185	BnaA09T0008300ZY	0	-	0	0	3082	0.0000000
zheyou73v0_A09	534780	537917	BnaA09T0008400ZY	0	+	0	0	3137	0.0000000
zheyou73v0_A09	538621	541330	BnaA09T0008500ZY	0	-	0	0	2709	0.0000000
zheyou73v0_A09	543060	547261	BnaA09T0008600ZY	0	-	0	0	4201	0.0000000
zheyou73v0_A09	547804	550434	BnaA09T0008700ZY	0	+	0	0	2630	0.0000000
zheyou73v0_A09	551011	552900	BnaA09T0008800ZY	0	+	0	0	1889	0.0000000
zheyou73v0_A09	558427	560972	BnaA09T0008900ZY	0	-	0	0	2545	0.0000000
zheyou73v0_A09	561778	563161	BnaA09T0009000ZY	0	+	0	0	1383	0.0000000
zheyou73v0_A09	588153	589387	BnaA09T0009100ZY	0	-	0	0	1234	0.0000000
zheyou73v0_A09	591485	593060	BnaA09T0009200ZY	0	-	0	0	1575	0.0000000
zheyou73v0_A09	596089	597810	BnaA09T0009300ZY	0	-	0	0	1721	0.0000000
zheyou73v0_A09	601414	603679	BnaA09T0009400ZY	0	+	0	0	2265	0.0000000
zheyou73v0_A09	605815	606256	BnaA09T0009500ZY	0	+	0	0	441	0.0000000
zheyou73v0_A09	606510	607930	BnaA09T0009600ZY	0	-	0	0	1420	0.0000000
zheyou73v0_A09	608715	611992	BnaA09T0009700ZY	0	+	0	0	3277	0.0000000
zheyou73v0_A09	614632	616315	BnaA09T0009800ZY	0	+	0	0	1683	0.0000000
zheyou73v0_A09	618115	620702	BnaA09T0009900ZY	0	+	0	0	2587	0.0000000
zheyou73v0_A09	622679	625736	BnaA09T0010000ZY	0	+	0	0	3057	0.0000000
zheyou73v0_A09	628535	630260	BnaA09T0010100ZY	0	+	0	0	1725	0.0000000
zheyou73v0_A09	633895	635511	BnaA09T0010200ZY	0	-	0	0	1616	0.0000000
zheyou73v0_A09	636588	638846	BnaA09T0010300ZY.1	0	+	0	0	2258	0.0000000
zheyou73v0_A09	637204	638846	BnaA09T0010300ZY	0	+	0	0	1642	0.0000000
zheyou73v0_A09	639711	642667	BnaA09T0010400ZY	0	+	0	0	2956	0.0000000
zheyou73v0_A09	643411	645467	BnaA09T0010500ZY	0	+	0	0	2056	0.0000000
zheyou73v0_A09	646098	646502	BnaA09T0010600ZY	0	-	0	0	404	0.0000000
zheyou73v0_A09	650413	652271	BnaA09T0010700ZY	0	+	0	0	1858	0.0000000
zheyou73v0_A09	652662	655732	BnaA09T0010800ZY	0	-	0	0	3070	0.0000000
zheyou73v0_A09	709436	710670	BnaA09T0010900ZY	0	-	0	0	1234	0.0000000
zheyou73v0_A09	712997	713698	BnaA09T0011000ZY	0	-	0	0	701	0.0000000
zheyou73v0_A09	719329	722640	BnaA09T0011100ZY	0	+	0	0	3311	0.0000000
zheyou73v0_A09	728324	728918	BnaA09T0011200ZY	0	+	0	0	594	0.0000000
zheyou73v0_A09	729409	731203	BnaA09T0011300ZY	0	+	0	0	1794	0.0000000
zheyou73v0_A09	731378	732546	BnaA09T0011400ZY	0	+	0	0	1168	0.0000000
zheyou73v0_A09	733177	736400	BnaA09T0011500ZY	0	-	0	0	3223	0.0000000
zheyou73v0_A09	736972	742309	BnaA09T0011600ZY	0	-	0	0	5337	0.0000000
zheyou73v0_A09	745647	747793	BnaA09T0011700ZY	0	+	0	0	2146	0.0000000
zheyou73v0_A09	748200	750909	BnaA09T0011800ZY	0	-	0	0	2709	0.0000000
zheyou73v0_A09	752342	754855	BnaA09T0011900ZY	0	-	0	0	2513	0.0000000
zheyou73v0_A09	755980	759647	BnaA09T0012000ZY	0	-	0	0	3667	0.0000000
zheyou73v0_A09	761081	761928	BnaA09T0012100ZY	0	-	0	0	847	0.0000000
zheyou73v0_A09	762478	764658	BnaA09T0012200ZY	0	+	0	0	2180	0.0000000
zheyou73v0_A09	764913	766299	BnaA09T0012300ZY	0	-	0	0	1386	0.0000000
zheyou73v0_A09	770048	772599	BnaA09T0012400ZY	0	+	0	0	2551	0.0000000
zheyou73v0_A09	783990	787443	BnaA09T0012500ZY	0	-	0	0	3453	0.0000000
zheyou73v0_A09	788612	791149	BnaA09T0012600ZY	0	+	0	0	2537	0.0000000
zheyou73v0_A09	791855	794561	BnaA09T0012700ZY	0	-	0	0	2706	0.0000000
zheyou73v0_A09	796246	800448	BnaA09T0012800ZY	0	-	0	0	4202	0.0000000
zheyou73v0_A09	806926	809468	BnaA09T0012900ZY	0	-	0	0	2542	0.0000000
zheyou73v0_A09	809916	811561	BnaA09T0013000ZY	0	+	0	0	1645	0.0000000
zheyou73v0_A09	850899	852320	BnaA09T0013100ZY	0	+	0	0	1421	0.0000000
zheyou73v0_A09	853099	854083	BnaA09T0013200ZY	0	-	0	0	984	0.0000000
zheyou73v0_A09	855185	856223	BnaA09T0013300ZY	0	-	0	0	1038	0.0000000
zheyou73v0_A09	858187	859195	BnaA09T0013400ZY	0	-	0	0	1008	0.0000000
zheyou73v0_A09	861252	863574	BnaA09T0013500ZY	0	-	0	0	2322	0.0000000
zheyou73v0_A09	861252	863574	BnaA09T0013500ZY.1	0	-	0	0	2322	0.0000000
zheyou73v0_A09	864989	868183	BnaA09T0013600ZY	0	-	0	0	3194	0.0000000
zheyou73v0_A09	868471	874771	BnaA09T0013700ZY	0	+	0	0	6300	0.0000000
zheyou73v0_A09	881692	883433	BnaA09T0013800ZY	0	-	0	0	1741	0.0000000
zheyou73v0_A09	884315	885371	BnaA09T0013900ZY	0	-	0	0	1056	0.0000000
zheyou73v0_A09	885816	888369	BnaA09T0014000ZY	0	-	0	0	2553	0.0000000
zheyou73v0_A09	891851	893469	BnaA09T0014100ZY	0	+	0	0	1618	0.0000000
zheyou73v0_A09	894005	895275	BnaA09T0014200ZY	0	+	0	0	1270	0.0000000
zheyou73v0_A09	895510	898255	BnaA09T0014300ZY	0	+	0	0	2745	0.0000000
zheyou73v0_A09	899077	900570	BnaA09T0014400ZY	0	-	0	0	1493	0.0000000
zheyou73v0_A09	901212	902544	BnaA09T0014500ZY	0	+	0	0	1332	0.0000000
zheyou73v0_A09	902940	904723	BnaA09T0014600ZY	0	-	0	0	1783	0.0000000
zheyou73v0_A09	902940	904793	BnaA09T0014600ZY.1	0	-	0	0	1853	0.0000000
zheyou73v0_A09	905102	906148	BnaA09T0014700ZY	0	+	0	0	1046	0.0000000
zheyou73v0_A09	917525	919593	BnaA09T0014800ZY	0	+	0	0	2068	0.0000000
zheyou73v0_A09	920718	925182	BnaA09T0014900ZY	0	+	0	0	4464	0.0000000
zheyou73v0_A09	925298	926337	BnaA09T0015000ZY	0	+	0	0	1039	0.0000000
zheyou73v0_A09	926574	929187	BnaA09T0015100ZY	0	+	0	0	2613	0.0000000
zheyou73v0_A09	933114	934598	BnaA09T0015200ZY	0	-	0	0	1484	0.0000000
zheyou73v0_A09	936028	937241	BnaA09T0015300ZY	0	+	0	0	1213	0.0000000
zheyou73v0_A09	941882	943954	BnaA09T0015400ZY	0	+	0	0	2072	0.0000000
zheyou73v0_A09	944918	947003	BnaA09T0015500ZY	0	-	0	0	2085	0.0000000
zheyou73v0_A09	949396	952107	BnaA09T0015600ZY	0	+	0	0	2711	0.0000000
zheyou73v0_A09	955692	957305	BnaA09T0015700ZY	0	+	0	0	1613	0.0000000
zheyou73v0_A09	961619	963118	BnaA09T0015800ZY	0	+	0	0	1499	0.0000000
zheyou73v0_A09	965121	965579	BnaA09T0015900ZY	0	-	0	0	458	0.0000000
zheyou73v0_A09	968026	970372	BnaA09T0016000ZY	0	-	0	0	2346	0.0000000
zheyou73v0_A09	970850	972705	BnaA09T0016100ZY	0	+	0	0	1855	0.0000000
zheyou73v0_A09	972788	975729	BnaA09T0016200ZY	0	+	0	0	2941	0.0000000
zheyou73v0_A09	976055	977872	BnaA09T0016300ZY	0	+	0	0	1817	0.0000000
zheyou73v0_A09	978055	983979	BnaA09T0016400ZY	0	-	0	0	5924	0.0000000
zheyou73v0_A09	985937	987060	BnaA09T0016500ZY	0	-	0	0	1123	0.0000000
zheyou73v0_A09	987193	989403	BnaA09T0016600ZY	0	+	0	0	2210	0.0000000
zheyou73v0_A09	992446	994460	BnaA09T0016700ZY	0	-	0	0	2014	0.0000000
zheyou73v0_A09	1043348	1044327	BnaA09T0016800ZY	0	-	0	0	979	0.0000000
zheyou73v0_A09	1049836	1058885	BnaA09T0016900ZY	0	+	0	0	9049	0.0000000
zheyou73v0_A09	1062142	1063341	BnaA09T0017000ZY	0	+	0	0	1199	0.0000000
zheyou73v0_A09	1067269	1069179	BnaA09T0017100ZY	0	+	0	0	1910	0.0000000
zheyou73v0_A09	1069384	1074845	BnaA09T0017200ZY	0	-	0	0	5461	0.0000000
zheyou73v0_A09	1074630	1080259	BnaA09T0017300ZY.1	0	+	0	0	5629	0.0000000
zheyou73v0_A09	1074724	1080259	BnaA09T0017300ZY	0	+	0	0	5535	0.0000000
zheyou73v0_A09	1092038	1092825	BnaA09T0017400ZY	0	+	0	0	787	0.0000000
zheyou73v0_A09	1094601	1095785	BnaA09T0017500ZY	0	+	0	0	1184	0.0000000
zheyou73v0_A09	1096411	1097985	BnaA09T0017600ZY	0	+	0	0	1574	0.0000000
zheyou73v0_A09	1096411	1097985	BnaA09T0017600ZY.1	0	+	0	0	1574	0.0000000
zheyou73v0_A09	1098023	1101166	BnaA09T0017700ZY	0	-	0	0	3143	0.0000000
zheyou73v0_A09	1098023	1101166	BnaA09T0017700ZY.1	0	-	0	0	3143	0.0000000
zheyou73v0_A09	1104089	1104953	BnaA09T0017800ZY	0	+	0	0	864	0.0000000
zheyou73v0_A09	1111909	1120700	BnaA09T0017900ZY	0	+	0	0	8791	0.0000000
zheyou73v0_A09	1122540	1124522	BnaA09T0018000ZY	0	-	0	0	1982	0.0000000
zheyou73v0_A09	1122540	1124522	BnaA09T0018000ZY.1	0	-	0	0	1982	0.0000000
zheyou73v0_A09	1122540	1124522	BnaA09T0018000ZY.2	0	-	0	0	1982	0.0000000
zheyou73v0_A09	1127375	1128260	BnaA09T0018100ZY	0	+	0	0	885	0.0000000
zheyou73v0_A09	1134663	1137230	BnaA09T0018200ZY	0	+	0	0	2567	0.0000000
zheyou73v0_A09	1134663	1137230	BnaA09T0018200ZY.1	0	+	0	0	2567	0.0000000
zheyou73v0_A09	1146521	1148796	BnaA09T0018300ZY	0	+	0	0	2275	0.0000000
zheyou73v0_A09	1146521	1148796	BnaA09T0018300ZY.1	0	+	0	0	2275	0.0000000
zheyou73v0_A09	1151006	1151967	BnaA09T0018400ZY	0	-	0	0	961	0.0000000
zheyou73v0_A09	1152226	1154637	BnaA09T0018500ZY	0	+	0	0	2411	0.0000000
zheyou73v0_A09	1152226	1154637	BnaA09T0018500ZY.1	0	+	0	0	2411	0.0000000
zheyou73v0_A09	1158536	1159469	BnaA09T0018600ZY	0	+	0	0	933	0.0000000
zheyou73v0_A09	1163273	1164839	BnaA09T0018700ZY	0	+	0	0	1566	0.0000000
zheyou73v0_A09	1163273	1164839	BnaA09T0018700ZY.1	0	+	0	0	1566	0.0000000
zheyou73v0_A09	1174213	1176157	BnaA09T0018800ZY	0	-	0	0	1944	0.0000000
zheyou73v0_A09	1185602	1188384	BnaA09T0018900ZY	0	-	0	0	2782	0.0000000
zheyou73v0_A09	1185602	1188384	BnaA09T0018900ZY.1	0	-	0	0	2782	0.0000000
zheyou73v0_A09	1185602	1188384	BnaA09T0018900ZY.2	0	-	0	0	2782	0.0000000
zheyou73v0_A09	1190973	1196062	BnaA09T0019000ZY	0	-	0	0	5089	0.0000000
zheyou73v0_A09	1199128	1201664	BnaA09T0019100ZY	0	-	0	0	2536	0.0000000
zheyou73v0_A09	1202352	1204791	BnaA09T0019200ZY	0	+	0	0	2439	0.0000000
zheyou73v0_A09	1204811	1205379	BnaA09T0019300ZY	0	-	0	0	568	0.0000000
zheyou73v0_A09	1208097	1209659	BnaA09T0019400ZY	0	+	0	0	1562	0.0000000
zheyou73v0_A09	1210328	1212281	BnaA09T0019500ZY	0	+	0	0	1953	0.0000000
zheyou73v0_A09	1212811	1214777	BnaA09T0019600ZY	0	-	0	0	1966	0.0000000
zheyou73v0_A09	1216715	1220225	BnaA09T0019700ZY	0	+	0	0	3510	0.0000000
zheyou73v0_A09	1220350	1221354	BnaA09T0019800ZY	0	-	0	0	1004	0.0000000
zheyou73v0_A09	1232118	1233542	BnaA09T0019900ZY	0	-	0	0	1424	0.0000000
zheyou73v0_A09	1259008	1260862	BnaA09T0020000ZY	0	-	0	0	1854	0.0000000
zheyou73v0_A09	1274981	1278377	BnaA09T0020100ZY	0	+	0	0	3396	0.0000000
zheyou73v0_A09	1279489	1281226	BnaA09T0020200ZY	0	-	0	0	1737	0.0000000
zheyou73v0_A09	1286133	1286442	BnaA09T0020300ZY	0	-	0	0	309	0.0000000
zheyou73v0_A09	1287456	1291132	BnaA09T0020400ZY	0	-	0	0	3676	0.0000000
zheyou73v0_A09	1293651	1294203	BnaA09T0020500ZY	0	+	0	0	552	0.0000000
zheyou73v0_A09	1294218	1295218	BnaA09T0020600ZY	0	+	0	0	1000	0.0000000
zheyou73v0_A09	1297266	1301006	BnaA09T0020700ZY	0	-	0	0	3740	0.0000000
zheyou73v0_A09	1303131	1309235	BnaA09T0020800ZY	0	-	0	0	6104	0.0000000
zheyou73v0_A09	1309742	1311257	BnaA09T0020900ZY	0	+	0	0	1515	0.0000000
zheyou73v0_A09	1312197	1312722	BnaA09T0021000ZY	0	+	0	0	525	0.0000000
zheyou73v0_A09	1315392	1317175	BnaA09T0021100ZY	0	-	0	0	1783	0.0000000
zheyou73v0_A09	1326379	1328035	BnaA09T0021200ZY	0	+	0	0	1656	0.0000000
zheyou73v0_A09	1336100	1338128	BnaA09T0021300ZY	0	-	0	0	2028	0.0000000
zheyou73v0_A09	1348635	1349802	BnaA09T0021400ZY	0	-	0	0	1167	0.0000000
zheyou73v0_A09	1352069	1354984	BnaA09T0021500ZY	0	-	0	0	2915	0.0000000
zheyou73v0_A09	1360956	1365837	BnaA09T0021600ZY	0	+	0	0	4881	0.0000000
zheyou73v0_A09	1368226	1372809	BnaA09T0021700ZY	0	+	0	0	4583	0.0000000
zheyou73v0_A09	1374050	1374503	BnaA09T0021800ZY	0	+	0	0	453	0.0000000
zheyou73v0_A09	1374790	1376945	BnaA09T0021900ZY	0	-	0	0	2155	0.0000000
zheyou73v0_A09	1376975	1378211	BnaA09T0022000ZY	0	-	0	0	1236	0.0000000
zheyou73v0_A09	1378384	1382417	BnaA09T0022100ZY	0	+	0	0	4033	0.0000000
zheyou73v0_A09	1383246	1385972	BnaA09T0022200ZY	0	-	0	0	2726	0.0000000
zheyou73v0_A09	1389855	1391610	BnaA09T0022300ZY	0	+	0	0	1755	0.0000000
zheyou73v0_A09	1392388	1392676	BnaA09T0022400ZY	0	+	0	0	288	0.0000000
zheyou73v0_A09	1392698	1393013	BnaA09T0022500ZY	0	+	0	0	315	0.0000000
zheyou73v0_A09	1399485	1401474	BnaA09T0022600ZY	0	+	0	0	1989	0.0000000
zheyou73v0_A09	1439365	1439915	BnaA09T0022700ZY	0	-	0	0	550	0.0000000
zheyou73v0_A09	1443064	1453316	BnaA09T0022800ZY	0	+	0	0	10252	0.0000000
zheyou73v0_A09	1479593	1484922	BnaA09T0022900ZY	0	-	0	0	5329	0.0000000
zheyou73v0_A09	1486181	1488449	BnaA09T0023000ZY	0	+	0	0	2268	0.0000000
zheyou73v0_A09	1489690	1490990	BnaA09T0023100ZY	0	-	0	0	1300	0.0000000
zheyou73v0_A09	1492331	1493086	BnaA09T0023200ZY	0	+	0	0	755	0.0000000
zheyou73v0_A09	1502655	1507836	BnaA09T0023300ZY	0	+	0	0	5181	0.0000000
zheyou73v0_A09	1509296	1513045	BnaA09T0023400ZY	0	+	0	0	3749	0.0000000
zheyou73v0_A09	1515127	1517664	BnaA09T0023500ZY	0	-	0	0	2537	0.0000000
zheyou73v0_A09	1523306	1525749	BnaA09T0023600ZY	0	-	0	0	2443	0.0000000
zheyou73v0_A09	1527416	1530604	BnaA09T0023700ZY	0	-	0	0	3188	0.0000000
zheyou73v0_A09	1547526	1550057	BnaA09T0023800ZY	0	+	0	0	2531	0.0000000
zheyou73v0_A09	1552475	1554743	BnaA09T0023900ZY	0	-	0	0	2268	0.0000000
zheyou73v0_A09	1569920	1572838	BnaA09T0024000ZY	0	-	0	0	2918	0.0000000
zheyou73v0_A09	1576086	1577664	BnaA09T0024100ZY	0	+	0	0	1578	0.0000000
zheyou73v0_A09	1579966	1581410	BnaA09T0024200ZY	0	-	0	0	1444	0.0000000
zheyou73v0_A09	1585786	1591887	BnaA09T0024300ZY	0	-	0	0	6101	0.0000000
zheyou73v0_A09	1592534	1593690	BnaA09T0024400ZY	0	+	0	0	1156	0.0000000
zheyou73v0_A09	1634640	1635190	BnaA09T0024500ZY	0	-	0	0	550	0.0000000
zheyou73v0_A09	1638339	1652341	BnaA09T0024600ZY	0	+	0	0	14002	0.0000000
zheyou73v0_A09	1683941	1685872	BnaA09T0024700ZY	0	-	0	0	1931	0.0000000
zheyou73v0_A09	1687080	1689355	BnaA09T0024800ZY	0	+	0	0	2275	0.0000000
zheyou73v0_A09	1694810	1696109	BnaA09T0024900ZY	0	-	0	0	1299	0.0000000
zheyou73v0_A09	1697487	1698042	BnaA09T0025000ZY	0	+	0	0	555	0.0000000
zheyou73v0_A09	1703569	1710172	BnaA09T0025100ZY	0	+	0	0	6603	0.0000000
zheyou73v0_A09	1711157	1715491	BnaA09T0025200ZY	0	+	0	0	4334	0.0000000
zheyou73v0_A09	1717184	1719781	BnaA09T0025300ZY	0	-	0	0	2597	0.0000000
zheyou73v0_A09	1724769	1727212	BnaA09T0025400ZY	0	-	0	0	2443	0.0000000
zheyou73v0_A09	1728875	1732064	BnaA09T0025500ZY	0	-	0	0	3189	0.0000000
zheyou73v0_A09	1747938	1750578	BnaA09T0025600ZY	0	+	0	0	2640	0.0000000
zheyou73v0_A09	1752897	1754285	BnaA09T0025700ZY	0	-	0	0	1388	0.0000000
zheyou73v0_A09	1756168	1758082	BnaA09T0025800ZY	0	+	0	0	1914	0.0000000
zheyou73v0_A09	1760702	1763039	BnaA09T0025900ZY	0	+	0	0	2337	0.0000000
zheyou73v0_A09	1764386	1767029	BnaA09T0026000ZY	0	+	0	0	2643	0.0000000
zheyou73v0_A09	1767158	1767830	BnaA09T0026100ZY	0	+	0	0	672	0.0000000
zheyou73v0_A09	1803734	1804600	BnaA09T0026200ZY	0	-	0	0	866	0.0000000
zheyou73v0_A09	1805701	1809435	BnaA09T0026300ZY	0	+	0	0	3734	0.0000000
zheyou73v0_A09	1812961	1815235	BnaA09T0026400ZY	0	+	0	0	2274	0.0000000
zheyou73v0_A09	1820369	1821176	BnaA09T0026500ZY	0	-	0	0	807	0.0000000
zheyou73v0_A09	1821265	1821661	BnaA09T0026600ZY	0	-	0	0	396	0.0000000
zheyou73v0_A09	1821722	1822382	BnaA09T0026700ZY	0	-	0	0	660	0.0000000
zheyou73v0_A09	1823516	1825962	BnaA09T0026800ZY	0	+	0	0	2446	0.0000000
zheyou73v0_A09	1826719	1828223	BnaA09T0026900ZY	0	+	0	0	1504	0.0000000
zheyou73v0_A09	1828472	1833743	BnaA09T0027000ZY	0	-	0	0	5271	0.0000000
zheyou73v0_A09	1840129	1846484	BnaA09T0027100ZY	0	-	0	0	6355	0.0000000
zheyou73v0_A09	1847865	1849196	BnaA09T0027200ZY	0	+	0	0	1331	0.0000000
zheyou73v0_A09	1850295	1852475	BnaA09T0027300ZY	0	+	0	0	2180	0.0000000
zheyou73v0_A09	1854065	1858419	BnaA09T0027400ZY	0	+	0	0	4354	0.0000000
zheyou73v0_A09	1860171	1860999	BnaA09T0027500ZY	0	-	0	0	828	0.0000000
zheyou73v0_A09	1862617	1863610	BnaA09T0027600ZY	0	-	0	0	993	0.0000000
zheyou73v0_A09	1867262	1868420	BnaA09T0027700ZY	0	-	0	0	1158	0.0000000
zheyou73v0_A09	1869873	1876645	BnaA09T0027800ZY	0	+	0	0	6772	0.0000000
zheyou73v0_A09	1877143	1879087	BnaA09T0027900ZY	0	-	0	0	1944	0.0000000
zheyou73v0_A09	1880724	1883558	BnaA09T0028000ZY	0	+	0	0	2834	0.0000000
zheyou73v0_A09	1890510	1891871	BnaA09T0028100ZY	0	+	0	0	1361	0.0000000
zheyou73v0_A09	1892085	1893435	BnaA09T0028200ZY	0	-	0	0	1350	0.0000000
zheyou73v0_A09	1893883	1895563	BnaA09T0028300ZY	0	+	0	0	1680	0.0000000
zheyou73v0_A09	1896638	1898853	BnaA09T0028400ZY	0	+	0	0	2215	0.0000000
zheyou73v0_A09	1899171	1901986	BnaA09T0028500ZY	0	+	0	0	2815	0.0000000
zheyou73v0_A09	1903788	1908891	BnaA09T0028600ZY	0	+	0	0	5103	0.0000000
zheyou73v0_A09	1909084	1912967	BnaA09T0028700ZY	0	-	0	0	3883	0.0000000
zheyou73v0_A09	1917386	1917887	BnaA09T0028800ZY	0	-	0	0	501	0.0000000
zheyou73v0_A09	1918985	1921780	BnaA09T0028900ZY	0	+	0	0	2795	0.0000000
zheyou73v0_A09	1927221	1928328	BnaA09T0029000ZY	0	-	0	0	1107	0.0000000
zheyou73v0_A09	1928779	1929049	BnaA09T0029100ZY	0	-	0	0	270	0.0000000
zheyou73v0_A09	1930636	1931545	BnaA09T0029200ZY	0	-	0	0	909	0.0000000
zheyou73v0_A09	1932045	1932726	BnaA09T0029300ZY	0	+	0	0	681	0.0000000
zheyou73v0_A09	1934397	1937107	BnaA09T0029400ZY	0	-	0	0	2710	0.0000000
zheyou73v0_A09	1938754	1941019	BnaA09T0029500ZY	0	+	0	0	2265	0.0000000
zheyou73v0_A09	1941438	1942674	BnaA09T0029600ZY	0	-	0	0	1236	0.0000000
zheyou73v0_A09	1945125	1945932	BnaA09T0029700ZY	0	-	0	0	807	0.0000000
zheyou73v0_A09	1949289	1962170	BnaA09T0029800ZY	0	-	0	0	12881	0.0000000
zheyou73v0_A09	1963198	1963643	BnaA09T0029900ZY	0	-	0	0	445	0.0000000
zheyou73v0_A09	1964925	1968437	BnaA09T0030000ZY	0	+	0	0	3512	0.0000000
zheyou73v0_A09	1972705	1974469	BnaA09T0030100ZY	0	+	0	0	1764	0.0000000
zheyou73v0_A09	1976597	1978658	BnaA09T0030200ZY	0	-	0	0	2061	0.0000000
zheyou73v0_A09	1980728	1983105	BnaA09T0030300ZY	0	+	0	0	2377	0.0000000
zheyou73v0_A09	1983893	1985381	BnaA09T0030400ZY	0	+	0	0	1488	0.0000000
zheyou73v0_A09	1985789	1987331	BnaA09T0030500ZY	0	-	0	0	1542	0.0000000
zheyou73v0_A09	1989437	1990101	BnaA09T0030600ZY	0	-	0	0	664	0.0000000
zheyou73v0_A09	1998448	2005722	BnaA09T0030700ZY	0	-	0	0	7274	0.0000000
zheyou73v0_A09	2006173	2007505	BnaA09T0030800ZY	0	+	0	0	1332	0.0000000
zheyou73v0_A09	2009546	2011434	BnaA09T0030900ZY	0	+	0	0	1888	0.0000000
zheyou73v0_A09	2015265	2017755	BnaA09T0031000ZY	0	+	0	0	2490	0.0000000
zheyou73v0_A09	2024492	2025681	BnaA09T0031100ZY	0	-	0	0	1189	0.0000000
zheyou73v0_A09	2027033	2033834	BnaA09T0031200ZY	0	+	0	0	6801	0.0000000
zheyou73v0_A09	2034332	2036276	BnaA09T0031300ZY	0	-	0	0	1944	0.0000000
zheyou73v0_A09	2037754	2040824	BnaA09T0031400ZY	0	+	0	0	3070	0.0000000
zheyou73v0_A09	2047429	2048790	BnaA09T0031500ZY	0	+	0	0	1361	0.0000000
zheyou73v0_A09	2049004	2050353	BnaA09T0031600ZY	0	-	0	0	1349	0.0000000
zheyou73v0_A09	2050800	2052451	BnaA09T0031700ZY	0	+	0	0	1651	0.0000000
zheyou73v0_A09	2053523	2055716	BnaA09T0031800ZY	0	+	0	0	2193	0.0000000
zheyou73v0_A09	2055960	2065304	BnaA09T0031900ZY	0	+	0	0	9344	0.0000000
zheyou73v0_A09	2055960	2058684	BnaA09T0031900ZY.1	0	+	0	0	2724	0.0000000
zheyou73v0_A09	2066980	2074439	BnaA09T0032000ZY	0	+	0	0	7459	0.0000000
zheyou73v0_A09	2074632	2079023	BnaA09T0032100ZY	0	-	0	0	4391	0.0000000
zheyou73v0_A09	2081864	2083774	BnaA09T0032200ZY	0	-	0	0	1910	0.0000000
zheyou73v0_A09	2084230	2086389	BnaA09T0032300ZY	0	-	0	0	2159	0.0000000
zheyou73v0_A09	2088344	2089663	BnaA09T0032400ZY	0	-	0	0	1319	0.0000000
zheyou73v0_A09	2090127	2091032	BnaA09T0032500ZY	0	+	0	0	905	0.0000000
zheyou73v0_A09	2090127	2091032	BnaA09T0032500ZY.1	0	+	0	0	905	0.0000000
zheyou73v0_A09	2092324	2095047	BnaA09T0032600ZY	0	-	0	0	2723	0.0000000
zheyou73v0_A09	2098703	2100880	BnaA09T0032700ZY	0	+	0	0	2177	0.0000000
zheyou73v0_A09	2103452	2104090	BnaA09T0032800ZY	0	-	0	0	638	0.0000000
zheyou73v0_A09	2106684	2114453	BnaA09T0032900ZY	0	-	0	0	7769	0.0000000
zheyou73v0_A09	2123620	2125253	BnaA09T0033000ZY	0	+	0	0	1633	0.0000000
zheyou73v0_A09	2127727	2128965	BnaA09T0033100ZY	0	+	0	0	1238	0.0000000
zheyou73v0_A09	2130988	2133129	BnaA09T0033200ZY	0	+	0	0	2141	0.0000000
zheyou73v0_A09	2133504	2134296	BnaA09T0033300ZY	0	-	0	0	792	0.0000000
zheyou73v0_A09	2151601	2154383	BnaA09T0033400ZY	0	-	0	0	2782	0.0000000
zheyou73v0_A09	2151601	2154383	BnaA09T0033400ZY.1	0	-	0	0	2782	0.0000000
zheyou73v0_A09	2165832	2170681	BnaA09T0033500ZY	0	+	0	0	4849	0.0000000
zheyou73v0_A09	2171345	2171951	BnaA09T0033600ZY	0	+	0	0	606	0.0000000
zheyou73v0_A09	2172325	2173669	BnaA09T0033700ZY	0	+	0	0	1344	0.0000000
zheyou73v0_A09	2174906	2176678	BnaA09T0033800ZY	0	+	0	0	1772	0.0000000
zheyou73v0_A09	2176907	2182853	BnaA09T0033900ZY	0	-	0	0	5946	0.0000000
zheyou73v0_A09	2181809	2182853	BnaA09T0033900ZY.1	0	-	0	0	1044	0.0000000
zheyou73v0_A09	2183550	2185638	BnaA09T0034000ZY	0	+	0	0	2088	0.0000000
zheyou73v0_A09	2186354	2189444	BnaA09T0034100ZY	0	+	0	0	3090	0.0000000
zheyou73v0_A09	2186354	2189444	BnaA09T0034100ZY.1	0	+	0	0	3090	0.0000000
zheyou73v0_A09	2191558	2193073	BnaA09T0034200ZY	0	+	0	0	1515	0.0000000
zheyou73v0_A09	2194728	2197301	BnaA09T0034300ZY	0	-	0	0	2573	0.0000000
zheyou73v0_A09	2197332	2199474	BnaA09T0034400ZY	0	-	0	0	2142	0.0000000
zheyou73v0_A09	2201705	2203936	BnaA09T0034500ZY	0	-	0	0	2231	0.0000000
zheyou73v0_A09	2201705	2203936	BnaA09T0034500ZY.1	0	-	0	0	2231	0.0000000
zheyou73v0_A09	2214422	2219102	BnaA09T0034600ZY	0	-	0	0	4680	0.0000000
zheyou73v0_A09	2220909	2223185	BnaA09T0034700ZY	0	+	0	0	2276	0.0000000
zheyou73v0_A09	2223249	2225716	BnaA09T0034800ZY	0	-	0	0	2467	0.0000000
zheyou73v0_A09	2223249	2225716	BnaA09T0034800ZY.1	0	-	0	0	2467	0.0000000
zheyou73v0_A09	2227026	2228943	BnaA09T0034900ZY	0	-	0	0	1917	0.0000000
zheyou73v0_A09	2229186	2230335	BnaA09T0035000ZY	0	+	0	0	1149	0.0000000
zheyou73v0_A09	2230559	2233400	BnaA09T0035100ZY	0	-	0	0	2841	0.0000000
zheyou73v0_A09	2235048	2236876	BnaA09T0035200ZY	0	+	0	0	1828	0.0000000
zheyou73v0_A09	2236936	2238222	BnaA09T0035300ZY	0	-	0	0	1286	0.0000000
zheyou73v0_A09	2239225	2243413	BnaA09T0035400ZY	0	-	0	0	4188	0.0000000
zheyou73v0_A09	2244190	2248713	BnaA09T0035500ZY	0	+	0	0	4523	0.0000000
zheyou73v0_A09	2244190	2248713	BnaA09T0035500ZY.1	0	+	0	0	4523	0.0000000
zheyou73v0_A09	2254882	2256269	BnaA09T0035600ZY	0	+	0	0	1387	0.0000000
zheyou73v0_A09	2260770	2262380	BnaA09T0035700ZY	0	-	0	0	1610	0.0000000
zheyou73v0_A09	2262978	2264240	BnaA09T0035800ZY	0	+	0	0	1262	0.0000000
zheyou73v0_A09	2267261	2267529	BnaA09T0035900ZY	0	+	0	0	268	0.0000000
zheyou73v0_A09	2273737	2274817	BnaA09T0036000ZY	0	-	0	0	1080	0.0000000
zheyou73v0_A09	2275789	2278255	BnaA09T0036100ZY	0	+	0	0	2466	0.0000000
zheyou73v0_A09	2278987	2282162	BnaA09T0036200ZY.1	0	+	0	0	3175	0.0000000
zheyou73v0_A09	2279235	2282162	BnaA09T0036200ZY	0	+	0	0	2927	0.0000000
zheyou73v0_A09	2279235	2282162	BnaA09T0036200ZY.2	0	+	0	0	2927	0.0000000
zheyou73v0_A09	2282504	2284229	BnaA09T0036300ZY	0	-	0	0	1725	0.0000000
zheyou73v0_A09	2288869	2290516	BnaA09T0036400ZY	0	+	0	0	1647	0.0000000
zheyou73v0_A09	2291483	2292335	BnaA09T0036500ZY	0	+	0	0	852	0.0000000
zheyou73v0_A09	2333252	2333971	BnaA09T0036600ZY	0	-	0	0	719	0.0000000
zheyou73v0_A09	2340089	2341584	BnaA09T0036700ZY	0	-	0	0	1495	0.0000000
zheyou73v0_A09	2342194	2345018	BnaA09T0036800ZY	0	-	0	0	2824	0.0000000
zheyou73v0_A09	2349623	2350440	BnaA09T0036900ZY	0	-	0	0	817	0.0000000
zheyou73v0_A09	2353116	2355306	BnaA09T0037000ZY	0	-	0	0	2190	0.0000000
zheyou73v0_A09	2357001	2359157	BnaA09T0037100ZY	0	+	0	0	2156	0.0000000
zheyou73v0_A09	2359501	2360860	BnaA09T0037200ZY	0	+	0	0	1359	0.0000000
zheyou73v0_A09	2359815	2360630	BnaA09T0037200ZY.1	0	+	0	0	815	0.0000000
zheyou73v0_A09	2361383	2361964	BnaA09T0037300ZY	0	+	0	0	581	0.0000000
zheyou73v0_A09	2361578	2364978	BnaA09T0037400ZY	0	-	0	0	3400	0.0000000
zheyou73v0_A09	2361578	2364978	BnaA09T0037400ZY.1	0	-	0	0	3400	0.0000000
zheyou73v0_A09	2366342	2367277	BnaA09T0037500ZY	0	-	0	0	935	0.0000000
zheyou73v0_A09	2368370	2371687	BnaA09T0037600ZY	0	-	0	0	3317	0.0000000
zheyou73v0_A09	2372254	2372458	BnaA09T0037700ZY	0	-	0	0	204	0.0000000
zheyou73v0_A09	2373487	2374778	BnaA09T0037800ZY	0	-	0	0	1291	0.0000000
zheyou73v0_A09	2376713	2377979	BnaA09T0037900ZY	0	+	0	0	1266	0.0000000
zheyou73v0_A09	2378306	2379644	BnaA09T0038000ZY	0	-	0	0	1338	0.0000000
zheyou73v0_A09	2379901	2380889	BnaA09T0038100ZY	0	+	0	0	988	0.0000000
zheyou73v0_A09	2381859	2383689	BnaA09T0038200ZY	0	+	0	0	1830	0.0000000
zheyou73v0_A09	2396613	2400153	BnaA09T0038300ZY	0	+	0	0	3540	0.0000000
zheyou73v0_A09	2400114	2403834	BnaA09T0038400ZY	0	-	0	0	3720	0.0000000
zheyou73v0_A09	2411461	2412975	BnaA09T0038500ZY	0	-	0	0	1514	0.0000000
zheyou73v0_A09	2413342	2415602	BnaA09T0038600ZY	0	+	0	0	2260	0.0000000
zheyou73v0_A09	2416560	2417758	BnaA09T0038700ZY	0	-	0	0	1198	0.0000000
zheyou73v0_A09	2419120	2422167	BnaA09T0038800ZY	0	-	0	0	3047	0.0000000
zheyou73v0_A09	2429726	2430638	BnaA09T0038900ZY	0	-	0	0	912	0.0000000
zheyou73v0_A09	2430943	2432742	BnaA09T0039000ZY	0	-	0	0	1799	0.0000000
zheyou73v0_A09	2434745	2437521	BnaA09T0039100ZY	0	+	0	0	2776	0.0000000
zheyou73v0_A09	2439695	2443067	BnaA09T0039200ZY	0	+	0	0	3372	0.0000000
zheyou73v0_A09	2444726	2447468	BnaA09T0039300ZY	0	+	0	0	2742	0.0000000
zheyou73v0_A09	2448244	2451693	BnaA09T0039400ZY	0	+	0	0	3449	0.0000000
zheyou73v0_A09	2452334	2452951	BnaA09T0039500ZY	0	+	0	0	617	0.0000000
zheyou73v0_A09	2454741	2455059	BnaA09T0039600ZY	0	-	0	0	318	0.0000000
zheyou73v0_A09	2455593	2458521	BnaA09T0039700ZY	0	+	0	0	2928	0.0000000
zheyou73v0_A09	2463973	2465954	BnaA09T0039800ZY	0	+	0	0	1981	0.0000000
zheyou73v0_A09	2469097	2470349	BnaA09T0039900ZY	0	+	0	0	1252	0.0000000
zheyou73v0_A09	2472430	2472793	BnaA09T0040000ZY	0	+	0	0	363	0.0000000
zheyou73v0_A09	2473924	2474233	BnaA09T0040100ZY	0	-	0	0	309	0.0000000
zheyou73v0_A09	2478569	2480144	BnaA09T0040200ZY	0	+	0	0	1575	0.0000000
zheyou73v0_A09	2487266	2489654	BnaA09T0040300ZY	0	+	0	0	2388	0.0000000
zheyou73v0_A09	2487266	2489891	BnaA09T0040300ZY.1	0	+	0	0	2625	0.0000000
zheyou73v0_A09	2494092	2494961	BnaA09T0040400ZY	0	+	0	0	869	0.0000000
zheyou73v0_A09	2501859	2512076	BnaA09T0040500ZY	0	-	0	0	10217	0.0000000
zheyou73v0_A09	2520420	2522912	BnaA09T0040600ZY	0	+	0	0	2492	0.0000000
zheyou73v0_A09	2526786	2531327	BnaA09T0040700ZY	0	+	0	0	4541	0.0000000
zheyou73v0_A09	2533050	2535484	BnaA09T0040800ZY	0	+	0	0	2434	0.0000000
zheyou73v0_A09	2544484	2548018	BnaA09T0040900ZY	0	+	0	0	3534	0.0000000
zheyou73v0_A09	2548832	2549808	BnaA09T0041000ZY	0	+	0	0	976	0.0000000
zheyou73v0_A09	2552288	2553501	BnaA09T0041100ZY	0	+	0	0	1213	0.0000000
zheyou73v0_A09	2555179	2556540	BnaA09T0041200ZY	0	-	0	0	1361	0.0000000
zheyou73v0_A09	2560119	2561468	BnaA09T0041300ZY	0	+	0	0	1349	0.0000000
zheyou73v0_A09	2577026	2577576	BnaA09T0041400ZY	0	-	0	0	550	0.0000000
zheyou73v0_A09	2578579	2580290	BnaA09T0041500ZY	0	-	0	0	1711	0.0000000
zheyou73v0_A09	2582192	2582534	BnaA09T0041600ZY	0	+	0	0	342	0.0000000
zheyou73v0_A09	2589609	2591372	BnaA09T0041700ZY	0	+	0	0	1763	0.0000000
zheyou73v0_A09	2592060	2593326	BnaA09T0041800ZY	0	-	0	0	1266	0.0000000
zheyou73v0_A09	2595378	2597577	BnaA09T0041900ZY	0	+	0	0	2199	0.0000000
zheyou73v0_A09	2613417	2616244	BnaA09T0042000ZY	0	+	0	0	2827	0.0000000
zheyou73v0_A09	2617388	2620028	BnaA09T0042100ZY	0	+	0	0	2640	0.0000000
zheyou73v0_A09	2620613	2621644	BnaA09T0042200ZY	0	-	0	0	1031	0.0000000
zheyou73v0_A09	2622823	2624764	BnaA09T0042300ZY	0	-	0	0	1941	0.0000000
zheyou73v0_A09	2630049	2631438	BnaA09T0042400ZY	0	+	0	0	1389	0.0000000
zheyou73v0_A09	2633782	2634957	BnaA09T0042500ZY	0	+	0	0	1175	0.0000000
zheyou73v0_A09	2636153	2636952	BnaA09T0042600ZY	0	-	0	0	799	0.0000000
zheyou73v0_A09	2643941	2649590	BnaA09T0042700ZY	0	-	0	0	5649	0.0000000
zheyou73v0_A09	2656866	2657238	BnaA09T0042800ZY	0	-	0	0	372	0.0000000
zheyou73v0_A09	2659160	2660130	BnaA09T0042900ZY	0	-	0	0	970	0.0000000
zheyou73v0_A09	2662338	2664271	BnaA09T0043000ZY	0	+	0	0	1933	0.0000000
zheyou73v0_A09	2668389	2669388	BnaA09T0043100ZY	0	+	0	0	999	0.0000000
zheyou73v0_A09	2676061	2677341	BnaA09T0043200ZY	0	-	0	0	1280	0.0000000
zheyou73v0_A09	2682823	2683141	BnaA09T0043300ZY	0	+	0	0	318	0.0000000
zheyou73v0_A09	2683544	2685074	BnaA09T0043400ZY	0	-	0	0	1530	0.0000000
zheyou73v0_A09	2699638	2702127	BnaA09T0043500ZY	0	+	0	0	2489	0.0000000
zheyou73v0_A09	2703512	2704948	BnaA09T0043600ZY	0	+	0	0	1436	0.0000000
zheyou73v0_A09	2705743	2709361	BnaA09T0043700ZY	0	+	0	0	3618	0.0000000
zheyou73v0_A09	2710215	2714515	BnaA09T0043800ZY	0	+	0	0	4300	0.0000000
zheyou73v0_A09	2715693	2716059	BnaA09T0043900ZY	0	-	0	0	366	0.0000000
zheyou73v0_A09	2744357	2746293	BnaA09T0044000ZY	0	-	0	0	1936	0.0000000
zheyou73v0_A09	2763044	2763960	BnaA09T0044100ZY	0	+	0	0	916	0.0000000
zheyou73v0_A09	2763044	2764211	BnaA09T0044100ZY.1	0	+	0	0	1167	0.0000000
zheyou73v0_A09	2766816	2770412	BnaA09T0044200ZY	0	-	0	0	3596	0.0000000
zheyou73v0_A09	2778218	2786299	BnaA09T0044300ZY	0	+	0	0	8081	0.0000000
zheyou73v0_A09	2786696	2787807	BnaA09T0044400ZY	0	-	0	0	1111	0.0000000
zheyou73v0_A09	2788512	2790061	BnaA09T0044500ZY	0	+	0	0	1549	0.0000000
zheyou73v0_A09	2790655	2792254	BnaA09T0044600ZY	0	-	0	0	1599	0.0000000
zheyou73v0_A09	2794270	2795938	BnaA09T0044700ZY	0	-	0	0	1668	0.0000000
zheyou73v0_A09	2799207	2800165	BnaA09T0044800ZY	0	+	0	0	958	0.0000000
zheyou73v0_A09	2800343	2801779	BnaA09T0044900ZY	0	-	0	0	1436	0.0000000
zheyou73v0_A09	2802541	2802927	BnaA09T0045000ZY	0	-	0	0	386	0.0000000
zheyou73v0_A09	2802960	2803585	BnaA09T0045100ZY	0	-	0	0	625	0.0000000
zheyou73v0_A09	2804448	2805488	BnaA09T0045200ZY	0	-	0	0	1040	0.0000000
zheyou73v0_A09	2806364	2808557	BnaA09T0045300ZY	0	+	0	0	2193	0.0000000
zheyou73v0_A09	2810073	2811241	BnaA09T0045400ZY	0	-	0	0	1168	0.0000000
zheyou73v0_A09	2812769	2814403	BnaA09T0045500ZY	0	-	0	0	1634	0.0000000
zheyou73v0_A09	2815631	2817023	BnaA09T0045600ZY	0	-	0	0	1392	0.0000000
zheyou73v0_A09	2817554	2824138	BnaA09T0045700ZY	0	-	0	0	6584	0.0000000
zheyou73v0_A09	2826453	2829080	BnaA09T0045800ZY	0	-	0	0	2627	0.0000000
zheyou73v0_A09	2830295	2833977	BnaA09T0045900ZY	0	-	0	0	3682	0.0000000
zheyou73v0_A09	2847696	2850475	BnaA09T0046000ZY	0	+	0	0	2779	0.0000000
zheyou73v0_A09	2852340	2854426	BnaA09T0046100ZY	0	+	0	0	2086	0.0000000
zheyou73v0_A09	2860610	2861864	BnaA09T0046200ZY	0	+	0	0	1254	0.0000000
zheyou73v0_A09	2864227	2867708	BnaA09T0046300ZY	0	+	0	0	3481	0.0000000
zheyou73v0_A09	2875522	2877946	BnaA09T0046400ZY	0	+	0	0	2424	0.0000000
zheyou73v0_A09	2876085	2877946	BnaA09T0046400ZY.1	0	+	0	0	1861	0.0000000
zheyou73v0_A09	2881041	2883707	BnaA09T0046500ZY	0	-	0	0	2666	0.0000000
zheyou73v0_A09	2890261	2890666	BnaA09T0046600ZY	0	+	0	0	405	0.0000000
zheyou73v0_A09	2896121	2898570	BnaA09T0046700ZY	0	-	0	0	2449	0.0000000
zheyou73v0_A09	2904065	2905707	BnaA09T0046800ZY	0	+	0	0	1642	0.0000000
zheyou73v0_A09	2904065	2905707	BnaA09T0046800ZY.1	0	+	0	0	1642	0.0000000
zheyou73v0_A09	2917245	2923669	BnaA09T0046900ZY	0	+	0	0	6424	0.0000000
zheyou73v0_A09	2917245	2923669	BnaA09T0046900ZY.1	0	+	0	0	6424	0.0000000
zheyou73v0_A09	2917245	2923669	BnaA09T0046900ZY.2	0	+	0	0	6424	0.0000000
zheyou73v0_A09	2924486	2926754	BnaA09T0047000ZY	0	+	0	0	2268	0.0000000
zheyou73v0_A09	2924486	2926754	BnaA09T0047000ZY.1	0	+	0	0	2268	0.0000000
zheyou73v0_A09	2924486	2926754	BnaA09T0047000ZY.2	0	+	0	0	2268	0.0000000
zheyou73v0_A09	2927362	2929798	BnaA09T0047100ZY	0	-	0	0	2436	0.0000000
zheyou73v0_A09	2930566	2931663	BnaA09T0047200ZY	0	-	0	0	1097	0.0000000
zheyou73v0_A09	2933180	2934137	BnaA09T0047300ZY	0	-	0	0	957	0.0000000
zheyou73v0_A09	2934524	2935372	BnaA09T0047400ZY	0	-	0	0	848	0.0000000
zheyou73v0_A09	2937053	2938004	BnaA09T0047500ZY	0	-	0	0	951	0.0000000
zheyou73v0_A09	2957641	2960987	BnaA09T0047600ZY	0	-	0	0	3346	0.0000000
zheyou73v0_A09	2967244	2969174	BnaA09T0047700ZY	0	+	0	0	1930	0.0000000
zheyou73v0_A09	2972647	2973616	BnaA09T0047800ZY	0	-	0	0	969	0.0000000
zheyou73v0_A09	2974044	2975891	BnaA09T0047900ZY	0	-	0	0	1847	0.0000000
zheyou73v0_A09	2977523	2978131	BnaA09T0048000ZY	0	+	0	0	608	0.0000000
zheyou73v0_A09	2978525	2980907	BnaA09T0048100ZY	0	-	0	0	2382	0.0000000
zheyou73v0_A09	2978525	2980907	BnaA09T0048100ZY.1	0	-	0	0	2382	0.0000000
zheyou73v0_A09	2982044	2984817	BnaA09T0048200ZY	0	+	0	0	2773	0.0000000
zheyou73v0_A09	2985533	2996406	BnaA09T0048300ZY	0	+	0	0	10873	0.0000000
zheyou73v0_A09	3005357	3012499	BnaA09T0048400ZY	0	-	0	0	7142	0.0000000
zheyou73v0_A09	3015157	3016253	BnaA09T0048500ZY	0	+	0	0	1096	0.0000000
zheyou73v0_A09	3016839	3020042	BnaA09T0048600ZY	0	+	0	0	3203	0.0000000
zheyou73v0_A09	3023249	3027020	BnaA09T0048700ZY	0	+	0	0	3771	0.0000000
zheyou73v0_A09	3030785	3032498	BnaA09T0048800ZY	0	-	0	0	1713	0.0000000
zheyou73v0_A09	3037896	3039272	BnaA09T0048900ZY	0	-	0	0	1376	0.0000000
zheyou73v0_A09	3044595	3045347	BnaA09T0049000ZY	0	+	0	0	752	0.0000000
zheyou73v0_A09	3045369	3049311	BnaA09T0049100ZY	0	-	0	0	3942	0.0000000
zheyou73v0_A09	3051081	3053289	BnaA09T0049200ZY	0	+	0	0	2208	0.0000000
zheyou73v0_A09	3053818	3054508	BnaA09T0049300ZY	0	+	0	0	690	0.0000000
zheyou73v0_A09	3054821	3059151	BnaA09T0049400ZY	0	+	0	0	4330	0.0000000
zheyou73v0_A09	3062765	3064289	BnaA09T0049500ZY	0	+	0	0	1524	0.0000000
zheyou73v0_A09	3064398	3068866	BnaA09T0049600ZY	0	-	0	0	4468	0.0000000
zheyou73v0_A09	3070531	3072000	BnaA09T0049700ZY	0	-	0	0	1469	0.0000000
zheyou73v0_A09	3073096	3074889	BnaA09T0049800ZY	0	-	0	0	1793	0.0000000
zheyou73v0_A09	3076787	3079129	BnaA09T0049900ZY	0	-	0	0	2342	0.0000000
zheyou73v0_A09	3082010	3083774	BnaA09T0050000ZY	0	+	0	0	1764	0.0000000
zheyou73v0_A09	3084299	3086122	BnaA09T0050100ZY	0	-	0	0	1823	0.0000000
zheyou73v0_A09	3087045	3087964	BnaA09T0050200ZY	0	+	0	0	919	0.0000000
zheyou73v0_A09	3090939	3092419	BnaA09T0050300ZY	0	-	0	0	1480	0.0000000
zheyou73v0_A09	3095120	3096485	BnaA09T0050400ZY	0	-	0	0	1365	0.0000000
zheyou73v0_A09	3099101	3099846	BnaA09T0050500ZY	0	+	0	0	745	0.0000000
zheyou73v0_A09	3100917	3101487	BnaA09T0050600ZY	0	+	0	0	570	0.0000000
zheyou73v0_A09	3104550	3109265	BnaA09T0050700ZY	0	+	0	0	4715	0.0000000
zheyou73v0_A09	3111832	3112220	BnaA09T0050800ZY	0	+	0	0	388	0.0000000
zheyou73v0_A09	3114066	3117887	BnaA09T0050900ZY	0	+	0	0	3821	0.0000000
zheyou73v0_A09	3119584	3121453	BnaA09T0051000ZY	0	-	0	0	1869	0.0000000
zheyou73v0_A09	3135388	3137032	BnaA09T0051100ZY	0	+	0	0	1644	0.0000000
zheyou73v0_A09	3165114	3166538	BnaA09T0051200ZY	0	-	0	0	1424	0.0000000
zheyou73v0_A09	3171129	3173583	BnaA09T0051300ZY	0	-	0	0	2454	0.0000000
zheyou73v0_A09	3175217	3176085	BnaA09T0051400ZY	0	-	0	0	868	0.0000000
zheyou73v0_A09	3177212	3179700	BnaA09T0051500ZY	0	-	0	0	2488	0.0000000
zheyou73v0_A09	3184993	3186803	BnaA09T0051600ZY	0	-	0	0	1810	0.0000000
zheyou73v0_A09	3187298	3192076	BnaA09T0051700ZY	0	-	0	0	4778	0.0000000
zheyou73v0_A09	3206746	3207675	BnaA09T0051800ZY	0	-	0	0	929	0.0000000
zheyou73v0_A09	3210472	3216515	BnaA09T0051900ZY	0	+	0	0	6043	0.0000000
zheyou73v0_A09	3210472	3216515	BnaA09T0051900ZY.1	0	+	0	0	6043	0.0000000
zheyou73v0_A09	3219416	3224978	BnaA09T0052000ZY	0	+	0	0	5562	0.0000000
zheyou73v0_A09	3219416	3224978	BnaA09T0052000ZY.1	0	+	0	0	5562	0.0000000
zheyou73v0_A09	3219416	3224188	BnaA09T0052000ZY.2	0	+	0	0	4772	0.0000000
zheyou73v0_A09	3229618	3230323	BnaA09T0052100ZY	0	+	0	0	705	0.0000000
zheyou73v0_A09	3233237	3234915	BnaA09T0052200ZY	0	+	0	0	1678	0.0000000
zheyou73v0_A09	3241138	3242970	BnaA09T0052300ZY	0	+	0	0	1832	0.0000000
zheyou73v0_A09	3245011	3248154	BnaA09T0052400ZY	0	-	0	0	3143	0.0000000
zheyou73v0_A09	3249393	3250007	BnaA09T0052500ZY	0	-	0	0	614	0.0000000
zheyou73v0_A09	3250942	3252937	BnaA09T0052600ZY	0	-	0	0	1995	0.0000000
zheyou73v0_A09	3255223	3255802	BnaA09T0052700ZY	0	-	0	0	579	0.0000000
zheyou73v0_A09	3262458	3264249	BnaA09T0052800ZY	0	-	0	0	1791	0.0000000
zheyou73v0_A09	3265310	3265773	BnaA09T0052900ZY	0	+	0	0	463	0.0000000
zheyou73v0_A09	3267025	3268838	BnaA09T0053000ZY	0	-	0	0	1813	0.0000000
zheyou73v0_A09	3274087	3275035	BnaA09T0053100ZY	0	-	0	0	948	0.0000000
zheyou73v0_A09	3275696	3278147	BnaA09T0053200ZY	0	+	0	0	2451	0.0000000
zheyou73v0_A09	3279514	3280072	BnaA09T0053300ZY	0	+	0	0	558	0.0000000
zheyou73v0_A09	3281352	3284279	BnaA09T0053400ZY	0	+	0	0	2927	0.0000000
zheyou73v0_A09	3285127	3287627	BnaA09T0053500ZY	0	+	0	0	2500	0.0000000
zheyou73v0_A09	3288239	3290909	BnaA09T0053600ZY	0	-	0	0	2670	0.0000000
zheyou73v0_A09	3292217	3294483	BnaA09T0053700ZY	0	-	0	0	2266	0.0000000
zheyou73v0_A09	3296179	3297254	BnaA09T0053800ZY	0	+	0	0	1075	0.0000000
zheyou73v0_A09	3297667	3299283	BnaA09T0053900ZY	0	+	0	0	1616	0.0000000
zheyou73v0_A09	3298840	3302207	BnaA09T0054000ZY	0	-	0	0	3367	0.0000000
zheyou73v0_A09	3303231	3304477	BnaA09T0054100ZY	0	-	0	0	1246	0.0000000
zheyou73v0_A09	3309370	3312713	BnaA09T0054200ZY	0	+	0	0	3343	0.0000000
zheyou73v0_A09	3313624	3341215	BnaA09T0054300ZY	0	+	0	0	27591	0.0000000
zheyou73v0_A09	3338935	3341403	BnaA09T0054300ZY.1	0	+	0	0	2468	0.0000000
zheyou73v0_A09	3338935	3341215	BnaA09T0054300ZY.3	0	+	0	0	2280	0.0000000
zheyou73v0_A09	3339058	3341403	BnaA09T0054300ZY.2	0	+	0	0	2345	0.0000000
zheyou73v0_A09	3342815	3344530	BnaA09T0054400ZY	0	+	0	0	1715	0.0000000
zheyou73v0_A09	3344819	3346028	BnaA09T0054500ZY	0	-	0	0	1209	0.0000000
zheyou73v0_A09	3346553	3347476	BnaA09T0054600ZY	0	+	0	0	923	0.0000000
zheyou73v0_A09	3348912	3351116	BnaA09T0054700ZY	0	+	0	0	2204	0.0000000
zheyou73v0_A09	3352902	3357221	BnaA09T0054800ZY	0	+	0	0	4319	0.0000000
zheyou73v0_A09	3357345	3358335	BnaA09T0054900ZY	0	+	0	0	990	0.0000000
zheyou73v0_A09	3358531	3360456	BnaA09T0055000ZY	0	-	0	0	1925	0.0000000
zheyou73v0_A09	3363522	3369004	BnaA09T0055100ZY	0	+	0	0	5482	0.0000000
zheyou73v0_A09	3370539	3379711	BnaA09T0055200ZY	0	+	0	0	9172	0.0000000
zheyou73v0_A09	3379880	3382988	BnaA09T0055300ZY	0	+	0	0	3108	0.0000000
zheyou73v0_A09	3383595	3385951	BnaA09T0055400ZY	0	-	0	0	2356	0.0000000
zheyou73v0_A09	3385969	3387752	BnaA09T0055500ZY	0	-	0	0	1783	0.0000000
zheyou73v0_A09	3385969	3387752	BnaA09T0055500ZY.1	0	-	0	0	1783	0.0000000
zheyou73v0_A09	3388583	3391251	BnaA09T0055600ZY	0	-	0	0	2668	0.0000000
zheyou73v0_A09	3399128	3408301	BnaA09T0055700ZY	0	+	0	0	9173	0.0000000
zheyou73v0_A09	3409166	3410501	BnaA09T0055800ZY	0	+	0	0	1335	0.0000000
zheyou73v0_A09	3413548	3415630	BnaA09T0055900ZY	0	+	0	0	2082	0.0000000
zheyou73v0_A09	3415903	3417395	BnaA09T0056000ZY	0	-	0	0	1492	0.0000000
zheyou73v0_A09	3418357	3419749	BnaA09T0056100ZY	0	+	0	0	1392	0.0000000
zheyou73v0_A09	3420699	3423028	BnaA09T0056200ZY	0	+	0	0	2329	0.0000000
zheyou73v0_A09	3423343	3424737	BnaA09T0056300ZY	0	-	0	0	1394	0.0000000
zheyou73v0_A09	3425677	3429629	BnaA09T0056400ZY	0	+	0	0	3952	0.0000000
zheyou73v0_A09	3430029	3433685	BnaA09T0056500ZY	0	-	0	0	3656	0.0000000
zheyou73v0_A09	3434031	3436429	BnaA09T0056600ZY	0	+	0	0	2398	0.0000000
zheyou73v0_A09	3436906	3439842	BnaA09T0056700ZY	0	+	0	0	2936	0.0000000
zheyou73v0_A09	3437777	3439842	BnaA09T0056700ZY.1	0	+	0	0	2065	0.0000000
zheyou73v0_A09	3440381	3443954	BnaA09T0056800ZY	0	+	0	0	3573	0.0000000
zheyou73v0_A09	3444610	3445143	BnaA09T0056900ZY	0	-	0	0	533	0.0000000
zheyou73v0_A09	3445544	3446650	BnaA09T0057000ZY	0	-	0	0	1106	0.0000000
zheyou73v0_A09	3449547	3450146	BnaA09T0057100ZY	0	+	0	0	599	0.0000000
zheyou73v0_A09	3450946	3453128	BnaA09T0057200ZY	0	+	0	0	2182	0.0000000
zheyou73v0_A09	3450946	3453128	BnaA09T0057200ZY.1	0	+	0	0	2182	0.0000000
zheyou73v0_A09	3453382	3455132	BnaA09T0057300ZY	0	+	0	0	1750	0.0000000
zheyou73v0_A09	3463186	3464070	BnaA09T0057400ZY	0	+	0	0	884	0.0000000
zheyou73v0_A09	3464201	3465792	BnaA09T0057500ZY	0	+	0	0	1591	0.0000000
zheyou73v0_A09	3465858	3467759	BnaA09T0057600ZY	0	+	0	0	1901	0.0000000
zheyou73v0_A09	3469820	3472447	BnaA09T0057700ZY	0	-	0	0	2627	0.0000000
zheyou73v0_A09	3475547	3476756	BnaA09T0057800ZY	0	+	0	0	1209	0.0000000
zheyou73v0_A09	3480815	3481646	BnaA09T0057900ZY	0	-	0	0	831	0.0000000
zheyou73v0_A09	3490037	3490850	BnaA09T0058000ZY	0	-	0	0	813	0.0000000
zheyou73v0_A09	3496973	3500075	BnaA09T0058100ZY	0	-	0	0	3102	0.0000000
zheyou73v0_A09	3512905	3515723	BnaA09T0058200ZY	0	-	0	0	2818	0.0000000
zheyou73v0_A09	3512905	3515099	BnaA09T0058200ZY.1	0	-	0	0	2194	0.0000000
zheyou73v0_A09	3521654	3521807	BnaA09T0058300ZY	0	+	0	0	153	0.0000000
zheyou73v0_A09	3523754	3524387	BnaA09T0058400ZY	0	-	0	0	633	0.0000000
zheyou73v0_A09	3524817	3529767	BnaA09T0058500ZY	0	-	0	0	4950	0.0000000
zheyou73v0_A09	3535010	3540240	BnaA09T0058600ZY	0	-	0	0	5230	0.0000000
zheyou73v0_A09	3540549	3542212	BnaA09T0058700ZY	0	+	0	0	1663	0.0000000
zheyou73v0_A09	3556306	3556727	BnaA09T0058800ZY	0	-	0	0	421	0.0000000
zheyou73v0_A09	3558085	3561186	BnaA09T0058900ZY	0	-	0	0	3101	0.0000000
zheyou73v0_A09	3569076	3572330	BnaA09T0059000ZY	0	+	0	0	3254	0.0000000
zheyou73v0_A09	3572739	3577936	BnaA09T0059100ZY	0	-	0	0	5197	0.0000000
zheyou73v0_A09	3578454	3582204	BnaA09T0059200ZY	0	-	0	0	3750	0.0000000
zheyou73v0_A09	3582946	3584060	BnaA09T0059300ZY	0	-	0	0	1114	0.0000000
zheyou73v0_A09	3585125	3587092	BnaA09T0059400ZY	0	+	0	0	1967	0.0000000
zheyou73v0_A09	3595867	3598378	BnaA09T0059500ZY	0	+	0	0	2511	0.0000000
zheyou73v0_A09	3598533	3599638	BnaA09T0059600ZY	0	+	0	0	1105	0.0000000
zheyou73v0_A09	3598533	3599638	BnaA09T0059600ZY.1	0	+	0	0	1105	0.0000000
zheyou73v0_A09	3599701	3601762	BnaA09T0059700ZY	0	-	0	0	2061	0.0000000
zheyou73v0_A09	3622955	3623216	BnaA09T0059800ZY	0	+	0	0	261	0.0000000
zheyou73v0_A09	3635944	3637329	BnaA09T0059900ZY	0	+	0	0	1385	0.0000000
zheyou73v0_A09	3642737	3645611	BnaA09T0060000ZY	0	-	0	0	2874	0.0000000
zheyou73v0_A09	3646721	3647450	BnaA09T0060100ZY	0	+	0	0	729	0.0000000
zheyou73v0_A09	3647600	3651184	BnaA09T0060200ZY	0	-	0	0	3584	0.0000000
zheyou73v0_A09	3652131	3653457	BnaA09T0060300ZY	0	-	0	0	1326	0.0000000
zheyou73v0_A09	3662207	3662444	BnaA09T0060400ZY	0	-	0	0	237	0.0000000
zheyou73v0_A09	3664056	3665435	BnaA09T0060500ZY	0	-	0	0	1379	0.0000000
zheyou73v0_A09	3671870	3674747	BnaA09T0060600ZY	0	-	0	0	2877	0.0000000
zheyou73v0_A09	3675857	3676587	BnaA09T0060700ZY	0	+	0	0	730	0.0000000
zheyou73v0_A09	3676737	3680322	BnaA09T0060800ZY	0	-	0	0	3585	0.0000000
zheyou73v0_A09	3681271	3682597	BnaA09T0060900ZY	0	-	0	0	1326	0.0000000
zheyou73v0_A09	3683696	3684227	BnaA09T0061000ZY	0	-	0	0	531	0.0000000
zheyou73v0_A09	3686613	3691093	BnaA09T0061100ZY	0	+	0	0	4480	0.0000000
zheyou73v0_A09	3692449	3695163	BnaA09T0061200ZY	0	-	0	0	2714	0.0000000
zheyou73v0_A09	3692449	3695163	BnaA09T0061200ZY.1	0	-	0	0	2714	0.0000000
zheyou73v0_A09	3702489	3708045	BnaA09T0061300ZY	0	-	0	0	5556	0.0000000
zheyou73v0_A09	3710784	3714428	BnaA09T0061400ZY	0	+	0	0	3644	0.0000000
zheyou73v0_A09	3715469	3716344	BnaA09T0061500ZY	0	+	0	0	875	0.0000000
zheyou73v0_A09	3716594	3718681	BnaA09T0061600ZY	0	-	0	0	2087	0.0000000
zheyou73v0_A09	3721530	3723302	BnaA09T0061700ZY	0	+	0	0	1772	0.0000000
zheyou73v0_A09	3726316	3729474	BnaA09T0061800ZY	0	+	0	0	3158	0.0000000
zheyou73v0_A09	3731114	3732032	BnaA09T0061900ZY	0	+	0	0	918	0.0000000
zheyou73v0_A09	3736426	3738316	BnaA09T0062000ZY	0	+	0	0	1890	0.0000000
zheyou73v0_A09	3736426	3738316	BnaA09T0062000ZY.1	0	+	0	0	1890	0.0000000
zheyou73v0_A09	3737203	3738316	BnaA09T0062000ZY.2	0	+	0	0	1113	0.0000000
zheyou73v0_A09	3740623	3741487	BnaA09T0062100ZY	0	-	0	0	864	0.0000000
zheyou73v0_A09	3744154	3745963	BnaA09T0062200ZY	0	+	0	0	1809	0.0000000
zheyou73v0_A09	3746264	3747412	BnaA09T0062300ZY	0	-	0	0	1148	0.0000000
zheyou73v0_A09	3749050	3750739	BnaA09T0062400ZY	0	+	0	0	1689	0.0000000
zheyou73v0_A09	3751743	3754313	BnaA09T0062500ZY	0	-	0	0	2570	0.0000000
zheyou73v0_A09	3755619	3756732	BnaA09T0062600ZY	0	+	0	0	1113	0.0000000
zheyou73v0_A09	3757580	3758982	BnaA09T0062700ZY	0	-	0	0	1402	0.0000000
zheyou73v0_A09	3760168	3760672	BnaA09T0062800ZY	0	+	0	0	504	0.0000000
zheyou73v0_A09	3762927	3763482	BnaA09T0062900ZY	0	+	0	0	555	0.0000000
zheyou73v0_A09	3764935	3765505	BnaA09T0063000ZY	0	+	0	0	570	0.0000000
zheyou73v0_A09	3768025	3768496	BnaA09T0063100ZY	0	+	0	0	471	0.0000000
zheyou73v0_A09	3769869	3771373	BnaA09T0063200ZY	0	-	0	0	1504	0.0000000
zheyou73v0_A09	3775465	3776302	BnaA09T0063300ZY	0	+	0	0	837	0.0000000
zheyou73v0_A09	3779505	3780920	BnaA09T0063400ZY	0	+	0	0	1415	0.0000000
zheyou73v0_A09	3787332	3789871	BnaA09T0063500ZY	0	+	0	0	2539	0.0000000
zheyou73v0_A09	3800980	3803243	BnaA09T0063600ZY	0	+	0	0	2263	0.0000000
zheyou73v0_A09	3806624	3808137	BnaA09T0063700ZY	0	+	0	0	1513	0.0000000
zheyou73v0_A09	3813348	3814142	BnaA09T0063800ZY	0	-	0	0	794	0.0000000
zheyou73v0_A09	3815183	3817873	BnaA09T0063900ZY	0	-	0	0	2690	0.0000000
zheyou73v0_A09	3830119	3833120	BnaA09T0064000ZY	0	+	0	0	3001	0.0000000
zheyou73v0_A09	3841526	3844256	BnaA09T0064100ZY	0	+	0	0	2730	0.0000000
zheyou73v0_A09	3845789	3849334	BnaA09T0064200ZY	0	+	0	0	3545	0.0000000
zheyou73v0_A09	3849966	3851376	BnaA09T0064300ZY	0	+	0	0	1410	0.0000000
zheyou73v0_A09	3851920	3853572	BnaA09T0064400ZY	0	+	0	0	1652	0.0000000
zheyou73v0_A09	3859676	3861561	BnaA09T0064500ZY	0	+	0	0	1885	0.0000000
zheyou73v0_A09	3862132	3868708	BnaA09T0064600ZY	0	+	0	0	6576	0.0000000
zheyou73v0_A09	3869251	3870496	BnaA09T0064700ZY	0	-	0	0	1245	0.0000000
zheyou73v0_A09	3875506	3876879	BnaA09T0064800ZY	0	-	0	0	1373	0.0000000
zheyou73v0_A09	3883110	3885808	BnaA09T0064900ZY	0	+	0	0	2698	0.0000000
zheyou73v0_A09	3889333	3890445	BnaA09T0065000ZY	0	-	0	0	1112	0.0000000
zheyou73v0_A09	3892369	3904916	BnaA09T0065100ZY	0	+	0	0	12547	0.0000000
zheyou73v0_A09	3911586	3912215	BnaA09T0065200ZY	0	+	0	0	629	0.0000000
zheyou73v0_A09	3917308	3918137	BnaA09T0065300ZY	0	-	0	0	829	0.0000000
zheyou73v0_A09	3920490	3924946	BnaA09T0065400ZY	0	-	0	0	4456	0.0000000
zheyou73v0_A09	3926958	3929197	BnaA09T0065500ZY	0	-	0	0	2239	0.0000000
zheyou73v0_A09	3931795	3932490	BnaA09T0065600ZY	0	+	0	0	695	0.0000000
zheyou73v0_A09	3932524	3934534	BnaA09T0065700ZY	0	-	0	0	2010	0.0000000
zheyou73v0_A09	3936322	3942026	BnaA09T0065800ZY	0	+	0	0	5704	0.0000000
zheyou73v0_A09	3948193	3949796	BnaA09T0065900ZY	0	-	0	0	1603	0.0000000
zheyou73v0_A09	3959291	3960512	BnaA09T0066000ZY	0	+	0	0	1221	0.0000000
zheyou73v0_A09	3963984	3966209	BnaA09T0066100ZY	0	-	0	0	2225	0.0000000
zheyou73v0_A09	3967106	3967590	BnaA09T0066200ZY	0	-	0	0	484	0.0000000
zheyou73v0_A09	3969937	3973393	BnaA09T0066300ZY	0	+	0	0	3456	0.0000000
zheyou73v0_A09	3974505	3975822	BnaA09T0066400ZY	0	+	0	0	1317	0.0000000
zheyou73v0_A09	3979394	3986582	BnaA09T0066500ZY	0	+	0	0	7188	0.0000000
zheyou73v0_A09	3987875	3990535	BnaA09T0066600ZY	0	+	0	0	2660	0.0000000
zheyou73v0_A09	3991990	4000397	BnaA09T0066700ZY	0	+	0	0	8407	0.0000000
zheyou73v0_A09	4002296	4002959	BnaA09T0066800ZY	0	+	0	0	663	0.0000000
zheyou73v0_A09	4004156	4006045	BnaA09T0066900ZY	0	-	0	0	1889	0.0000000
zheyou73v0_A09	4004156	4006045	BnaA09T0066900ZY.1	0	-	0	0	1889	0.0000000
zheyou73v0_A09	4010170	4013009	BnaA09T0067000ZY	0	+	0	0	2839	0.0000000
zheyou73v0_A09	4013072	4014310	BnaA09T0067100ZY	0	-	0	0	1238	0.0000000
zheyou73v0_A09	4019948	4022721	BnaA09T0067200ZY	0	+	0	0	2773	0.0000000
zheyou73v0_A09	4027250	4029871	BnaA09T0067300ZY	0	+	0	0	2621	0.0000000
zheyou73v0_A09	4033280	4035834	BnaA09T0067400ZY	0	+	0	0	2554	0.0000000
zheyou73v0_A09	4038709	4046686	BnaA09T0067500ZY	0	+	0	0	7977	0.0000000
zheyou73v0_A09	4047452	4048266	BnaA09T0067600ZY	0	+	0	0	814	0.0000000
zheyou73v0_A09	4058284	4060017	BnaA09T0067700ZY	0	+	0	0	1733	0.0000000
zheyou73v0_A09	4060506	4063653	BnaA09T0067800ZY	0	+	0	0	3147	0.0000000
zheyou73v0_A09	4060506	4063653	BnaA09T0067800ZY.1	0	+	0	0	3147	0.0000000
zheyou73v0_A09	4074559	4077447	BnaA09T0067900ZY.2	0	+	0	0	2888	0.0000000
zheyou73v0_A09	4074571	4077447	BnaA09T0067900ZY	0	+	0	0	2876	0.0000000
zheyou73v0_A09	4075191	4077447	BnaA09T0067900ZY.1	0	+	0	0	2256	0.0000000
zheyou73v0_A09	4081303	4085387	BnaA09T0068000ZY	0	+	0	0	4084	0.0000000
zheyou73v0_A09	4081303	4085387	BnaA09T0068000ZY.2	0	+	0	0	4084	0.0000000
zheyou73v0_A09	4081560	4085387	BnaA09T0068000ZY.1	0	+	0	0	3827	0.0000000
zheyou73v0_A09	4088004	4091417	BnaA09T0068100ZY	0	+	0	0	3413	0.0000000
zheyou73v0_A09	4093372	4095048	BnaA09T0068200ZY	0	+	0	0	1676	0.0000000
zheyou73v0_A09	4095147	4096009	BnaA09T0068300ZY	0	-	0	0	862	0.0000000
zheyou73v0_A09	4096461	4098939	BnaA09T0068400ZY	0	-	0	0	2478	0.0000000
zheyou73v0_A09	4105728	4107100	BnaA09T0068500ZY	0	+	0	0	1372	0.0000000
zheyou73v0_A09	4112952	4114676	BnaA09T0068600ZY	0	+	0	0	1724	0.0000000
zheyou73v0_A09	4124691	4129324	BnaA09T0068700ZY	0	+	0	0	4633	0.0000000
zheyou73v0_A09	4142251	4144755	BnaA09T0068800ZY	0	+	0	0	2504	0.0000000
zheyou73v0_A09	4152150	4153530	BnaA09T0068900ZY	0	-	0	0	1380	0.0000000
zheyou73v0_A09	4155252	4156182	BnaA09T0069000ZY	0	+	0	0	930	0.0000000
zheyou73v0_A09	4156362	4160278	BnaA09T0069100ZY	0	-	0	0	3916	0.0000000
zheyou73v0_A09	4160706	4161599	BnaA09T0069200ZY	0	+	0	0	893	0.0000000
zheyou73v0_A09	4162062	4166048	BnaA09T0069300ZY	0	-	0	0	3986	0.0000000
zheyou73v0_A09	4162062	4166048	BnaA09T0069300ZY.1	0	-	0	0	3986	0.0000000
zheyou73v0_A09	4166982	4169708	BnaA09T0069400ZY	0	-	0	0	2726	0.0000000
zheyou73v0_A09	4170979	4171898	BnaA09T0069500ZY	0	+	0	0	919	0.0000000
zheyou73v0_A09	4173394	4177436	BnaA09T0069600ZY	0	+	0	0	4042	0.0000000
zheyou73v0_A09	4179826	4182874	BnaA09T0069700ZY	0	-	0	0	3048	0.0000000
zheyou73v0_A09	4197380	4200058	BnaA09T0069800ZY	0	+	0	0	2678	0.0000000
zheyou73v0_A09	4200245	4201530	BnaA09T0069900ZY	0	-	0	0	1285	0.0000000
zheyou73v0_A09	4205417	4206098	BnaA09T0070000ZY	0	+	0	0	681	0.0000000
zheyou73v0_A09	4214512	4216663	BnaA09T0070100ZY	0	+	0	0	2151	0.0000000
zheyou73v0_A09	4218979	4229193	BnaA09T0070200ZY	0	+	0	0	10214	0.0000000
zheyou73v0_A09	4219130	4229193	BnaA09T0070200ZY.1	0	+	0	0	10063	0.0000000
zheyou73v0_A09	4231839	4234211	BnaA09T0070300ZY	0	+	0	0	2372	0.0000000
zheyou73v0_A09	4231839	4234211	BnaA09T0070300ZY.1	0	+	0	0	2372	0.0000000
zheyou73v0_A09	4234072	4237119	BnaA09T0070400ZY	0	-	0	0	3047	0.0000000
zheyou73v0_A09	4237954	4239467	BnaA09T0070500ZY	0	+	0	0	1513	0.0000000
zheyou73v0_A09	4239882	4241681	BnaA09T0070600ZY	0	-	0	0	1799	0.0000000
zheyou73v0_A09	4241995	4243701	BnaA09T0070700ZY	0	-	0	0	1706	0.0000000
zheyou73v0_A09	4244525	4245865	BnaA09T0070800ZY	0	+	0	0	1340	0.0000000
zheyou73v0_A09	4247955	4256993	BnaA09T0070900ZY	0	-	0	0	9038	0.0000000
zheyou73v0_A09	4259894	4260364	BnaA09T0071000ZY	0	-	0	0	470	0.0000000
zheyou73v0_A09	4261000	4261418	BnaA09T0071100ZY	0	-	0	0	418	0.0000000
zheyou73v0_A09	4263954	4265732	BnaA09T0071200ZY	0	+	0	0	1778	0.0000000
zheyou73v0_A09	4263954	4265732	BnaA09T0071200ZY.1	0	+	0	0	1778	0.0000000
zheyou73v0_A09	4265844	4267596	BnaA09T0071300ZY	0	-	0	0	1752	0.0000000
zheyou73v0_A09	4278957	4279250	BnaA09T0071400ZY	0	-	0	0	293	0.0000000
zheyou73v0_A09	4281892	4284233	BnaA09T0071500ZY	0	-	0	0	2341	0.0000000
zheyou73v0_A09	4290107	4292074	BnaA09T0071600ZY	0	-	0	0	1967	0.0000000
zheyou73v0_A09	4293463	4295875	BnaA09T0071700ZY	0	+	0	0	2412	0.0000000
zheyou73v0_A09	4296203	4297209	BnaA09T0071800ZY	0	-	0	0	1006	0.0000000
zheyou73v0_A09	4299392	4300663	BnaA09T0071900ZY	0	-	0	0	1271	0.0000000
zheyou73v0_A09	4306437	4308836	BnaA09T0072000ZY	0	-	0	0	2399	0.0000000
zheyou73v0_A09	4318421	4320110	BnaA09T0072100ZY	0	-	0	0	1689	0.0000000
zheyou73v0_A09	4347941	4349297	BnaA09T0072200ZY	0	-	0	0	1356	0.0000000
zheyou73v0_A09	4351578	4353041	BnaA09T0072300ZY	0	-	0	0	1463	0.0000000
zheyou73v0_A09	4353218	4358608	BnaA09T0072400ZY	0	+	0	0	5390	0.0000000
zheyou73v0_A09	4360778	4362097	BnaA09T0072500ZY	0	+	0	0	1319	0.0000000
zheyou73v0_A09	4365475	4366611	BnaA09T0072600ZY	0	+	0	0	1136	0.0000000
zheyou73v0_A09	4370198	4371519	BnaA09T0072700ZY	0	-	0	0	1321	0.0000000
zheyou73v0_A09	4382535	4383684	BnaA09T0072800ZY	0	+	0	0	1149	0.0000000
zheyou73v0_A09	4392058	4398556	BnaA09T0072900ZY	0	-	0	0	6498	0.0000000
zheyou73v0_A09	4400086	4401323	BnaA09T0073000ZY	0	+	0	0	1237	0.0000000
zheyou73v0_A09	4401879	4406390	BnaA09T0073100ZY	0	-	0	0	4511	0.0000000
zheyou73v0_A09	4412518	4415205	BnaA09T0073200ZY	0	-	0	0	2687	0.0000000
zheyou73v0_A09	4417649	4419130	BnaA09T0073300ZY	0	-	0	0	1481	0.0000000
zheyou73v0_A09	4424331	4426904	BnaA09T0073400ZY	0	+	0	0	2573	0.0000000
zheyou73v0_A09	4427473	4430416	BnaA09T0073500ZY	0	-	0	0	2943	0.0000000
zheyou73v0_A09	4431169	4432462	BnaA09T0073600ZY	0	+	0	0	1293	0.0000000
zheyou73v0_A09	4432731	4437873	BnaA09T0073700ZY	0	-	0	0	5142	0.0000000
zheyou73v0_A09	4443170	4444762	BnaA09T0073800ZY	0	-	0	0	1592	0.0000000
zheyou73v0_A09	4445023	4448569	BnaA09T0073900ZY	0	-	0	0	3546	0.0000000
zheyou73v0_A09	4448790	4450079	BnaA09T0074000ZY	0	+	0	0	1289	0.0000000
zheyou73v0_A09	4455663	4456401	BnaA09T0074100ZY	0	+	0	0	738	0.0000000
zheyou73v0_A09	4459931	4462126	BnaA09T0074200ZY	0	-	0	0	2195	0.0000000
zheyou73v0_A09	4463120	4464199	BnaA09T0074300ZY	0	-	0	0	1079	0.0000000
zheyou73v0_A09	4472093	4474713	BnaA09T0074400ZY	0	+	0	0	2620	0.0000000
zheyou73v0_A09	4476820	4479526	BnaA09T0074500ZY	0	+	0	0	2706	0.0000000
zheyou73v0_A09	4479750	4482126	BnaA09T0074600ZY	0	-	0	0	2376	0.0000000
zheyou73v0_A09	4485701	4487633	BnaA09T0074700ZY	0	+	0	0	1932	0.0000000
zheyou73v0_A09	4488098	4488323	BnaA09T0074800ZY	0	-	0	0	225	0.0000000
zheyou73v0_A09	4491851	4494123	BnaA09T0074900ZY	0	-	0	0	2272	0.0000000
zheyou73v0_A09	4509469	4512152	BnaA09T0075000ZY	0	-	0	0	2683	0.0000000
zheyou73v0_A09	4512738	4514797	BnaA09T0075100ZY	0	-	0	0	2059	0.0000000
zheyou73v0_A09	4515872	4517928	BnaA09T0075200ZY	0	+	0	0	2056	0.0000000
zheyou73v0_A09	4520651	4524043	BnaA09T0075300ZY	0	+	0	0	3392	0.0000000
zheyou73v0_A09	4528600	4532112	BnaA09T0075400ZY	0	+	0	0	3512	0.0000000
zheyou73v0_A09	4532898	4533516	BnaA09T0075500ZY	0	-	0	0	618	0.0000000
zheyou73v0_A09	4539779	4539968	BnaA09T0075600ZY	0	-	0	0	189	0.0000000
zheyou73v0_A09	4550234	4550706	BnaA09T0075700ZY	0	-	0	0	472	0.0000000
zheyou73v0_A09	4551143	4551909	BnaA09T0075800ZY	0	-	0	0	766	0.0000000
zheyou73v0_A09	4555269	4557228	BnaA09T0075900ZY	0	+	0	0	1959	0.0000000
zheyou73v0_A09	4557568	4558993	BnaA09T0076000ZY	0	-	0	0	1425	0.0000000
zheyou73v0_A09	4559154	4561094	BnaA09T0076100ZY	0	+	0	0	1940	0.0000000
zheyou73v0_A09	4561984	4564681	BnaA09T0076200ZY	0	-	0	0	2697	0.0000000
zheyou73v0_A09	4573365	4574805	BnaA09T0076300ZY	0	+	0	0	1440	0.0000000
zheyou73v0_A09	4575533	4577836	BnaA09T0076400ZY	0	-	0	0	2303	0.0000000
zheyou73v0_A09	4586352	4590309	BnaA09T0076500ZY	0	+	0	0	3957	0.0000000
zheyou73v0_A09	4594094	4596773	BnaA09T0076600ZY	0	-	0	0	2679	0.0000000
zheyou73v0_A09	4597680	4600432	BnaA09T0076700ZY	0	-	0	0	2752	0.0000000
zheyou73v0_A09	4602563	4602875	BnaA09T0076800ZY	0	+	0	0	312	0.0000000
zheyou73v0_A09	4612329	4625253	BnaA09T0076900ZY	0	+	0	0	12924	0.0000000
zheyou73v0_A09	4632890	4634609	BnaA09T0077000ZY	0	-	0	0	1719	0.0000000
zheyou73v0_A09	4632890	4634609	BnaA09T0077000ZY.1	0	-	0	0	1719	0.0000000
zheyou73v0_A09	4635781	4637499	BnaA09T0077100ZY	0	-	0	0	1718	0.0000000
zheyou73v0_A09	4640335	4641735	BnaA09T0077200ZY	0	-	0	0	1400	0.0000000
zheyou73v0_A09	4642382	4645530	BnaA09T0077300ZY	0	-	0	0	3148	0.0000000
zheyou73v0_A09	4649839	4651120	BnaA09T0077400ZY	0	-	0	0	1281	0.0000000
zheyou73v0_A09	4651700	4653726	BnaA09T0077500ZY	0	-	0	0	2026	0.0000000
zheyou73v0_A09	4654472	4656761	BnaA09T0077600ZY	0	+	0	0	2289	0.0000000
zheyou73v0_A09	4658046	4660172	BnaA09T0077700ZY	0	+	0	0	2126	0.0000000
zheyou73v0_A09	4666351	4667545	BnaA09T0077800ZY	0	+	0	0	1194	0.0000000
zheyou73v0_A09	4671337	4672043	BnaA09T0077900ZY	0	+	0	0	706	0.0000000
zheyou73v0_A09	4677507	4678668	BnaA09T0078000ZY	0	+	0	0	1161	0.0000000
zheyou73v0_A09	4679290	4680285	BnaA09T0078100ZY	0	+	0	0	995	0.0000000
zheyou73v0_A09	4680428	4680617	BnaA09T0078200ZY	0	-	0	0	189	0.0000000
zheyou73v0_A09	4691277	4692631	BnaA09T0078300ZY	0	-	0	0	1354	0.0000000
zheyou73v0_A09	4738966	4741344	BnaA09T0078400ZY	0	+	0	0	2378	0.0000000
zheyou73v0_A09	4742328	4753121	BnaA09T0078500ZY	0	-	0	0	10793	0.0000000
zheyou73v0_A09	4754733	4756483	BnaA09T0078600ZY	0	-	0	0	1750	0.0000000
zheyou73v0_A09	4789660	4793087	BnaA09T0078700ZY	0	+	0	0	3427	0.0000000
zheyou73v0_A09	4789660	4793087	BnaA09T0078700ZY.1	0	+	0	0	3427	0.0000000
zheyou73v0_A09	4789660	4793087	BnaA09T0078700ZY.2	0	+	0	0	3427	0.0000000
zheyou73v0_A09	4794365	4797906	BnaA09T0078800ZY	0	+	0	0	3541	0.0000000
zheyou73v0_A09	4798900	4799714	BnaA09T0078900ZY	0	+	0	0	814	0.0000000
zheyou73v0_A09	4802082	4804719	BnaA09T0079000ZY	0	-	0	0	2637	0.0000000
zheyou73v0_A09	4806240	4809496	BnaA09T0079100ZY	0	+	0	0	3256	0.0000000
zheyou73v0_A09	4806240	4809496	BnaA09T0079100ZY.1	0	+	0	0	3256	0.0000000
zheyou73v0_A09	4814808	4816463	BnaA09T0079200ZY	0	+	0	0	1655	0.0000000
zheyou73v0_A09	4817059	4829069	BnaA09T0079300ZY	0	-	0	0	12010	0.0000000
zheyou73v0_A09	4838138	4841882	BnaA09T0079400ZY	0	+	0	0	3744	0.0000000
zheyou73v0_A09	4842838	4843917	BnaA09T0079500ZY	0	+	0	0	1079	0.0000000
zheyou73v0_A09	4849366	4851124	BnaA09T0079600ZY	0	-	0	0	1758	0.0000000
zheyou73v0_A09	4854917	4856603	BnaA09T0079700ZY	0	-	0	0	1686	0.0000000
zheyou73v0_A09	4859882	4862238	BnaA09T0079800ZY	0	+	0	0	2356	0.0000000
zheyou73v0_A09	4862704	4870983	BnaA09T0079900ZY	0	-	0	0	8279	0.0000000
zheyou73v0_A09	4874443	4877269	BnaA09T0080000ZY	0	-	0	0	2826	0.0000000
zheyou73v0_A09	4874514	4875996	BnaA09T0080100ZY	0	+	0	0	1482	0.0000000
zheyou73v0_A09	4877625	4878424	BnaA09T0080200ZY	0	-	0	0	799	0.0000000
zheyou73v0_A09	4878692	4880771	BnaA09T0080300ZY	0	+	0	0	2079	0.0000000
zheyou73v0_A09	4881854	4884544	BnaA09T0080400ZY	0	+	0	0	2690	0.0000000
zheyou73v0_A09	4884819	4886355	BnaA09T0080500ZY	0	-	0	0	1536	0.0000000
zheyou73v0_A09	4888445	4888658	BnaA09T0080600ZY	0	+	0	0	213	0.0000000
zheyou73v0_A09	4900754	4900964	BnaA09T0080700ZY	0	+	0	0	210	0.0000000
zheyou73v0_A09	4903146	4903511	BnaA09T0080800ZY	0	+	0	0	365	0.0000000
zheyou73v0_A09	4904678	4905276	BnaA09T0080900ZY	0	-	0	0	598	0.0000000
zheyou73v0_A09	4906953	4907244	BnaA09T0081000ZY	0	+	0	0	291	0.0000000
zheyou73v0_A09	4908089	4910659	BnaA09T0081100ZY	0	-	0	0	2570	0.0000000
zheyou73v0_A09	4920668	4921222	BnaA09T0081200ZY	0	-	0	0	554	0.0000000
zheyou73v0_A09	4928226	4929168	BnaA09T0081300ZY	0	-	0	0	942	0.0000000
zheyou73v0_A09	4929325	4931815	BnaA09T0081400ZY	0	-	0	0	2490	0.0000000
zheyou73v0_A09	4932406	4935822	BnaA09T0081500ZY	0	-	0	0	3416	0.0000000
zheyou73v0_A09	4936869	4938046	BnaA09T0081600ZY	0	+	0	0	1177	0.0000000
zheyou73v0_A09	4941207	4942132	BnaA09T0081700ZY	0	-	0	0	925	0.0000000
zheyou73v0_A09	4944591	4946609	BnaA09T0081800ZY	0	+	0	0	2018	0.0000000
zheyou73v0_A09	4947247	4951811	BnaA09T0081900ZY	0	-	0	0	4564	0.0000000
zheyou73v0_A09	4947247	4951811	BnaA09T0081900ZY.2	0	-	0	0	4564	0.0000000
zheyou73v0_A09	4947773	4951811	BnaA09T0081900ZY.1	0	-	0	0	4038	0.0000000
zheyou73v0_A09	4953905	4957030	BnaA09T0082000ZY	0	+	0	0	3125	0.0000000
zheyou73v0_A09	4957096	4959246	BnaA09T0082100ZY	0	-	0	0	2150	0.0000000
zheyou73v0_A09	4960984	4962757	BnaA09T0082200ZY	0	-	0	0	1773	0.0000000
zheyou73v0_A09	4964294	4971016	BnaA09T0082300ZY	0	-	0	0	6722	0.0000000
zheyou73v0_A09	4971955	4973499	BnaA09T0082400ZY	0	-	0	0	1544	0.0000000
zheyou73v0_A09	4975794	4979072	BnaA09T0082500ZY	0	-	0	0	3278	0.0000000
zheyou73v0_A09	4983006	4984521	BnaA09T0082600ZY	0	-	0	0	1515	0.0000000
zheyou73v0_A09	4988040	4989672	BnaA09T0082700ZY	0	-	0	0	1632	0.0000000
zheyou73v0_A09	4990838	4991681	BnaA09T0082800ZY	0	+	0	0	843	0.0000000
zheyou73v0_A09	4991422	4995044	BnaA09T0082900ZY	0	-	0	0	3622	0.0000000
zheyou73v0_A09	4995525	4997662	BnaA09T0083000ZY	0	+	0	0	2137	0.0000000
zheyou73v0_A09	5004368	5007134	BnaA09T0083100ZY	0	+	0	0	2766	0.0000000
zheyou73v0_A09	5012873	5016147	BnaA09T0083200ZY	0	-	0	0	3274	0.0000000
zheyou73v0_A09	5016404	5019912	BnaA09T0083300ZY	0	+	0	0	3508	0.0000000
zheyou73v0_A09	5025021	5027242	BnaA09T0083400ZY	0	+	0	0	2221	0.0000000
zheyou73v0_A09	5075797	5079150	BnaA09T0083500ZY	0	-	0	0	3353	0.0000000
zheyou73v0_A09	5082901	5084994	BnaA09T0083600ZY	0	-	0	0	2093	0.0000000
zheyou73v0_A09	5086146	5087218	BnaA09T0083700ZY	0	-	0	0	1072	0.0000000
zheyou73v0_A09	5088173	5091076	BnaA09T0083800ZY	0	+	0	0	2903	0.0000000
zheyou73v0_A09	5091343	5094115	BnaA09T0083900ZY	0	-	0	0	2772	0.0000000
zheyou73v0_A09	5096955	5097495	BnaA09T0084000ZY	0	-	0	0	540	0.0000000
zheyou73v0_A09	5105098	5106779	BnaA09T0084100ZY	0	+	0	0	1681	0.0000000
zheyou73v0_A09	5110306	5111613	BnaA09T0084200ZY	0	+	0	0	1307	0.0000000
zheyou73v0_A09	5112984	5116148	BnaA09T0084300ZY	0	+	0	0	3164	0.0000000
zheyou73v0_A09	5116302	5119975	BnaA09T0084400ZY	0	-	0	0	3673	0.0000000
zheyou73v0_A09	5121543	5124046	BnaA09T0084500ZY	0	-	0	0	2503	0.0000000
zheyou73v0_A09	5129731	5132267	BnaA09T0084600ZY	0	-	0	0	2536	0.0000000
zheyou73v0_A09	5133196	5134927	BnaA09T0084700ZY	0	+	0	0	1731	0.0000000
zheyou73v0_A09	5135262	5136077	BnaA09T0084800ZY	0	-	0	0	815	0.0000000
zheyou73v0_A09	5143773	5144346	BnaA09T0084900ZY	0	+	0	0	573	0.0000000
zheyou73v0_A09	5161958	5173326	BnaA09T0085000ZY	0	+	0	0	11368	0.0000000
zheyou73v0_A09	5161958	5163667	BnaA09T0085000ZY.1	0	+	0	0	1709	0.0000000
zheyou73v0_A09	5172105	5173863	BnaA09T0085100ZY	0	-	0	0	1758	0.0000000
zheyou73v0_A09	5174030	5175670	BnaA09T0085200ZY	0	+	0	0	1640	0.0000000
zheyou73v0_A09	5177342	5178701	BnaA09T0085300ZY	0	-	0	0	1359	0.0000000
zheyou73v0_A09	5180487	5181297	BnaA09T0085400ZY	0	-	0	0	810	0.0000000
zheyou73v0_A09	5181891	5182238	BnaA09T0085500ZY	0	-	0	0	347	0.0000000
zheyou73v0_A09	5183870	5185104	BnaA09T0085600ZY	0	+	0	0	1234	0.0000000
zheyou73v0_A09	5186645	5188525	BnaA09T0085700ZY	0	-	0	0	1880	0.0000000
zheyou73v0_A09	5192282	5198124	BnaA09T0085800ZY	0	+	0	0	5842	0.0000000
zheyou73v0_A09	5200251	5204402	BnaA09T0085900ZY	0	+	0	0	4151	0.0000000
zheyou73v0_A09	5204743	5207068	BnaA09T0086000ZY	0	-	0	0	2325	0.0000000
zheyou73v0_A09	5208184	5210940	BnaA09T0086100ZY	0	+	0	0	2756	0.0000000
zheyou73v0_A09	5212690	5216411	BnaA09T0086200ZY	0	+	0	0	3721	0.0000000
zheyou73v0_A09	5217218	5219291	BnaA09T0086300ZY	0	-	0	0	2073	0.0000000
zheyou73v0_A09	5219246	5220565	BnaA09T0086400ZY	0	+	0	0	1319	0.0000000
zheyou73v0_A09	5219246	5220565	BnaA09T0086400ZY.1	0	+	0	0	1319	0.0000000
zheyou73v0_A09	5221333	5223397	BnaA09T0086500ZY	0	+	0	0	2064	0.0000000
zheyou73v0_A09	5233799	5235600	BnaA09T0086600ZY	0	+	0	0	1801	0.0000000
zheyou73v0_A09	5233799	5235600	BnaA09T0086600ZY.1	0	+	0	0	1801	0.0000000
zheyou73v0_A09	5236893	5238836	BnaA09T0086700ZY	0	-	0	0	1943	0.0000000
zheyou73v0_A09	5241908	5244646	BnaA09T0086800ZY	0	-	0	0	2738	0.0000000
zheyou73v0_A09	5241908	5244646	BnaA09T0086800ZY.1	0	-	0	0	2738	0.0000000
zheyou73v0_A09	5245203	5248519	BnaA09T0086900ZY	0	-	0	0	3316	0.0000000
zheyou73v0_A09	5253541	5256014	BnaA09T0087000ZY	0	+	0	0	2473	0.0000000
zheyou73v0_A09	5256321	5258680	BnaA09T0087100ZY	0	-	0	0	2359	0.0000000
zheyou73v0_A09	5262001	5262710	BnaA09T0087200ZY	0	+	0	0	709	0.0000000
zheyou73v0_A09	5268077	5271840	BnaA09T0087300ZY	0	+	0	0	3763	0.0000000
zheyou73v0_A09	5271166	5273045	BnaA09T0087400ZY	0	-	0	0	1879	0.0000000
zheyou73v0_A09	5278417	5279798	BnaA09T0087500ZY	0	-	0	0	1381	0.0000000
zheyou73v0_A09	5285472	5286304	BnaA09T0087600ZY	0	-	0	0	832	0.0000000
zheyou73v0_A09	5299984	5300455	BnaA09T0087700ZY	0	-	0	0	471	0.0000000
zheyou73v0_A09	5307624	5313369	BnaA09T0087800ZY	0	+	0	0	5745	0.0000000
zheyou73v0_A09	5320729	5322734	BnaA09T0087900ZY	0	+	0	0	2005	0.0000000
zheyou73v0_A09	5341274	5342387	BnaA09T0088000ZY	0	+	0	0	1113	0.0000000
zheyou73v0_A09	5342991	5344783	BnaA09T0088100ZY	0	+	0	0	1792	0.0000000
zheyou73v0_A09	5345268	5346525	BnaA09T0088200ZY	0	+	0	0	1257	0.0000000
zheyou73v0_A09	5347206	5351238	BnaA09T0088300ZY	0	-	0	0	4032	0.0000000
zheyou73v0_A09	5352168	5353116	BnaA09T0088400ZY	0	-	0	0	948	0.0000000
zheyou73v0_A09	5354221	5355636	BnaA09T0088500ZY	0	-	0	0	1415	0.0000000
zheyou73v0_A09	5357457	5359083	BnaA09T0088600ZY	0	-	0	0	1626	0.0000000
zheyou73v0_A09	5359585	5363035	BnaA09T0088700ZY	0	-	0	0	3450	0.0000000
zheyou73v0_A09	5359585	5363035	BnaA09T0088700ZY.1	0	-	0	0	3450	0.0000000
zheyou73v0_A09	5363757	5364923	BnaA09T0088800ZY	0	+	0	0	1166	0.0000000
zheyou73v0_A09	5368229	5369424	BnaA09T0088900ZY	0	+	0	0	1195	0.0000000
zheyou73v0_A09	5373618	5374046	BnaA09T0089000ZY	0	-	0	0	428	0.0000000
zheyou73v0_A09	5388673	5394793	BnaA09T0089100ZY	0	+	0	0	6120	0.0000000
zheyou73v0_A09	5392619	5394793	BnaA09T0089100ZY.1	0	+	0	0	2174	0.0000000
zheyou73v0_A09	5400260	5402081	BnaA09T0089200ZY	0	+	0	0	1821	0.0000000
zheyou73v0_A09	5402435	5403273	BnaA09T0089300ZY	0	-	0	0	838	0.0000000
zheyou73v0_A09	5415677	5416628	BnaA09T0089400ZY	0	-	0	0	951	0.0000000
zheyou73v0_A09	5421401	5421936	BnaA09T0089500ZY	0	-	0	0	535	0.0000000
zheyou73v0_A09	5423034	5426755	BnaA09T0089600ZY	0	-	0	0	3721	0.0000000
zheyou73v0_A09	5423034	5426755	BnaA09T0089600ZY.1	0	-	0	0	3721	0.0000000
zheyou73v0_A09	5423034	5426755	BnaA09T0089600ZY.2	0	-	0	0	3721	0.0000000
zheyou73v0_A09	5436615	5437423	BnaA09T0089700ZY	0	+	0	0	808	0.0000000
zheyou73v0_A09	5440916	5442807	BnaA09T0089800ZY	0	-	0	0	1891	0.0000000
zheyou73v0_A09	5448931	5450294	BnaA09T0089900ZY	0	-	0	0	1363	0.0000000
zheyou73v0_A09	5455402	5455973	BnaA09T0090000ZY	0	-	0	0	571	0.0000000
zheyou73v0_A09	5456511	5460125	BnaA09T0090100ZY	0	-	0	0	3614	0.0000000
zheyou73v0_A09	5461606	5462846	BnaA09T0090200ZY	0	+	0	0	1240	0.0000000
zheyou73v0_A09	5461606	5462846	BnaA09T0090200ZY.1	0	+	0	0	1240	0.0000000
zheyou73v0_A09	5463335	5466317	BnaA09T0090300ZY	0	-	0	0	2982	0.0000000
zheyou73v0_A09	5466782	5467978	BnaA09T0090400ZY	0	-	0	0	1196	0.0000000
zheyou73v0_A09	5472519	5473920	BnaA09T0090500ZY	0	-	0	0	1401	0.0000000
zheyou73v0_A09	5484576	5485431	BnaA09T0090600ZY	0	-	0	0	855	0.0000000
zheyou73v0_A09	5511994	5513736	BnaA09T0090700ZY	0	+	0	0	1742	0.0000000
zheyou73v0_A09	5511994	5514023	BnaA09T0090700ZY.1	0	+	0	0	2029	0.0000000
zheyou73v0_A09	5518605	5521865	BnaA09T0090800ZY	0	+	0	0	3260	0.0000000
zheyou73v0_A09	5522666	5524409	BnaA09T0090900ZY	0	+	0	0	1743	0.0000000
zheyou73v0_A09	5525180	5529566	BnaA09T0091000ZY	0	+	0	0	4386	0.0000000
zheyou73v0_A09	5537278	5538798	BnaA09T0091100ZY	0	+	0	0	1520	0.0000000
zheyou73v0_A09	5544985	5545360	BnaA09T0091200ZY	0	+	0	0	375	0.0000000
zheyou73v0_A09	5546589	5548191	BnaA09T0091300ZY	0	-	0	0	1602	0.0000000
zheyou73v0_A09	5552285	5553934	BnaA09T0091400ZY	0	-	0	0	1649	0.0000000
zheyou73v0_A09	5554505	5555679	BnaA09T0091500ZY	0	-	0	0	1174	0.0000000
zheyou73v0_A09	5559398	5561217	BnaA09T0091600ZY	0	-	0	0	1819	0.0000000
zheyou73v0_A09	5562225	5563631	BnaA09T0091700ZY	0	-	0	0	1406	0.0000000
zheyou73v0_A09	5567568	5567793	BnaA09T0091800ZY	0	+	0	0	225	0.0000000
zheyou73v0_A09	5568128	5568395	BnaA09T0091900ZY	0	+	0	0	267	0.0000000
zheyou73v0_A09	5570726	5571981	BnaA09T0092000ZY	0	+	0	0	1255	0.0000000
zheyou73v0_A09	5572324	5573414	BnaA09T0092100ZY	0	-	0	0	1090	0.0000000
zheyou73v0_A09	5572324	5573414	BnaA09T0092100ZY.1	0	-	0	0	1090	0.0000000
zheyou73v0_A09	5574391	5575857	BnaA09T0092200ZY	0	+	0	0	1466	0.0000000
zheyou73v0_A09	5576033	5576866	BnaA09T0092300ZY	0	-	0	0	833	0.0000000
zheyou73v0_A09	5579593	5582285	BnaA09T0092400ZY	0	+	0	0	2692	0.0000000
zheyou73v0_A09	5583438	5584328	BnaA09T0092500ZY	0	-	0	0	890	0.0000000
zheyou73v0_A09	5585012	5587020	BnaA09T0092600ZY	0	-	0	0	2008	0.0000000
zheyou73v0_A09	5589005	5589907	BnaA09T0092700ZY	0	+	0	0	902	0.0000000
zheyou73v0_A09	5593502	5597038	BnaA09T0092800ZY	0	+	0	0	3536	0.0000000
zheyou73v0_A09	5601344	5602276	BnaA09T0092900ZY	0	+	0	0	932	0.0000000
zheyou73v0_A09	5606375	5607762	BnaA09T0093000ZY	0	+	0	0	1387	0.0000000
zheyou73v0_A09	5607959	5609535	BnaA09T0093100ZY	0	-	0	0	1576	0.0000000
zheyou73v0_A09	5615481	5616224	BnaA09T0093200ZY	0	+	0	0	743	0.0000000
zheyou73v0_A09	5618029	5619758	BnaA09T0093300ZY	0	+	0	0	1729	0.0000000
zheyou73v0_A09	5656500	5657549	BnaA09T0093400ZY	0	+	0	0	1049	0.0000000
zheyou73v0_A09	5658029	5661473	BnaA09T0093500ZY	0	-	0	0	3444	0.0000000
zheyou73v0_A09	5662161	5665966	BnaA09T0093600ZY	0	-	0	0	3805	0.0000000
zheyou73v0_A09	5667722	5669250	BnaA09T0093700ZY	0	+	0	0	1528	0.0000000
zheyou73v0_A09	5669984	5671559	BnaA09T0093800ZY	0	+	0	0	1575	0.0000000
zheyou73v0_A09	5674036	5681041	BnaA09T0093900ZY	0	+	0	0	7005	0.0000000
zheyou73v0_A09	5683735	5684905	BnaA09T0094000ZY	0	+	0	0	1170	0.0000000
zheyou73v0_A09	5685867	5688349	BnaA09T0094100ZY	0	-	0	0	2482	0.0000000
zheyou73v0_A09	5685867	5688349	BnaA09T0094100ZY.1	0	-	0	0	2482	0.0000000
zheyou73v0_A09	5689096	5689780	BnaA09T0094200ZY	0	+	0	0	684	0.0000000
zheyou73v0_A09	5690639	5691331	BnaA09T0094300ZY	0	-	0	0	692	0.0000000
zheyou73v0_A09	5692028	5692999	BnaA09T0094400ZY	0	-	0	0	971	0.0000000
zheyou73v0_A09	5697337	5699229	BnaA09T0094500ZY	0	+	0	0	1892	0.0000000
zheyou73v0_A09	5699973	5703435	BnaA09T0094600ZY	0	+	0	0	3462	0.0000000
zheyou73v0_A09	5705076	5705589	BnaA09T0094700ZY	0	-	0	0	513	0.0000000
zheyou73v0_A09	5706355	5707562	BnaA09T0094800ZY	0	-	0	0	1207	0.0000000
zheyou73v0_A09	5708353	5711858	BnaA09T0094900ZY	0	+	0	0	3505	0.0000000
zheyou73v0_A09	5712016	5714602	BnaA09T0095000ZY	0	-	0	0	2586	0.0000000
zheyou73v0_A09	5717738	5718374	BnaA09T0095100ZY	0	+	0	0	636	0.0000000
zheyou73v0_A09	5718595	5720282	BnaA09T0095200ZY	0	-	0	0	1687	0.0000000
zheyou73v0_A09	5723632	5726089	BnaA09T0095300ZY	0	-	0	0	2457	0.0000000
zheyou73v0_A09	5728949	5732105	BnaA09T0095400ZY	0	+	0	0	3156	0.0000000
zheyou73v0_A09	5734423	5736098	BnaA09T0095500ZY	0	+	0	0	1675	0.0000000
zheyou73v0_A09	5737274	5737466	BnaA09T0095600ZY	0	-	0	0	192	0.0000000
zheyou73v0_A09	5740952	5741222	BnaA09T0095700ZY	0	-	0	0	270	0.0000000
zheyou73v0_A09	5744808	5746168	BnaA09T0095800ZY	0	+	0	0	1360	0.0000000
zheyou73v0_A09	5744808	5746097	BnaA09T0095800ZY.1	0	+	0	0	1289	0.0000000
zheyou73v0_A09	5746985	5749135	BnaA09T0095900ZY	0	+	0	0	2150	0.0000000
zheyou73v0_A09	5750025	5750616	BnaA09T0096000ZY	0	-	0	0	591	0.0000000
zheyou73v0_A09	5753303	5753534	BnaA09T0096100ZY	0	-	0	0	231	0.0000000
zheyou73v0_A09	5754825	5755276	BnaA09T0096200ZY	0	-	0	0	451	0.0000000
zheyou73v0_A09	5763948	5764939	BnaA09T0096300ZY	0	-	0	0	991	0.0000000
zheyou73v0_A09	5763948	5764939	BnaA09T0096300ZY.1	0	-	0	0	991	0.0000000
zheyou73v0_A09	5773974	5774745	BnaA09T0096400ZY	0	+	0	0	771	0.0000000
zheyou73v0_A09	5775427	5778733	BnaA09T0096500ZY	0	-	0	0	3306	0.0000000
zheyou73v0_A09	5779366	5786627	BnaA09T0096600ZY	0	-	0	0	7261	0.0000000
zheyou73v0_A09	5789261	5791187	BnaA09T0096700ZY	0	+	0	0	1926	0.0000000
zheyou73v0_A09	5791294	5793445	BnaA09T0096800ZY	0	-	0	0	2151	0.0000000
zheyou73v0_A09	5795433	5795787	BnaA09T0096900ZY	0	+	0	0	354	0.0000000
zheyou73v0_A09	5797074	5798394	BnaA09T0097000ZY	0	-	0	0	1320	0.0000000
zheyou73v0_A09	5807536	5809250	BnaA09T0097100ZY	0	-	0	0	1714	0.0000000
zheyou73v0_A09	5825376	5828174	BnaA09T0097200ZY	0	+	0	0	2798	0.0000000
zheyou73v0_A09	5829050	5830274	BnaA09T0097300ZY	0	+	0	0	1224	0.0000000
zheyou73v0_A09	5835121	5836178	BnaA09T0097400ZY	0	+	0	0	1057	0.0000000
zheyou73v0_A09	5837867	5839178	BnaA09T0097500ZY	0	-	0	0	1311	0.0000000
zheyou73v0_A09	5847119	5850396	BnaA09T0097600ZY	0	+	0	0	3277	0.0000000
zheyou73v0_A09	5850672	5851224	BnaA09T0097700ZY	0	-	0	0	552	0.0000000
zheyou73v0_A09	5852393	5852929	BnaA09T0097800ZY	0	-	0	0	536	0.0000000
zheyou73v0_A09	5854924	5856562	BnaA09T0097900ZY	0	-	0	0	1638	0.0000000
zheyou73v0_A09	5860197	5873566	BnaA09T0098000ZY	0	+	0	0	13369	0.0000000
zheyou73v0_A09	5860197	5873566	BnaA09T0098000ZY.1	0	+	0	0	13369	0.0000000
zheyou73v0_A09	5860197	5873566	BnaA09T0098000ZY.2	0	+	0	0	13369	0.0000000
zheyou73v0_A09	5860197	5861720	BnaA09T0098000ZY.3	0	+	0	0	1523	0.0000000
zheyou73v0_A09	5873939	5877045	BnaA09T0098100ZY	0	+	0	0	3106	0.0000000
zheyou73v0_A09	5878256	5882683	BnaA09T0098200ZY	0	+	0	0	4427	0.0000000
zheyou73v0_A09	5878256	5882683	BnaA09T0098200ZY.1	0	+	0	0	4427	0.0000000
zheyou73v0_A09	5883643	5885422	BnaA09T0098300ZY	0	+	0	0	1779	0.0000000
zheyou73v0_A09	5889081	5889979	BnaA09T0098400ZY	0	-	0	0	898	0.0000000
zheyou73v0_A09	5899929	5904353	BnaA09T0098500ZY	0	+	0	0	4424	0.0000000
zheyou73v0_A09	5905313	5910670	BnaA09T0098600ZY	0	+	0	0	5357	0.0000000
zheyou73v0_A09	5909772	5911648	BnaA09T0098700ZY	0	-	0	0	1876	0.0000000
zheyou73v0_A09	5916080	5916839	BnaA09T0098800ZY	0	+	0	0	759	0.0000000
zheyou73v0_A09	5923563	5925541	BnaA09T0098900ZY	0	+	0	0	1978	0.0000000
zheyou73v0_A09	5925830	5927414	BnaA09T0099000ZY	0	-	0	0	1584	0.0000000
zheyou73v0_A09	5929006	5930651	BnaA09T0099100ZY	0	-	0	0	1645	0.0000000
zheyou73v0_A09	5933985	5934910	BnaA09T0099200ZY	0	+	0	0	925	0.0000000
zheyou73v0_A09	5934928	5937120	BnaA09T0099300ZY	0	-	0	0	2192	0.0000000
zheyou73v0_A09	5934928	5937120	BnaA09T0099300ZY.1	0	-	0	0	2192	0.0000000
zheyou73v0_A09	5948089	5948713	BnaA09T0099400ZY	0	-	0	0	624	0.0000000
zheyou73v0_A09	5951341	5951736	BnaA09T0099500ZY	0	-	0	0	395	0.0000000
zheyou73v0_A09	5952337	5965054	BnaA09T0099600ZY	0	-	0	0	12717	0.0000000
zheyou73v0_A09	5952337	5953688	BnaA09T0099600ZY.1	0	-	0	0	1351	0.0000000
zheyou73v0_A09	5952337	5953688	BnaA09T0099600ZY.2	0	-	0	0	1351	0.0000000
zheyou73v0_A09	5952337	5953583	BnaA09T0099600ZY.3	0	-	0	0	1246	0.0000000
zheyou73v0_A09	5965762	5967079	BnaA09T0099700ZY	0	-	0	0	1317	0.0000000
zheyou73v0_A09	5970301	5973653	BnaA09T0099800ZY	0	+	0	0	3352	0.0000000
zheyou73v0_A09	5976720	5982260	BnaA09T0099900ZY	0	+	0	0	5540	0.0000000
zheyou73v0_A09	5976720	5982260	BnaA09T0099900ZY.1	0	+	0	0	5540	0.0000000
zheyou73v0_A09	5983692	5986633	BnaA09T0100000ZY	0	-	0	0	2941	0.0000000
zheyou73v0_A09	5986947	5989105	BnaA09T0100100ZY	0	+	0	0	2158	0.0000000
zheyou73v0_A09	5989453	5991445	BnaA09T0100200ZY	0	-	0	0	1992	0.0000000
zheyou73v0_A09	5992317	5996053	BnaA09T0100300ZY	0	-	0	0	3736	0.0000000
zheyou73v0_A09	5996363	5998271	BnaA09T0100400ZY	0	+	0	0	1908	0.0000000
zheyou73v0_A09	6007841	6008762	BnaA09T0100500ZY	0	+	0	0	921	0.0000000
zheyou73v0_A09	6012580	6014868	BnaA09T0100600ZY	0	+	0	0	2288	0.0000000
zheyou73v0_A09	6012580	6014868	BnaA09T0100600ZY.1	0	+	0	0	2288	0.0000000
zheyou73v0_A09	6015065	6015714	BnaA09T0100700ZY	0	-	0	0	649	0.0000000
zheyou73v0_A09	6017603	6026122	BnaA09T0100800ZY	0	+	0	0	8519	0.0000000
zheyou73v0_A09	6017603	6026122	BnaA09T0100800ZY.1	0	+	0	0	8519	0.0000000
zheyou73v0_A09	6027335	6031386	BnaA09T0100900ZY	0	-	0	0	4051	0.0000000
zheyou73v0_A09	6033201	6035106	BnaA09T0101000ZY	0	-	0	0	1905	0.0000000
zheyou73v0_A09	6037896	6044038	BnaA09T0101100ZY	0	+	0	0	6142	0.0000000
zheyou73v0_A09	6061442	6062778	BnaA09T0101200ZY	0	-	0	0	1336	0.0000000
zheyou73v0_A09	6081830	6084452	BnaA09T0101300ZY.1	0	+	0	0	2622	0.0000000
zheyou73v0_A09	6081928	6084452	BnaA09T0101300ZY	0	+	0	0	2524	0.0000000
zheyou73v0_A09	6082035	6084452	BnaA09T0101300ZY.2	0	+	0	0	2417	0.0000000
zheyou73v0_A09	6089956	6093111	BnaA09T0101400ZY	0	+	0	0	3155	0.0000000
zheyou73v0_A09	6093746	6095423	BnaA09T0101500ZY	0	-	0	0	1677	0.0000000
zheyou73v0_A09	6093746	6095317	BnaA09T0101500ZY.1	0	-	0	0	1571	0.0000000
zheyou73v0_A09	6097116	6099472	BnaA09T0101600ZY	0	-	0	0	2356	0.0000000
zheyou73v0_A09	6114219	6115869	BnaA09T0101700ZY	0	-	0	0	1650	0.0000000
zheyou73v0_A09	6124633	6126827	BnaA09T0101800ZY	0	+	0	0	2194	0.0000000
zheyou73v0_A09	6131433	6133564	BnaA09T0101900ZY	0	-	0	0	2131	0.0000000
zheyou73v0_A09	6137051	6138820	BnaA09T0102000ZY	0	-	0	0	1769	0.0000000
zheyou73v0_A09	6140391	6141952	BnaA09T0102100ZY	0	-	0	0	1561	0.0000000
zheyou73v0_A09	6143190	6145295	BnaA09T0102200ZY	0	-	0	0	2105	0.0000000
zheyou73v0_A09	6143190	6145295	BnaA09T0102200ZY.1	0	-	0	0	2105	0.0000000
zheyou73v0_A09	6146574	6156743	BnaA09T0102300ZY	0	-	0	0	10169	0.0000000
zheyou73v0_A09	6146574	6156743	BnaA09T0102300ZY.1	0	-	0	0	10169	0.0000000
zheyou73v0_A09	6146574	6156743	BnaA09T0102300ZY.2	0	-	0	0	10169	0.0000000
zheyou73v0_A09	6146574	6156743	BnaA09T0102300ZY.3	0	-	0	0	10169	0.0000000
zheyou73v0_A09	6146574	6156743	BnaA09T0102300ZY.4	0	-	0	0	10169	0.0000000
zheyou73v0_A09	6159312	6159658	BnaA09T0102400ZY	0	-	0	0	346	0.0000000
zheyou73v0_A09	6167231	6172267	BnaA09T0102500ZY	0	+	0	0	5036	0.0000000
zheyou73v0_A09	6168197	6172267	BnaA09T0102500ZY.1	0	+	0	0	4070	0.0000000
zheyou73v0_A09	6172491	6173315	BnaA09T0102600ZY	0	-	0	0	824	0.0000000
zheyou73v0_A09	6176469	6178073	BnaA09T0102700ZY	0	+	0	0	1604	0.0000000
zheyou73v0_A09	6179012	6189995	BnaA09T0102800ZY	0	+	0	0	10983	0.0000000
zheyou73v0_A09	6190516	6194762	BnaA09T0102900ZY	0	+	0	0	4246	0.0000000
zheyou73v0_A09	6196705	6200440	BnaA09T0103000ZY	0	+	0	0	3735	0.0000000
zheyou73v0_A09	6205667	6208314	BnaA09T0103100ZY	0	+	0	0	2647	0.0000000
zheyou73v0_A09	6212011	6215427	BnaA09T0103200ZY	0	+	0	0	3416	0.0000000
zheyou73v0_A09	6220456	6222226	BnaA09T0103300ZY	0	+	0	0	1770	0.0000000
zheyou73v0_A09	6220456	6222226	BnaA09T0103300ZY.1	0	+	0	0	1770	0.0000000
zheyou73v0_A09	6237574	6239418	BnaA09T0103400ZY	0	-	0	0	1844	0.0000000
zheyou73v0_A09	6243940	6244637	BnaA09T0103500ZY	0	+	0	0	697	0.0000000
zheyou73v0_A09	6255023	6257846	BnaA09T0103600ZY	0	-	0	0	2823	0.0000000
zheyou73v0_A09	6261681	6262426	BnaA09T0103700ZY	0	+	0	0	745	0.0000000
zheyou73v0_A09	6263144	6266381	BnaA09T0103800ZY	0	+	0	0	3237	0.0000000
zheyou73v0_A09	6320364	6321475	BnaA09T0103900ZY	0	+	0	0	1111	0.0000000
zheyou73v0_A09	6321862	6323064	BnaA09T0104000ZY	0	-	0	0	1202	0.0000000
zheyou73v0_A09	6323854	6325208	BnaA09T0104100ZY	0	-	0	0	1354	0.0000000
zheyou73v0_A09	6323854	6325208	BnaA09T0104100ZY.1	0	-	0	0	1354	0.0000000
zheyou73v0_A09	6327879	6329156	BnaA09T0104200ZY	0	+	0	0	1277	0.0000000
zheyou73v0_A09	6332598	6333417	BnaA09T0104300ZY	0	+	0	0	819	0.0000000
zheyou73v0_A09	6332598	6333417	BnaA09T0104300ZY.1	0	+	0	0	819	0.0000000
zheyou73v0_A09	6335771	6337991	BnaA09T0104400ZY	0	-	0	0	2220	0.0000000
zheyou73v0_A09	6335771	6337991	BnaA09T0104400ZY.1	0	-	0	0	2220	0.0000000
zheyou73v0_A09	6344133	6346358	BnaA09T0104500ZY	0	-	0	0	2225	0.0000000
zheyou73v0_A09	6359248	6362154	BnaA09T0104600ZY	0	-	0	0	2906	0.0000000
zheyou73v0_A09	6362524	6363913	BnaA09T0104700ZY	0	-	0	0	1389	0.0000000
zheyou73v0_A09	6366473	6369385	BnaA09T0104800ZY	0	+	0	0	2912	0.0000000
zheyou73v0_A09	6377080	6378247	BnaA09T0104900ZY	0	-	0	0	1167	0.0000000
zheyou73v0_A09	6379955	6381666	BnaA09T0105000ZY	0	-	0	0	1711	0.0000000
zheyou73v0_A09	6382505	6383761	BnaA09T0105100ZY	0	+	0	0	1256	0.0000000
zheyou73v0_A09	6385351	6386354	BnaA09T0105200ZY	0	-	0	0	1003	0.0000000
zheyou73v0_A09	6388907	6389840	BnaA09T0105300ZY	0	+	0	0	933	0.0000000
zheyou73v0_A09	6391544	6393159	BnaA09T0105400ZY	0	+	0	0	1615	0.0000000
zheyou73v0_A09	6393264	6395642	BnaA09T0105500ZY	0	+	0	0	2378	0.0000000
zheyou73v0_A09	6398525	6399360	BnaA09T0105600ZY	0	+	0	0	835	0.0000000
zheyou73v0_A09	6404015	6406166	BnaA09T0105700ZY	0	+	0	0	2151	0.0000000
zheyou73v0_A09	6409073	6411368	BnaA09T0105800ZY	0	+	0	0	2295	0.0000000
zheyou73v0_A09	6420655	6421564	BnaA09T0105900ZY	0	-	0	0	909	0.0000000
zheyou73v0_A09	6443272	6444267	BnaA09T0106000ZY	0	-	0	0	995	0.0000000
zheyou73v0_A09	6444948	6446178	BnaA09T0106100ZY	0	-	0	0	1230	0.0000000
zheyou73v0_A09	6447112	6447964	BnaA09T0106200ZY	0	-	0	0	852	0.0000000
zheyou73v0_A09	6450461	6451025	BnaA09T0106300ZY	0	-	0	0	564	0.0000000
zheyou73v0_A09	6451355	6455061	BnaA09T0106400ZY	0	-	0	0	3706	0.0000000
zheyou73v0_A09	6544289	6545822	BnaA09T0106500ZY	0	+	0	0	1533	0.0000000
zheyou73v0_A09	6546243	6549996	BnaA09T0106600ZY	0	-	0	0	3753	0.0000000
zheyou73v0_A09	6560026	6560548	BnaA09T0106700ZY	0	-	0	0	522	0.0000000
zheyou73v0_A09	6562038	6563375	BnaA09T0106800ZY	0	-	0	0	1337	0.0000000
zheyou73v0_A09	6564760	6573264	BnaA09T0106900ZY	0	-	0	0	8504	0.0000000
zheyou73v0_A09	6577616	6580087	BnaA09T0107000ZY	0	+	0	0	2471	0.0000000
zheyou73v0_A09	6580294	6581980	BnaA09T0107100ZY	0	-	0	0	1686	0.0000000
zheyou73v0_A09	6583512	6585074	BnaA09T0107200ZY	0	+	0	0	1562	0.0000000
zheyou73v0_A09	6591519	6594435	BnaA09T0107300ZY	0	-	0	0	2916	0.0000000
zheyou73v0_A09	6595336	6596207	BnaA09T0107400ZY	0	+	0	0	871	0.0000000
zheyou73v0_A09	6598854	6600472	BnaA09T0107500ZY	0	+	0	0	1618	0.0000000
zheyou73v0_A09	6598854	6600472	BnaA09T0107500ZY.1	0	+	0	0	1618	0.0000000
zheyou73v0_A09	6601626	6604422	BnaA09T0107600ZY	0	-	0	0	2796	0.0000000
zheyou73v0_A09	6603104	6604422	BnaA09T0107600ZY.1	0	-	0	0	1318	0.0000000
zheyou73v0_A09	6613206	6614030	BnaA09T0107700ZY	0	+	0	0	824	0.0000000
zheyou73v0_A09	6614277	6615152	BnaA09T0107800ZY	0	-	0	0	875	0.0000000
zheyou73v0_A09	6616384	6619330	BnaA09T0107900ZY	0	+	0	0	2946	0.0000000
zheyou73v0_A09	6617195	6619145	BnaA09T0107900ZY.1	0	+	0	0	1950	0.0000000
zheyou73v0_A09	6621786	6622742	BnaA09T0108000ZY	0	+	0	0	956	0.0000000
zheyou73v0_A09	6623154	6625311	BnaA09T0108100ZY	0	-	0	0	2157	0.0000000
zheyou73v0_A09	6623154	6625311	BnaA09T0108100ZY.1	0	-	0	0	2157	0.0000000
zheyou73v0_A09	6625901	6627474	BnaA09T0108200ZY	0	-	0	0	1573	0.0000000
zheyou73v0_A09	6628712	6629935	BnaA09T0108300ZY	0	+	0	0	1223	0.0000000
zheyou73v0_A09	6631059	6637390	BnaA09T0108400ZY	0	+	0	0	6331	0.0000000
zheyou73v0_A09	6631059	6637390	BnaA09T0108400ZY.1	0	+	0	0	6331	0.0000000
zheyou73v0_A09	6638258	6643873	BnaA09T0108500ZY	0	+	0	0	5615	0.0000000
zheyou73v0_A09	6645634	6648232	BnaA09T0108600ZY	0	-	0	0	2598	0.0000000
zheyou73v0_A09	6654473	6655734	BnaA09T0108700ZY	0	+	0	0	1261	0.0000000
zheyou73v0_A09	6657098	6659368	BnaA09T0108800ZY	0	-	0	0	2270	0.0000000
zheyou73v0_A09	6663350	6666674	BnaA09T0108900ZY	0	-	0	0	3324	0.0000000
zheyou73v0_A09	6663350	6666673	BnaA09T0108900ZY.1	0	-	0	0	3323	0.0000000
zheyou73v0_A09	6663350	6666673	BnaA09T0108900ZY.2	0	-	0	0	3323	0.0000000
zheyou73v0_A09	6667717	6670266	BnaA09T0109000ZY	0	-	0	0	2549	0.0000000
zheyou73v0_A09	6683365	6686818	BnaA09T0109100ZY	0	+	0	0	3453	0.0000000
zheyou73v0_A09	6688015	6689563	BnaA09T0109200ZY	0	+	0	0	1548	0.0000000
zheyou73v0_A09	6697323	6699749	BnaA09T0109300ZY	0	+	0	0	2426	0.0000000
zheyou73v0_A09	6701839	6704824	BnaA09T0109400ZY	0	+	0	0	2985	0.0000000
zheyou73v0_A09	6705609	6706656	BnaA09T0109500ZY	0	-	0	0	1047	0.0000000
zheyou73v0_A09	6719897	6720922	BnaA09T0109600ZY	0	-	0	0	1025	0.0000000
zheyou73v0_A09	6721509	6730061	BnaA09T0109700ZY	0	+	0	0	8552	0.0000000
zheyou73v0_A09	6739194	6741968	BnaA09T0109800ZY	0	+	0	0	2774	0.0000000
zheyou73v0_A09	6750533	6752557	BnaA09T0109900ZY	0	+	0	0	2024	0.0000000
zheyou73v0_A09	6753923	6757663	BnaA09T0110000ZY	0	-	0	0	3740	0.0000000
zheyou73v0_A09	6761661	6761838	BnaA09T0110100ZY	0	-	0	0	177	0.0000000
zheyou73v0_A09	6770566	6772560	BnaA09T0110200ZY	0	+	0	0	1994	0.0000000
zheyou73v0_A09	6773568	6779393	BnaA09T0110300ZY	0	-	0	0	5825	0.0000000
zheyou73v0_A09	6782134	6782963	BnaA09T0110400ZY	0	-	0	0	829	0.0000000
zheyou73v0_A09	6783361	6784142	BnaA09T0110500ZY.1	0	+	0	0	781	0.0000000
zheyou73v0_A09	6783361	6784142	BnaA09T0110500ZY.2	0	+	0	0	781	0.0000000
zheyou73v0_A09	6783361	6784142	BnaA09T0110500ZY.3	0	+	0	0	781	0.0000000
zheyou73v0_A09	6783382	6784142	BnaA09T0110500ZY	0	+	0	0	760	0.0000000
zheyou73v0_A09	6787144	6789107	BnaA09T0110600ZY	0	+	0	0	1963	0.0000000
zheyou73v0_A09	6790571	6792121	BnaA09T0110700ZY	0	+	0	0	1550	0.0000000
zheyou73v0_A09	6792823	6793163	BnaA09T0110800ZY	0	+	0	0	340	0.0000000
zheyou73v0_A09	6794306	6796905	BnaA09T0110900ZY	0	+	0	0	2599	0.0000000
zheyou73v0_A09	6805231	6806098	BnaA09T0111000ZY	0	+	0	0	867	0.0000000
zheyou73v0_A09	6807389	6809494	BnaA09T0111100ZY	0	-	0	0	2105	0.0000000
zheyou73v0_A09	6812632	6816290	BnaA09T0111200ZY	0	-	0	0	3658	0.0000000
zheyou73v0_A09	6812632	6816290	BnaA09T0111200ZY.1	0	-	0	0	3658	0.0000000
zheyou73v0_A09	6820605	6820929	BnaA09T0111300ZY	0	+	0	0	324	0.0000000
zheyou73v0_A09	6860642	6862816	BnaA09T0111400ZY	0	+	0	0	2174	0.0000000
zheyou73v0_A09	6872879	6874969	BnaA09T0111500ZY	0	+	0	0	2090	0.0000000
zheyou73v0_A09	6877585	6878142	BnaA09T0111600ZY	0	+	0	0	557	0.0000000
zheyou73v0_A09	6878671	6880992	BnaA09T0111700ZY	0	-	0	0	2321	0.0000000
zheyou73v0_A09	6882164	6883755	BnaA09T0111800ZY	0	+	0	0	1591	0.0000000
zheyou73v0_A09	6882164	6883755	BnaA09T0111800ZY.1	0	+	0	0	1591	0.0000000
zheyou73v0_A09	6884443	6886049	BnaA09T0111900ZY	0	+	0	0	1606	0.0000000
zheyou73v0_A09	6895097	6895897	BnaA09T0112000ZY	0	-	0	0	800	0.0000000
zheyou73v0_A09	6896394	6897177	BnaA09T0112100ZY	0	-	0	0	783	0.0000000
zheyou73v0_A09	6914403	6930619	BnaA09T0112200ZY	0	-	0	0	16216	0.0000000
zheyou73v0_A09	6939197	6941248	BnaA09T0112300ZY	0	-	0	0	2051	0.0000000
zheyou73v0_A09	6952063	6952452	BnaA09T0112400ZY	0	+	0	0	389	0.0000000
zheyou73v0_A09	6953178	6953468	BnaA09T0112500ZY	0	+	0	0	290	0.0000000
zheyou73v0_A09	6958590	6959250	BnaA09T0112600ZY	0	+	0	0	660	0.0000000
zheyou73v0_A09	6960563	6963332	BnaA09T0112700ZY	0	+	0	0	2769	0.0000000
zheyou73v0_A09	6963730	6965397	BnaA09T0112800ZY	0	+	0	0	1667	0.0000000
zheyou73v0_A09	6966651	6967379	BnaA09T0112900ZY	0	+	0	0	728	0.0000000
zheyou73v0_A09	6968540	6970844	BnaA09T0113000ZY	0	+	0	0	2304	0.0000000
zheyou73v0_A09	6972998	6980314	BnaA09T0113100ZY	0	+	0	0	7316	0.0000000
zheyou73v0_A09	6972998	6980130	BnaA09T0113100ZY.1	0	+	0	0	7132	0.0000000
zheyou73v0_A09	6983710	6985683	BnaA09T0113200ZY	0	-	0	0	1973	0.0000000
zheyou73v0_A09	6989228	6989920	BnaA09T0113300ZY	0	-	0	0	692	0.0000000
zheyou73v0_A09	7004355	7006275	BnaA09T0113400ZY	0	-	0	0	1920	0.0000000
zheyou73v0_A09	7007231	7008808	BnaA09T0113500ZY	0	-	0	0	1577	0.0000000
zheyou73v0_A09	7015645	7023328	BnaA09T0113600ZY	0	+	0	0	7683	0.0000000
zheyou73v0_A09	7024291	7026440	BnaA09T0113700ZY	0	-	0	0	2149	0.0000000
zheyou73v0_A09	7024291	7026440	BnaA09T0113700ZY.1	0	-	0	0	2149	0.0000000
zheyou73v0_A09	7024291	7026440	BnaA09T0113700ZY.2	0	-	0	0	2149	0.0000000
zheyou73v0_A09	7024291	7026440	BnaA09T0113700ZY.3	0	-	0	0	2149	0.0000000
zheyou73v0_A09	7024291	7026110	BnaA09T0113700ZY.4	0	-	0	0	1819	0.0000000
zheyou73v0_A09	7024291	7026440	BnaA09T0113700ZY.5	0	-	0	0	2149	0.0000000
zheyou73v0_A09	7029251	7031075	BnaA09T0113800ZY	0	+	0	0	1824	0.0000000
zheyou73v0_A09	7031533	7032345	BnaA09T0113900ZY	0	+	0	0	812	0.0000000
zheyou73v0_A09	7058470	7060653	BnaA09T0114000ZY	0	+	0	0	2183	0.0000000
zheyou73v0_A09	7058470	7060653	BnaA09T0114000ZY.1	0	+	0	0	2183	0.0000000
zheyou73v0_A09	7065599	7065917	BnaA09T0114100ZY	0	-	0	0	318	0.0000000
zheyou73v0_A09	7066083	7066476	BnaA09T0114200ZY	0	-	0	0	393	0.0000000
zheyou73v0_A09	7066480	7067344	BnaA09T0114300ZY	0	-	0	0	864	0.0000000
zheyou73v0_A09	7069798	7075272	BnaA09T0114400ZY	0	+	0	0	5474	0.0000000
zheyou73v0_A09	7077238	7078036	BnaA09T0114500ZY	0	-	0	0	798	0.0000000
zheyou73v0_A09	7085043	7085983	BnaA09T0114600ZY	0	-	0	0	940	0.0000000
zheyou73v0_A09	7096465	7097593	BnaA09T0114700ZY	0	+	0	0	1128	0.0000000
zheyou73v0_A09	7103816	7104307	BnaA09T0114800ZY	0	-	0	0	491	0.0000000
zheyou73v0_A09	7104361	7105372	BnaA09T0114900ZY	0	-	0	0	1011	0.0000000
zheyou73v0_A09	7124176	7125753	BnaA09T0115000ZY	0	-	0	0	1577	0.0000000
zheyou73v0_A09	7128868	7131902	BnaA09T0115100ZY	0	-	0	0	3034	0.0000000
zheyou73v0_A09	7128868	7131729	BnaA09T0115100ZY.1	0	-	0	0	2861	0.0000000
zheyou73v0_A09	7140781	7143597	BnaA09T0115200ZY	0	+	0	0	2816	0.0000000
zheyou73v0_A09	7143704	7145619	BnaA09T0115300ZY	0	-	0	0	1915	0.0000000
zheyou73v0_A09	7152510	7154694	BnaA09T0115400ZY	0	-	0	0	2184	0.0000000
zheyou73v0_A09	7155267	7156823	BnaA09T0115500ZY	0	-	0	0	1556	0.0000000
zheyou73v0_A09	7158228	7162000	BnaA09T0115600ZY	0	-	0	0	3772	0.0000000
zheyou73v0_A09	7158228	7162000	BnaA09T0115600ZY.1	0	-	0	0	3772	0.0000000
zheyou73v0_A09	7158228	7162000	BnaA09T0115600ZY.2	0	-	0	0	3772	0.0000000
zheyou73v0_A09	7167416	7169257	BnaA09T0115700ZY	0	-	0	0	1841	0.0000000
zheyou73v0_A09	7167416	7169257	BnaA09T0115700ZY.1	0	-	0	0	1841	0.0000000
zheyou73v0_A09	7178994	7180351	BnaA09T0115800ZY	0	+	0	0	1357	0.0000000
zheyou73v0_A09	7181795	7182663	BnaA09T0115900ZY	0	-	0	0	868	0.0000000
zheyou73v0_A09	7186244	7188117	BnaA09T0116000ZY	0	+	0	0	1873	0.0000000
zheyou73v0_A09	7189247	7190360	BnaA09T0116100ZY	0	-	0	0	1113	0.0000000
zheyou73v0_A09	7192280	7193504	BnaA09T0116200ZY	0	-	0	0	1224	0.0000000
zheyou73v0_A09	7199108	7200216	BnaA09T0116300ZY	0	+	0	0	1108	0.0000000
zheyou73v0_A09	7226619	7230765	BnaA09T0116400ZY	0	+	0	0	4146	0.0000000
zheyou73v0_A09	7226619	7230765	BnaA09T0116400ZY.1	0	+	0	0	4146	0.0000000
zheyou73v0_A09	7232421	7235114	BnaA09T0116500ZY	0	+	0	0	2693	0.0000000
zheyou73v0_A09	7239382	7239903	BnaA09T0116600ZY	0	-	0	0	521	0.0000000
zheyou73v0_A09	7242152	7245835	BnaA09T0116700ZY	0	+	0	0	3683	0.0000000
zheyou73v0_A09	7246593	7248422	BnaA09T0116800ZY	0	-	0	0	1829	0.0000000
zheyou73v0_A09	7252370	7255123	BnaA09T0116900ZY	0	+	0	0	2753	0.0000000
zheyou73v0_A09	7262239	7264857	BnaA09T0117000ZY	0	+	0	0	2618	0.0000000
zheyou73v0_A09	7272712	7274047	BnaA09T0117100ZY	0	-	0	0	1335	0.0000000
zheyou73v0_A09	7296612	7297235	BnaA09T0117200ZY	0	-	0	0	623	0.0000000
zheyou73v0_A09	7310636	7316230	BnaA09T0117300ZY	0	+	0	0	5594	0.0000000
zheyou73v0_A09	7319313	7320110	BnaA09T0117400ZY	0	-	0	0	797	0.0000000
zheyou73v0_A09	7328504	7329173	BnaA09T0117500ZY	0	+	0	0	669	0.0000000
zheyou73v0_A09	7333498	7337641	BnaA09T0117600ZY	0	+	0	0	4143	0.0000000
zheyou73v0_A09	7344507	7346570	BnaA09T0117700ZY	0	-	0	0	2063	0.0000000
zheyou73v0_A09	7347979	7349732	BnaA09T0117800ZY	0	+	0	0	1753	0.0000000
zheyou73v0_A09	7349859	7352535	BnaA09T0117900ZY	0	-	0	0	2676	0.0000000
zheyou73v0_A09	7357636	7360460	BnaA09T0118000ZY	0	+	0	0	2824	0.0000000
zheyou73v0_A09	7361684	7363440	BnaA09T0118100ZY	0	+	0	0	1756	0.0000000
zheyou73v0_A09	7363994	7364548	BnaA09T0118200ZY	0	-	0	0	554	0.0000000
zheyou73v0_A09	7368770	7371843	BnaA09T0118300ZY	0	+	0	0	3073	0.0000000
zheyou73v0_A09	7372331	7376586	BnaA09T0118400ZY	0	-	0	0	4255	0.0000000
zheyou73v0_A09	7372331	7376069	BnaA09T0118400ZY.1	0	-	0	0	3738	0.0000000
zheyou73v0_A09	7387709	7388451	BnaA09T0118500ZY	0	+	0	0	742	0.0000000
zheyou73v0_A09	7390580	7394522	BnaA09T0118600ZY	0	+	0	0	3942	0.0000000
zheyou73v0_A09	7390580	7393752	BnaA09T0118600ZY.1	0	+	0	0	3172	0.0000000
zheyou73v0_A09	7397396	7398323	BnaA09T0118700ZY	0	+	0	0	927	0.0000000
zheyou73v0_A09	7398970	7400712	BnaA09T0118800ZY	0	+	0	0	1742	0.0000000
zheyou73v0_A09	7402056	7405405	BnaA09T0118900ZY	0	-	0	0	3349	0.0000000
zheyou73v0_A09	7402056	7405405	BnaA09T0118900ZY.1	0	-	0	0	3349	0.0000000
zheyou73v0_A09	7402056	7405405	BnaA09T0118900ZY.2	0	-	0	0	3349	0.0000000
zheyou73v0_A09	7412674	7415865	BnaA09T0119000ZY	0	+	0	0	3191	0.0000000
zheyou73v0_A09	7416298	7418745	BnaA09T0119100ZY	0	-	0	0	2447	0.0000000
zheyou73v0_A09	7421355	7423722	BnaA09T0119200ZY	0	+	0	0	2367	0.0000000
zheyou73v0_A09	7424219	7428117	BnaA09T0119300ZY	0	-	0	0	3898	0.0000000
zheyou73v0_A09	7463567	7465332	BnaA09T0119400ZY	0	+	0	0	1765	0.0000000
zheyou73v0_A09	7465956	7469249	BnaA09T0119500ZY	0	+	0	0	3293	0.0000000
zheyou73v0_A09	7469735	7472401	BnaA09T0119600ZY	0	+	0	0	2666	0.0000000
zheyou73v0_A09	7477502	7478855	BnaA09T0119700ZY	0	+	0	0	1353	0.0000000
zheyou73v0_A09	7477502	7478855	BnaA09T0119700ZY.1	0	+	0	0	1353	0.0000000
zheyou73v0_A09	7480061	7484731	BnaA09T0119800ZY	0	-	0	0	4670	0.0000000
zheyou73v0_A09	7487943	7489131	BnaA09T0119900ZY	0	-	0	0	1188	0.0000000
zheyou73v0_A09	7493084	7495551	BnaA09T0120000ZY	0	+	0	0	2467	0.0000000
zheyou73v0_A09	7496773	7498217	BnaA09T0120100ZY	0	+	0	0	1444	0.0000000
zheyou73v0_A09	7506257	7509768	BnaA09T0120200ZY	0	+	0	0	3511	0.0000000
zheyou73v0_A09	7506257	7509389	BnaA09T0120200ZY.1	0	+	0	0	3132	0.0000000
zheyou73v0_A09	7510117	7511078	BnaA09T0120300ZY	0	+	0	0	961	0.0000000
zheyou73v0_A09	7512208	7513199	BnaA09T0120400ZY	0	+	0	0	991	0.0000000
zheyou73v0_A09	7513307	7514815	BnaA09T0120500ZY	0	+	0	0	1508	0.0000000
zheyou73v0_A09	7516273	7517223	BnaA09T0120600ZY	0	-	0	0	950	0.0000000
zheyou73v0_A09	7520981	7522655	BnaA09T0120700ZY	0	-	0	0	1674	0.0000000
zheyou73v0_A09	7529359	7530710	BnaA09T0120800ZY	0	-	0	0	1351	0.0000000
zheyou73v0_A09	7533619	7536696	BnaA09T0120900ZY	0	-	0	0	3077	0.0000000
zheyou73v0_A09	7533619	7536696	BnaA09T0120900ZY.1	0	-	0	0	3077	0.0000000
zheyou73v0_A09	7538200	7538988	BnaA09T0121000ZY	0	+	0	0	788	0.0000000
zheyou73v0_A09	7539870	7542502	BnaA09T0121100ZY	0	-	0	0	2632	0.0000000
zheyou73v0_A09	7571727	7571958	BnaA09T0121200ZY	0	-	0	0	231	0.0000000
zheyou73v0_A09	7572977	7573669	BnaA09T0121300ZY	0	+	0	0	692	0.0000000
zheyou73v0_A09	7583017	7586059	BnaA09T0121400ZY	0	+	0	0	3042	0.0000000
zheyou73v0_A09	7586538	7591551	BnaA09T0121500ZY	0	-	0	0	5013	0.0000000
zheyou73v0_A09	7592283	7592805	BnaA09T0121600ZY	0	-	0	0	522	0.0000000
zheyou73v0_A09	7600737	7602665	BnaA09T0121700ZY	0	-	0	0	1928	0.0000000
zheyou73v0_A09	7610533	7615792	BnaA09T0121800ZY	0	+	0	0	5259	0.0000000
zheyou73v0_A09	7621831	7629142	BnaA09T0121900ZY	0	-	0	0	7311	0.0000000
zheyou73v0_A09	7631138	7631735	BnaA09T0122000ZY	0	+	0	0	597	0.0000000
zheyou73v0_A09	7633553	7636189	BnaA09T0122100ZY	0	-	0	0	2636	0.0000000
zheyou73v0_A09	7633553	7636189	BnaA09T0122100ZY.1	0	-	0	0	2636	0.0000000
zheyou73v0_A09	7633553	7636189	BnaA09T0122100ZY.2	0	-	0	0	2636	0.0000000
zheyou73v0_A09	7637202	7639588	BnaA09T0122200ZY	0	-	0	0	2386	0.0000000
zheyou73v0_A09	7640352	7641628	BnaA09T0122300ZY	0	-	0	0	1276	0.0000000
zheyou73v0_A09	7651650	7655226	BnaA09T0122400ZY.1	0	-	0	0	3576	0.0000000
zheyou73v0_A09	7651902	7655499	BnaA09T0122400ZY	0	-	0	0	3597	0.0000000
zheyou73v0_A09	7655953	7657306	BnaA09T0122500ZY	0	-	0	0	1353	0.0000000
zheyou73v0_A09	7659885	7664768	BnaA09T0122600ZY	0	+	0	0	4883	0.0000000
zheyou73v0_A09	7671253	7674425	BnaA09T0122700ZY	0	+	0	0	3172	0.0000000
zheyou73v0_A09	7690001	7692806	BnaA09T0122800ZY	0	+	0	0	2805	0.0000000
zheyou73v0_A09	7698439	7704183	BnaA09T0122900ZY	0	+	0	0	5744	0.0000000
zheyou73v0_A09	7706096	7709202	BnaA09T0123000ZY	0	+	0	0	3106	0.0000000
zheyou73v0_A09	7709486	7710192	BnaA09T0123100ZY	0	+	0	0	706	0.0000000
zheyou73v0_A09	7713143	7715319	BnaA09T0123200ZY	0	+	0	0	2176	0.0000000
zheyou73v0_A09	7717174	7719373	BnaA09T0123300ZY	0	+	0	0	2199	0.0000000
zheyou73v0_A09	7719704	7721011	BnaA09T0123400ZY	0	-	0	0	1307	0.0000000
zheyou73v0_A09	7728387	7730967	BnaA09T0123500ZY	0	-	0	0	2580	0.0000000
zheyou73v0_A09	7733793	7734639	BnaA09T0123600ZY	0	+	0	0	846	0.0000000
zheyou73v0_A09	7737115	7739564	BnaA09T0123700ZY	0	-	0	0	2449	0.0000000
zheyou73v0_A09	7741423	7743113	BnaA09T0123800ZY	0	+	0	0	1690	0.0000000
zheyou73v0_A09	7743220	7746117	BnaA09T0123900ZY	0	-	0	0	2897	0.0000000
zheyou73v0_A09	7747692	7754409	BnaA09T0124000ZY	0	+	0	0	6717	0.0000000
zheyou73v0_A09	7755988	7757540	BnaA09T0124100ZY	0	-	0	0	1552	0.0000000
zheyou73v0_A09	7759089	7759981	BnaA09T0124200ZY	0	-	0	0	892	0.0000000
zheyou73v0_A09	7760200	7761635	BnaA09T0124300ZY	0	-	0	0	1435	0.0000000
zheyou73v0_A09	7764356	7766034	BnaA09T0124400ZY	0	+	0	0	1678	0.0000000
zheyou73v0_A09	7764356	7766034	BnaA09T0124400ZY.1	0	+	0	0	1678	0.0000000
zheyou73v0_A09	7772104	7773263	BnaA09T0124500ZY	0	-	0	0	1159	0.0000000
zheyou73v0_A09	7772104	7773263	BnaA09T0124500ZY.1	0	-	0	0	1159	0.0000000
zheyou73v0_A09	7774939	7775263	BnaA09T0124600ZY	0	-	0	0	324	0.0000000
zheyou73v0_A09	7783309	7786519	BnaA09T0124700ZY	0	-	0	0	3210	0.0000000
zheyou73v0_A09	7789186	7790129	BnaA09T0124800ZY	0	-	0	0	943	0.0000000
zheyou73v0_A09	7792388	7792994	BnaA09T0124900ZY	0	+	0	0	606	0.0000000
zheyou73v0_A09	7794867	7795116	BnaA09T0125000ZY	0	+	0	0	249	0.0000000
zheyou73v0_A09	7805877	7807413	BnaA09T0125100ZY	0	-	0	0	1536	0.0000000
zheyou73v0_A09	7823669	7825252	BnaA09T0125200ZY	0	+	0	0	1583	0.0000000
zheyou73v0_A09	7829435	7831090	BnaA09T0125300ZY	0	-	0	0	1655	0.0000000
zheyou73v0_A09	7831881	7833590	BnaA09T0125400ZY	0	-	0	0	1709	0.0000000
zheyou73v0_A09	7835737	7836320	BnaA09T0125500ZY	0	+	0	0	583	0.0000000
zheyou73v0_A09	7837032	7837538	BnaA09T0125600ZY	0	+	0	0	506	0.0000000
zheyou73v0_A09	7839582	7840998	BnaA09T0125700ZY	0	-	0	0	1416	0.0000000
zheyou73v0_A09	7845598	7847826	BnaA09T0125800ZY	0	-	0	0	2228	0.0000000
zheyou73v0_A09	7860909	7863683	BnaA09T0125900ZY	0	+	0	0	2774	0.0000000
zheyou73v0_A09	7864352	7866152	BnaA09T0126000ZY	0	-	0	0	1800	0.0000000
zheyou73v0_A09	7867382	7869069	BnaA09T0126100ZY	0	+	0	0	1687	0.0000000
zheyou73v0_A09	7869966	7870380	BnaA09T0126200ZY	0	+	0	0	414	0.0000000
zheyou73v0_A09	7877320	7882145	BnaA09T0126300ZY	0	+	0	0	4825	0.0000000
zheyou73v0_A09	7884327	7884543	BnaA09T0126400ZY	0	-	0	0	216	0.0000000
zheyou73v0_A09	7889019	7898808	BnaA09T0126500ZY	0	+	0	0	9789	0.0000000
zheyou73v0_A09	7904050	7906151	BnaA09T0126600ZY	0	-	0	0	2101	0.0000000
zheyou73v0_A09	7909402	7912249	BnaA09T0126700ZY	0	-	0	0	2847	0.0000000
zheyou73v0_A09	7913129	7914760	BnaA09T0126800ZY	0	+	0	0	1631	0.0000000
zheyou73v0_A09	7915893	7918484	BnaA09T0126900ZY	0	+	0	0	2591	0.0000000
zheyou73v0_A09	7921798	7922162	BnaA09T0127000ZY	0	-	0	0	364	0.0000000
zheyou73v0_A09	7924808	7928832	BnaA09T0127100ZY	0	-	0	0	4024	0.0000000
zheyou73v0_A09	7924808	7928832	BnaA09T0127100ZY.1	0	-	0	0	4024	0.0000000
zheyou73v0_A09	7924808	7928832	BnaA09T0127100ZY.2	0	-	0	0	4024	0.0000000
zheyou73v0_A09	7934453	7938526	BnaA09T0127200ZY	0	+	0	0	4073	0.0000000
zheyou73v0_A09	7934453	7938526	BnaA09T0127200ZY.1	0	+	0	0	4073	0.0000000
zheyou73v0_A09	7934453	7938526	BnaA09T0127200ZY.2	0	+	0	0	4073	0.0000000
zheyou73v0_A09	7938749	7941931	BnaA09T0127300ZY	0	+	0	0	3182	0.0000000
zheyou73v0_A09	7942875	7944023	BnaA09T0127400ZY	0	+	0	0	1148	0.0000000
zheyou73v0_A09	7944329	7944626	BnaA09T0127500ZY	0	-	0	0	297	0.0000000
zheyou73v0_A09	7944723	7945740	BnaA09T0127600ZY	0	-	0	0	1017	0.0000000
zheyou73v0_A09	7955203	7959770	BnaA09T0127700ZY	0	+	0	0	4567	0.0000000
zheyou73v0_A09	7955203	7958395	BnaA09T0127700ZY.1	0	+	0	0	3192	0.0000000
zheyou73v0_A09	7966426	7968079	BnaA09T0127800ZY	0	+	0	0	1653	0.0000000
zheyou73v0_A09	7969063	7970700	BnaA09T0127900ZY	0	+	0	0	1637	0.0000000
zheyou73v0_A09	7971340	7972532	BnaA09T0128000ZY	0	+	0	0	1192	0.0000000
zheyou73v0_A09	7982112	7985483	BnaA09T0128100ZY	0	+	0	0	3371	0.0000000
zheyou73v0_A09	7986966	7991685	BnaA09T0128200ZY	0	-	0	0	4719	0.0000000
zheyou73v0_A09	7995541	7995808	BnaA09T0128300ZY	0	-	0	0	267	0.0000000
zheyou73v0_A09	8000241	8007275	BnaA09T0128400ZY	0	-	0	0	7034	0.0000000
zheyou73v0_A09	8017560	8018118	BnaA09T0128500ZY	0	-	0	0	558	0.0000000
zheyou73v0_A09	8020502	8021763	BnaA09T0128600ZY	0	-	0	0	1261	0.0000000
zheyou73v0_A09	8030190	8030943	BnaA09T0128700ZY	0	+	0	0	753	0.0000000
zheyou73v0_A09	8032530	8061936	BnaA09T0128800ZY	0	+	0	0	29406	0.0000000
zheyou73v0_A09	8062516	8063981	BnaA09T0128900ZY	0	-	0	0	1465	0.0000000
zheyou73v0_A09	8075953	8077852	BnaA09T0129000ZY	0	-	0	0	1899	0.0000000
zheyou73v0_A09	8084789	8084999	BnaA09T0129100ZY	0	+	0	0	210	0.0000000
zheyou73v0_A09	8093688	8094920	BnaA09T0129200ZY	0	+	0	0	1232	0.0000000
zheyou73v0_A09	8098266	8099900	BnaA09T0129300ZY	0	-	0	0	1634	0.0000000
zheyou73v0_A09	8100330	8102228	BnaA09T0129400ZY	0	+	0	0	1898	0.0000000
zheyou73v0_A09	8100330	8102228	BnaA09T0129400ZY.1	0	+	0	0	1898	0.0000000
zheyou73v0_A09	8102233	8104458	BnaA09T0129500ZY	0	-	0	0	2225	0.0000000
zheyou73v0_A09	8105259	8106167	BnaA09T0129600ZY	0	-	0	0	908	0.0000000
zheyou73v0_A09	8108164	8109457	BnaA09T0129700ZY	0	+	0	0	1293	0.0000000
zheyou73v0_A09	8108164	8109457	BnaA09T0129700ZY.1	0	+	0	0	1293	0.0000000
zheyou73v0_A09	8110790	8111144	BnaA09T0129800ZY	0	+	0	0	354	0.0000000
zheyou73v0_A09	8116828	8119110	BnaA09T0129900ZY	0	-	0	0	2282	0.0000000
zheyou73v0_A09	8119611	8121569	BnaA09T0130000ZY	0	-	0	0	1958	0.0000000
zheyou73v0_A09	8127583	8129945	BnaA09T0130100ZY	0	-	0	0	2362	0.0000000
zheyou73v0_A09	8149170	8152958	BnaA09T0130200ZY	0	+	0	0	3788	0.0000000
zheyou73v0_A09	8160410	8163601	BnaA09T0130300ZY	0	+	0	0	3191	0.0000000
zheyou73v0_A09	8160410	8163601	BnaA09T0130300ZY.1	0	+	0	0	3191	0.0000000
zheyou73v0_A09	8172996	8173636	BnaA09T0130400ZY	0	-	0	0	640	0.0000000
zheyou73v0_A09	8178534	8182161	BnaA09T0130500ZY	0	+	0	0	3627	0.0000000
zheyou73v0_A09	8188835	8192169	BnaA09T0130600ZY	0	+	0	0	3334	0.0000000
zheyou73v0_A09	8188835	8192169	BnaA09T0130600ZY.1	0	+	0	0	3334	0.0000000
zheyou73v0_A09	8195106	8200294	BnaA09T0130700ZY	0	+	0	0	5188	0.0000000
zheyou73v0_A09	8200647	8202134	BnaA09T0130800ZY	0	+	0	0	1487	0.0000000
zheyou73v0_A09	8202550	8204568	BnaA09T0130900ZY	0	-	0	0	2018	0.0000000
zheyou73v0_A09	8208036	8215855	BnaA09T0131000ZY	0	-	0	0	7819	0.0000000
zheyou73v0_A09	8223104	8225788	BnaA09T0131100ZY	0	+	0	0	2684	0.0000000
zheyou73v0_A09	8227050	8228832	BnaA09T0131200ZY	0	+	0	0	1782	0.0000000
zheyou73v0_A09	8230825	8232814	BnaA09T0131300ZY	0	+	0	0	1989	0.0000000
zheyou73v0_A09	8237013	8238625	BnaA09T0131400ZY	0	-	0	0	1612	0.0000000
zheyou73v0_A09	8238500	8241161	BnaA09T0131500ZY	0	+	0	0	2661	0.0000000
zheyou73v0_A09	8241988	8243636	BnaA09T0131600ZY	0	+	0	0	1648	0.0000000
zheyou73v0_A09	8247893	8254635	BnaA09T0131700ZY	0	-	0	0	6742	0.0000000
zheyou73v0_A09	8262651	8265838	BnaA09T0131800ZY	0	+	0	0	3187	0.0000000
zheyou73v0_A09	8268510	8271044	BnaA09T0131900ZY	0	-	0	0	2534	0.0000000
zheyou73v0_A09	8281701	8284851	BnaA09T0132000ZY	0	+	0	0	3150	0.0000000
zheyou73v0_A09	8285262	8285661	BnaA09T0132100ZY	0	-	0	0	399	0.0000000
zheyou73v0_A09	8285734	8293323	BnaA09T0132200ZY	0	-	0	0	7589	0.0000000
zheyou73v0_A09	8293873	8295662	BnaA09T0132300ZY	0	+	0	0	1789	0.0000000
zheyou73v0_A09	8304573	8305987	BnaA09T0132400ZY	0	-	0	0	1414	0.0000000
zheyou73v0_A09	8306813	8308587	BnaA09T0132500ZY	0	-	0	0	1774	0.0000000
zheyou73v0_A09	8315421	8320903	BnaA09T0132600ZY	0	+	0	0	5482	0.0000000
zheyou73v0_A09	8322270	8324951	BnaA09T0132700ZY	0	-	0	0	2681	0.0000000
zheyou73v0_A09	8328050	8329169	BnaA09T0132800ZY	0	+	0	0	1119	0.0000000
zheyou73v0_A09	8328050	8329382	BnaA09T0132800ZY.1	0	+	0	0	1332	0.0000000
zheyou73v0_A09	8330920	8333127	BnaA09T0132900ZY	0	+	0	0	2207	0.0000000
zheyou73v0_A09	8335939	8336590	BnaA09T0133000ZY	0	-	0	0	651	0.0000000
zheyou73v0_A09	8345464	8347741	BnaA09T0133100ZY	0	-	0	0	2277	0.0000000
zheyou73v0_A09	8346019	8347741	BnaA09T0133100ZY.1	0	-	0	0	1722	0.0000000
zheyou73v0_A09	8348614	8350399	BnaA09T0133200ZY	0	-	0	0	1785	0.0000000
zheyou73v0_A09	8353528	8355805	BnaA09T0133300ZY	0	+	0	0	2277	0.0000000
zheyou73v0_A09	8359609	8361841	BnaA09T0133400ZY	0	-	0	0	2232	0.0000000
zheyou73v0_A09	8369789	8371238	BnaA09T0133500ZY	0	+	0	0	1449	0.0000000
zheyou73v0_A09	8372600	8375813	BnaA09T0133600ZY	0	+	0	0	3213	0.0000000
zheyou73v0_A09	8377699	8378721	BnaA09T0133700ZY	0	+	0	0	1022	0.0000000
zheyou73v0_A09	8379386	8380675	BnaA09T0133800ZY	0	-	0	0	1289	0.0000000
zheyou73v0_A09	8380984	8383186	BnaA09T0133900ZY	0	+	0	0	2202	0.0000000
zheyou73v0_A09	8383147	8385370	BnaA09T0134000ZY	0	-	0	0	2223	0.0000000
zheyou73v0_A09	8392456	8396259	BnaA09T0134100ZY	0	-	0	0	3803	0.0000000
zheyou73v0_A09	8396705	8398578	BnaA09T0134200ZY	0	-	0	0	1873	0.0000000
zheyou73v0_A09	8400989	8402523	BnaA09T0134300ZY	0	+	0	0	1534	0.0000000
zheyou73v0_A09	8403725	8406852	BnaA09T0134400ZY	0	-	0	0	3127	0.0000000
zheyou73v0_A09	8409970	8410377	BnaA09T0134500ZY	0	-	0	0	407	0.0000000
zheyou73v0_A09	8415323	8416146	BnaA09T0134600ZY	0	+	0	0	823	0.0000000
zheyou73v0_A09	8416492	8419777	BnaA09T0134700ZY	0	-	0	0	3285	0.0000000
zheyou73v0_A09	8423829	8426036	BnaA09T0134800ZY	0	+	0	0	2207	0.0000000
zheyou73v0_A09	8426341	8426955	BnaA09T0134900ZY	0	+	0	0	614	0.0000000
zheyou73v0_A09	8427103	8428652	BnaA09T0135000ZY	0	-	0	0	1549	0.0000000
zheyou73v0_A09	8430120	8431219	BnaA09T0135100ZY	0	+	0	0	1099	0.0000000
zheyou73v0_A09	8431278	8431780	BnaA09T0135200ZY	0	-	0	0	502	0.0000000
zheyou73v0_A09	8431978	8433212	BnaA09T0135300ZY	0	+	0	0	1234	0.0000000
zheyou73v0_A09	8433357	8433834	BnaA09T0135400ZY	0	+	0	0	477	0.0000000
zheyou73v0_A09	8433994	8434653	BnaA09T0135500ZY	0	+	0	0	659	0.0000000
zheyou73v0_A09	8435171	8435411	BnaA09T0135600ZY	0	-	0	0	240	0.0000000
zheyou73v0_A09	8436269	8438674	BnaA09T0135700ZY	0	-	0	0	2405	0.0000000
zheyou73v0_A09	8444673	8445441	BnaA09T0135800ZY	0	+	0	0	768	0.0000000
zheyou73v0_A09	8449346	8455996	BnaA09T0135900ZY	0	+	0	0	6650	0.0000000
zheyou73v0_A09	8456018	8458247	BnaA09T0136000ZY	0	+	0	0	2229	0.0000000
zheyou73v0_A09	8470863	8472052	BnaA09T0136100ZY	0	+	0	0	1189	0.0000000
zheyou73v0_A09	8476795	8477893	BnaA09T0136200ZY	0	-	0	0	1098	0.0000000
zheyou73v0_A09	8478294	8479447	BnaA09T0136300ZY	0	+	0	0	1153	0.0000000
zheyou73v0_A09	8488774	8489467	BnaA09T0136400ZY	0	+	0	0	693	0.0000000
zheyou73v0_A09	8495520	8496456	BnaA09T0136500ZY	0	-	0	0	936	0.0000000
zheyou73v0_A09	8522591	8523830	BnaA09T0136600ZY	0	+	0	0	1239	0.0000000
zheyou73v0_A09	8537797	8541851	BnaA09T0136700ZY	0	+	0	0	4054	0.0000000
zheyou73v0_A09	8542922	8547146	BnaA09T0136800ZY	0	-	0	0	4224	0.0000000
zheyou73v0_A09	8559301	8560010	BnaA09T0136900ZY	0	+	0	0	709	0.0000000
zheyou73v0_A09	8560593	8562276	BnaA09T0137000ZY	0	-	0	0	1683	0.0000000
zheyou73v0_A09	8570712	8573215	BnaA09T0137100ZY	0	-	0	0	2503	0.0000000
zheyou73v0_A09	8570712	8572647	BnaA09T0137100ZY.1	0	-	0	0	1935	0.0000000
zheyou73v0_A09	8576105	8577425	BnaA09T0137200ZY	0	-	0	0	1320	0.0000000
zheyou73v0_A09	8577610	8579200	BnaA09T0137300ZY	0	+	0	0	1590	0.0000000
zheyou73v0_A09	8585786	8587678	BnaA09T0137400ZY	0	+	0	0	1892	0.0000000
zheyou73v0_A09	8590477	8593947	BnaA09T0137500ZY	0	-	0	0	3470	0.0000000
zheyou73v0_A09	8596634	8599616	BnaA09T0137600ZY	0	-	0	0	2982	0.0000000
zheyou73v0_A09	8601371	8601840	BnaA09T0137700ZY	0	+	0	0	469	0.0000000
zheyou73v0_A09	8628158	8630814	BnaA09T0137800ZY	0	+	0	0	2656	0.0000000
zheyou73v0_A09	8632441	8635000	BnaA09T0137900ZY	0	-	0	0	2559	0.0000000
zheyou73v0_A09	8641489	8643841	BnaA09T0138000ZY	0	-	0	0	2352	0.0000000
zheyou73v0_A09	8652196	8654018	BnaA09T0138100ZY	0	-	0	0	1822	0.0000000
zheyou73v0_A09	8661616	8662682	BnaA09T0138200ZY	0	+	0	0	1066	0.0000000
zheyou73v0_A09	8667652	8670189	BnaA09T0138300ZY	0	-	0	0	2537	0.0000000
zheyou73v0_A09	8687606	8689131	BnaA09T0138400ZY	0	+	0	0	1525	0.0000000
zheyou73v0_A09	8693745	8694273	BnaA09T0138500ZY	0	+	0	0	528	0.0000000
zheyou73v0_A09	8694457	8695639	BnaA09T0138600ZY	0	+	0	0	1182	0.0000000
zheyou73v0_A09	8699290	8700271	BnaA09T0138700ZY	0	-	0	0	981	0.0000000
zheyou73v0_A09	8723008	8726379	BnaA09T0138800ZY	0	+	0	0	3371	0.0000000
zheyou73v0_A09	8726713	8732745	BnaA09T0138900ZY	0	-	0	0	6032	0.0000000
zheyou73v0_A09	8741114	8742843	BnaA09T0139000ZY	0	+	0	0	1729	0.0000000
zheyou73v0_A09	8743572	8744124	BnaA09T0139100ZY	0	-	0	0	552	0.0000000
zheyou73v0_A09	8744557	8749248	BnaA09T0139200ZY	0	-	0	0	4691	0.0000000
zheyou73v0_A09	8749714	8753996	BnaA09T0139300ZY	0	-	0	0	4282	0.0000000
zheyou73v0_A09	8757270	8757630	BnaA09T0139400ZY	0	+	0	0	360	0.0000000
zheyou73v0_A09	8760657	8763887	BnaA09T0139500ZY	0	-	0	0	3230	0.0000000
zheyou73v0_A09	8765422	8767016	BnaA09T0139600ZY	0	-	0	0	1594	0.0000000
zheyou73v0_A09	8767222	8768578	BnaA09T0139700ZY	0	+	0	0	1356	0.0000000
zheyou73v0_A09	8768665	8770076	BnaA09T0139800ZY	0	-	0	0	1411	0.0000000
zheyou73v0_A09	8770259	8771000	BnaA09T0139900ZY	0	-	0	0	741	0.0000000
zheyou73v0_A09	8774210	8775996	BnaA09T0140000ZY	0	+	0	0	1786	0.0000000
zheyou73v0_A09	8776331	8778088	BnaA09T0140100ZY	0	+	0	0	1757	0.0000000
zheyou73v0_A09	8778466	8781059	BnaA09T0140200ZY	0	-	0	0	2593	0.0000000
zheyou73v0_A09	8781194	8784454	BnaA09T0140300ZY	0	-	0	0	3260	0.0000000
zheyou73v0_A09	8781194	8784454	BnaA09T0140300ZY.1	0	-	0	0	3260	0.0000000
zheyou73v0_A09	8781194	8784454	BnaA09T0140300ZY.2	0	-	0	0	3260	0.0000000
zheyou73v0_A09	8784860	8785378	BnaA09T0140400ZY	0	-	0	0	518	0.0000000
zheyou73v0_A09	8789348	8793349	BnaA09T0140500ZY	0	-	0	0	4001	0.0000000
zheyou73v0_A09	8836655	8837612	BnaA09T0140600ZY	0	+	0	0	957	0.0000000
zheyou73v0_A09	8838808	8839498	BnaA09T0140700ZY	0	-	0	0	690	0.0000000
zheyou73v0_A09	8840763	8842823	BnaA09T0140800ZY	0	-	0	0	2060	0.0000000
zheyou73v0_A09	8847099	8848298	BnaA09T0140900ZY	0	+	0	0	1199	0.0000000
zheyou73v0_A09	8853898	8855543	BnaA09T0141000ZY	0	-	0	0	1645	0.0000000
zheyou73v0_A09	8859886	8862306	BnaA09T0141100ZY	0	-	0	0	2420	0.0000000
zheyou73v0_A09	8871460	8872678	BnaA09T0141200ZY	0	+	0	0	1218	0.0000000
zheyou73v0_A09	8873140	8874805	BnaA09T0141300ZY	0	-	0	0	1665	0.0000000
zheyou73v0_A09	8875291	8877529	BnaA09T0141400ZY	0	-	0	0	2238	0.0000000
zheyou73v0_A09	8879163	8880288	BnaA09T0141500ZY	0	-	0	0	1125	0.0000000
zheyou73v0_A09	8886324	8886927	BnaA09T0141600ZY	0	+	0	0	603	0.0000000
zheyou73v0_A09	8888410	8888666	BnaA09T0141700ZY	0	+	0	0	256	0.0000000
zheyou73v0_A09	8890733	8893109	BnaA09T0141800ZY	0	-	0	0	2376	0.0000000
zheyou73v0_A09	8897210	8898229	BnaA09T0141900ZY	0	-	0	0	1019	0.0000000
zheyou73v0_A09	8898458	8898830	BnaA09T0142000ZY	0	+	0	0	372	0.0000000
zheyou73v0_A09	8898902	8900752	BnaA09T0142100ZY	0	-	0	0	1850	0.0000000
zheyou73v0_A09	8902219	8903995	BnaA09T0142200ZY	0	+	0	0	1776	0.0000000
zheyou73v0_A09	8905274	8908467	BnaA09T0142300ZY	0	+	0	0	3193	0.0000000
zheyou73v0_A09	8909461	8911608	BnaA09T0142400ZY	0	-	0	0	2147	0.0000000
zheyou73v0_A09	8911876	8915246	BnaA09T0142500ZY	0	+	0	0	3370	0.0000000
zheyou73v0_A09	8918004	8921266	BnaA09T0142600ZY	0	+	0	0	3262	0.0000000
zheyou73v0_A09	8924017	8928555	BnaA09T0142700ZY	0	+	0	0	4538	0.0000000
zheyou73v0_A09	8932221	8932587	BnaA09T0142800ZY	0	-	0	0	366	0.0000000
zheyou73v0_A09	8937581	8938720	BnaA09T0142900ZY	0	-	0	0	1139	0.0000000
zheyou73v0_A09	8944227	8945361	BnaA09T0143000ZY	0	-	0	0	1134	0.0000000
zheyou73v0_A09	8956118	8957676	BnaA09T0143100ZY	0	+	0	0	1558	0.0000000
zheyou73v0_A09	8959945	8960646	BnaA09T0143200ZY	0	-	0	0	701	0.0000000
zheyou73v0_A09	8961169	8994304	BnaA09T0143300ZY	0	-	0	0	33135	0.0000000
zheyou73v0_A09	8994838	8995113	BnaA09T0143400ZY	0	+	0	0	275	0.0000000
zheyou73v0_A09	8995892	8999437	BnaA09T0143500ZY	0	+	0	0	3545	0.0000000
zheyou73v0_A09	8999867	9002969	BnaA09T0143600ZY	0	+	0	0	3102	0.0000000
zheyou73v0_A09	9009553	9015912	BnaA09T0143700ZY	0	-	0	0	6359	0.0000000
zheyou73v0_A09	9022481	9025302	BnaA09T0143800ZY	0	-	0	0	2821	0.0000000
zheyou73v0_A09	9026215	9027006	BnaA09T0143900ZY	0	+	0	0	791	0.0000000
zheyou73v0_A09	9030153	9031393	BnaA09T0144000ZY	0	+	0	0	1240	0.0000000
zheyou73v0_A09	9042899	9044365	BnaA09T0144100ZY	0	+	0	0	1466	0.0000000
zheyou73v0_A09	9050262	9052781	BnaA09T0144200ZY	0	-	0	0	2519	0.0000000
zheyou73v0_A09	9053056	9054440	BnaA09T0144300ZY	0	+	0	0	1384	0.0000000
zheyou73v0_A09	9069974	9072163	BnaA09T0144400ZY	0	+	0	0	2189	0.0000000
zheyou73v0_A09	9073497	9073885	BnaA09T0144500ZY	0	+	0	0	388	0.0000000
zheyou73v0_A09	9086036	9094017	BnaA09T0144600ZY	0	+	0	0	7981	0.0000000
zheyou73v0_A09	9096260	9099175	BnaA09T0144700ZY	0	+	0	0	2915	0.0000000
zheyou73v0_A09	9102945	9105104	BnaA09T0144800ZY	0	+	0	0	2159	0.0000000
zheyou73v0_A09	9105795	9109673	BnaA09T0144900ZY	0	+	0	0	3878	0.0000000
zheyou73v0_A09	9131186	9131723	BnaA09T0145000ZY	0	+	0	0	537	0.0000000
zheyou73v0_A09	9133346	9138842	BnaA09T0145100ZY	0	+	0	0	5496	0.0000000
zheyou73v0_A09	9141128	9144683	BnaA09T0145200ZY	0	+	0	0	3555	0.0000000
zheyou73v0_A09	9145839	9149551	BnaA09T0145300ZY	0	-	0	0	3712	0.0000000
zheyou73v0_A09	9151974	9153913	BnaA09T0145400ZY	0	-	0	0	1939	0.0000000
zheyou73v0_A09	9156451	9156751	BnaA09T0145500ZY	0	-	0	0	300	0.0000000
zheyou73v0_A09	9164742	9165249	BnaA09T0145600ZY	0	+	0	0	507	0.0000000
zheyou73v0_A09	9169843	9171069	BnaA09T0145700ZY	0	-	0	0	1226	0.0000000
zheyou73v0_A09	9171384	9172700	BnaA09T0145800ZY	0	-	0	0	1316	0.0000000
zheyou73v0_A09	9177972	9179489	BnaA09T0145900ZY	0	+	0	0	1517	0.0000000
zheyou73v0_A09	9194390	9197272	BnaA09T0146000ZY	0	+	0	0	2882	0.0000000
zheyou73v0_A09	9202585	9209469	BnaA09T0146100ZY	0	-	0	0	6884	0.0000000
zheyou73v0_A09	9229906	9233417	BnaA09T0146200ZY	0	+	0	0	3511	0.0000000
zheyou73v0_A09	9234233	9237772	BnaA09T0146300ZY	0	-	0	0	3539	0.0000000
zheyou73v0_A09	9245729	9248149	BnaA09T0146400ZY	0	+	0	0	2420	0.0000000
zheyou73v0_A09	9249419	9252039	BnaA09T0146500ZY	0	+	0	0	2620	0.0000000
zheyou73v0_A09	9255358	9259181	BnaA09T0146600ZY	0	-	0	0	3823	0.0000000
zheyou73v0_A09	9273992	9280254	BnaA09T0146700ZY	0	+	0	0	6262	0.0000000
zheyou73v0_A09	9280642	9281225	BnaA09T0146800ZY	0	+	0	0	583	0.0000000
zheyou73v0_A09	9281411	9282463	BnaA09T0146900ZY	0	-	0	0	1052	0.0000000
zheyou73v0_A09	9284795	9285210	BnaA09T0147000ZY	0	-	0	0	415	0.0000000
zheyou73v0_A09	9287197	9287615	BnaA09T0147100ZY	0	+	0	0	418	0.0000000
zheyou73v0_A09	9288973	9291625	BnaA09T0147200ZY	0	-	0	0	2652	0.0000000
zheyou73v0_A09	9310613	9312782	BnaA09T0147300ZY	0	+	0	0	2169	0.0000000
zheyou73v0_A09	9310613	9312782	BnaA09T0147300ZY.1	0	+	0	0	2169	0.0000000
zheyou73v0_A09	9313850	9315683	BnaA09T0147400ZY	0	-	0	0	1833	0.0000000
zheyou73v0_A09	9328195	9328831	BnaA09T0147500ZY	0	-	0	0	636	0.0000000
zheyou73v0_A09	9339489	9340743	BnaA09T0147600ZY	0	+	0	0	1254	0.0000000
zheyou73v0_A09	9344844	9345467	BnaA09T0147700ZY	0	+	0	0	623	0.0000000
zheyou73v0_A09	9346514	9347592	BnaA09T0147800ZY	0	+	0	0	1078	0.0000000
zheyou73v0_A09	9349061	9352120	BnaA09T0147900ZY	0	+	0	0	3059	0.0000000
zheyou73v0_A09	9353378	9357254	BnaA09T0148000ZY	0	+	0	0	3876	0.0000000
zheyou73v0_A09	9357617	9360390	BnaA09T0148100ZY	0	+	0	0	2773	0.0000000
zheyou73v0_A09	9357684	9360390	BnaA09T0148100ZY.1	0	+	0	0	2706	0.0000000
zheyou73v0_A09	9362779	9363293	BnaA09T0148200ZY	0	+	0	0	514	0.0000000
zheyou73v0_A09	9368159	9370265	BnaA09T0148300ZY	0	+	0	0	2106	0.0000000
zheyou73v0_A09	9370818	9372225	BnaA09T0148400ZY	0	-	0	0	1407	0.0000000
zheyou73v0_A09	9373531	9374450	BnaA09T0148500ZY	0	-	0	0	919	0.0000000
zheyou73v0_A09	9375979	9377346	BnaA09T0148600ZY	0	+	0	0	1367	0.0000000
zheyou73v0_A09	9386343	9387689	BnaA09T0148700ZY	0	+	0	0	1346	0.0000000
zheyou73v0_A09	9397993	9399248	BnaA09T0148800ZY	0	-	0	0	1255	0.0000000
zheyou73v0_A09	9399380	9400998	BnaA09T0148900ZY	0	-	0	0	1618	0.0000000
zheyou73v0_A09	9425328	9426983	BnaA09T0149000ZY	0	+	0	0	1655	0.0000000
zheyou73v0_A09	9428332	9431371	BnaA09T0149100ZY	0	-	0	0	3039	0.0000000
zheyou73v0_A09	9433460	9435556	BnaA09T0149200ZY	0	+	0	0	2096	0.0000000
zheyou73v0_A09	9442129	9444201	BnaA09T0149300ZY	0	+	0	0	2072	0.0000000
zheyou73v0_A09	9454309	9455760	BnaA09T0149400ZY	0	+	0	0	1451	0.0000000
zheyou73v0_A09	9458670	9461273	BnaA09T0149500ZY	0	+	0	0	2603	0.0000000
zheyou73v0_A09	9458670	9461273	BnaA09T0149500ZY.1	0	+	0	0	2603	0.0000000
zheyou73v0_A09	9479060	9479807	BnaA09T0149600ZY	0	-	0	0	747	0.0000000
zheyou73v0_A09	9481858	9482529	BnaA09T0149700ZY	0	+	0	0	671	0.0000000
zheyou73v0_A09	9487613	9491861	BnaA09T0149800ZY	0	+	0	0	4248	0.0000000
zheyou73v0_A09	9487937	9491861	BnaA09T0149800ZY.1	0	+	0	0	3924	0.0000000
zheyou73v0_A09	9513947	9515652	BnaA09T0149900ZY	0	-	0	0	1705	0.0000000
zheyou73v0_A09	9522830	9531911	BnaA09T0150000ZY	0	-	0	0	9081	0.0000000
zheyou73v0_A09	9535264	9537471	BnaA09T0150100ZY	0	+	0	0	2207	0.0000000
zheyou73v0_A09	9537533	9537997	BnaA09T0150200ZY	0	+	0	0	464	0.0000000
zheyou73v0_A09	9559315	9575656	BnaA09T0150300ZY	0	-	0	0	16341	0.0000000
zheyou73v0_A09	9575673	9577992	BnaA09T0150400ZY	0	-	0	0	2319	0.0000000
zheyou73v0_A09	9584721	9586850	BnaA09T0150500ZY	0	+	0	0	2129	0.0000000
zheyou73v0_A09	9586873	9593357	BnaA09T0150600ZY	0	+	0	0	6484	0.0000000
zheyou73v0_A09	9594621	9595784	BnaA09T0150700ZY	0	-	0	0	1163	0.0000000
zheyou73v0_A09	9608621	9610389	BnaA09T0150800ZY	0	+	0	0	1768	0.0000000
zheyou73v0_A09	9615993	9616979	BnaA09T0150900ZY	0	-	0	0	986	0.0000000
zheyou73v0_A09	9624655	9627489	BnaA09T0151000ZY	0	+	0	0	2834	0.0000000
zheyou73v0_A09	9642106	9644091	BnaA09T0151100ZY	0	+	0	0	1985	0.0000000
zheyou73v0_A09	9642106	9644091	BnaA09T0151100ZY.1	0	+	0	0	1985	0.0000000
zheyou73v0_A09	9644092	9646800	BnaA09T0151200ZY	0	+	0	0	2708	0.0000000
zheyou73v0_A09	9650438	9653622	BnaA09T0151300ZY	0	+	0	0	3184	0.0000000
zheyou73v0_A09	9656709	9658739	BnaA09T0151400ZY	0	-	0	0	2030	0.0000000
zheyou73v0_A09	9676578	9678484	BnaA09T0151500ZY	0	+	0	0	1906	0.0000000
zheyou73v0_A09	9676578	9678484	BnaA09T0151500ZY.1	0	+	0	0	1906	0.0000000
zheyou73v0_A09	9685398	9686439	BnaA09T0151600ZY	0	+	0	0	1041	0.0000000
zheyou73v0_A09	9690398	9691487	BnaA09T0151700ZY	0	+	0	0	1089	0.0000000
zheyou73v0_A09	9714976	9715591	BnaA09T0151800ZY	0	+	0	0	615	0.0000000
zheyou73v0_A09	9724485	9727638	BnaA09T0151900ZY	0	+	0	0	3153	0.0000000
zheyou73v0_A09	9727549	9730246	BnaA09T0152000ZY	0	-	0	0	2697	0.0000000
zheyou73v0_A09	9732297	9733869	BnaA09T0152100ZY	0	+	0	0	1572	0.0000000
zheyou73v0_A09	9754438	9756299	BnaA09T0152200ZY	0	+	0	0	1861	0.0000000
zheyou73v0_A09	9758758	9759883	BnaA09T0152300ZY	0	-	0	0	1125	0.0000000
zheyou73v0_A09	9783777	9786228	BnaA09T0152400ZY	0	+	0	0	2451	0.0000000
zheyou73v0_A09	9786319	9787659	BnaA09T0152500ZY	0	-	0	0	1340	0.0000000
zheyou73v0_A09	9805493	9806248	BnaA09T0152600ZY	0	+	0	0	755	0.0000000
zheyou73v0_A09	9813785	9815208	BnaA09T0152700ZY	0	-	0	0	1423	0.0000000
zheyou73v0_A09	9817850	9821699	BnaA09T0152800ZY	0	-	0	0	3849	0.0000000
zheyou73v0_A09	9827577	9829972	BnaA09T0152900ZY	0	-	0	0	2395	0.0000000
zheyou73v0_A09	9832511	9834024	BnaA09T0153000ZY	0	-	0	0	1513	0.0000000
zheyou73v0_A09	9843037	9846007	BnaA09T0153100ZY	0	+	0	0	2970	0.0000000
zheyou73v0_A09	9846306	9846876	BnaA09T0153200ZY	0	+	0	0	570	0.0000000
zheyou73v0_A09	9857561	9863483	BnaA09T0153300ZY	0	-	0	0	5922	0.0000000
zheyou73v0_A09	9857561	9863483	BnaA09T0153300ZY.1	0	-	0	0	5922	0.0000000
zheyou73v0_A09	9883558	9884391	BnaA09T0153400ZY	0	-	0	0	833	0.0000000
zheyou73v0_A09	9897542	9898206	BnaA09T0153500ZY	0	+	0	0	664	0.0000000
zheyou73v0_A09	9904210	9905603	BnaA09T0153600ZY	0	-	0	0	1393	0.0000000
zheyou73v0_A09	9908441	9909768	BnaA09T0153700ZY	0	+	0	0	1327	0.0000000
zheyou73v0_A09	9909658	9910935	BnaA09T0153800ZY	0	-	0	0	1277	0.0000000
zheyou73v0_A09	9933011	9935205	BnaA09T0153900ZY	0	+	0	0	2194	0.0000000
zheyou73v0_A09	9938776	9941239	BnaA09T0154000ZY	0	-	0	0	2463	0.0000000
zheyou73v0_A09	9958641	9962178	BnaA09T0154100ZY.1	0	+	0	0	3537	0.0000000
zheyou73v0_A09	9958641	9962178	BnaA09T0154100ZY.2	0	+	0	0	3537	0.0000000
zheyou73v0_A09	9958792	9962178	BnaA09T0154100ZY	0	+	0	0	3386	0.0000000
zheyou73v0_A09	9972305	9974482	BnaA09T0154200ZY	0	-	0	0	2177	0.0000000
zheyou73v0_A09	9984268	9986116	BnaA09T0154300ZY	0	-	0	0	1848	0.0000000
zheyou73v0_A09	9984268	9986116	BnaA09T0154300ZY.1	0	-	0	0	1848	0.0000000
zheyou73v0_A09	10028081	10028420	BnaA09T0154400ZY	0	+	0	0	339	0.0000000
zheyou73v0_A09	10052316	10055198	BnaA09T0154500ZY	0	+	0	0	2882	0.0000000
zheyou73v0_A09	10060630	10063705	BnaA09T0154600ZY	0	-	0	0	3075	0.0000000
zheyou73v0_A09	10077322	10081321	BnaA09T0154700ZY	0	+	0	0	3999	0.0000000
zheyou73v0_A09	10094925	10099664	BnaA09T0154800ZY	0	+	0	0	4739	0.0000000
zheyou73v0_A09	10102374	10103590	BnaA09T0154900ZY	0	-	0	0	1216	0.0000000
zheyou73v0_A09	10119355	10123955	BnaA09T0155000ZY	0	+	0	0	4600	0.0000000
zheyou73v0_A09	10127182	10137959	BnaA09T0155100ZY	0	+	0	0	10777	0.0000000
zheyou73v0_A09	10163008	10165382	BnaA09T0155200ZY	0	+	0	0	2374	0.0000000
zheyou73v0_A09	10176643	10178048	BnaA09T0155300ZY	0	+	0	0	1405	0.0000000
zheyou73v0_A09	10179780	10185855	BnaA09T0155400ZY	0	+	0	0	6075	0.0000000
zheyou73v0_A09	10179780	10185855	BnaA09T0155400ZY.1	0	+	0	0	6075	0.0000000
zheyou73v0_A09	10186847	10187282	BnaA09T0155500ZY	0	+	0	0	435	0.0000000
zheyou73v0_A09	10192773	10194877	BnaA09T0155600ZY	0	+	0	0	2104	0.0000000
zheyou73v0_A09	10195570	10196011	BnaA09T0155700ZY	0	+	0	0	441	0.0000000
zheyou73v0_A09	10198467	10198914	BnaA09T0155800ZY	0	+	0	0	447	0.0000000
zheyou73v0_A09	10203027	10205482	BnaA09T0155900ZY	0	-	0	0	2455	0.0000000
zheyou73v0_A09	10208126	10209230	BnaA09T0156000ZY	0	+	0	0	1104	0.0000000
zheyou73v0_A09	10222485	10229243	BnaA09T0156100ZY	0	+	0	0	6758	0.0000000
zheyou73v0_A09	10236793	10237317	BnaA09T0156200ZY	0	+	0	0	524	0.0000000
zheyou73v0_A09	10237552	10239218	BnaA09T0156300ZY	0	-	0	0	1666	0.0000000
zheyou73v0_A09	10240144	10241451	BnaA09T0156400ZY	0	-	0	0	1307	0.0000000
zheyou73v0_A09	10242704	10244163	BnaA09T0156500ZY	0	-	0	0	1459	0.0000000
zheyou73v0_A09	10244951	10246565	BnaA09T0156600ZY	0	-	0	0	1614	0.0000000
zheyou73v0_A09	10258501	10259401	BnaA09T0156700ZY	0	-	0	0	900	0.0000000
zheyou73v0_A09	10266703	10269404	BnaA09T0156800ZY	0	+	0	0	2701	0.0000000
zheyou73v0_A09	10266703	10269404	BnaA09T0156800ZY.1	0	+	0	0	2701	0.0000000
zheyou73v0_A09	10287986	10292087	BnaA09T0156900ZY	0	+	0	0	4101	0.0000000
zheyou73v0_A09	10298241	10304882	BnaA09T0157000ZY	0	-	0	0	6641	0.0000000
zheyou73v0_A09	10311764	10312944	BnaA09T0157100ZY	0	-	0	0	1180	0.0000000
zheyou73v0_A09	10318185	10319754	BnaA09T0157200ZY	0	+	0	0	1569	0.0000000
zheyou73v0_A09	10326958	10330780	BnaA09T0157300ZY	0	+	0	0	3822	0.0000000
zheyou73v0_A09	10326958	10330780	BnaA09T0157300ZY.1	0	+	0	0	3822	0.0000000
zheyou73v0_A09	10326958	10330780	BnaA09T0157300ZY.2	0	+	0	0	3822	0.0000000
zheyou73v0_A09	10326958	10330780	BnaA09T0157300ZY.3	0	+	0	0	3822	0.0000000
zheyou73v0_A09	10334317	10335773	BnaA09T0157400ZY	0	+	0	0	1456	0.0000000
zheyou73v0_A09	10342049	10342734	BnaA09T0157500ZY	0	+	0	0	685	0.0000000
zheyou73v0_A09	10342871	10344361	BnaA09T0157600ZY	0	+	0	0	1490	0.0000000
zheyou73v0_A09	10360334	10362608	BnaA09T0157700ZY.1	0	+	0	0	2274	0.0000000
zheyou73v0_A09	10360334	10362608	BnaA09T0157700ZY.2	0	+	0	0	2274	0.0000000
zheyou73v0_A09	10360337	10362608	BnaA09T0157700ZY	0	+	0	0	2271	0.0000000
zheyou73v0_A09	10369880	10371588	BnaA09T0157800ZY	0	+	0	0	1708	0.0000000
zheyou73v0_A09	10391498	10396623	BnaA09T0157900ZY	0	+	0	0	5125	0.0000000
zheyou73v0_A09	10397082	10398532	BnaA09T0158000ZY	0	-	0	0	1450	0.0000000
zheyou73v0_A09	10408481	10417543	BnaA09T0158100ZY	0	+	0	0	9062	0.0000000
zheyou73v0_A09	10425170	10433065	BnaA09T0158200ZY	0	+	0	0	7895	0.0000000
zheyou73v0_A09	10425170	10433065	BnaA09T0158200ZY.1	0	+	0	0	7895	0.0000000
zheyou73v0_A09	10425170	10432373	BnaA09T0158200ZY.2	0	+	0	0	7203	0.0000000
zheyou73v0_A09	10435896	10437612	BnaA09T0158300ZY	0	-	0	0	1716	0.0000000
zheyou73v0_A09	10459973	10461676	BnaA09T0158400ZY	0	+	0	0	1703	0.0000000
zheyou73v0_A09	10464404	10465033	BnaA09T0158500ZY	0	+	0	0	629	0.0000000
zheyou73v0_A09	10466190	10468824	BnaA09T0158600ZY	0	-	0	0	2634	0.0000000
zheyou73v0_A09	10470930	10473781	BnaA09T0158700ZY	0	-	0	0	2851	0.0000000
zheyou73v0_A09	10474268	10491392	BnaA09T0158800ZY	0	-	0	0	17124	0.0000000
zheyou73v0_A09	10499940	10502931	BnaA09T0158900ZY	0	-	0	0	2991	0.0000000
zheyou73v0_A09	10530011	10532703	BnaA09T0159000ZY	0	-	0	0	2692	0.0000000
zheyou73v0_A09	10541313	10548309	BnaA09T0159100ZY	0	-	0	0	6996	0.0000000
zheyou73v0_A09	10550736	10554608	BnaA09T0159200ZY	0	+	0	0	3872	0.0000000
zheyou73v0_A09	10570104	10571986	BnaA09T0159300ZY	0	-	0	0	1882	0.0000000
zheyou73v0_A09	10589633	10593342	BnaA09T0159400ZY	0	+	0	0	3709	0.0000000
zheyou73v0_A09	10594164	10595511	BnaA09T0159500ZY	0	-	0	0	1347	0.0000000
zheyou73v0_A09	10599237	10601167	BnaA09T0159600ZY	0	+	0	0	1930	0.0000000
zheyou73v0_A09	10605604	10607486	BnaA09T0159700ZY	0	+	0	0	1882	0.0000000
zheyou73v0_A09	10609382	10611249	BnaA09T0159800ZY	0	+	0	0	1867	0.0000000
zheyou73v0_A09	10609382	10611249	BnaA09T0159800ZY.1	0	+	0	0	1867	0.0000000
zheyou73v0_A09	10611502	10612317	BnaA09T0159900ZY	0	-	0	0	815	0.0000000
zheyou73v0_A09	10612622	10616677	BnaA09T0160000ZY	0	-	0	0	4055	0.0000000
zheyou73v0_A09	10612622	10615418	BnaA09T0160000ZY.1	0	-	0	0	2796	0.0000000
zheyou73v0_A09	10630497	10631055	BnaA09T0160100ZY	0	-	0	0	558	0.0000000
zheyou73v0_A09	10641875	10642651	BnaA09T0160200ZY	0	+	0	0	776	0.0000000
zheyou73v0_A09	10655043	10655557	BnaA09T0160300ZY	0	-	0	0	514	0.0000000
zheyou73v0_A09	10657713	10663456	BnaA09T0160400ZY	0	-	0	0	5743	0.0000000
zheyou73v0_A09	10663304	10670798	BnaA09T0160500ZY	0	+	0	0	7494	0.0000000
zheyou73v0_A09	10671349	10672081	BnaA09T0160600ZY	0	+	0	0	732	0.0000000
zheyou73v0_A09	10674530	10675661	BnaA09T0160700ZY	0	+	0	0	1131	0.0000000
zheyou73v0_A09	10677361	10678468	BnaA09T0160800ZY	0	-	0	0	1107	0.0000000
zheyou73v0_A09	10680314	10683859	BnaA09T0160900ZY	0	-	0	0	3545	0.0000000
zheyou73v0_A09	10701464	10701843	BnaA09T0161000ZY	0	+	0	0	379	0.0000000
zheyou73v0_A09	10708605	10711547	BnaA09T0161100ZY	0	+	0	0	2942	0.0000000
zheyou73v0_A09	10725671	10730349	BnaA09T0161200ZY	0	+	0	0	4678	0.0000000
zheyou73v0_A09	10742126	10742723	BnaA09T0161300ZY	0	-	0	0	597	0.0000000
zheyou73v0_A09	10770618	10771644	BnaA09T0161400ZY	0	-	0	0	1026	0.0000000
zheyou73v0_A09	10784496	10790144	BnaA09T0161500ZY	0	+	0	0	5648	0.0000000
zheyou73v0_A09	10791508	10794169	BnaA09T0161600ZY	0	+	0	0	2661	0.0000000
zheyou73v0_A09	10791508	10794169	BnaA09T0161600ZY.1	0	+	0	0	2661	0.0000000
zheyou73v0_A09	10795123	10795405	BnaA09T0161700ZY	0	+	0	0	282	0.0000000
zheyou73v0_A09	10798141	10800918	BnaA09T0161800ZY	0	+	0	0	2777	0.0000000
zheyou73v0_A09	10810130	10812484	BnaA09T0161900ZY	0	+	0	0	2354	0.0000000
zheyou73v0_A09	10814655	10814988	BnaA09T0162000ZY	0	-	0	0	333	0.0000000
zheyou73v0_A09	10820054	10821134	BnaA09T0162100ZY	0	-	0	0	1080	0.0000000
zheyou73v0_A09	10823226	10825321	BnaA09T0162200ZY	0	+	0	0	2095	0.0000000
zheyou73v0_A09	10825439	10825961	BnaA09T0162300ZY	0	-	0	0	522	0.0000000
zheyou73v0_A09	10827908	10829573	BnaA09T0162400ZY	0	+	0	0	1665	0.0000000
zheyou73v0_A09	10830195	10832111	BnaA09T0162500ZY	0	+	0	0	1916	0.0000000
zheyou73v0_A09	10835476	10837091	BnaA09T0162600ZY	0	+	0	0	1615	0.0000000
zheyou73v0_A09	10854616	10856105	BnaA09T0162700ZY	0	+	0	0	1489	0.0000000
zheyou73v0_A09	10857529	10859509	BnaA09T0162800ZY	0	+	0	0	1980	0.0000000
zheyou73v0_A09	10867687	10869440	BnaA09T0162900ZY	0	+	0	0	1753	0.0000000
zheyou73v0_A09	10869779	10872856	BnaA09T0163000ZY	0	-	0	0	3077	0.0000000
zheyou73v0_A09	10869779	10872856	BnaA09T0163000ZY.1	0	-	0	0	3077	0.0000000
zheyou73v0_A09	10873569	10874770	BnaA09T0163100ZY	0	+	0	0	1201	0.0000000
zheyou73v0_A09	10875411	10875570	BnaA09T0163200ZY	0	-	0	0	159	0.0000000
zheyou73v0_A09	10876077	10879038	BnaA09T0163300ZY	0	+	0	0	2961	0.0000000
zheyou73v0_A09	10902007	10904600	BnaA09T0163400ZY	0	+	0	0	2593	0.0000000
zheyou73v0_A09	10913969	10916214	BnaA09T0163500ZY	0	+	0	0	2245	0.0000000
zheyou73v0_A09	10916632	10917502	BnaA09T0163600ZY	0	-	0	0	870	0.0000000
zheyou73v0_A09	10917512	10919056	BnaA09T0163700ZY	0	-	0	0	1544	0.0000000
zheyou73v0_A09	10926552	10929055	BnaA09T0163800ZY	0	-	0	0	2503	0.0000000
zheyou73v0_A09	10933024	10937171	BnaA09T0163900ZY	0	+	0	0	4147	0.0000000
zheyou73v0_A09	10937864	10939866	BnaA09T0164000ZY	0	+	0	0	2002	0.0000000
zheyou73v0_A09	10940298	10940586	BnaA09T0164100ZY	0	-	0	0	288	0.0000000
zheyou73v0_A09	10946728	10948422	BnaA09T0164200ZY	0	+	0	0	1694	0.0000000
zheyou73v0_A09	10960103	10961496	BnaA09T0164300ZY	0	+	0	0	1393	0.0000000
zheyou73v0_A09	10962952	10982408	BnaA09T0164400ZY	0	+	0	0	19456	0.0000000
zheyou73v0_A09	10983894	10984743	BnaA09T0164500ZY	0	+	0	0	849	0.0000000
zheyou73v0_A09	10986415	10987293	BnaA09T0164600ZY	0	+	0	0	878	0.0000000
zheyou73v0_A09	10992693	10994857	BnaA09T0164700ZY	0	+	0	0	2164	0.0000000
zheyou73v0_A09	11003662	11004745	BnaA09T0164800ZY	0	-	0	0	1083	0.0000000
zheyou73v0_A09	11005440	11007441	BnaA09T0164900ZY	0	+	0	0	2001	0.0000000
zheyou73v0_A09	11007651	11010825	BnaA09T0165000ZY	0	-	0	0	3174	0.0000000
zheyou73v0_A09	11036399	11036561	BnaA09T0165100ZY	0	+	0	0	162	0.0000000
zheyou73v0_A09	11038793	11039534	BnaA09T0165200ZY	0	+	0	0	741	0.0000000
zheyou73v0_A09	11040266	11041603	BnaA09T0165300ZY	0	-	0	0	1337	0.0000000
zheyou73v0_A09	11040527	11041603	BnaA09T0165300ZY.1	0	-	0	0	1076	0.0000000
zheyou73v0_A09	11042255	11043649	BnaA09T0165400ZY	0	+	0	0	1394	0.0000000
zheyou73v0_A09	11090419	11092318	BnaA09T0165500ZY	0	+	0	0	1899	0.0000000
zheyou73v0_A09	11097145	11099578	BnaA09T0165600ZY	0	-	0	0	2433	0.0000000
zheyou73v0_A09	11120289	11122169	BnaA09T0165700ZY	0	+	0	0	1880	0.0000000
zheyou73v0_A09	11132150	11132644	BnaA09T0165800ZY	0	-	0	0	494	0.0000000
zheyou73v0_A09	11144278	11146400	BnaA09T0165900ZY	0	+	0	0	2122	0.0000000
zheyou73v0_A09	11174914	11176319	BnaA09T0166000ZY	0	+	0	0	1405	0.0000000
zheyou73v0_A09	11176995	11177868	BnaA09T0166100ZY	0	+	0	0	873	0.0000000
zheyou73v0_A09	11183751	11184218	BnaA09T0166200ZY	0	-	0	0	467	0.0000000
zheyou73v0_A09	11189264	11201658	BnaA09T0166300ZY	0	+	0	0	12394	0.0000000
zheyou73v0_A09	11201419	11204047	BnaA09T0166400ZY	0	-	0	0	2628	0.0000000
zheyou73v0_A09	11207377	11208733	BnaA09T0166500ZY	0	+	0	0	1356	0.0000000
zheyou73v0_A09	11209750	11210818	BnaA09T0166600ZY	0	-	0	0	1068	0.0000000
zheyou73v0_A09	11213042	11214395	BnaA09T0166700ZY	0	+	0	0	1353	0.0000000
zheyou73v0_A09	11215837	11216984	BnaA09T0166800ZY	0	+	0	0	1147	0.0000000
zheyou73v0_A09	11220997	11222067	BnaA09T0166900ZY	0	+	0	0	1070	0.0000000
zheyou73v0_A09	11222578	11228379	BnaA09T0167000ZY	0	-	0	0	5801	0.0000000
zheyou73v0_A09	11232530	11233124	BnaA09T0167100ZY	0	+	0	0	594	0.0000000
zheyou73v0_A09	11245765	11247836	BnaA09T0167200ZY	0	+	0	0	2071	0.0000000
zheyou73v0_A09	11264811	11270054	BnaA09T0167300ZY	0	+	0	0	5243	0.0000000
zheyou73v0_A09	11264811	11269646	BnaA09T0167300ZY.1	0	+	0	0	4835	0.0000000
zheyou73v0_A09	11276579	11285664	BnaA09T0167400ZY	0	-	0	0	9085	0.0000000
zheyou73v0_A09	11314727	11315540	BnaA09T0167500ZY	0	+	0	0	813	0.0000000
zheyou73v0_A09	11315666	11317138	BnaA09T0167600ZY	0	-	0	0	1472	0.0000000
zheyou73v0_A09	11319434	11320718	BnaA09T0167700ZY	0	-	0	0	1284	0.0000000
zheyou73v0_A09	11329145	11331153	BnaA09T0167800ZY	0	-	0	0	2008	0.0000000
zheyou73v0_A09	11341553	11342133	BnaA09T0167900ZY	0	+	0	0	580	0.0000000
zheyou73v0_A09	11345901	11346999	BnaA09T0168000ZY	0	-	0	0	1098	0.0000000
zheyou73v0_A09	11352772	11356879	BnaA09T0168100ZY	0	-	0	0	4107	0.0000000
zheyou73v0_A09	11358901	11361536	BnaA09T0168200ZY	0	-	0	0	2635	0.0000000
zheyou73v0_A09	11358901	11361536	BnaA09T0168200ZY.1	0	-	0	0	2635	0.0000000
zheyou73v0_A09	11383267	11384190	BnaA09T0168300ZY	0	-	0	0	923	0.0000000
zheyou73v0_A09	11390755	11402828	BnaA09T0168400ZY	0	+	0	0	12073	0.0000000
zheyou73v0_A09	11405454	11410176	BnaA09T0168500ZY	0	+	0	0	4722	0.0000000
zheyou73v0_A09	11413318	11425767	BnaA09T0168600ZY	0	+	0	0	12449	0.0000000
zheyou73v0_A09	11444635	11457056	BnaA09T0168700ZY	0	-	0	0	12421	0.0000000
zheyou73v0_A09	11467989	11468439	BnaA09T0168800ZY	0	-	0	0	450	0.0000000
zheyou73v0_A09	11480610	11481100	BnaA09T0168900ZY	0	-	0	0	490	0.0000000
zheyou73v0_A09	11481464	11482889	BnaA09T0169000ZY	0	-	0	0	1425	0.0000000
zheyou73v0_A09	11484632	11485907	BnaA09T0169100ZY	0	+	0	0	1275	0.0000000
zheyou73v0_A09	11487045	11488447	BnaA09T0169200ZY	0	-	0	0	1402	0.0000000
zheyou73v0_A09	11489046	11500005	BnaA09T0169300ZY	0	-	0	0	10959	0.0000000
zheyou73v0_A09	11489925	11490303	BnaA09T0169400ZY	0	+	0	0	378	0.0000000
zheyou73v0_A09	11496201	11497592	BnaA09T0169500ZY	0	-	0	0	1391	0.0000000
zheyou73v0_A09	11498267	11500005	BnaA09T0169300ZY.1	0	-	0	0	1738	0.0000000
zheyou73v0_A09	11506053	11506986	BnaA09T0169600ZY	0	-	0	0	933	0.0000000
zheyou73v0_A09	11514666	11517488	BnaA09T0169700ZY	0	+	0	0	2822	0.0000000
zheyou73v0_A09	11519378	11520003	BnaA09T0169800ZY	0	-	0	0	625	0.0000000
zheyou73v0_A09	11526257	11526604	BnaA09T0169900ZY	0	+	0	0	347	0.0000000
zheyou73v0_A09	11542364	11546237	BnaA09T0170000ZY	0	-	0	0	3873	0.0000000
zheyou73v0_A09	11553467	11557540	BnaA09T0170100ZY	0	-	0	0	4073	0.0000000
zheyou73v0_A09	11582855	11587950	BnaA09T0170200ZY	0	+	0	0	5095	0.0000000
zheyou73v0_A09	11652151	11652361	BnaA09T0170300ZY	0	-	0	0	210	0.0000000
zheyou73v0_A09	11653445	11655367	BnaA09T0170400ZY	0	+	0	0	1922	0.0000000
zheyou73v0_A09	11659343	11660713	BnaA09T0170500ZY	0	-	0	0	1370	0.0000000
zheyou73v0_A09	11662263	11664888	BnaA09T0170600ZY	0	+	0	0	2625	0.0000000
zheyou73v0_A09	11666534	11666854	BnaA09T0170700ZY	0	+	0	0	320	0.0000000
zheyou73v0_A09	11668416	11669300	BnaA09T0170800ZY	0	-	0	0	884	0.0000000
zheyou73v0_A09	11672351	11674410	BnaA09T0170900ZY	0	+	0	0	2059	0.0000000
zheyou73v0_A09	11676204	11681684	BnaA09T0171000ZY	0	-	0	0	5480	0.0000000
zheyou73v0_A09	11682461	11683762	BnaA09T0171100ZY	0	-	0	0	1301	0.0000000
zheyou73v0_A09	11701750	11702785	BnaA09T0171200ZY	0	+	0	0	1035	0.0000000
zheyou73v0_A09	11703864	11705327	BnaA09T0171300ZY	0	+	0	0	1463	0.0000000
zheyou73v0_A09	11710980	11719333	BnaA09T0171400ZY	0	+	0	0	8353	0.0000000
zheyou73v0_A09	11726011	11730135	BnaA09T0171500ZY	0	+	0	0	4124	0.0000000
zheyou73v0_A09	11729862	11732809	BnaA09T0171600ZY	0	-	0	0	2947	0.0000000
zheyou73v0_A09	11749526	11750966	BnaA09T0171700ZY	0	-	0	0	1440	0.0000000
zheyou73v0_A09	11750987	11751266	BnaA09T0171800ZY	0	-	0	0	279	0.0000000
zheyou73v0_A09	11755540	11757531	BnaA09T0171900ZY	0	+	0	0	1991	0.0000000
zheyou73v0_A09	11762160	11763776	BnaA09T0172000ZY	0	+	0	0	1616	0.0000000
zheyou73v0_A09	11766357	11768931	BnaA09T0172100ZY	0	+	0	0	2574	0.0000000
zheyou73v0_A09	11769532	11770252	BnaA09T0172200ZY	0	-	0	0	720	0.0000000
zheyou73v0_A09	11771960	11772305	BnaA09T0172300ZY	0	+	0	0	345	0.0000000
zheyou73v0_A09	11775372	11787402	BnaA09T0172400ZY	0	+	0	0	12030	0.0000000
zheyou73v0_A09	11789359	11791037	BnaA09T0172500ZY	0	+	0	0	1678	0.0000000
zheyou73v0_A09	11808340	11810421	BnaA09T0172600ZY	0	+	0	0	2081	0.0000000
zheyou73v0_A09	11810650	11811784	BnaA09T0172700ZY	0	+	0	0	1134	0.0000000
zheyou73v0_A09	11813903	11815897	BnaA09T0172800ZY	0	-	0	0	1994	0.0000000
zheyou73v0_A09	11826271	11828815	BnaA09T0172900ZY	0	+	0	0	2544	0.0000000
zheyou73v0_A09	11830006	11830195	BnaA09T0173000ZY	0	-	0	0	189	0.0000000
zheyou73v0_A09	11862741	11864435	BnaA09T0173100ZY	0	+	0	0	1694	0.0000000
zheyou73v0_A09	11869536	11871230	BnaA09T0173200ZY	0	+	0	0	1694	0.0000000
zheyou73v0_A09	11876090	11877759	BnaA09T0173300ZY	0	-	0	0	1669	0.0000000
zheyou73v0_A09	11889137	11889386	BnaA09T0173400ZY	0	-	0	0	249	0.0000000
zheyou73v0_A09	11913035	11916106	BnaA09T0173500ZY	0	+	0	0	3071	0.0000000
zheyou73v0_A09	11916453	11919050	BnaA09T0173600ZY	0	-	0	0	2597	0.0000000
zheyou73v0_A09	11916453	11918954	BnaA09T0173600ZY.1	0	-	0	0	2501	0.0000000
zheyou73v0_A09	11916453	11919050	BnaA09T0173600ZY.2	0	-	0	0	2597	0.0000000
zheyou73v0_A09	11929849	11930769	BnaA09T0173700ZY	0	+	0	0	920	0.0000000
zheyou73v0_A09	11952000	11952859	BnaA09T0173800ZY	0	-	0	0	859	0.0000000
zheyou73v0_A09	11953509	11954911	BnaA09T0173900ZY	0	-	0	0	1402	0.0000000
zheyou73v0_A09	11964272	11973341	BnaA09T0174000ZY	0	+	0	0	9069	0.0000000
zheyou73v0_A09	11986206	11988890	BnaA09T0174100ZY	0	-	0	0	2684	0.0000000
zheyou73v0_A09	11989605	11990766	BnaA09T0174200ZY	0	+	0	0	1161	0.0000000
zheyou73v0_A09	12059639	12062027	BnaA09T0174300ZY	0	+	0	0	2388	0.0000000
zheyou73v0_A09	12065769	12068684	BnaA09T0174400ZY	0	+	0	0	2915	0.0000000
zheyou73v0_A09	12068960	12069866	BnaA09T0174500ZY	0	-	0	0	906	0.0000000
zheyou73v0_A09	12070099	12072716	BnaA09T0174600ZY	0	-	0	0	2617	0.0000000
zheyou73v0_A09	12075340	12082464	BnaA09T0174700ZY	0	-	0	0	7124	0.0000000
zheyou73v0_A09	12090458	12092414	BnaA09T0174800ZY	0	-	0	0	1956	0.0000000
zheyou73v0_A09	12104822	12106722	BnaA09T0174900ZY	0	-	0	0	1900	0.0000000
zheyou73v0_A09	12112115	12113030	BnaA09T0175000ZY	0	-	0	0	915	0.0000000
zheyou73v0_A09	12114614	12116922	BnaA09T0175100ZY	0	+	0	0	2308	0.0000000
zheyou73v0_A09	12114800	12116922	BnaA09T0175100ZY.1	0	+	0	0	2122	0.0000000
zheyou73v0_A09	12114800	12116922	BnaA09T0175100ZY.2	0	+	0	0	2122	0.0000000
zheyou73v0_A09	12131638	12132233	BnaA09T0175200ZY	0	+	0	0	595	0.0000000
zheyou73v0_A09	12132498	12135026	BnaA09T0175300ZY	0	-	0	0	2528	0.0000000
zheyou73v0_A09	12139726	12152053	BnaA09T0175400ZY	0	-	0	0	12327	0.0000000
zheyou73v0_A09	12155576	12170443	BnaA09T0175500ZY	0	-	0	0	14867	0.0000000
zheyou73v0_A09	12173307	12195494	BnaA09T0175600ZY	0	-	0	0	22187	0.0000000
zheyou73v0_A09	12200599	12207116	BnaA09T0175700ZY	0	-	0	0	6517	0.0000000
zheyou73v0_A09	12200599	12207116	BnaA09T0175700ZY.1	0	-	0	0	6517	0.0000000
zheyou73v0_A09	12213488	12215127	BnaA09T0175800ZY	0	-	0	0	1639	0.0000000
zheyou73v0_A09	12217304	12219011	BnaA09T0175900ZY	0	-	0	0	1707	0.0000000
zheyou73v0_A09	12221203	12223953	BnaA09T0176000ZY	0	+	0	0	2750	0.0000000
zheyou73v0_A09	12221203	12223433	BnaA09T0176000ZY.1	0	+	0	0	2230	0.0000000
zheyou73v0_A09	12226862	12228062	BnaA09T0176100ZY	0	+	0	0	1200	0.0000000
zheyou73v0_A09	12228496	12231623	BnaA09T0176200ZY	0	-	0	0	3127	0.0000000
zheyou73v0_A09	12238700	12239796	BnaA09T0176300ZY	0	+	0	0	1096	0.0000000
zheyou73v0_A09	12268620	12270625	BnaA09T0176400ZY	0	-	0	0	2005	0.0000000
zheyou73v0_A09	12272644	12275351	BnaA09T0176500ZY	0	-	0	0	2707	0.0000000
zheyou73v0_A09	12276276	12276898	BnaA09T0176600ZY	0	+	0	0	622	0.0000000
zheyou73v0_A09	12287930	12290886	BnaA09T0176700ZY	0	+	0	0	2956	0.0000000
zheyou73v0_A09	12298355	12300798	BnaA09T0176800ZY	0	-	0	0	2443	0.0000000
zheyou73v0_A09	12309093	12310838	BnaA09T0176900ZY	0	-	0	0	1745	0.0000000
zheyou73v0_A09	12309093	12310838	BnaA09T0176900ZY.1	0	-	0	0	1745	0.0000000
zheyou73v0_A09	12312369	12312737	BnaA09T0177000ZY	0	+	0	0	368	0.0000000
zheyou73v0_A09	12314020	12316666	BnaA09T0177100ZY	0	-	0	0	2646	0.0000000
zheyou73v0_A09	12327356	12328784	BnaA09T0177200ZY	0	+	0	0	1428	0.0000000
zheyou73v0_A09	12330581	12331992	BnaA09T0177300ZY	0	+	0	0	1411	0.0000000
zheyou73v0_A09	12332181	12335488	BnaA09T0177400ZY	0	-	0	0	3307	0.0000000
zheyou73v0_A09	12335752	12336175	BnaA09T0177500ZY	0	-	0	0	423	0.0000000
zheyou73v0_A09	12343071	12343334	BnaA09T0177600ZY	0	-	0	0	263	0.0000000
zheyou73v0_A09	12346999	12349455	BnaA09T0177700ZY	0	-	0	0	2456	0.0000000
zheyou73v0_A09	12354364	12355770	BnaA09T0177800ZY	0	+	0	0	1406	0.0000000
zheyou73v0_A09	12356557	12360119	BnaA09T0177900ZY	0	-	0	0	3562	0.0000000
zheyou73v0_A09	12362917	12364365	BnaA09T0178000ZY	0	-	0	0	1448	0.0000000
zheyou73v0_A09	12368332	12371451	BnaA09T0178100ZY	0	-	0	0	3119	0.0000000
zheyou73v0_A09	12374564	12380550	BnaA09T0178200ZY	0	-	0	0	5986	0.0000000
zheyou73v0_A09	12390189	12394036	BnaA09T0178300ZY	0	+	0	0	3847	0.0000000
zheyou73v0_A09	12406794	12412547	BnaA09T0178400ZY	0	-	0	0	5753	0.0000000
zheyou73v0_A09	12424110	12429296	BnaA09T0178500ZY	0	-	0	0	5186	0.0000000
zheyou73v0_A09	12429529	12430540	BnaA09T0178600ZY	0	+	0	0	1011	0.0000000
zheyou73v0_A09	12431207	12438679	BnaA09T0178700ZY	0	-	0	0	7472	0.0000000
zheyou73v0_A09	12454662	12455977	BnaA09T0178800ZY	0	+	0	0	1315	0.0000000
zheyou73v0_A09	12454662	12455977	BnaA09T0178800ZY.1	0	+	0	0	1315	0.0000000
zheyou73v0_A09	12458488	12461814	BnaA09T0178900ZY.1	0	-	0	0	3326	0.0000000
zheyou73v0_A09	12458771	12461814	BnaA09T0178900ZY	0	-	0	0	3043	0.0000000
zheyou73v0_A09	12466164	12467409	BnaA09T0179000ZY	0	+	0	0	1245	0.0000000
zheyou73v0_A09	12470928	12471979	BnaA09T0179100ZY	0	+	0	0	1051	0.0000000
zheyou73v0_A09	12475152	12479250	BnaA09T0179200ZY	0	+	0	0	4098	0.0000000
zheyou73v0_A09	12475152	12479250	BnaA09T0179200ZY.1	0	+	0	0	4098	0.0000000
zheyou73v0_A09	12475152	12479250	BnaA09T0179200ZY.2	0	+	0	0	4098	0.0000000
zheyou73v0_A09	12475152	12479250	BnaA09T0179200ZY.3	0	+	0	0	4098	0.0000000
zheyou73v0_A09	12483340	12488886	BnaA09T0179300ZY	0	+	0	0	5546	0.0000000
zheyou73v0_A09	12483340	12488886	BnaA09T0179300ZY.1	0	+	0	0	5546	0.0000000
zheyou73v0_A09	12490838	12491732	BnaA09T0179400ZY	0	+	0	0	894	0.0000000
zheyou73v0_A09	12493029	12493730	BnaA09T0179500ZY	0	-	0	0	701	0.0000000
zheyou73v0_A09	12498223	12504592	BnaA09T0179600ZY	0	-	0	0	6369	0.0000000
zheyou73v0_A09	12507382	12509129	BnaA09T0179700ZY	0	-	0	0	1747	0.0000000
zheyou73v0_A09	12512336	12516580	BnaA09T0179800ZY	0	+	0	0	4244	0.0000000
zheyou73v0_A09	12530768	12533401	BnaA09T0179900ZY	0	-	0	0	2633	0.0000000
zheyou73v0_A09	12541843	12543282	BnaA09T0180000ZY	0	-	0	0	1439	0.0000000
zheyou73v0_A09	12541843	12543282	BnaA09T0180000ZY.1	0	-	0	0	1439	0.0000000
zheyou73v0_A09	12541843	12543282	BnaA09T0180000ZY.2	0	-	0	0	1439	0.0000000
zheyou73v0_A09	12545879	12548432	BnaA09T0180100ZY	0	+	0	0	2553	0.0000000
zheyou73v0_A09	12550327	12551549	BnaA09T0180200ZY	0	+	0	0	1222	0.0000000
zheyou73v0_A09	12559948	12562538	BnaA09T0180300ZY	0	+	0	0	2590	0.0000000
zheyou73v0_A09	12563587	12565231	BnaA09T0180400ZY	0	-	0	0	1644	0.0000000
zheyou73v0_A09	12572124	12572936	BnaA09T0180500ZY	0	-	0	0	812	0.0000000
zheyou73v0_A09	12575723	12578002	BnaA09T0180600ZY	0	-	0	0	2279	0.0000000
zheyou73v0_A09	12583623	12584178	BnaA09T0180700ZY	0	-	0	0	555	0.0000000
zheyou73v0_A09	12593296	12601000	BnaA09T0180800ZY	0	+	0	0	7704	0.0000000
zheyou73v0_A09	12603954	12610868	BnaA09T0180900ZY.1	0	-	0	0	6914	0.0000000
zheyou73v0_A09	12603954	12610868	BnaA09T0180900ZY.2	0	-	0	0	6914	0.0000000
zheyou73v0_A09	12604139	12610868	BnaA09T0180900ZY	0	-	0	0	6729	0.0000000
zheyou73v0_A09	12612145	12614400	BnaA09T0181000ZY	0	+	0	0	2255	0.0000000
zheyou73v0_A09	12645547	12645853	BnaA09T0181100ZY	0	+	0	0	306	0.0000000
zheyou73v0_A09	12652807	12654539	BnaA09T0181200ZY	0	+	0	0	1732	0.0000000
zheyou73v0_A09	12655145	12657066	BnaA09T0181300ZY	0	+	0	0	1921	0.0000000
zheyou73v0_A09	12657486	12658527	BnaA09T0181400ZY	0	-	0	0	1041	0.0000000
zheyou73v0_A09	12717967	12719556	BnaA09T0181500ZY	0	+	0	0	1589	0.0000000
zheyou73v0_A09	12720347	12722781	BnaA09T0181600ZY	0	+	0	0	2434	0.0000000
zheyou73v0_A09	12725615	12727367	BnaA09T0181700ZY	0	+	0	0	1752	0.0000000
zheyou73v0_A09	12725615	12727367	BnaA09T0181700ZY.1	0	+	0	0	1752	0.0000000
zheyou73v0_A09	12725615	12727367	BnaA09T0181700ZY.2	0	+	0	0	1752	0.0000000
zheyou73v0_A09	12737075	12737964	BnaA09T0181800ZY	0	+	0	0	889	0.0000000
zheyou73v0_A09	12738938	12741797	BnaA09T0181900ZY	0	-	0	0	2859	0.0000000
zheyou73v0_A09	12749504	12751749	BnaA09T0182000ZY	0	-	0	0	2245	0.0000000
zheyou73v0_A09	12758179	12761821	BnaA09T0182100ZY	0	+	0	0	3642	0.0000000
zheyou73v0_A09	12758179	12761821	BnaA09T0182100ZY.1	0	+	0	0	3642	0.0000000
zheyou73v0_A09	12781390	12785662	BnaA09T0182200ZY	0	+	0	0	4272	0.0000000
zheyou73v0_A09	12813106	12815492	BnaA09T0182300ZY	0	+	0	0	2386	0.0000000
zheyou73v0_A09	12817229	12818468	BnaA09T0182400ZY	0	-	0	0	1239	0.0000000
zheyou73v0_A09	12821852	12822953	BnaA09T0182500ZY	0	-	0	0	1101	0.0000000
zheyou73v0_A09	12823693	12824157	BnaA09T0182600ZY	0	-	0	0	464	0.0000000
zheyou73v0_A09	12825988	12827991	BnaA09T0182700ZY	0	-	0	0	2003	0.0000000
zheyou73v0_A09	12833063	12834898	BnaA09T0182800ZY	0	-	0	0	1835	0.0000000
zheyou73v0_A09	12837700	12839772	BnaA09T0182900ZY	0	+	0	0	2072	0.0000000
zheyou73v0_A09	12841095	12841956	BnaA09T0183000ZY	0	-	0	0	861	0.0000000
zheyou73v0_A09	12847259	12848971	BnaA09T0183100ZY	0	-	0	0	1712	0.0000000
zheyou73v0_A09	12850999	12854728	BnaA09T0183200ZY	0	-	0	0	3729	0.0000000
zheyou73v0_A09	12864788	12865984	BnaA09T0183300ZY	0	-	0	0	1196	0.0000000
zheyou73v0_A09	12886787	12888512	BnaA09T0183400ZY	0	+	0	0	1725	0.0000000
zheyou73v0_A09	12890261	12891572	BnaA09T0183500ZY	0	-	0	0	1311	0.0000000
zheyou73v0_A09	12890261	12891572	BnaA09T0183500ZY.1	0	-	0	0	1311	0.0000000
zheyou73v0_A09	12898544	12899916	BnaA09T0183600ZY	0	-	0	0	1372	0.0000000
zheyou73v0_A09	12898544	12899916	BnaA09T0183600ZY.1	0	-	0	0	1372	0.0000000
zheyou73v0_A09	12898544	12899916	BnaA09T0183600ZY.2	0	-	0	0	1372	0.0000000
zheyou73v0_A09	12901723	12904742	BnaA09T0183700ZY	0	-	0	0	3019	0.0000000
zheyou73v0_A09	12909502	12912240	BnaA09T0183800ZY	0	-	0	0	2738	0.0000000
zheyou73v0_A09	12920652	12927336	BnaA09T0183900ZY	0	+	0	0	6684	0.0000000
zheyou73v0_A09	12928751	12929786	BnaA09T0184000ZY	0	+	0	0	1035	0.0000000
zheyou73v0_A09	12928751	12929786	BnaA09T0184000ZY.1	0	+	0	0	1035	0.0000000
zheyou73v0_A09	12930407	12931991	BnaA09T0184100ZY	0	-	0	0	1584	0.0000000
zheyou73v0_A09	12933111	12934336	BnaA09T0184200ZY	0	+	0	0	1225	0.0000000
zheyou73v0_A09	12943128	12943437	BnaA09T0184300ZY	0	+	0	0	309	0.0000000
zheyou73v0_A09	12960869	12963069	BnaA09T0184400ZY	0	+	0	0	2200	0.0000000
zheyou73v0_A09	12968737	12970243	BnaA09T0184500ZY	0	-	0	0	1506	0.0000000
zheyou73v0_A09	12977251	12981350	BnaA09T0184600ZY	0	+	0	0	4099	0.0000000
zheyou73v0_A09	12977251	12981350	BnaA09T0184600ZY.1	0	+	0	0	4099	0.0000000
zheyou73v0_A09	12981448	12982060	BnaA09T0184700ZY	0	-	0	0	612	0.0000000
zheyou73v0_A09	12984361	12991552	BnaA09T0184800ZY	0	+	0	0	7191	0.0000000
zheyou73v0_A09	12991929	12994158	BnaA09T0184900ZY	0	-	0	0	2229	0.0000000
zheyou73v0_A09	12998300	12999617	BnaA09T0185000ZY	0	+	0	0	1317	0.0000000
zheyou73v0_A09	12999778	13001000	BnaA09T0185100ZY	0	-	0	0	1222	0.0000000
zheyou73v0_A09	13020169	13022204	BnaA09T0185200ZY	0	-	0	0	2035	0.0000000
zheyou73v0_A09	13022777	13026043	BnaA09T0185300ZY	0	-	0	0	3266	0.0000000
zheyou73v0_A09	13030722	13031258	BnaA09T0185400ZY	0	-	0	0	536	0.0000000
zheyou73v0_A09	13035705	13037449	BnaA09T0185500ZY	0	+	0	0	1744	0.0000000
zheyou73v0_A09	13042115	13043648	BnaA09T0185600ZY	0	-	0	0	1533	0.0000000
zheyou73v0_A09	13084213	13085716	BnaA09T0185700ZY	0	+	0	0	1503	0.0000000
zheyou73v0_A09	13098754	13100116	BnaA09T0185800ZY	0	+	0	0	1362	0.0000000
zheyou73v0_A09	13102226	13106608	BnaA09T0185900ZY	0	-	0	0	4382	0.0000000
zheyou73v0_A09	13163569	13163797	BnaA09T0186000ZY	0	+	0	0	228	0.0000000
zheyou73v0_A09	13164837	13166294	BnaA09T0186100ZY	0	+	0	0	1457	0.0000000
zheyou73v0_A09	13172394	13173050	BnaA09T0186200ZY	0	-	0	0	656	0.0000000
zheyou73v0_A09	13190531	13194874	BnaA09T0186300ZY	0	+	0	0	4343	0.0000000
zheyou73v0_A09	13195322	13195881	BnaA09T0186400ZY	0	-	0	0	559	0.0000000
zheyou73v0_A09	13199327	13200625	BnaA09T0186500ZY	0	+	0	0	1298	0.0000000
zheyou73v0_A09	13199327	13200625	BnaA09T0186500ZY.1	0	+	0	0	1298	0.0000000
zheyou73v0_A09	13201249	13202379	BnaA09T0186600ZY	0	+	0	0	1130	0.0000000
zheyou73v0_A09	13206144	13206770	BnaA09T0186700ZY	0	+	0	0	626	0.0000000
zheyou73v0_A09	13221136	13224717	BnaA09T0186800ZY	0	-	0	0	3581	0.0000000
zheyou73v0_A09	13263602	13264779	BnaA09T0186900ZY	0	+	0	0	1177	0.0000000
zheyou73v0_A09	13301458	13303177	BnaA09T0187000ZY	0	-	0	0	1719	0.0000000
zheyou73v0_A09	13307908	13309688	BnaA09T0187100ZY	0	-	0	0	1780	0.0000000
zheyou73v0_A09	13311133	13312896	BnaA09T0187200ZY	0	+	0	0	1763	0.0000000
zheyou73v0_A09	13313770	13316366	BnaA09T0187300ZY	0	-	0	0	2596	0.0000000
zheyou73v0_A09	13327086	13327522	BnaA09T0187400ZY	0	+	0	0	436	0.0000000
zheyou73v0_A09	13337307	13337848	BnaA09T0187500ZY	0	-	0	0	541	0.0000000
zheyou73v0_A09	13344797	13353894	BnaA09T0187600ZY	0	-	0	0	9097	0.0000000
zheyou73v0_A09	13357972	13360151	BnaA09T0187700ZY	0	-	0	0	2179	0.0000000
zheyou73v0_A09	13357972	13360151	BnaA09T0187700ZY.1	0	-	0	0	2179	0.0000000
zheyou73v0_A09	13363344	13369526	BnaA09T0187800ZY	0	+	0	0	6182	0.0000000
zheyou73v0_A09	13380954	13382644	BnaA09T0187900ZY	0	-	0	0	1690	0.0000000
zheyou73v0_A09	13401062	13403818	BnaA09T0188000ZY	0	+	0	0	2756	0.0000000
zheyou73v0_A09	13403802	13406487	BnaA09T0188100ZY	0	-	0	0	2685	0.0000000
zheyou73v0_A09	13415640	13416283	BnaA09T0188200ZY	0	+	0	0	643	0.0000000
zheyou73v0_A09	13417445	13417974	BnaA09T0188300ZY	0	-	0	0	529	0.0000000
zheyou73v0_A09	13421383	13423617	BnaA09T0188400ZY	0	-	0	0	2234	0.0000000
zheyou73v0_A09	13429273	13430927	BnaA09T0188500ZY	0	+	0	0	1654	0.0000000
zheyou73v0_A09	13434484	13435426	BnaA09T0188600ZY	0	-	0	0	942	0.0000000
zheyou73v0_A09	13449484	13451418	BnaA09T0188700ZY	0	+	0	0	1934	0.0000000
zheyou73v0_A09	13449484	13451418	BnaA09T0188700ZY.1	0	+	0	0	1934	0.0000000
zheyou73v0_A09	13454505	13457506	BnaA09T0188800ZY	0	+	0	0	3001	0.0000000
zheyou73v0_A09	13459039	13462445	BnaA09T0188900ZY	0	+	0	0	3406	0.0000000
zheyou73v0_A09	13463224	13467151	BnaA09T0189000ZY	0	-	0	0	3927	0.0000000
zheyou73v0_A09	13467453	13470935	BnaA09T0189100ZY	0	-	0	0	3482	0.0000000
zheyou73v0_A09	13474071	13487246	BnaA09T0189200ZY	0	-	0	0	13175	0.0000000
zheyou73v0_A09	13493456	13498297	BnaA09T0189300ZY	0	-	0	0	4841	0.0000000
zheyou73v0_A09	13503528	13505200	BnaA09T0189400ZY	0	-	0	0	1672	0.0000000
zheyou73v0_A09	13516431	13517347	BnaA09T0189500ZY	0	+	0	0	916	0.0000000
zheyou73v0_A09	13531649	13533367	BnaA09T0189600ZY	0	-	0	0	1718	0.0000000
zheyou73v0_A09	13531649	13534475	BnaA09T0189600ZY.1	0	-	0	0	2826	0.0000000
zheyou73v0_A09	13531649	13533367	BnaA09T0189600ZY.2	0	-	0	0	1718	0.0000000
zheyou73v0_A09	13533586	13534276	BnaA09T0189700ZY	0	+	0	0	690	0.0000000
zheyou73v0_A09	13543727	13543940	BnaA09T0189800ZY	0	-	0	0	213	0.0000000
zheyou73v0_A09	13544934	13545607	BnaA09T0189900ZY	0	+	0	0	673	0.0000000
zheyou73v0_A09	13565443	13567453	BnaA09T0190000ZY	0	+	0	0	2010	0.0000000
zheyou73v0_A09	13567574	13569237	BnaA09T0190100ZY	0	-	0	0	1663	0.0000000
zheyou73v0_A09	13578682	13580128	BnaA09T0190200ZY	0	-	0	0	1446	0.0000000
zheyou73v0_A09	13583369	13586293	BnaA09T0190300ZY	0	-	0	0	2924	0.0000000
zheyou73v0_A09	13588251	13590980	BnaA09T0190400ZY	0	+	0	0	2729	0.0000000
zheyou73v0_A09	13592380	13594966	BnaA09T0190500ZY	0	-	0	0	2586	0.0000000
zheyou73v0_A09	13611560	13613187	BnaA09T0190600ZY	0	-	0	0	1627	0.0000000
zheyou73v0_A09	13614122	13616182	BnaA09T0190700ZY	0	-	0	0	2060	0.0000000
zheyou73v0_A09	13616864	13618615	BnaA09T0190800ZY	0	-	0	0	1751	0.0000000
zheyou73v0_A09	13622012	13623377	BnaA09T0190900ZY	0	+	0	0	1365	0.0000000
zheyou73v0_A09	13626080	13628629	BnaA09T0191000ZY	0	-	0	0	2549	0.0000000
zheyou73v0_A09	13626080	13628629	BnaA09T0191000ZY.1	0	-	0	0	2549	0.0000000
zheyou73v0_A09	13635863	13638161	BnaA09T0191100ZY	0	-	0	0	2298	0.0000000
zheyou73v0_A09	13649807	13651999	BnaA09T0191200ZY	0	-	0	0	2192	0.0000000
zheyou73v0_A09	13655743	13657451	BnaA09T0191300ZY	0	-	0	0	1708	0.0000000
zheyou73v0_A09	13659028	13661020	BnaA09T0191400ZY	0	-	0	0	1992	0.0000000
zheyou73v0_A09	13659516	13661020	BnaA09T0191400ZY.1	0	-	0	0	1504	0.0000000
zheyou73v0_A09	13670210	13672282	BnaA09T0191500ZY	0	+	0	0	2072	0.0000000
zheyou73v0_A09	13672673	13673033	BnaA09T0191600ZY	0	-	0	0	360	0.0000000
zheyou73v0_A09	13673121	13676974	BnaA09T0191700ZY	0	+	0	0	3853	0.0000000
zheyou73v0_A09	13677834	13680841	BnaA09T0191800ZY	0	-	0	0	3007	0.0000000
zheyou73v0_A09	13686021	13687266	BnaA09T0191900ZY	0	+	0	0	1245	0.0000000
zheyou73v0_A09	13702431	13703280	BnaA09T0192000ZY	0	+	0	0	849	0.0000000
zheyou73v0_A09	13703868	13704846	BnaA09T0192100ZY	0	-	0	0	978	0.0000000
zheyou73v0_A09	13708194	13709172	BnaA09T0192200ZY	0	-	0	0	978	0.0000000
zheyou73v0_A09	13709903	13710769	BnaA09T0192300ZY	0	+	0	0	866	0.0000000
zheyou73v0_A09	13711638	13714011	BnaA09T0192400ZY	0	+	0	0	2373	0.0000000
zheyou73v0_A09	13715054	13716617	BnaA09T0192500ZY	0	+	0	0	1563	0.0000000
zheyou73v0_A09	13716851	13717769	BnaA09T0192600ZY	0	-	0	0	918	0.0000000
zheyou73v0_A09	13725867	13728150	BnaA09T0192700ZY	0	+	0	0	2283	0.0000000
zheyou73v0_A09	13742538	13745673	BnaA09T0192800ZY	0	+	0	0	3135	0.0000000
zheyou73v0_A09	13745454	13750706	BnaA09T0192900ZY	0	-	0	0	5252	0.0000000
zheyou73v0_A09	13751571	13761143	BnaA09T0193000ZY	0	-	0	0	9572	0.0000000
zheyou73v0_A09	13763188	13768699	BnaA09T0193100ZY	0	-	0	0	5511	0.0000000
zheyou73v0_A09	13791481	13795120	BnaA09T0193200ZY	0	-	0	0	3639	0.0000000
zheyou73v0_A09	13801097	13802002	BnaA09T0193300ZY	0	+	0	0	905	0.0000000
zheyou73v0_A09	13805983	13808580	BnaA09T0193400ZY	0	+	0	0	2597	0.0000000
zheyou73v0_A09	13813803	13825351	BnaA09T0193500ZY	0	+	0	0	11548	0.0000000
zheyou73v0_A09	13828850	13833133	BnaA09T0193600ZY	0	-	0	0	4283	0.0000000
zheyou73v0_A09	13836015	13837347	BnaA09T0193700ZY	0	+	0	0	1332	0.0000000
zheyou73v0_A09	13837816	13841227	BnaA09T0193800ZY	0	+	0	0	3411	0.0000000
zheyou73v0_A09	13842724	13847028	BnaA09T0193900ZY	0	+	0	0	4304	0.0000000
zheyou73v0_A09	13856656	13858513	BnaA09T0194000ZY	0	-	0	0	1857	0.0000000
zheyou73v0_A09	13860628	13861570	BnaA09T0194100ZY	0	-	0	0	942	0.0000000
zheyou73v0_A09	13901613	13902587	BnaA09T0194200ZY	0	+	0	0	974	0.0000000
zheyou73v0_A09	13918971	13922410	BnaA09T0194300ZY	0	+	0	0	3439	0.0000000
zheyou73v0_A09	13934521	13935419	BnaA09T0194400ZY	0	-	0	0	898	0.0000000
zheyou73v0_A09	13945823	13947435	BnaA09T0194500ZY	0	+	0	0	1612	0.0000000
zheyou73v0_A09	13952310	13955292	BnaA09T0194600ZY	0	+	0	0	2982	0.0000000
zheyou73v0_A09	13958673	13963254	BnaA09T0194700ZY	0	-	0	0	4581	0.0000000
zheyou73v0_A09	13981964	13982902	BnaA09T0194800ZY	0	-	0	0	938	0.0000000
zheyou73v0_A09	13983373	13984820	BnaA09T0194900ZY	0	-	0	0	1447	0.0000000
zheyou73v0_A09	13994219	13996734	BnaA09T0195000ZY	0	-	0	0	2515	0.0000000
zheyou73v0_A09	14000762	14003213	BnaA09T0195100ZY	0	-	0	0	2451	0.0000000
zheyou73v0_A09	14035537	14036009	BnaA09T0195200ZY	0	-	0	0	472	0.0000000
zheyou73v0_A09	14038655	14040454	BnaA09T0195300ZY	0	-	0	0	1799	0.0000000
zheyou73v0_A09	14041464	14043209	BnaA09T0195400ZY	0	-	0	0	1745	0.0000000
zheyou73v0_A09	14044500	14053056	BnaA09T0195500ZY	0	+	0	0	8556	0.0000000
zheyou73v0_A09	14056214	14057228	BnaA09T0195600ZY	0	-	0	0	1014	0.0000000
zheyou73v0_A09	14067147	14073617	BnaA09T0195700ZY	0	+	0	0	6470	0.0000000
zheyou73v0_A09	14076493	14081923	BnaA09T0195800ZY	0	-	0	0	5430	0.0000000
zheyou73v0_A09	14108637	14112168	BnaA09T0195900ZY	0	+	0	0	3531	0.0000000
zheyou73v0_A09	14117139	14119851	BnaA09T0196000ZY	0	+	0	0	2712	0.0000000
zheyou73v0_A09	14119928	14121536	BnaA09T0196100ZY	0	-	0	0	1608	0.0000000
zheyou73v0_A09	14126838	14129474	BnaA09T0196200ZY	0	+	0	0	2636	0.0000000
zheyou73v0_A09	14133412	14135568	BnaA09T0196300ZY	0	+	0	0	2156	0.0000000
zheyou73v0_A09	14135890	14141439	BnaA09T0196400ZY	0	+	0	0	5549	0.0000000
zheyou73v0_A09	14157613	14157958	BnaA09T0196500ZY	0	-	0	0	345	0.0000000
zheyou73v0_A09	14164118	14164670	BnaA09T0196600ZY	0	+	0	0	552	0.0000000
zheyou73v0_A09	14169568	14171077	BnaA09T0196700ZY	0	-	0	0	1509	0.0000000
zheyou73v0_A09	14175152	14177673	BnaA09T0196800ZY	0	-	0	0	2521	0.0000000
zheyou73v0_A09	14178370	14184539	BnaA09T0196900ZY	0	-	0	0	6169	0.0000000
zheyou73v0_A09	14198821	14201009	BnaA09T0197000ZY	0	+	0	0	2188	0.0000000
zheyou73v0_A09	14201363	14202696	BnaA09T0197100ZY	0	+	0	0	1333	0.0000000
zheyou73v0_A09	14201363	14202696	BnaA09T0197100ZY.1	0	+	0	0	1333	0.0000000
zheyou73v0_A09	14214526	14216352	BnaA09T0197200ZY	0	+	0	0	1826	0.0000000
zheyou73v0_A09	14214526	14216352	BnaA09T0197200ZY.1	0	+	0	0	1826	0.0000000
zheyou73v0_A09	14218708	14222721	BnaA09T0197300ZY	0	-	0	0	4013	0.0000000
zheyou73v0_A09	14228060	14231501	BnaA09T0197400ZY	0	+	0	0	3441	0.0000000
zheyou73v0_A09	14231965	14233295	BnaA09T0197500ZY	0	-	0	0	1330	0.0000000
zheyou73v0_A09	14261594	14263240	BnaA09T0197600ZY	0	-	0	0	1646	0.0000000
zheyou73v0_A09	14277619	14278600	BnaA09T0197700ZY	0	-	0	0	981	0.0000000
zheyou73v0_A09	14279143	14281411	BnaA09T0197800ZY	0	+	0	0	2268	0.0000000
zheyou73v0_A09	14310294	14317205	BnaA09T0197900ZY	0	-	0	0	6911	0.0000000
zheyou73v0_A09	14325349	14326012	BnaA09T0198000ZY	0	-	0	0	663	0.0000000
zheyou73v0_A09	14330693	14335634	BnaA09T0198100ZY	0	-	0	0	4941	0.0000000
zheyou73v0_A09	14342922	14343291	BnaA09T0198200ZY	0	-	0	0	369	0.0000000
zheyou73v0_A09	14343323	14345418	BnaA09T0198300ZY	0	-	0	0	2095	0.0000000
zheyou73v0_A09	14361260	14365922	BnaA09T0198400ZY	0	+	0	0	4662	0.0000000
zheyou73v0_A09	14370296	14370611	BnaA09T0198500ZY	0	+	0	0	315	0.0000000
zheyou73v0_A09	14380152	14381275	BnaA09T0198600ZY	0	-	0	0	1123	0.0000000
zheyou73v0_A09	14388359	14389653	BnaA09T0198700ZY	0	-	0	0	1294	0.0000000
zheyou73v0_A09	14396055	14396423	BnaA09T0198800ZY	0	-	0	0	368	0.0000000
zheyou73v0_A09	14396963	14398621	BnaA09T0198900ZY	0	-	0	0	1658	0.0000000
zheyou73v0_A09	14403081	14403423	BnaA09T0199000ZY	0	-	0	0	342	0.0000000
zheyou73v0_A09	14412466	14415243	BnaA09T0199100ZY	0	+	0	0	2777	0.0000000
zheyou73v0_A09	14416737	14418111	BnaA09T0199200ZY	0	+	0	0	1374	0.0000000
zheyou73v0_A09	14418214	14425568	BnaA09T0199300ZY	0	-	0	0	7354	0.0000000
zheyou73v0_A09	14426286	14430931	BnaA09T0199400ZY	0	-	0	0	4645	0.0000000
zheyou73v0_A09	14433877	14434912	BnaA09T0199500ZY	0	-	0	0	1035	0.0000000
zheyou73v0_A09	14439624	14440457	BnaA09T0199600ZY	0	-	0	0	833	0.0000000
zheyou73v0_A09	14441247	14444443	BnaA09T0199700ZY	0	-	0	0	3196	0.0000000
zheyou73v0_A09	14458353	14460897	BnaA09T0199800ZY	0	+	0	0	2544	0.0000000
zheyou73v0_A09	14461516	14463884	BnaA09T0199900ZY	0	-	0	0	2368	0.0000000
zheyou73v0_A09	14474520	14478467	BnaA09T0200000ZY	0	+	0	0	3947	0.0000000
zheyou73v0_A09	14489221	14493149	BnaA09T0200100ZY	0	-	0	0	3928	0.0000000
zheyou73v0_A09	14496354	14496546	BnaA09T0200200ZY	0	+	0	0	192	0.0000000
zheyou73v0_A09	14510162	14513835	BnaA09T0200300ZY	0	-	0	0	3673	0.0000000
zheyou73v0_A09	14517281	14517473	BnaA09T0200400ZY	0	+	0	0	192	0.0000000
zheyou73v0_A09	14548208	14549611	BnaA09T0200500ZY	0	-	0	0	1403	0.0000000
zheyou73v0_A09	14550831	14552986	BnaA09T0200600ZY	0	-	0	0	2155	0.0000000
zheyou73v0_A09	14554047	14555871	BnaA09T0200700ZY	0	-	0	0	1824	0.0000000
zheyou73v0_A09	14556267	14558865	BnaA09T0200800ZY	0	+	0	0	2598	0.0000000
zheyou73v0_A09	14559296	14560305	BnaA09T0200900ZY	0	+	0	0	1009	0.0000000
zheyou73v0_A09	14560681	14588189	BnaA09T0201000ZY	0	+	0	0	27508	0.0000000
zheyou73v0_A09	14589487	14591069	BnaA09T0201100ZY	0	+	0	0	1582	0.0000000
zheyou73v0_A09	14591226	14596506	BnaA09T0201200ZY	0	-	0	0	5280	0.0000000
zheyou73v0_A09	14601805	14604620	BnaA09T0201300ZY	0	+	0	0	2815	0.0000000
zheyou73v0_A09	14605918	14607394	BnaA09T0201400ZY	0	-	0	0	1476	0.0000000
zheyou73v0_A09	14605918	14607394	BnaA09T0201400ZY.1	0	-	0	0	1476	0.0000000
zheyou73v0_A09	14622654	14625391	BnaA09T0201500ZY	0	+	0	0	2737	0.0000000
zheyou73v0_A09	14622654	14625391	BnaA09T0201500ZY.1	0	+	0	0	2737	0.0000000
zheyou73v0_A09	14626782	14628698	BnaA09T0201600ZY	0	+	0	0	1916	0.0000000
zheyou73v0_A09	14626782	14628698	BnaA09T0201600ZY.1	0	+	0	0	1916	0.0000000
zheyou73v0_A09	14629678	14631805	BnaA09T0201700ZY	0	+	0	0	2127	0.0000000
zheyou73v0_A09	14637636	14638608	BnaA09T0201800ZY	0	+	0	0	972	0.0000000
zheyou73v0_A09	14649550	14653392	BnaA09T0201900ZY	0	+	0	0	3842	0.0000000
zheyou73v0_A09	14672613	14674002	BnaA09T0202000ZY	0	+	0	0	1389	0.0000000
zheyou73v0_A09	14675176	14676834	BnaA09T0202100ZY	0	-	0	0	1658	0.0000000
zheyou73v0_A09	14685953	14686676	BnaA09T0202200ZY	0	+	0	0	723	0.0000000
zheyou73v0_A09	14693713	14694763	BnaA09T0202300ZY	0	+	0	0	1050	0.0000000
zheyou73v0_A09	14703088	14705138	BnaA09T0202400ZY	0	+	0	0	2050	0.0000000
zheyou73v0_A09	14712660	14713904	BnaA09T0202500ZY	0	-	0	0	1244	0.0000000
zheyou73v0_A09	14718594	14719522	BnaA09T0202600ZY	0	-	0	0	928	0.0000000
zheyou73v0_A09	14720572	14722552	BnaA09T0202700ZY	0	-	0	0	1980	0.0000000
zheyou73v0_A09	14729293	14730970	BnaA09T0202800ZY	0	+	0	0	1677	0.0000000
zheyou73v0_A09	14749613	14751614	BnaA09T0202900ZY	0	+	0	0	2001	0.0000000
zheyou73v0_A09	14780039	14781569	BnaA09T0203000ZY	0	+	0	0	1530	0.0000000
zheyou73v0_A09	14815813	14816889	BnaA09T0203100ZY	0	-	0	0	1076	0.0000000
zheyou73v0_A09	14837024	14837330	BnaA09T0203200ZY	0	+	0	0	306	0.0000000
zheyou73v0_A09	14841679	14846706	BnaA09T0203300ZY	0	+	0	0	5027	0.0000000
zheyou73v0_A09	14842287	14846706	BnaA09T0203300ZY.1	0	+	0	0	4419	0.0000000
zheyou73v0_A09	14847473	14848055	BnaA09T0203400ZY	0	-	0	0	582	0.0000000
zheyou73v0_A09	14869034	14869614	BnaA09T0203500ZY	0	-	0	0	580	0.0000000
zheyou73v0_A09	14874872	14878701	BnaA09T0203600ZY	0	+	0	0	3829	0.0000000
zheyou73v0_A09	14887512	14888308	BnaA09T0203700ZY	0	-	0	0	796	0.0000000
zheyou73v0_A09	14896384	14896624	BnaA09T0203800ZY	0	-	0	0	240	0.0000000
zheyou73v0_A09	14905598	14905931	BnaA09T0203900ZY	0	+	0	0	333	0.0000000
zheyou73v0_A09	14923907	14924383	BnaA09T0204000ZY	0	-	0	0	476	0.0000000
zheyou73v0_A09	14935070	14942586	BnaA09T0204100ZY	0	+	0	0	7516	0.0000000
zheyou73v0_A09	14943041	14944950	BnaA09T0204200ZY	0	+	0	0	1909	0.0000000
zheyou73v0_A09	14959250	14960843	BnaA09T0204300ZY	0	+	0	0	1593	0.0000000
zheyou73v0_A09	14959250	14960843	BnaA09T0204300ZY.1	0	+	0	0	1593	0.0000000
zheyou73v0_A09	14959250	14960843	BnaA09T0204300ZY.2	0	+	0	0	1593	0.0000000
zheyou73v0_A09	14959250	14960843	BnaA09T0204300ZY.3	0	+	0	0	1593	0.0000000
zheyou73v0_A09	14992925	14994008	BnaA09T0204400ZY	0	+	0	0	1083	0.0000000
zheyou73v0_A09	14994615	14997031	BnaA09T0204500ZY	0	-	0	0	2416	0.0000000
zheyou73v0_A09	15010789	15011560	BnaA09T0204600ZY	0	-	0	0	771	0.0000000
zheyou73v0_A09	15022933	15025518	BnaA09T0204700ZY	0	-	0	0	2585	0.0000000
zheyou73v0_A09	15023333	15025518	BnaA09T0204700ZY.1	0	-	0	0	2185	0.0000000
zheyou73v0_A09	15040424	15041847	BnaA09T0204800ZY	0	-	0	0	1423	0.0000000
zheyou73v0_A09	15042306	15044127	BnaA09T0204900ZY	0	+	0	0	1821	0.0000000
zheyou73v0_A09	15049043	15051722	BnaA09T0205000ZY	0	+	0	0	2679	0.0000000
zheyou73v0_A09	15054663	15056662	BnaA09T0205100ZY	0	+	0	0	1999	0.0000000
zheyou73v0_A09	15056848	15059151	BnaA09T0205200ZY	0	-	0	0	2303	0.0000000
zheyou73v0_A09	15059736	15060794	BnaA09T0205300ZY	0	-	0	0	1058	0.0000000
zheyou73v0_A09	15064891	15066703	BnaA09T0205400ZY	0	+	0	0	1812	0.0000000
zheyou73v0_A09	15066778	15068869	BnaA09T0205500ZY	0	-	0	0	2091	0.0000000
zheyou73v0_A09	15066778	15068869	BnaA09T0205500ZY.1	0	-	0	0	2091	0.0000000
zheyou73v0_A09	15082813	15083844	BnaA09T0205600ZY	0	-	0	0	1031	0.0000000
zheyou73v0_A09	15122222	15123220	BnaA09T0205700ZY	0	-	0	0	998	0.0000000
zheyou73v0_A09	15130513	15131615	BnaA09T0205800ZY	0	+	0	0	1102	0.0000000
zheyou73v0_A09	15138652	15139039	BnaA09T0205900ZY	0	+	0	0	387	0.0000000
zheyou73v0_A09	15140278	15143569	BnaA09T0206000ZY	0	+	0	0	3291	0.0000000
zheyou73v0_A09	15145235	15150093	BnaA09T0206100ZY	0	-	0	0	4858	0.0000000
zheyou73v0_A09	15158425	15161424	BnaA09T0206200ZY	0	-	0	0	2999	0.0000000
zheyou73v0_A09	15165568	15166757	BnaA09T0206300ZY	0	+	0	0	1189	0.0000000
zheyou73v0_A09	15167756	15173150	BnaA09T0206400ZY	0	-	0	0	5394	0.0000000
zheyou73v0_A09	15175286	15193927	BnaA09T0206500ZY	0	+	0	0	18641	0.0000000
zheyou73v0_A09	15194718	15195023	BnaA09T0206600ZY	0	-	0	0	305	0.0000000
zheyou73v0_A09	15196360	15198487	BnaA09T0206700ZY	0	+	0	0	2127	0.0000000
zheyou73v0_A09	15198830	15201293	BnaA09T0206800ZY	0	-	0	0	2463	0.0000000
zheyou73v0_A09	15203486	15204391	BnaA09T0206900ZY	0	-	0	0	905	0.0000000
zheyou73v0_A09	15205416	15209862	BnaA09T0207000ZY	0	-	0	0	4446	0.0000000
zheyou73v0_A09	15211478	15215896	BnaA09T0207100ZY	0	-	0	0	4418	0.0000000
zheyou73v0_A09	15213557	15215399	BnaA09T0207100ZY.1	0	-	0	0	1842	0.0000000
zheyou73v0_A09	15218013	15218701	BnaA09T0207200ZY	0	-	0	0	688	0.0000000
zheyou73v0_A09	15221893	15222448	BnaA09T0207300ZY	0	+	0	0	555	0.0000000
zheyou73v0_A09	15222756	15224862	BnaA09T0207400ZY	0	-	0	0	2106	0.0000000
zheyou73v0_A09	15225658	15226945	BnaA09T0207500ZY	0	+	0	0	1287	0.0000000
zheyou73v0_A09	15226802	15228453	BnaA09T0207600ZY	0	-	0	0	1651	0.0000000
zheyou73v0_A09	15230456	15233260	BnaA09T0207700ZY	0	+	0	0	2804	0.0000000
zheyou73v0_A09	15230456	15233260	BnaA09T0207700ZY.1	0	+	0	0	2804	0.0000000
zheyou73v0_A09	15233509	15236243	BnaA09T0207800ZY	0	-	0	0	2734	0.0000000
zheyou73v0_A09	15238937	15242072	BnaA09T0207900ZY	0	-	0	0	3135	0.0000000
zheyou73v0_A09	15243892	15245525	BnaA09T0208000ZY	0	-	0	0	1633	0.0000000
zheyou73v0_A09	15256502	15257291	BnaA09T0208100ZY	0	+	0	0	789	0.0000000
zheyou73v0_A09	15257919	15259667	BnaA09T0208200ZY	0	-	0	0	1748	0.0000000
zheyou73v0_A09	15257919	15259667	BnaA09T0208200ZY.1	0	-	0	0	1748	0.0000000
zheyou73v0_A09	15261802	15262760	BnaA09T0208300ZY	0	+	0	0	958	0.0000000
zheyou73v0_A09	15269155	15271385	BnaA09T0208400ZY	0	+	0	0	2230	0.0000000
zheyou73v0_A09	15273310	15274779	BnaA09T0208500ZY	0	-	0	0	1469	0.0000000
zheyou73v0_A09	15275712	15276370	BnaA09T0208600ZY	0	-	0	0	658	0.0000000
zheyou73v0_A09	15298933	15301802	BnaA09T0208700ZY	0	-	0	0	2869	0.0000000
zheyou73v0_A09	15320481	15321699	BnaA09T0208800ZY	0	+	0	0	1218	0.0000000
zheyou73v0_A09	15323207	15324590	BnaA09T0208900ZY	0	-	0	0	1383	0.0000000
zheyou73v0_A09	15326446	15326866	BnaA09T0209000ZY	0	-	0	0	420	0.0000000
zheyou73v0_A09	15329136	15329860	BnaA09T0209100ZY	0	-	0	0	724	0.0000000
zheyou73v0_A09	15339250	15346360	BnaA09T0209200ZY	0	-	0	0	7110	0.0000000
zheyou73v0_A09	15347752	15350323	BnaA09T0209300ZY	0	-	0	0	2571	0.0000000
zheyou73v0_A09	15356498	15358219	BnaA09T0209400ZY	0	+	0	0	1721	0.0000000
zheyou73v0_A09	15360442	15362158	BnaA09T0209500ZY	0	-	0	0	1716	0.0000000
zheyou73v0_A09	15367834	15368463	BnaA09T0209600ZY	0	-	0	0	629	0.0000000
zheyou73v0_A09	15368557	15373998	BnaA09T0209700ZY	0	-	0	0	5441	0.0000000
zheyou73v0_A09	15388060	15389106	BnaA09T0209800ZY	0	+	0	0	1046	0.0000000
zheyou73v0_A09	15397484	15398345	BnaA09T0209900ZY	0	-	0	0	861	0.0000000
zheyou73v0_A09	15399358	15400284	BnaA09T0210000ZY	0	+	0	0	926	0.0000000
zheyou73v0_A09	15417282	15419607	BnaA09T0210100ZY	0	-	0	0	2325	0.0000000
zheyou73v0_A09	15437838	15438417	BnaA09T0210200ZY	0	-	0	0	579	0.0000000
zheyou73v0_A09	15441909	15442622	BnaA09T0210300ZY	0	-	0	0	713	0.0000000
zheyou73v0_A09	15449101	15452520	BnaA09T0210400ZY	0	+	0	0	3419	0.0000000
zheyou73v0_A09	15453438	15454272	BnaA09T0210500ZY	0	+	0	0	834	0.0000000
zheyou73v0_A09	15460214	15461135	BnaA09T0210600ZY	0	-	0	0	921	0.0000000
zheyou73v0_A09	15467134	15472056	BnaA09T0210700ZY	0	-	0	0	4922	0.0000000
zheyou73v0_A09	15475770	15476488	BnaA09T0210800ZY	0	-	0	0	718	0.0000000
zheyou73v0_A09	15478360	15480117	BnaA09T0210900ZY	0	-	0	0	1757	0.0000000
zheyou73v0_A09	15481465	15483245	BnaA09T0211000ZY	0	-	0	0	1780	0.0000000
zheyou73v0_A09	15509580	15510428	BnaA09T0211100ZY	0	-	0	0	848	0.0000000
zheyou73v0_A09	15509580	15510428	BnaA09T0211100ZY.1	0	-	0	0	848	0.0000000
zheyou73v0_A09	15526439	15528803	BnaA09T0211200ZY	0	+	0	0	2364	0.0000000
zheyou73v0_A09	15553375	15553912	BnaA09T0211300ZY	0	-	0	0	537	0.0000000
zheyou73v0_A09	15560792	15561793	BnaA09T0211400ZY	0	+	0	0	1001	0.0000000
zheyou73v0_A09	15565652	15573190	BnaA09T0211500ZY	0	-	0	0	7538	0.0000000
zheyou73v0_A09	15581266	15587348	BnaA09T0211600ZY	0	+	0	0	6082	0.0000000
zheyou73v0_A09	15588397	15590862	BnaA09T0211700ZY	0	-	0	0	2465	0.0000000
zheyou73v0_A09	15596860	15597463	BnaA09T0211800ZY	0	-	0	0	603	0.0000000
zheyou73v0_A09	15598488	15601318	BnaA09T0211900ZY	0	+	0	0	2830	0.0000000
zheyou73v0_A09	15605616	15608767	BnaA09T0212000ZY	0	+	0	0	3151	0.0000000
zheyou73v0_A09	15609566	15611355	BnaA09T0212100ZY.1	0	+	0	0	1789	0.0000000
zheyou73v0_A09	15609570	15611355	BnaA09T0212100ZY	0	+	0	0	1785	0.0000000
zheyou73v0_A09	15620882	15622968	BnaA09T0212200ZY	0	+	0	0	2086	0.0000000
zheyou73v0_A09	15659043	15663053	BnaA09T0212300ZY	0	+	0	0	4010	0.0000000
zheyou73v0_A09	15690837	15694118	BnaA09T0212400ZY	0	-	0	0	3281	0.0000000
zheyou73v0_A09	15694320	15694776	BnaA09T0212500ZY	0	-	0	0	456	0.0000000
zheyou73v0_A09	15705162	15705869	BnaA09T0212600ZY	0	-	0	0	707	0.0000000
zheyou73v0_A09	15713792	15717742	BnaA09T0212700ZY	0	+	0	0	3950	0.0000000
zheyou73v0_A09	15722145	15722998	BnaA09T0212800ZY	0	+	0	0	853	0.0000000
zheyou73v0_A09	15735738	15738830	BnaA09T0212900ZY	0	-	0	0	3092	0.0000000
zheyou73v0_A09	15740602	15741212	BnaA09T0213000ZY	0	-	0	0	610	0.0000000
zheyou73v0_A09	15743573	15745585	BnaA09T0213100ZY	0	+	0	0	2012	0.0000000
zheyou73v0_A09	15754657	15759826	BnaA09T0213200ZY.1	0	+	0	0	5169	0.0000000
zheyou73v0_A09	15754786	15759826	BnaA09T0213200ZY	0	+	0	0	5040	0.0000000
zheyou73v0_A09	15754786	15756520	BnaA09T0213200ZY.2	0	+	0	0	1734	0.0000000
zheyou73v0_A09	15768887	15770695	BnaA09T0213300ZY	0	-	0	0	1808	0.0000000
zheyou73v0_A09	15778965	15781641	BnaA09T0213400ZY	0	+	0	0	2676	0.0000000
zheyou73v0_A09	15794660	15796847	BnaA09T0213500ZY	0	+	0	0	2187	0.0000000
zheyou73v0_A09	15800409	15800799	BnaA09T0213600ZY	0	+	0	0	390	0.0000000
zheyou73v0_A09	15801055	15802384	BnaA09T0213700ZY	0	+	0	0	1329	0.0000000
zheyou73v0_A09	15804905	15806685	BnaA09T0213800ZY	0	+	0	0	1780	0.0000000
zheyou73v0_A09	15806991	15808808	BnaA09T0213900ZY	0	-	0	0	1817	0.0000000
zheyou73v0_A09	15809495	15811538	BnaA09T0214000ZY	0	-	0	0	2043	0.0000000
zheyou73v0_A09	15812016	15813070	BnaA09T0214100ZY	0	+	0	0	1054	0.0000000
zheyou73v0_A09	15815034	15817515	BnaA09T0214200ZY	0	+	0	0	2481	0.0000000
zheyou73v0_A09	15826892	15828762	BnaA09T0214300ZY	0	-	0	0	1870	0.0000000
zheyou73v0_A09	15846029	15847602	BnaA09T0214400ZY	0	+	0	0	1573	0.0000000
zheyou73v0_A09	15853193	15854486	BnaA09T0214500ZY	0	-	0	0	1293	0.0000000
zheyou73v0_A09	15869732	15871816	BnaA09T0214600ZY	0	+	0	0	2084	0.0000000
zheyou73v0_A09	15873300	15876267	BnaA09T0214700ZY	0	+	0	0	2967	0.0000000
zheyou73v0_A09	15877352	15880080	BnaA09T0214800ZY	0	+	0	0	2728	0.0000000
zheyou73v0_A09	15883236	15890576	BnaA09T0214900ZY	0	+	0	0	7340	0.0000000
zheyou73v0_A09	15896308	15896920	BnaA09T0215000ZY	0	+	0	0	612	0.0000000
zheyou73v0_A09	15900243	15901695	BnaA09T0215100ZY	0	-	0	0	1452	0.0000000
zheyou73v0_A09	15903741	15915118	BnaA09T0215200ZY	0	-	0	0	11377	0.0000000
zheyou73v0_A09	15992589	15994984	BnaA09T0215300ZY	0	+	0	0	2395	0.0000000
zheyou73v0_A09	16003690	16008793	BnaA09T0215400ZY	0	-	0	0	5103	0.0000000
zheyou73v0_A09	16026873	16028891	BnaA09T0215500ZY	0	-	0	0	2018	0.0000000
zheyou73v0_A09	16034843	16035716	BnaA09T0215600ZY	0	-	0	0	873	0.0000000
zheyou73v0_A09	16040354	16041344	BnaA09T0215700ZY	0	+	0	0	990	0.0000000
zheyou73v0_A09	16042462	16044176	BnaA09T0215800ZY	0	-	0	0	1714	0.0000000
zheyou73v0_A09	16044385	16057112	BnaA09T0215900ZY	0	-	0	0	12727	0.0000000
zheyou73v0_A09	16070473	16074389	BnaA09T0216000ZY	0	+	0	0	3916	0.0000000
zheyou73v0_A09	16076518	16078880	BnaA09T0216100ZY	0	+	0	0	2362	0.0000000
zheyou73v0_A09	16079948	16081980	BnaA09T0216200ZY	0	+	0	0	2032	0.0000000
zheyou73v0_A09	16088103	16088964	BnaA09T0216300ZY	0	+	0	0	861	0.0000000
zheyou73v0_A09	16089107	16090817	BnaA09T0216400ZY	0	+	0	0	1710	0.0000000
zheyou73v0_A09	16090911	16091609	BnaA09T0216500ZY	0	+	0	0	698	0.0000000
zheyou73v0_A09	16093478	16093721	BnaA09T0216600ZY	0	+	0	0	243	0.0000000
zheyou73v0_A09	16100676	16109853	BnaA09T0216700ZY	0	+	0	0	9177	0.0000000
zheyou73v0_A09	16112790	16114174	BnaA09T0216800ZY	0	+	0	0	1384	0.0000000
zheyou73v0_A09	16117082	16117860	BnaA09T0216900ZY	0	+	0	0	778	0.0000000
zheyou73v0_A09	16118236	16121301	BnaA09T0217000ZY	0	+	0	0	3065	0.0000000
zheyou73v0_A09	16121613	16122460	BnaA09T0217100ZY	0	+	0	0	847	0.0000000
zheyou73v0_A09	16129802	16131362	BnaA09T0217200ZY	0	-	0	0	1560	0.0000000
zheyou73v0_A09	16138421	16141011	BnaA09T0217300ZY	0	+	0	0	2590	0.0000000
zheyou73v0_A09	16138421	16141011	BnaA09T0217300ZY.1	0	+	0	0	2590	0.0000000
zheyou73v0_A09	16141391	16142739	BnaA09T0217400ZY	0	+	0	0	1348	0.0000000
zheyou73v0_A09	16189439	16190012	BnaA09T0217500ZY	0	-	0	0	573	0.0000000
zheyou73v0_A09	16210175	16210534	BnaA09T0217600ZY	0	+	0	0	359	0.0000000
zheyou73v0_A09	16213763	16214884	BnaA09T0217700ZY	0	-	0	0	1121	0.0000000
zheyou73v0_A09	16221762	16221951	BnaA09T0217800ZY	0	+	0	0	189	0.0000000
zheyou73v0_A09	16226297	16226604	BnaA09T0217900ZY	0	+	0	0	307	0.0000000
zheyou73v0_A09	16231584	16233032	BnaA09T0218000ZY	0	-	0	0	1448	0.0000000
zheyou73v0_A09	16237397	16240851	BnaA09T0218100ZY	0	+	0	0	3454	0.0000000
zheyou73v0_A09	16237397	16240851	BnaA09T0218100ZY.1	0	+	0	0	3454	0.0000000
zheyou73v0_A09	16238171	16240851	BnaA09T0218100ZY.2	0	+	0	0	2680	0.0000000
zheyou73v0_A09	16242705	16243761	BnaA09T0218200ZY	0	+	0	0	1056	0.0000000
zheyou73v0_A09	16242705	16243761	BnaA09T0218200ZY.1	0	+	0	0	1056	0.0000000
zheyou73v0_A09	16246755	16247523	BnaA09T0218300ZY	0	+	0	0	768	0.0000000
zheyou73v0_A09	16267468	16269569	BnaA09T0218400ZY	0	+	0	0	2101	0.0000000
zheyou73v0_A09	16272258	16276245	BnaA09T0218500ZY	0	+	0	0	3987	0.0000000
zheyou73v0_A09	16313905	16314157	BnaA09T0218600ZY	0	-	0	0	252	0.0000000
zheyou73v0_A09	16324193	16324929	BnaA09T0218700ZY	0	+	0	0	736	0.0000000
zheyou73v0_A09	16330954	16335613	BnaA09T0218800ZY	0	+	0	0	4659	0.0000000
zheyou73v0_A09	16338255	16339599	BnaA09T0218900ZY	0	+	0	0	1344	0.0000000
zheyou73v0_A09	16344299	16346658	BnaA09T0219000ZY	0	-	0	0	2359	0.0000000
zheyou73v0_A09	16348973	16349421	BnaA09T0219100ZY	0	-	0	0	448	0.0000000
zheyou73v0_A09	16370904	16371938	BnaA09T0219200ZY	0	+	0	0	1034	0.0000000
zheyou73v0_A09	16378627	16379365	BnaA09T0219300ZY	0	+	0	0	738	0.0000000
zheyou73v0_A09	16380228	16382839	BnaA09T0219400ZY	0	-	0	0	2611	0.0000000
zheyou73v0_A09	16383182	16385658	BnaA09T0219500ZY	0	+	0	0	2476	0.0000000
zheyou73v0_A09	16386728	16386890	BnaA09T0219600ZY	0	-	0	0	162	0.0000000
zheyou73v0_A09	16387595	16387880	BnaA09T0219700ZY	0	+	0	0	285	0.0000000
zheyou73v0_A09	16401373	16402077	BnaA09T0219800ZY	0	+	0	0	704	0.0000000
zheyou73v0_A09	16404594	16405544	BnaA09T0219900ZY	0	+	0	0	950	0.0000000
zheyou73v0_A09	16414432	16415480	BnaA09T0220000ZY	0	+	0	0	1048	0.0000000
zheyou73v0_A09	16424870	16427162	BnaA09T0220100ZY	0	+	0	0	2292	0.0000000
zheyou73v0_A09	16424870	16427162	BnaA09T0220100ZY.1	0	+	0	0	2292	0.0000000
zheyou73v0_A09	16461979	16462704	BnaA09T0220200ZY	0	+	0	0	725	0.0000000
zheyou73v0_A09	16467124	16468991	BnaA09T0220300ZY	0	-	0	0	1867	0.0000000
zheyou73v0_A09	16469611	16470046	BnaA09T0220400ZY	0	-	0	0	435	0.0000000
zheyou73v0_A09	16470737	16474359	BnaA09T0220500ZY	0	-	0	0	3622	0.0000000
zheyou73v0_A09	16475197	16479914	BnaA09T0220600ZY	0	-	0	0	4717	0.0000000
zheyou73v0_A09	16475197	16479914	BnaA09T0220600ZY.1	0	-	0	0	4717	0.0000000
zheyou73v0_A09	16480091	16482270	BnaA09T0220700ZY	0	+	0	0	2179	0.0000000
zheyou73v0_A09	16482759	16483329	BnaA09T0220800ZY	0	-	0	0	570	0.0000000
zheyou73v0_A09	16490275	16491565	BnaA09T0220900ZY	0	-	0	0	1290	0.0000000
zheyou73v0_A09	16492446	16493508	BnaA09T0221000ZY	0	+	0	0	1062	0.0000000
zheyou73v0_A09	16494107	16497310	BnaA09T0221100ZY	0	-	0	0	3203	0.0000000
zheyou73v0_A09	16494107	16497310	BnaA09T0221100ZY.1	0	-	0	0	3203	0.0000000
zheyou73v0_A09	16497621	16498856	BnaA09T0221200ZY	0	+	0	0	1235	0.0000000
zheyou73v0_A09	16499151	16500531	BnaA09T0221300ZY	0	+	0	0	1380	0.0000000
zheyou73v0_A09	16502390	16505266	BnaA09T0221400ZY	0	+	0	0	2876	0.0000000
zheyou73v0_A09	16506630	16510219	BnaA09T0221500ZY	0	+	0	0	3589	0.0000000
zheyou73v0_A09	16511019	16511588	BnaA09T0221600ZY	0	+	0	0	569	0.0000000
zheyou73v0_A09	16531391	16533344	BnaA09T0221700ZY	0	+	0	0	1953	0.0000000
zheyou73v0_A09	16631242	16632889	BnaA09T0221800ZY	0	+	0	0	1647	0.0000000
zheyou73v0_A09	16633100	16639209	BnaA09T0221900ZY.1	0	-	0	0	6109	0.0000000
zheyou73v0_A09	16633521	16639087	BnaA09T0221900ZY	0	-	0	0	5566	0.0000000
zheyou73v0_A09	16640278	16642403	BnaA09T0222000ZY	0	+	0	0	2125	0.0000000
zheyou73v0_A09	16644302	16645138	BnaA09T0222100ZY	0	-	0	0	836	0.0000000
zheyou73v0_A09	16645986	16647884	BnaA09T0222200ZY	0	-	0	0	1898	0.0000000
zheyou73v0_A09	16649989	16652272	BnaA09T0222300ZY	0	-	0	0	2283	0.0000000
zheyou73v0_A09	16655771	16657624	BnaA09T0222400ZY	0	+	0	0	1853	0.0000000
zheyou73v0_A09	16670996	16672127	BnaA09T0222500ZY	0	+	0	0	1131	0.0000000
zheyou73v0_A09	16676892	16677513	BnaA09T0222600ZY	0	-	0	0	621	0.0000000
zheyou73v0_A09	16681978	16682681	BnaA09T0222700ZY	0	+	0	0	703	0.0000000
zheyou73v0_A09	16682524	16684772	BnaA09T0222800ZY	0	-	0	0	2248	0.0000000
zheyou73v0_A09	16689444	16692222	BnaA09T0222900ZY	0	+	0	0	2778	0.0000000
zheyou73v0_A09	16692721	16696861	BnaA09T0223000ZY	0	-	0	0	4140	0.0000000
zheyou73v0_A09	16697270	16698974	BnaA09T0223100ZY	0	+	0	0	1704	0.0000000
zheyou73v0_A09	16697270	16698974	BnaA09T0223100ZY.1	0	+	0	0	1704	0.0000000
zheyou73v0_A09	16700410	16701964	BnaA09T0223200ZY	0	+	0	0	1554	0.0000000
zheyou73v0_A09	16704451	16706726	BnaA09T0223300ZY	0	-	0	0	2275	0.0000000
zheyou73v0_A09	16708802	16711514	BnaA09T0223400ZY	0	-	0	0	2712	0.0000000
zheyou73v0_A09	16719486	16721151	BnaA09T0223500ZY	0	-	0	0	1665	0.0000000
zheyou73v0_A09	16740687	16742431	BnaA09T0223600ZY	0	+	0	0	1744	0.0000000
zheyou73v0_A09	16750551	16752582	BnaA09T0223700ZY	0	+	0	0	2031	0.0000000
zheyou73v0_A09	16764513	16766449	BnaA09T0223800ZY	0	+	0	0	1936	0.0000000
zheyou73v0_A09	16782149	16791015	BnaA09T0223900ZY	0	+	0	0	8866	0.0000000
zheyou73v0_A09	16797186	16799459	BnaA09T0224000ZY	0	+	0	0	2273	0.0000000
zheyou73v0_A09	16823275	16824680	BnaA09T0224100ZY	0	-	0	0	1405	0.0000000
zheyou73v0_A09	16823275	16824680	BnaA09T0224100ZY.1	0	-	0	0	1405	0.0000000
zheyou73v0_A09	16838503	16840783	BnaA09T0224200ZY	0	-	0	0	2280	0.0000000
zheyou73v0_A09	16842424	16843008	BnaA09T0224300ZY	0	+	0	0	584	0.0000000
zheyou73v0_A09	16843751	16844978	BnaA09T0224400ZY	0	+	0	0	1227	0.0000000
zheyou73v0_A09	16845970	16849910	BnaA09T0224500ZY	0	-	0	0	3940	0.0000000
zheyou73v0_A09	16854271	16855357	BnaA09T0224600ZY	0	-	0	0	1086	0.0000000
zheyou73v0_A09	16871047	16871708	BnaA09T0224700ZY	0	-	0	0	661	0.0000000
zheyou73v0_A09	16873237	16874290	BnaA09T0224800ZY	0	-	0	0	1053	0.0000000
zheyou73v0_A09	16876372	16877961	BnaA09T0224900ZY	0	-	0	0	1589	0.0000000
zheyou73v0_A09	16886864	16888883	BnaA09T0225000ZY	0	-	0	0	2019	0.0000000
zheyou73v0_A09	16907384	16911044	BnaA09T0225100ZY	0	+	0	0	3660	0.0000000
zheyou73v0_A09	16911174	16911807	BnaA09T0225200ZY	0	-	0	0	633	0.0000000
zheyou73v0_A09	16913066	16918529	BnaA09T0225300ZY	0	-	0	0	5463	0.0000000
zheyou73v0_A09	16924796	16927005	BnaA09T0225400ZY	0	-	0	0	2209	0.0000000
zheyou73v0_A09	16936873	16940109	BnaA09T0225500ZY	0	-	0	0	3236	0.0000000
zheyou73v0_A09	16949598	16952898	BnaA09T0225600ZY	0	+	0	0	3300	0.0000000
zheyou73v0_A09	16953120	16954572	BnaA09T0225700ZY	0	-	0	0	1452	0.0000000
zheyou73v0_A09	16955131	16959913	BnaA09T0225800ZY	0	+	0	0	4782	0.0000000
zheyou73v0_A09	16965572	16972219	BnaA09T0225900ZY	0	+	0	0	6647	0.0000000
zheyou73v0_A09	16980196	16980692	BnaA09T0226000ZY	0	-	0	0	496	0.0000000
zheyou73v0_A09	16981970	16984859	BnaA09T0226100ZY	0	+	0	0	2889	0.0000000
zheyou73v0_A09	17020869	17022417	BnaA09T0226200ZY	0	+	0	0	1548	0.0000000
zheyou73v0_A09	17024114	17025851	BnaA09T0226300ZY	0	-	0	0	1737	0.0000000
zheyou73v0_A09	17028247	17035671	BnaA09T0226400ZY	0	-	0	0	7424	0.0000000
zheyou73v0_A09	17059570	17065260	BnaA09T0226500ZY	0	+	0	0	5690	0.0000000
zheyou73v0_A09	17068141	17069211	BnaA09T0226600ZY	0	+	0	0	1070	0.0000000
zheyou73v0_A09	17077064	17078222	BnaA09T0226700ZY	0	-	0	0	1158	0.0000000
zheyou73v0_A09	17093093	17099341	BnaA09T0226800ZY.1	0	+	0	0	6248	0.0000000
zheyou73v0_A09	17094081	17099341	BnaA09T0226800ZY	0	+	0	0	5260	0.0000000
zheyou73v0_A09	17099450	17103362	BnaA09T0226900ZY	0	-	0	0	3912	0.0000000
zheyou73v0_A09	17099450	17103362	BnaA09T0226900ZY.1	0	-	0	0	3912	0.0000000
zheyou73v0_A09	17099450	17103362	BnaA09T0226900ZY.2	0	-	0	0	3912	0.0000000
zheyou73v0_A09	17109447	17111666	BnaA09T0227000ZY	0	-	0	0	2219	0.0000000
zheyou73v0_A09	17109447	17111666	BnaA09T0227000ZY.1	0	-	0	0	2219	0.0000000
zheyou73v0_A09	17109447	17111666	BnaA09T0227000ZY.2	0	-	0	0	2219	0.0000000
zheyou73v0_A09	17125091	17127128	BnaA09T0227100ZY	0	+	0	0	2037	0.0000000
zheyou73v0_A09	17127133	17129414	BnaA09T0227200ZY	0	-	0	0	2281	0.0000000
zheyou73v0_A09	17130537	17135006	BnaA09T0227300ZY	0	-	0	0	4469	0.0000000
zheyou73v0_A09	17144014	17147979	BnaA09T0227400ZY	0	+	0	0	3965	0.0000000
zheyou73v0_A09	17148288	17149360	BnaA09T0227500ZY	0	-	0	0	1072	0.0000000
zheyou73v0_A09	17154691	17156720	BnaA09T0227600ZY	0	+	0	0	2029	0.0000000
zheyou73v0_A09	17156871	17160510	BnaA09T0227700ZY	0	-	0	0	3639	0.0000000
zheyou73v0_A09	17167047	17167257	BnaA09T0227800ZY	0	+	0	0	210	0.0000000
zheyou73v0_A09	17167789	17170407	BnaA09T0227900ZY	0	+	0	0	2618	0.0000000
zheyou73v0_A09	17176720	17189361	BnaA09T0228000ZY	0	+	0	0	12641	0.0000000
zheyou73v0_A09	17196287	17197394	BnaA09T0228100ZY	0	+	0	0	1107	0.0000000
zheyou73v0_A09	17197763	17199404	BnaA09T0228200ZY	0	-	0	0	1641	0.0000000
zheyou73v0_A09	17209955	17212175	BnaA09T0228300ZY	0	+	0	0	2220	0.0000000
zheyou73v0_A09	17240190	17244229	BnaA09T0228400ZY	0	-	0	0	4039	0.0000000
zheyou73v0_A09	17252476	17255243	BnaA09T0228500ZY	0	-	0	0	2767	0.0000000
zheyou73v0_A09	17272700	17273582	BnaA09T0228600ZY	0	+	0	0	882	0.0000000
zheyou73v0_A09	17285943	17288484	BnaA09T0228700ZY	0	+	0	0	2541	0.0000000
zheyou73v0_A09	17298810	17301303	BnaA09T0228800ZY	0	+	0	0	2493	0.0000000
zheyou73v0_A09	17305391	17306597	BnaA09T0228900ZY	0	-	0	0	1206	0.0000000
zheyou73v0_A09	17307281	17308567	BnaA09T0229000ZY	0	+	0	0	1286	0.0000000
zheyou73v0_A09	17308782	17311301	BnaA09T0229100ZY	0	-	0	0	2519	0.0000000
zheyou73v0_A09	17313819	17316682	BnaA09T0229200ZY	0	-	0	0	2863	0.0000000
zheyou73v0_A09	17333914	17337074	BnaA09T0229300ZY	0	+	0	0	3160	0.0000000
zheyou73v0_A09	17342052	17342620	BnaA09T0229400ZY	0	+	0	0	568	0.0000000
zheyou73v0_A09	17366021	17367438	BnaA09T0229500ZY	0	+	0	0	1417	0.0000000
zheyou73v0_A09	17366021	17367438	BnaA09T0229500ZY.1	0	+	0	0	1417	0.0000000
zheyou73v0_A09	17366021	17367438	BnaA09T0229500ZY.2	0	+	0	0	1417	0.0000000
zheyou73v0_A09	17367372	17368293	BnaA09T0229600ZY	0	-	0	0	921	0.0000000
zheyou73v0_A09	17368581	17369022	BnaA09T0229700ZY	0	+	0	0	441	0.0000000
zheyou73v0_A09	17369386	17370543	BnaA09T0229800ZY	0	-	0	0	1157	0.0000000
zheyou73v0_A09	17372274	17374242	BnaA09T0229900ZY	0	-	0	0	1968	0.0000000
zheyou73v0_A09	17372274	17374242	BnaA09T0229900ZY.1	0	-	0	0	1968	0.0000000
zheyou73v0_A09	17374468	17377578	BnaA09T0230000ZY	0	-	0	0	3110	0.0000000
zheyou73v0_A09	17382107	17384194	BnaA09T0230100ZY	0	-	0	0	2087	0.0000000
zheyou73v0_A09	17386187	17390275	BnaA09T0230200ZY	0	-	0	0	4088	0.0000000
zheyou73v0_A09	17386187	17390275	BnaA09T0230200ZY.1	0	-	0	0	4088	0.0000000
zheyou73v0_A09	17394748	17396735	BnaA09T0230300ZY	0	-	0	0	1987	0.0000000
zheyou73v0_A09	17398929	17400523	BnaA09T0230400ZY	0	-	0	0	1594	0.0000000
zheyou73v0_A09	17401441	17404027	BnaA09T0230500ZY	0	-	0	0	2586	0.0000000
zheyou73v0_A09	17406119	17408342	BnaA09T0230600ZY	0	+	0	0	2223	0.0000000
zheyou73v0_A09	17406119	17408772	BnaA09T0230600ZY.1	0	+	0	0	2653	0.0000000
zheyou73v0_A09	17410352	17413872	BnaA09T0230700ZY	0	+	0	0	3520	0.0000000
zheyou73v0_A09	17410352	17413872	BnaA09T0230700ZY.1	0	+	0	0	3520	0.0000000
zheyou73v0_A09	17428157	17429688	BnaA09T0230800ZY	0	+	0	0	1531	0.0000000
zheyou73v0_A09	17428157	17429688	BnaA09T0230800ZY.1	0	+	0	0	1531	0.0000000
zheyou73v0_A09	17429830	17438836	BnaA09T0230900ZY	0	-	0	0	9006	0.0000000
zheyou73v0_A09	17439751	17442265	BnaA09T0231000ZY	0	-	0	0	2514	0.0000000
zheyou73v0_A09	17439751	17442265	BnaA09T0231000ZY.1	0	-	0	0	2514	0.0000000
zheyou73v0_A09	17448150	17449659	BnaA09T0231100ZY	0	+	0	0	1509	0.0000000
zheyou73v0_A09	17449784	17451599	BnaA09T0231200ZY	0	-	0	0	1815	0.0000000
zheyou73v0_A09	17453268	17453529	BnaA09T0231300ZY	0	+	0	0	261	0.0000000
zheyou73v0_A09	17458620	17461322	BnaA09T0231400ZY	0	+	0	0	2702	0.0000000
zheyou73v0_A09	17469623	17472419	BnaA09T0231500ZY	0	+	0	0	2796	0.0000000
zheyou73v0_A09	17475685	17476600	BnaA09T0231600ZY	0	+	0	0	915	0.0000000
zheyou73v0_A09	17489963	17491104	BnaA09T0231700ZY	0	-	0	0	1141	0.0000000
zheyou73v0_A09	17497765	17501149	BnaA09T0231800ZY	0	-	0	0	3384	0.0000000
zheyou73v0_A09	17502827	17503202	BnaA09T0231900ZY	0	-	0	0	375	0.0000000
zheyou73v0_A09	17508407	17512212	BnaA09T0232000ZY	0	-	0	0	3805	0.0000000
zheyou73v0_A09	17512996	17513779	BnaA09T0232100ZY	0	-	0	0	783	0.0000000
zheyou73v0_A09	17515945	17518110	BnaA09T0232200ZY	0	+	0	0	2165	0.0000000
zheyou73v0_A09	17526963	17527801	BnaA09T0232300ZY	0	+	0	0	838	0.0000000
zheyou73v0_A09	17527847	17531169	BnaA09T0232400ZY	0	-	0	0	3322	0.0000000
zheyou73v0_A09	17527847	17531169	BnaA09T0232400ZY.1	0	-	0	0	3322	0.0000000
zheyou73v0_A09	17532054	17542509	BnaA09T0232500ZY	0	+	0	0	10455	0.0000000
zheyou73v0_A09	17548012	17549246	BnaA09T0232600ZY	0	+	0	0	1234	0.0000000
zheyou73v0_A09	17558861	17559504	BnaA09T0232700ZY	0	-	0	0	643	0.0000000
zheyou73v0_A09	17590859	17591260	BnaA09T0232800ZY	0	-	0	0	401	0.0000000
zheyou73v0_A09	17592599	17594243	BnaA09T0232900ZY	0	+	0	0	1644	0.0000000
zheyou73v0_A09	17608986	17609786	BnaA09T0233000ZY	0	+	0	0	800	0.0000000
zheyou73v0_A09	17644281	17645314	BnaA09T0233100ZY	0	+	0	0	1033	0.0000000
zheyou73v0_A09	17661385	17661764	BnaA09T0233200ZY	0	-	0	0	379	0.0000000
zheyou73v0_A09	17679355	17682852	BnaA09T0233300ZY	0	+	0	0	3497	0.0000000
zheyou73v0_A09	17682930	17684110	BnaA09T0233400ZY	0	-	0	0	1180	0.0000000
zheyou73v0_A09	17687248	17691067	BnaA09T0233500ZY	0	-	0	0	3819	0.0000000
zheyou73v0_A09	17703953	17704803	BnaA09T0233600ZY	0	+	0	0	850	0.0000000
zheyou73v0_A09	17706903	17707446	BnaA09T0233700ZY	0	+	0	0	543	0.0000000
zheyou73v0_A09	17712132	17712964	BnaA09T0233800ZY	0	-	0	0	832	0.0000000
zheyou73v0_A09	17716084	17717123	BnaA09T0233900ZY	0	-	0	0	1039	0.0000000
zheyou73v0_A09	17718585	17721167	BnaA09T0234000ZY	0	-	0	0	2582	0.0000000
zheyou73v0_A09	17732844	17733911	BnaA09T0234100ZY	0	+	0	0	1067	0.0000000
zheyou73v0_A09	17775803	17776013	BnaA09T0234200ZY	0	+	0	0	210	0.0000000
zheyou73v0_A09	17776039	17777721	BnaA09T0234300ZY	0	+	0	0	1682	0.0000000
zheyou73v0_A09	17777743	17778190	BnaA09T0234400ZY	0	+	0	0	447	0.0000000
zheyou73v0_A09	17794726	17796496	BnaA09T0234500ZY	0	+	0	0	1770	0.0000000
zheyou73v0_A09	17800703	17801286	BnaA09T0234600ZY	0	+	0	0	583	0.0000000
zheyou73v0_A09	17812942	17813641	BnaA09T0234700ZY	0	+	0	0	699	0.0000000
zheyou73v0_A09	17814667	17816963	BnaA09T0234800ZY	0	+	0	0	2296	0.0000000
zheyou73v0_A09	17817940	17819814	BnaA09T0234900ZY.1	0	-	0	0	1874	0.0000000
zheyou73v0_A09	17817951	17819814	BnaA09T0234900ZY	0	-	0	0	1863	0.0000000
zheyou73v0_A09	17822169	17822818	BnaA09T0235000ZY	0	+	0	0	649	0.0000000
zheyou73v0_A09	17827861	17831767	BnaA09T0235100ZY	0	+	0	0	3906	0.0000000
zheyou73v0_A09	17832338	17838066	BnaA09T0235200ZY	0	-	0	0	5728	0.0000000
zheyou73v0_A09	17858069	17859201	BnaA09T0235300ZY	0	+	0	0	1132	0.0000000
zheyou73v0_A09	17867796	17868324	BnaA09T0235400ZY	0	-	0	0	528	0.0000000
zheyou73v0_A09	17868683	17872683	BnaA09T0235500ZY	0	+	0	0	4000	0.0000000
zheyou73v0_A09	17884808	17887219	BnaA09T0235600ZY	0	-	0	0	2411	0.0000000
zheyou73v0_A09	17884808	17887219	BnaA09T0235600ZY.1	0	-	0	0	2411	0.0000000
zheyou73v0_A09	17894741	17895344	BnaA09T0235700ZY	0	+	0	0	603	0.0000000
zheyou73v0_A09	17895875	17904741	BnaA09T0235800ZY	0	-	0	0	8866	0.0000000
zheyou73v0_A09	17909240	17913939	BnaA09T0235900ZY	0	+	0	0	4699	0.0000000
zheyou73v0_A09	17915131	17917804	BnaA09T0236000ZY	0	+	0	0	2673	0.0000000
zheyou73v0_A09	17915131	17917804	BnaA09T0236000ZY.1	0	+	0	0	2673	0.0000000
zheyou73v0_A09	17927326	17930704	BnaA09T0236100ZY	0	+	0	0	3378	0.0000000
zheyou73v0_A09	17931090	17932854	BnaA09T0236200ZY	0	+	0	0	1764	0.0000000
zheyou73v0_A09	17933866	17934808	BnaA09T0236300ZY	0	+	0	0	942	0.0000000
zheyou73v0_A09	17939248	17942172	BnaA09T0236400ZY	0	+	0	0	2924	0.0000000
zheyou73v0_A09	17945331	17946865	BnaA09T0236500ZY	0	-	0	0	1534	0.0000000
zheyou73v0_A09	17958551	17965718	BnaA09T0236600ZY	0	-	0	0	7167	0.0000000
zheyou73v0_A09	17958551	17965780	BnaA09T0236600ZY.1	0	-	0	0	7229	0.0000000
zheyou73v0_A09	17988365	17988843	BnaA09T0236700ZY	0	+	0	0	478	0.0000000
zheyou73v0_A09	18000686	18004334	BnaA09T0236800ZY	0	+	0	0	3648	0.0000000
zheyou73v0_A09	18000686	18004334	BnaA09T0236800ZY.1	0	+	0	0	3648	0.0000000
zheyou73v0_A09	18022019	18024143	BnaA09T0236900ZY	0	+	0	0	2124	0.0000000
zheyou73v0_A09	18029486	18032617	BnaA09T0237000ZY	0	+	0	0	3131	0.0000000
zheyou73v0_A09	18033269	18036254	BnaA09T0237100ZY	0	-	0	0	2985	0.0000000
zheyou73v0_A09	18040337	18045716	BnaA09T0237200ZY	0	+	0	0	5379	0.0000000
zheyou73v0_A09	18046091	18048373	BnaA09T0237300ZY	0	-	0	0	2282	0.0000000
zheyou73v0_A09	18050054	18050957	BnaA09T0237400ZY	0	-	0	0	903	0.0000000
zheyou73v0_A09	18066764	18069041	BnaA09T0237500ZY	0	-	0	0	2277	0.0000000
zheyou73v0_A09	18105435	18106074	BnaA09T0237600ZY	0	+	0	0	639	0.0000000
zheyou73v0_A09	18108694	18111650	BnaA09T0237700ZY	0	-	0	0	2956	0.0000000
zheyou73v0_A09	18108694	18111650	BnaA09T0237700ZY.1	0	-	0	0	2956	0.0000000
zheyou73v0_A09	18123051	18126926	BnaA09T0237800ZY	0	-	0	0	3875	0.0000000
zheyou73v0_A09	18128390	18130206	BnaA09T0237900ZY	0	-	0	0	1816	0.0000000
zheyou73v0_A09	18132404	18132653	BnaA09T0238000ZY	0	-	0	0	249	0.0000000
zheyou73v0_A09	18143556	18146060	BnaA09T0238100ZY	0	+	0	0	2504	0.0000000
zheyou73v0_A09	18143556	18146060	BnaA09T0238100ZY.1	0	+	0	0	2504	0.0000000
zheyou73v0_A09	18143556	18146060	BnaA09T0238100ZY.2	0	+	0	0	2504	0.0000000
zheyou73v0_A09	18146328	18154237	BnaA09T0238200ZY	0	+	0	0	7909	0.0000000
zheyou73v0_A09	18154376	18155862	BnaA09T0238300ZY	0	-	0	0	1486	0.0000000
zheyou73v0_A09	18170026	18171538	BnaA09T0238400ZY	0	-	0	0	1512	0.0000000
zheyou73v0_A09	18188575	18199958	BnaA09T0238500ZY	0	-	0	0	11383	0.0000000
zheyou73v0_A09	18217217	18218680	BnaA09T0238600ZY	0	-	0	0	1463	0.0000000
zheyou73v0_A09	18221355	18225532	BnaA09T0238700ZY	0	-	0	0	4177	0.0000000
zheyou73v0_A09	18231657	18233287	BnaA09T0238800ZY	0	-	0	0	1630	0.0000000
zheyou73v0_A09	18238291	18239203	BnaA09T0238900ZY	0	+	0	0	912	0.0000000
zheyou73v0_A09	18253961	18255021	BnaA09T0239000ZY	0	+	0	0	1060	0.0000000
zheyou73v0_A09	18262475	18263536	BnaA09T0239100ZY	0	+	0	0	1061	0.0000000
zheyou73v0_A09	18272641	18274962	BnaA09T0239200ZY	0	+	0	0	2321	0.0000000
zheyou73v0_A09	18275825	18277049	BnaA09T0239300ZY	0	+	0	0	1224	0.0000000
zheyou73v0_A09	18288614	18289742	BnaA09T0239400ZY	0	-	0	0	1128	0.0000000
zheyou73v0_A09	18297178	18298037	BnaA09T0239500ZY	0	-	0	0	859	0.0000000
zheyou73v0_A09	18309348	18313903	BnaA09T0239600ZY	0	+	0	0	4555	0.0000000
zheyou73v0_A09	18309348	18313579	BnaA09T0239600ZY.1	0	+	0	0	4231	0.0000000
zheyou73v0_A09	18314854	18317151	BnaA09T0239700ZY	0	+	0	0	2297	0.0000000
zheyou73v0_A09	18314854	18317151	BnaA09T0239700ZY.1	0	+	0	0	2297	0.0000000
zheyou73v0_A09	18317725	18320081	BnaA09T0239800ZY	0	+	0	0	2356	0.0000000
zheyou73v0_A09	18328689	18331243	BnaA09T0239900ZY	0	+	0	0	2554	0.0000000
zheyou73v0_A09	18339626	18340808	BnaA09T0240000ZY	0	-	0	0	1182	0.0000000
zheyou73v0_A09	18386912	18387193	BnaA09T0240100ZY	0	-	0	0	281	0.0000000
zheyou73v0_A09	18389972	18390146	BnaA09T0240200ZY	0	+	0	0	174	0.0000000
zheyou73v0_A09	18397194	18397410	BnaA09T0240300ZY	0	+	0	0	216	0.0000000
zheyou73v0_A09	18405533	18405737	BnaA09T0240400ZY	0	-	0	0	204	0.0000000
zheyou73v0_A09	18421190	18422967	BnaA09T0240500ZY	0	-	0	0	1777	0.0000000
zheyou73v0_A09	18428685	18433588	BnaA09T0240600ZY	0	-	0	0	4903	0.0000000
zheyou73v0_A09	18449483	18450342	BnaA09T0240700ZY	0	-	0	0	859	0.0000000
zheyou73v0_A09	18450895	18453598	BnaA09T0240800ZY	0	+	0	0	2703	0.0000000
zheyou73v0_A09	18458910	18462004	BnaA09T0240900ZY	0	-	0	0	3094	0.0000000
zheyou73v0_A09	18479324	18481257	BnaA09T0241000ZY	0	-	0	0	1933	0.0000000
zheyou73v0_A09	18481994	18484434	BnaA09T0241100ZY	0	+	0	0	2440	0.0000000
zheyou73v0_A09	18492505	18493668	BnaA09T0241200ZY	0	+	0	0	1163	0.0000000
zheyou73v0_A09	18494960	18496636	BnaA09T0241300ZY	0	-	0	0	1676	0.0000000
zheyou73v0_A09	18502177	18504124	BnaA09T0241400ZY	0	-	0	0	1947	0.0000000
zheyou73v0_A09	18512502	18517775	BnaA09T0241500ZY	0	-	0	0	5273	0.0000000
zheyou73v0_A09	18525733	18526746	BnaA09T0241600ZY	0	-	0	0	1013	0.0000000
zheyou73v0_A09	18532768	18534785	BnaA09T0241700ZY	0	+	0	0	2017	0.0000000
zheyou73v0_A09	18535232	18536528	BnaA09T0241800ZY	0	-	0	0	1296	0.0000000
zheyou73v0_A09	18540449	18543914	BnaA09T0241900ZY	0	+	0	0	3465	0.0000000
zheyou73v0_A09	18553050	18554242	BnaA09T0242000ZY	0	+	0	0	1192	0.0000000
zheyou73v0_A09	18573121	18576881	BnaA09T0242100ZY	0	-	0	0	3760	0.0000000
zheyou73v0_A09	18578666	18579203	BnaA09T0242200ZY	0	-	0	0	537	0.0000000
zheyou73v0_A09	18592912	18593958	BnaA09T0242300ZY	0	+	0	0	1046	0.0000000
zheyou73v0_A09	18618172	18621416	BnaA09T0242400ZY	0	+	0	0	3244	0.0000000
zheyou73v0_A09	18636805	18637857	BnaA09T0242500ZY	0	-	0	0	1052	0.0000000
zheyou73v0_A09	18639436	18640124	BnaA09T0242600ZY	0	+	0	0	688	0.0000000
zheyou73v0_A09	18649931	18651518	BnaA09T0242700ZY	0	-	0	0	1587	0.0000000
zheyou73v0_A09	18651740	18655928	BnaA09T0242800ZY	0	-	0	0	4188	0.0000000
zheyou73v0_A09	18651740	18655928	BnaA09T0242800ZY.1	0	-	0	0	4188	0.0000000
zheyou73v0_A09	18657139	18659744	BnaA09T0242900ZY	0	-	0	0	2605	0.0000000
zheyou73v0_A09	18660857	18666046	BnaA09T0243000ZY	0	-	0	0	5189	0.0000000
zheyou73v0_A09	18660857	18666046	BnaA09T0243000ZY.1	0	-	0	0	5189	0.0000000
zheyou73v0_A09	18682826	18683764	BnaA09T0243100ZY	0	+	0	0	938	0.0000000
zheyou73v0_A09	18688124	18689982	BnaA09T0243200ZY	0	+	0	0	1858	0.0000000
zheyou73v0_A09	18690235	18692242	BnaA09T0243300ZY	0	+	0	0	2007	0.0000000
zheyou73v0_A09	18692707	18693865	BnaA09T0243400ZY	0	+	0	0	1158	0.0000000
zheyou73v0_A09	18698750	18699463	BnaA09T0243500ZY	0	+	0	0	713	0.0000000
zheyou73v0_A09	18708726	18710803	BnaA09T0243600ZY	0	-	0	0	2077	0.0000000
zheyou73v0_A09	18727545	18732092	BnaA09T0243700ZY	0	-	0	0	4547	0.0000000
zheyou73v0_A09	18735396	18735630	BnaA09T0243800ZY	0	+	0	0	234	0.0000000
zheyou73v0_A09	18736077	18737784	BnaA09T0243900ZY	0	-	0	0	1707	0.0000000
zheyou73v0_A09	18748229	18749617	BnaA09T0244000ZY	0	+	0	0	1388	0.0000000
zheyou73v0_A09	18748229	18749922	BnaA09T0244000ZY.1	0	+	0	0	1693	0.0000000
zheyou73v0_A09	18771419	18772582	BnaA09T0244100ZY	0	-	0	0	1163	0.0000000
zheyou73v0_A09	18791055	18793808	BnaA09T0244200ZY	0	+	0	0	2753	0.0000000
zheyou73v0_A09	18794090	18796024	BnaA09T0244300ZY	0	+	0	0	1934	0.0000000
zheyou73v0_A09	18794260	18796024	BnaA09T0244300ZY.1	0	+	0	0	1764	0.0000000
zheyou73v0_A09	18796608	18798673	BnaA09T0244400ZY	0	+	0	0	2065	0.0000000
zheyou73v0_A09	18804126	18805127	BnaA09T0244500ZY	0	+	0	0	1001	0.0000000
zheyou73v0_A09	18809247	18809674	BnaA09T0244600ZY	0	-	0	0	427	0.0000000
zheyou73v0_A09	18811430	18813390	BnaA09T0244700ZY	0	-	0	0	1960	0.0000000
zheyou73v0_A09	18822825	18824627	BnaA09T0244800ZY	0	-	0	0	1802	0.0000000
zheyou73v0_A09	18822825	18824627	BnaA09T0244800ZY.1	0	-	0	0	1802	0.0000000
zheyou73v0_A09	18840031	18840541	BnaA09T0244900ZY	0	-	0	0	510	0.0000000
zheyou73v0_A09	18847886	18848382	BnaA09T0245000ZY	0	-	0	0	496	0.0000000
zheyou73v0_A09	18850865	18852371	BnaA09T0245100ZY	0	-	0	0	1506	0.0000000
zheyou73v0_A09	18858992	18860586	BnaA09T0245200ZY	0	+	0	0	1594	0.0000000
zheyou73v0_A09	18862257	18870192	BnaA09T0245300ZY	0	-	0	0	7935	0.0000000
zheyou73v0_A09	18870740	18871697	BnaA09T0245400ZY	0	+	0	0	957	0.0000000
zheyou73v0_A09	18874097	18875633	BnaA09T0245500ZY	0	-	0	0	1536	0.0000000
zheyou73v0_A09	18891534	18894045	BnaA09T0245600ZY	0	+	0	0	2511	0.0000000
zheyou73v0_A09	18920600	18923111	BnaA09T0245700ZY	0	-	0	0	2511	0.0000000
zheyou73v0_A09	18933469	18935985	BnaA09T0245800ZY	0	+	0	0	2516	0.0000000
zheyou73v0_A09	18933469	18935985	BnaA09T0245800ZY.1	0	+	0	0	2516	0.0000000
zheyou73v0_A09	18933469	18935985	BnaA09T0245800ZY.2	0	+	0	0	2516	0.0000000
zheyou73v0_A09	18933469	18935985	BnaA09T0245800ZY.3	0	+	0	0	2516	0.0000000
zheyou73v0_A09	18935569	18935998	BnaA09T0245900ZY	0	-	0	0	429	0.0000000
zheyou73v0_A09	18949554	18953963	BnaA09T0246000ZY	0	+	0	0	4409	0.0000000
zheyou73v0_A09	18949554	18953963	BnaA09T0246000ZY.1	0	+	0	0	4409	0.0000000
zheyou73v0_A09	18954923	18957987	BnaA09T0246100ZY	0	+	0	0	3064	0.0000000
zheyou73v0_A09	18958555	18960022	BnaA09T0246200ZY	0	-	0	0	1467	0.0000000
zheyou73v0_A09	18970359	18972674	BnaA09T0246300ZY	0	-	0	0	2315	0.0000000
zheyou73v0_A09	18974120	18977728	BnaA09T0246400ZY	0	+	0	0	3608	0.0000000
zheyou73v0_A09	18982202	18983027	BnaA09T0246500ZY	0	-	0	0	825	0.0000000
zheyou73v0_A09	18998610	19000321	BnaA09T0246600ZY	0	-	0	0	1711	0.0000000
zheyou73v0_A09	19001960	19006050	BnaA09T0246700ZY	0	+	0	0	4090	0.0000000
zheyou73v0_A09	19010662	19012403	BnaA09T0246800ZY	0	-	0	0	1741	0.0000000
zheyou73v0_A09	19021270	19029442	BnaA09T0246900ZY	0	+	0	0	8172	0.0000000
zheyou73v0_A09	19029495	19030401	BnaA09T0247000ZY	0	+	0	0	906	0.0000000
zheyou73v0_A09	19031258	19033151	BnaA09T0247100ZY	0	+	0	0	1893	0.0000000
zheyou73v0_A09	19033465	19036124	BnaA09T0247200ZY	0	-	0	0	2659	0.0000000
zheyou73v0_A09	19053783	19055500	BnaA09T0247300ZY	0	-	0	0	1717	0.0000000
zheyou73v0_A09	19091571	19092437	BnaA09T0247400ZY	0	+	0	0	866	0.0000000
zheyou73v0_A09	19100797	19102184	BnaA09T0247500ZY	0	-	0	0	1387	0.0000000
zheyou73v0_A09	19116339	19117593	BnaA09T0247600ZY	0	-	0	0	1254	0.0000000
zheyou73v0_A09	19124788	19126276	BnaA09T0247700ZY	0	-	0	0	1488	0.0000000
zheyou73v0_A09	19133697	19134285	BnaA09T0247800ZY	0	-	0	0	588	0.0000000
zheyou73v0_A09	19135663	19136664	BnaA09T0247900ZY	0	+	0	0	1001	0.0000000
zheyou73v0_A09	19137623	19139946	BnaA09T0248000ZY	0	+	0	0	2323	0.0000000
zheyou73v0_A09	19142130	19143582	BnaA09T0248100ZY	0	+	0	0	1452	0.0000000
zheyou73v0_A09	19150329	19153454	BnaA09T0248200ZY	0	+	0	0	3125	0.0000000
zheyou73v0_A09	19153659	19155453	BnaA09T0248300ZY	0	-	0	0	1794	0.0000000
zheyou73v0_A09	19178263	19181437	BnaA09T0248400ZY	0	-	0	0	3174	0.0000000
zheyou73v0_A09	19251845	19252698	BnaA09T0248500ZY	0	+	0	0	853	0.0000000
zheyou73v0_A09	19255044	19265074	BnaA09T0248600ZY	0	-	0	0	10030	0.0000000
zheyou73v0_A09	19298190	19299013	BnaA09T0248700ZY	0	+	0	0	823	0.0000000
zheyou73v0_A09	19315622	19327335	BnaA09T0248800ZY	0	-	0	0	11713	0.0000000
zheyou73v0_A09	19333527	19334403	BnaA09T0248900ZY	0	+	0	0	876	0.0000000
zheyou73v0_A09	19338760	19339778	BnaA09T0249000ZY	0	+	0	0	1018	0.0000000
zheyou73v0_A09	19340058	19343241	BnaA09T0249100ZY	0	-	0	0	3183	0.0000000
zheyou73v0_A09	19350646	19351412	BnaA09T0249200ZY	0	-	0	0	766	0.0000000
zheyou73v0_A09	19361312	19363420	BnaA09T0249300ZY	0	+	0	0	2108	0.0000000
zheyou73v0_A09	19361312	19364759	BnaA09T0249400ZY	0	-	0	0	3447	0.0000000
zheyou73v0_A09	19361312	19364759	BnaA09T0249400ZY.1	0	-	0	0	3447	0.0000000
zheyou73v0_A09	19364788	19366583	BnaA09T0249500ZY	0	-	0	0	1795	0.0000000
zheyou73v0_A09	19364788	19366583	BnaA09T0249500ZY.1	0	-	0	0	1795	0.0000000
zheyou73v0_A09	19364788	19366605	BnaA09T0249500ZY.2	0	-	0	0	1817	0.0000000
zheyou73v0_A09	19364788	19366605	BnaA09T0249500ZY.3	0	-	0	0	1817	0.0000000
zheyou73v0_A09	19379649	19382076	BnaA09T0249600ZY	0	+	0	0	2427	0.0000000
zheyou73v0_A09	19403844	19404379	BnaA09T0249700ZY	0	-	0	0	535	0.0000000
zheyou73v0_A09	19424557	19428453	BnaA09T0249800ZY	0	+	0	0	3896	0.0000000
zheyou73v0_A09	19424557	19428453	BnaA09T0249800ZY.1	0	+	0	0	3896	0.0000000
zheyou73v0_A09	19424557	19428453	BnaA09T0249800ZY.2	0	+	0	0	3896	0.0000000
zheyou73v0_A09	19439260	19443921	BnaA09T0249900ZY	0	+	0	0	4661	0.0000000
zheyou73v0_A09	19443594	19445696	BnaA09T0250000ZY	0	-	0	0	2102	0.0000000
zheyou73v0_A09	19493884	19495784	BnaA09T0250100ZY	0	+	0	0	1900	0.0000000
zheyou73v0_A09	19493884	19495784	BnaA09T0250100ZY.1	0	+	0	0	1900	0.0000000
zheyou73v0_A09	19493884	19495784	BnaA09T0250100ZY.2	0	+	0	0	1900	0.0000000
zheyou73v0_A09	19507434	19510223	BnaA09T0250200ZY	0	+	0	0	2789	0.0000000
zheyou73v0_A09	19531400	19534057	BnaA09T0250300ZY	0	-	0	0	2657	0.0000000
zheyou73v0_A09	19538579	19539093	BnaA09T0250400ZY	0	+	0	0	514	0.0000000
zheyou73v0_A09	19553968	19555631	BnaA09T0250500ZY	0	-	0	0	1663	0.0000000
zheyou73v0_A09	19571809	19571968	BnaA09T0250600ZY	0	-	0	0	159	0.0000000
zheyou73v0_A09	19575725	19576319	BnaA09T0250700ZY	0	+	0	0	594	0.0000000
zheyou73v0_A09	19581641	19585399	BnaA09T0250800ZY	0	-	0	0	3758	0.0000000
zheyou73v0_A09	19587325	19592069	BnaA09T0250900ZY	0	+	0	0	4744	0.0000000
zheyou73v0_A09	19596885	19598462	BnaA09T0251000ZY	0	-	0	0	1577	0.0000000
zheyou73v0_A09	19603874	19604741	BnaA09T0251100ZY	0	+	0	0	867	0.0000000
zheyou73v0_A09	19639594	19640342	BnaA09T0251200ZY	0	+	0	0	748	0.0000000
zheyou73v0_A09	19654160	19655932	BnaA09T0251300ZY	0	+	0	0	1772	0.0000000
zheyou73v0_A09	19655652	19659302	BnaA09T0251400ZY.1	0	-	0	0	3650	0.0000000
zheyou73v0_A09	19655879	19659302	BnaA09T0251400ZY	0	-	0	0	3423	0.0000000
zheyou73v0_A09	19655879	19659302	BnaA09T0251400ZY.2	0	-	0	0	3423	0.0000000
zheyou73v0_A09	19665839	19667442	BnaA09T0251500ZY	0	-	0	0	1603	0.0000000
zheyou73v0_A09	19699548	19705424	BnaA09T0251600ZY	0	-	0	0	5876	0.0000000
zheyou73v0_A09	19719875	19720619	BnaA09T0251700ZY	0	-	0	0	744	0.0000000
zheyou73v0_A09	19738361	19739504	BnaA09T0251800ZY	0	-	0	0	1143	0.0000000
zheyou73v0_A09	19756765	19758093	BnaA09T0251900ZY	0	-	0	0	1328	0.0000000
zheyou73v0_A09	19758882	19762120	BnaA09T0252000ZY	0	+	0	0	3238	0.0000000
zheyou73v0_A09	19766166	19767271	BnaA09T0252100ZY	0	+	0	0	1105	0.0000000
zheyou73v0_A09	19776205	19777147	BnaA09T0252200ZY	0	+	0	0	942	0.0000000
zheyou73v0_A09	19798044	19798529	BnaA09T0252300ZY	0	+	0	0	485	0.0000000
zheyou73v0_A09	19800669	19805068	BnaA09T0252400ZY	0	-	0	0	4399	0.0000000
zheyou73v0_A09	19814077	19814601	BnaA09T0252500ZY	0	-	0	0	524	0.0000000
zheyou73v0_A09	19815783	19816220	BnaA09T0252600ZY	0	-	0	0	437	0.0000000
zheyou73v0_A09	19845791	19847513	BnaA09T0252700ZY	0	+	0	0	1722	0.0000000
zheyou73v0_A09	19853691	19854222	BnaA09T0252800ZY	0	+	0	0	531	0.0000000
zheyou73v0_A09	19854796	19854952	BnaA09T0252900ZY	0	-	0	0	156	0.0000000
zheyou73v0_A09	19857804	19859633	BnaA09T0253000ZY	0	+	0	0	1829	0.0000000
zheyou73v0_A09	19864722	19867801	BnaA09T0253100ZY	0	+	0	0	3079	0.0000000
zheyou73v0_A09	19911932	19914996	BnaA09T0253200ZY	0	+	0	0	3064	0.0000000
zheyou73v0_A09	19971110	19972839	BnaA09T0253300ZY	0	+	0	0	1729	0.0000000
zheyou73v0_A09	19983022	19984190	BnaA09T0253400ZY	0	+	0	0	1168	0.0000000
zheyou73v0_A09	20017840	20027447	BnaA09T0253500ZY	0	-	0	0	9607	0.0000000
zheyou73v0_A09	20044475	20044814	BnaA09T0253600ZY	0	-	0	0	339	0.0000000
zheyou73v0_A09	20047406	20047676	BnaA09T0253700ZY	0	-	0	0	270	0.0000000
zheyou73v0_A09	20053940	20055128	BnaA09T0253800ZY.1	0	+	0	0	1188	0.0000000
zheyou73v0_A09	20053943	20055128	BnaA09T0253800ZY	0	+	0	0	1185	0.0000000
zheyou73v0_A09	20068126	20069048	BnaA09T0253900ZY	0	-	0	0	922	0.0000000
zheyou73v0_A09	20083376	20085263	BnaA09T0254000ZY	0	-	0	0	1887	0.0000000
zheyou73v0_A09	20083376	20085263	BnaA09T0254000ZY.1	0	-	0	0	1887	0.0000000
zheyou73v0_A09	20091014	20092216	BnaA09T0254100ZY	0	-	0	0	1202	0.0000000
zheyou73v0_A09	20129146	20130061	BnaA09T0254200ZY	0	-	0	0	915	0.0000000
zheyou73v0_A09	20146564	20148044	BnaA09T0254300ZY	0	+	0	0	1480	0.0000000
zheyou73v0_A09	20158216	20161280	BnaA09T0254400ZY	0	-	0	0	3064	0.0000000
zheyou73v0_A09	20158216	20160672	BnaA09T0254400ZY.1	0	-	0	0	2456	0.0000000
zheyou73v0_A09	20171814	20172867	BnaA09T0254500ZY	0	-	0	0	1053	0.0000000
zheyou73v0_A09	20195066	20195871	BnaA09T0254600ZY	0	+	0	0	805	0.0000000
zheyou73v0_A09	20197089	20197371	BnaA09T0254700ZY	0	+	0	0	282	0.0000000
zheyou73v0_A09	20197995	20198558	BnaA09T0254800ZY	0	-	0	0	563	0.0000000
zheyou73v0_A09	20229071	20231567	BnaA09T0254900ZY	0	+	0	0	2496	0.0000000
zheyou73v0_A09	20233119	20234825	BnaA09T0255000ZY	0	+	0	0	1706	0.0000000
zheyou73v0_A09	20238835	20242881	BnaA09T0255100ZY	0	-	0	0	4046	0.0000000
zheyou73v0_A09	20275199	20280966	BnaA09T0255200ZY	0	-	0	0	5767	0.0000000
zheyou73v0_A09	20288681	20289963	BnaA09T0255300ZY	0	+	0	0	1282	0.0000000
zheyou73v0_A09	20334279	20334708	BnaA09T0255400ZY	0	-	0	0	429	0.0000000
zheyou73v0_A09	20335336	20335555	BnaA09T0255500ZY	0	-	0	0	219	0.0000000
zheyou73v0_A09	20340817	20350097	BnaA09T0255600ZY	0	+	0	0	9280	0.0000000
zheyou73v0_A09	20355356	20356754	BnaA09T0255700ZY	0	-	0	0	1398	0.0000000
zheyou73v0_A09	20394906	20395297	BnaA09T0255800ZY	0	-	0	0	391	0.0000000
zheyou73v0_A09	20410612	20411924	BnaA09T0255900ZY	0	-	0	0	1312	0.0000000
zheyou73v0_A09	20426517	20432796	BnaA09T0256000ZY	0	-	0	0	6279	0.0000000
zheyou73v0_A09	20448227	20451823	BnaA09T0256100ZY	0	-	0	0	3596	0.0000000
zheyou73v0_A09	20456946	20460439	BnaA09T0256200ZY	0	+	0	0	3493	0.0000000
zheyou73v0_A09	20456946	20459925	BnaA09T0256200ZY.1	0	+	0	0	2979	0.0000000
zheyou73v0_A09	20465102	20467416	BnaA09T0256300ZY	0	-	0	0	2314	0.0000000
zheyou73v0_A09	20465102	20467283	BnaA09T0256300ZY.1	0	-	0	0	2181	0.0000000
zheyou73v0_A09	20465102	20467416	BnaA09T0256300ZY.2	0	-	0	0	2314	0.0000000
zheyou73v0_A09	20465102	20467013	BnaA09T0256300ZY.3	0	-	0	0	1911	0.0000000
zheyou73v0_A09	20487858	20488426	BnaA09T0256400ZY	0	+	0	0	568	0.0000000
zheyou73v0_A09	20488711	20489211	BnaA09T0256500ZY	0	+	0	0	500	0.0000000
zheyou73v0_A09	20492164	20495599	BnaA09T0256600ZY	0	+	0	0	3435	0.0000000
zheyou73v0_A09	20492164	20495599	BnaA09T0256600ZY.1	0	+	0	0	3435	0.0000000
zheyou73v0_A09	20502381	20505100	BnaA09T0256700ZY	0	-	0	0	2719	0.0000000
zheyou73v0_A09	20503480	20505100	BnaA09T0256700ZY.1	0	-	0	0	1620	0.0000000
zheyou73v0_A09	20518413	20518682	BnaA09T0256800ZY	0	+	0	0	269	0.0000000
zheyou73v0_A09	20518717	20529142	BnaA09T0256900ZY	0	+	0	0	10425	0.0000000
zheyou73v0_A09	20533141	20566177	BnaA09T0257000ZY	0	+	0	0	33036	0.0000000
zheyou73v0_A09	20800467	20804118	BnaA09T0257100ZY	0	-	0	0	3651	0.0000000
zheyou73v0_A09	20804623	20804971	BnaA09T0257200ZY	0	-	0	0	348	0.0000000
zheyou73v0_A09	20807121	20807688	BnaA09T0257300ZY	0	+	0	0	567	0.0000000
zheyou73v0_A09	20831493	20833547	BnaA09T0257400ZY	0	-	0	0	2054	0.0000000
zheyou73v0_A09	20938042	20938600	BnaA09T0257500ZY	0	-	0	0	558	0.0000000
zheyou73v0_A09	20975435	20980081	BnaA09T0257600ZY	0	-	0	0	4646	0.0000000
zheyou73v0_A09	20975435	20980081	BnaA09T0257600ZY.1	0	-	0	0	4646	0.0000000
zheyou73v0_A09	20975435	20980081	BnaA09T0257600ZY.2	0	-	0	0	4646	0.0000000
zheyou73v0_A09	20975435	20980081	BnaA09T0257600ZY.3	0	-	0	0	4646	0.0000000
zheyou73v0_A09	21209862	21214091	BnaA09T0257700ZY	0	-	0	0	4229	0.0000000
zheyou73v0_A09	21214163	21222339	BnaA09T0257800ZY	0	-	0	0	8176	0.0000000
zheyou73v0_A09	21236249	21239008	BnaA09T0257900ZY	0	+	0	0	2759	0.0000000
zheyou73v0_A09	21262894	21263589	BnaA09T0258000ZY	0	+	0	0	695	0.0000000
zheyou73v0_A09	21268632	21277332	BnaA09T0258100ZY	0	+	0	0	8700	0.0000000
zheyou73v0_A09	21281391	21291544	BnaA09T0258200ZY	0	+	0	0	10153	0.0000000
zheyou73v0_A09	21334587	21334907	BnaA09T0258300ZY	0	-	0	0	320	0.0000000
zheyou73v0_A09	21340473	21350867	BnaA09T0258400ZY	0	+	0	0	10394	0.0000000
zheyou73v0_A09	21368343	21370788	BnaA09T0258500ZY	0	-	0	0	2445	0.0000000
zheyou73v0_A09	21373188	21375447	BnaA09T0258600ZY	0	+	0	0	2259	0.0000000
zheyou73v0_A09	21398540	21399006	BnaA09T0258700ZY	0	-	0	0	466	0.0000000
zheyou73v0_A09	21409619	21412063	BnaA09T0258800ZY	0	-	0	0	2444	0.0000000
zheyou73v0_A09	21420621	21422881	BnaA09T0258900ZY	0	+	0	0	2260	0.0000000
zheyou73v0_A09	21425715	21426789	BnaA09T0259000ZY	0	-	0	0	1074	0.0000000
zheyou73v0_A09	21427711	21430201	BnaA09T0259100ZY	0	+	0	0	2490	0.0000000
zheyou73v0_A09	21427711	21430201	BnaA09T0259100ZY.1	0	+	0	0	2490	0.0000000
zheyou73v0_A09	21427711	21430201	BnaA09T0259100ZY.2	0	+	0	0	2490	0.0000000
zheyou73v0_A09	21427711	21430201	BnaA09T0259100ZY.3	0	+	0	0	2490	0.0000000
zheyou73v0_A09	21454489	21456012	BnaA09T0259200ZY	0	+	0	0	1523	0.0000000
zheyou73v0_A09	21457996	21459208	BnaA09T0259300ZY	0	+	0	0	1212	0.0000000
zheyou73v0_A09	21680276	21685154	BnaA09T0259400ZY	0	-	0	0	4878	0.0000000
zheyou73v0_A09	21742781	21743698	BnaA09T0259500ZY	0	+	0	0	917	0.0000000
zheyou73v0_A09	21960968	21961172	BnaA09T0259600ZY	0	+	0	0	204	0.0000000
zheyou73v0_A09	21962087	21962255	BnaA09T0259700ZY	0	+	0	0	168	0.0000000
zheyou73v0_A09	21962261	21962802	BnaA09T0259800ZY	0	+	0	0	541	0.0000000
zheyou73v0_A09	21962961	21963529	BnaA09T0259900ZY	0	-	0	0	568	0.0000000
zheyou73v0_A09	22031973	22032318	BnaA09T0260000ZY	0	+	0	0	345	0.0000000
zheyou73v0_A09	22032956	22033328	BnaA09T0260100ZY	0	-	0	0	372	0.0000000
zheyou73v0_A09	22033450	22033917	BnaA09T0260200ZY	0	-	0	0	467	0.0000000
zheyou73v0_A09	22034071	22035250	BnaA09T0260300ZY	0	-	0	0	1179	0.0000000
zheyou73v0_A09	22200736	22200978	BnaA09T0260400ZY	0	+	0	0	242	0.0000000
zheyou73v0_A09	22201723	22202604	BnaA09T0260500ZY	0	+	0	0	881	0.0000000
zheyou73v0_A09	22341123	22342212	BnaA09T0260600ZY	0	+	0	0	1089	0.0000000
zheyou73v0_A09	22344882	22345143	BnaA09T0260700ZY	0	-	0	0	261	0.0000000
zheyou73v0_A09	22345405	22345872	BnaA09T0260800ZY	0	-	0	0	467	0.0000000
zheyou73v0_A09	22346026	22347171	BnaA09T0260900ZY	0	-	0	0	1145	0.0000000
zheyou73v0_A09	22347428	22347638	BnaA09T0261000ZY	0	+	0	0	210	0.0000000
zheyou73v0_A09	22412088	22412298	BnaA09T0261100ZY	0	-	0	0	210	0.0000000
zheyou73v0_A09	22412806	22420008	BnaA09T0261200ZY	0	+	0	0	7202	0.0000000
zheyou73v0_A09	22421799	22422030	BnaA09T0261300ZY	0	-	0	0	231	0.0000000
zheyou73v0_A09	22443400	22444611	BnaA09T0261400ZY	0	+	0	0	1211	0.0000000
zheyou73v0_A09	22444765	22445730	BnaA09T0261500ZY	0	+	0	0	965	0.0000000
zheyou73v0_A09	22445781	22446604	BnaA09T0261600ZY	0	-	0	0	823	0.0000000
zheyou73v0_A09	22452766	22452976	BnaA09T0261700ZY	0	-	0	0	210	0.0000000
zheyou73v0_A09	22453495	22455563	BnaA09T0261800ZY	0	+	0	0	2068	0.0000000
zheyou73v0_A09	22470405	22470561	BnaA09T0261900ZY	0	-	0	0	156	0.0000000
zheyou73v0_A09	22480604	22480760	BnaA09T0262000ZY	0	-	0	0	156	0.0000000
zheyou73v0_A09	22489391	22489894	BnaA09T0262100ZY	0	+	0	0	503	0.0000000
zheyou73v0_A09	22543507	22543974	BnaA09T0262200ZY	0	+	0	0	467	0.0000000
zheyou73v0_A09	22544096	22544498	BnaA09T0262300ZY	0	+	0	0	402	0.0000000
zheyou73v0_A09	22544524	22545348	BnaA09T0262400ZY	0	-	0	0	824	0.0000000
zheyou73v0_A09	22551291	22552502	BnaA09T0262500ZY	0	+	0	0	1211	0.0000000
zheyou73v0_A09	22552656	22553123	BnaA09T0262600ZY	0	+	0	0	467	0.0000000
zheyou73v0_A09	22553931	22554150	BnaA09T0262700ZY	0	-	0	0	219	0.0000000
zheyou73v0_A09	22571808	22572861	BnaA09T0262800ZY	0	+	0	0	1053	0.0000000
zheyou73v0_A09	22573173	22574138	BnaA09T0262900ZY	0	+	0	0	965	0.0000000
zheyou73v0_A09	22597855	22599448	BnaA09T0263000ZY	0	-	0	0	1593	0.0000000
zheyou73v0_A09	22605715	22606926	BnaA09T0263100ZY	0	+	0	0	1211	0.0000000
zheyou73v0_A09	22607080	22615501	BnaA09T0263200ZY	0	+	0	0	8421	0.0000000
zheyou73v0_A09	22615660	22617027	BnaA09T0263300ZY	0	-	0	0	1367	0.0000000
zheyou73v0_A09	22638925	22640136	BnaA09T0263400ZY	0	+	0	0	1211	0.0000000
zheyou73v0_A09	22648264	22648432	BnaA09T0263500ZY	0	-	0	0	168	0.0000000
zheyou73v0_A09	22654627	22655838	BnaA09T0263600ZY	0	+	0	0	1211	0.0000000
zheyou73v0_A09	22656237	22657196	BnaA09T0263700ZY	0	-	0	0	959	0.0000000
zheyou73v0_A09	22684699	22684867	BnaA09T0263800ZY	0	-	0	0	168	0.0000000
zheyou73v0_A09	22685954	22687066	BnaA09T0263900ZY	0	-	0	0	1112	0.0000000
zheyou73v0_A09	22690133	22690571	BnaA09T0264000ZY	0	+	0	0	438	0.0000000
zheyou73v0_A09	22692973	22694841	BnaA09T0264100ZY	0	+	0	0	1868	0.0000000
zheyou73v0_A09	22875515	22875723	BnaA09T0264200ZY	0	+	0	0	208	0.0000000
zheyou73v0_A09	23143870	23144246	BnaA09T0264300ZY	0	+	0	0	376	0.0000000
zheyou73v0_A09	23144907	23145060	BnaA09T0264400ZY	0	-	0	0	153	0.0000000
zheyou73v0_A09	23177343	23177580	BnaA09T0264500ZY	0	+	0	0	237	0.0000000
zheyou73v0_A09	23178265	23178433	BnaA09T0264600ZY	0	-	0	0	168	0.0000000
zheyou73v0_A09	23762061	23763026	BnaA09T0264700ZY	0	-	0	0	965	0.0000000
zheyou73v0_A09	23763322	23763514	BnaA09T0264800ZY	0	-	0	0	192	0.0000000
zheyou73v0_A09	23770313	23770646	BnaA09T0264900ZY	0	+	0	0	333	0.0000000
zheyou73v0_A09	23821160	23822342	BnaA09T0265000ZY	0	+	0	0	1182	0.0000000
zheyou73v0_A09	23822349	23822766	BnaA09T0265100ZY	0	+	0	0	417	0.0000000
zheyou73v0_A09	23826546	23826789	BnaA09T0265200ZY	0	-	0	0	243	0.0000000
zheyou73v0_A09	23828809	23829070	BnaA09T0265300ZY	0	-	0	0	261	0.0000000
zheyou73v0_A09	23849094	23851940	BnaA09T0265400ZY	0	-	0	0	2846	0.0000000
zheyou73v0_A09	23852193	23852526	BnaA09T0265500ZY	0	-	0	0	333	0.0000000
zheyou73v0_A09	24048774	24049224	BnaA09T0265600ZY	0	-	0	0	450	0.0000000
zheyou73v0_A09	24201089	24201683	BnaA09T0265700ZY	0	-	0	0	594	0.0000000
zheyou73v0_A09	24235835	24240076	BnaA09T0265800ZY	0	+	0	0	4241	0.0000000
zheyou73v0_A09	24248742	24249953	BnaA09T0265900ZY	0	+	0	0	1211	0.0000000
zheyou73v0_A09	24250353	24251946	BnaA09T0266000ZY	0	-	0	0	1593	0.0000000
zheyou73v0_A09	24277760	24279355	BnaA09T0266100ZY	0	-	0	0	1595	0.0000000
zheyou73v0_A09	24287182	24289250	BnaA09T0266200ZY	0	+	0	0	2068	0.0000000
zheyou73v0_A09	24289957	24290125	BnaA09T0266300ZY	0	-	0	0	168	0.0000000
zheyou73v0_A09	24312844	24313054	BnaA09T0266400ZY	0	-	0	0	210	0.0000000
zheyou73v0_A09	24313311	24314522	BnaA09T0266500ZY	0	+	0	0	1211	0.0000000
zheyou73v0_A09	24314676	24315143	BnaA09T0266600ZY	0	+	0	0	467	0.0000000
zheyou73v0_A09	24315692	24316515	BnaA09T0266700ZY	0	-	0	0	823	0.0000000
zheyou73v0_A09	24317432	24317765	BnaA09T0266800ZY	0	-	0	0	333	0.0000000
zheyou73v0_A09	24330828	24331745	BnaA09T0266900ZY	0	+	0	0	917	0.0000000
zheyou73v0_A09	24359564	24359732	BnaA09T0267000ZY	0	-	0	0	168	0.0000000
zheyou73v0_A09	24366926	24369072	BnaA09T0267100ZY	0	-	0	0	2146	0.0000000
zheyou73v0_A09	24369989	24372938	BnaA09T0267200ZY	0	-	0	0	2949	0.0000000
zheyou73v0_A09	24400685	24401517	BnaA09T0267300ZY	0	-	0	0	832	0.0000000
zheyou73v0_A09	24408832	24411011	BnaA09T0267400ZY	0	-	0	0	2179	0.0000000
zheyou73v0_A09	24424285	24425496	BnaA09T0267500ZY	0	+	0	0	1211	0.0000000
zheyou73v0_A09	24425897	24427490	BnaA09T0267600ZY	0	-	0	0	1593	0.0000000
zheyou73v0_A09	24524106	24524310	BnaA09T0267700ZY	0	+	0	0	204	0.0000000
zheyou73v0_A09	24537165	24537324	BnaA09T0267800ZY	0	-	0	0	159	0.0000000
zheyou73v0_A09	24634726	24634936	BnaA09T0267900ZY	0	-	0	0	210	0.0000000
zheyou73v0_A09	24642184	24642424	BnaA09T0268000ZY	0	+	0	0	240	0.0000000
zheyou73v0_A09	24642467	24642778	BnaA09T0268100ZY	0	-	0	0	311	0.0000000
zheyou73v0_A09	24664067	24665026	BnaA09T0268200ZY	0	-	0	0	959	0.0000000
zheyou73v0_A09	24665487	24665655	BnaA09T0268300ZY	0	-	0	0	168	0.0000000
zheyou73v0_A09	24893341	24895702	BnaA09T0268400ZY	0	-	0	0	2361	0.0000000
zheyou73v0_A09	24902714	24904128	BnaA09T0268500ZY	0	-	0	0	1414	0.0000000
zheyou73v0_A09	24910195	24910763	BnaA09T0268600ZY	0	-	0	0	568	0.0000000
zheyou73v0_A09	24925817	24925973	BnaA09T0268700ZY	0	-	0	0	156	0.0000000
zheyou73v0_A09	25105096	25105338	BnaA09T0268800ZY	0	+	0	0	242	0.0000000
zheyou73v0_A09	25113033	25115417	BnaA09T0268900ZY	0	+	0	0	2384	0.0000000
zheyou73v0_A09	25172884	25173455	BnaA09T0269000ZY	0	+	0	0	571	0.0000000
zheyou73v0_A09	25285728	25285938	BnaA09T0269100ZY	0	+	0	0	210	0.0000000
zheyou73v0_A09	25328983	25329425	BnaA09T0269200ZY	0	+	0	0	442	0.0000000
zheyou73v0_A09	25404907	25405696	BnaA09T0269300ZY	0	+	0	0	789	0.0000000
zheyou73v0_A09	25406254	25407214	BnaA09T0269400ZY	0	-	0	0	960	0.0000000
zheyou73v0_A09	25422076	25422286	BnaA09T0269500ZY	0	-	0	0	210	0.0000000
zheyou73v0_A09	25433239	25433407	BnaA09T0269600ZY	0	-	0	0	168	0.0000000
zheyou73v0_A09	25434324	25434528	BnaA09T0269700ZY	0	-	0	0	204	0.0000000
zheyou73v0_A09	25745330	25745498	BnaA09T0269800ZY	0	+	0	0	168	0.0000000
zheyou73v0_A09	25746693	25747158	BnaA09T0269900ZY	0	-	0	0	465	0.0000000
zheyou73v0_A09	25747312	25747923	BnaA09T0270000ZY	0	-	0	0	611	0.0000000
zheyou73v0_A09	25885623	25885956	BnaA09T0270100ZY	0	-	0	0	333	0.0000000
zheyou73v0_A09	25962790	25963003	BnaA09T0270200ZY	0	-	0	0	213	0.0000000
zheyou73v0_A09	25985095	25990782	BnaA09T0270300ZY	0	-	0	0	5687	0.0000000
zheyou73v0_A09	26052712	26053228	BnaA09T0270400ZY	0	+	0	0	516	0.0000000
zheyou73v0_A09	26117545	26118971	BnaA09T0270500ZY	0	-	0	0	1426	0.0000000
zheyou73v0_A09	26140178	26141721	BnaA09T0270600ZY	0	-	0	0	1543	0.0000000
zheyou73v0_A09	26198240	26199833	BnaA09T0270700ZY	0	+	0	0	1593	0.0000000
zheyou73v0_A09	26200233	26201444	BnaA09T0270800ZY	0	-	0	0	1211	0.0000000
zheyou73v0_A09	26215204	26217075	BnaA09T0270900ZY	0	-	0	0	1871	0.0000000
zheyou73v0_A09	26218091	26218576	BnaA09T0271000ZY	0	+	0	0	485	0.0000000
zheyou73v0_A09	26221487	26222698	BnaA09T0271100ZY	0	-	0	0	1211	0.0000000
zheyou73v0_A09	26228386	26230455	BnaA09T0271200ZY	0	+	0	0	2069	0.0000000
zheyou73v0_A09	26231161	26231329	BnaA09T0271300ZY	0	-	0	0	168	0.0000000
zheyou73v0_A09	26233730	26235597	BnaA09T0271400ZY	0	+	0	0	1867	0.0000000
zheyou73v0_A09	26237362	26238185	BnaA09T0271500ZY	0	+	0	0	823	0.0000000
zheyou73v0_A09	26238734	26239165	BnaA09T0271600ZY	0	-	0	0	431	0.0000000
zheyou73v0_A09	26239319	26240530	BnaA09T0271700ZY	0	-	0	0	1211	0.0000000
zheyou73v0_A09	26240787	26240997	BnaA09T0271800ZY	0	+	0	0	210	0.0000000
zheyou73v0_A09	26436746	26438290	BnaA09T0271900ZY	0	-	0	0	1544	0.0000000
zheyou73v0_A09	26438756	26438924	BnaA09T0272000ZY	0	-	0	0	168	0.0000000
zheyou73v0_A09	26452234	26453444	BnaA09T0272100ZY	0	+	0	0	1210	0.0000000
zheyou73v0_A09	26453844	26455437	BnaA09T0272200ZY	0	-	0	0	1593	0.0000000
zheyou73v0_A09	26460884	26461094	BnaA09T0272300ZY	0	-	0	0	210	0.0000000
zheyou73v0_A09	27188254	27191506	BnaA09T0272400ZY	0	-	0	0	3252	0.0000000
zheyou73v0_A09	27265887	27266369	BnaA09T0272500ZY	0	-	0	0	482	0.0000000
zheyou73v0_A09	27360443	27360611	BnaA09T0272600ZY	0	+	0	0	168	0.0000000
zheyou73v0_A09	27360645	27361059	BnaA09T0272700ZY	0	+	0	0	414	0.0000000
zheyou73v0_A09	27636807	27637210	BnaA09T0272800ZY	0	+	0	0	403	0.0000000
zheyou73v0_A09	27638121	27641419	BnaA09T0272900ZY	0	+	0	0	3298	0.0000000
zheyou73v0_A09	27708629	27710710	BnaA09T0273000ZY	0	+	0	0	2081	0.0000000
zheyou73v0_A09	27710761	27711584	BnaA09T0273100ZY	0	-	0	0	823	0.0000000
zheyou73v0_A09	27718015	27720083	BnaA09T0273200ZY	0	+	0	0	2068	0.0000000
zheyou73v0_A09	27720134	27720957	BnaA09T0273300ZY	0	-	0	0	823	0.0000000
zheyou73v0_A09	27733154	27736435	BnaA09T0273400ZY	0	+	0	0	3281	0.0000000
zheyou73v0_A09	27737390	27737558	BnaA09T0273500ZY	0	-	0	0	168	0.0000000
zheyou73v0_A09	27738475	27738679	BnaA09T0273600ZY	0	-	0	0	204	0.0000000
zheyou73v0_A09	27743895	27745106	BnaA09T0273700ZY	0	+	0	0	1211	0.0000000
zheyou73v0_A09	27745260	27745727	BnaA09T0273800ZY	0	+	0	0	467	0.0000000
zheyou73v0_A09	27773822	27775511	BnaA09T0273900ZY	0	-	0	0	1689	0.0000000
zheyou73v0_A09	27782112	27783077	BnaA09T0274000ZY	0	+	0	0	965	0.0000000
zheyou73v0_A09	27789033	27789255	BnaA09T0274100ZY	0	+	0	0	222	0.0000000
zheyou73v0_A09	27798793	27799015	BnaA09T0274200ZY	0	+	0	0	222	0.0000000
zheyou73v0_A09	27805569	27807748	BnaA09T0274300ZY	0	+	0	0	2179	0.0000000
zheyou73v0_A09	27809512	27809734	BnaA09T0274400ZY	0	+	0	0	222	0.0000000
zheyou73v0_A09	27815417	27838489	BnaA09T0274500ZY	0	+	0	0	23072	0.0000000
zheyou73v0_A09	27845602	27846425	BnaA09T0274600ZY	0	+	0	0	823	0.0000000
zheyou73v0_A09	27846476	27861433	BnaA09T0274700ZY	0	-	0	0	14957	0.0000000
zheyou73v0_A09	27861587	27862798	BnaA09T0274800ZY	0	-	0	0	1211	0.0000000
zheyou73v0_A09	27868545	27868713	BnaA09T0274900ZY	0	+	0	0	168	0.0000000
zheyou73v0_A09	27869130	27869597	BnaA09T0275000ZY	0	-	0	0	467	0.0000000
zheyou73v0_A09	27871519	27873654	BnaA09T0275100ZY	0	+	0	0	2135	0.0000000
zheyou73v0_A09	27875432	27875645	BnaA09T0275200ZY	0	-	0	0	213	0.0000000
zheyou73v0_A09	27882659	27888876	BnaA09T0275300ZY	0	+	0	0	6217	0.0000000
zheyou73v0_A09	27889577	27889745	BnaA09T0275400ZY	0	-	0	0	168	0.0000000
zheyou73v0_A09	27906787	27907910	BnaA09T0275500ZY	0	+	0	0	1123	0.0000000
zheyou73v0_A09	27910238	27912069	BnaA09T0275600ZY	0	+	0	0	1831	0.0000000
zheyou73v0_A09	27914525	27914693	BnaA09T0275700ZY	0	-	0	0	168	0.0000000
zheyou73v0_A09	27920339	27920549	BnaA09T0275800ZY	0	-	0	0	210	0.0000000
zheyou73v0_A09	27920806	27922017	BnaA09T0275900ZY	0	+	0	0	1211	0.0000000
zheyou73v0_A09	27922417	27924010	BnaA09T0276000ZY	0	-	0	0	1593	0.0000000
zheyou73v0_A09	27930465	27930675	BnaA09T0276100ZY	0	+	0	0	210	0.0000000
zheyou73v0_A09	27948400	27949349	BnaA09T0276200ZY	0	-	0	0	949	0.0000000
zheyou73v0_A09	27967844	27968171	BnaA09T0276300ZY	0	-	0	0	327	0.0000000
zheyou73v0_A09	27968324	27969535	BnaA09T0276400ZY	0	-	0	0	1211	0.0000000
zheyou73v0_A09	27973397	27974884	BnaA09T0276500ZY	0	+	0	0	1487	0.0000000
zheyou73v0_A09	27974935	27977003	BnaA09T0276600ZY	0	-	0	0	2068	0.0000000
zheyou73v0_A09	27977522	27977732	BnaA09T0276700ZY	0	+	0	0	210	0.0000000
zheyou73v0_A09	27989503	27990324	BnaA09T0276800ZY	0	+	0	0	821	0.0000000
zheyou73v0_A09	27990375	27992443	BnaA09T0276900ZY	0	-	0	0	2068	0.0000000
zheyou73v0_A09	27999028	27999196	BnaA09T0277000ZY	0	+	0	0	168	0.0000000
zheyou73v0_A09	27999662	28000621	BnaA09T0277100ZY	0	+	0	0	959	0.0000000
zheyou73v0_A09	28001021	28002232	BnaA09T0277200ZY	0	-	0	0	1211	0.0000000
zheyou73v0_A09	28020618	28021399	BnaA09T0277300ZY	0	-	0	0	781	0.0000000
zheyou73v0_A09	28027144	28027539	BnaA09T0277400ZY	0	-	0	0	395	0.0000000
zheyou73v0_A09	28029180	28029438	BnaA09T0277500ZY	0	-	0	0	258	0.0000000
zheyou73v0_A09	28033908	28034166	BnaA09T0277600ZY	0	-	0	0	258	0.0000000
zheyou73v0_A09	28038251	28038779	BnaA09T0277700ZY	0	+	0	0	528	0.0000000
zheyou73v0_A09	28039696	28040519	BnaA09T0277800ZY	0	+	0	0	823	0.0000000
zheyou73v0_A09	28040570	28050654	BnaA09T0277900ZY	0	-	0	0	10084	0.0000000
zheyou73v0_A09	28050808	28052019	BnaA09T0278000ZY	0	-	0	0	1211	0.0000000
zheyou73v0_A09	28077862	28079455	BnaA09T0278100ZY	0	+	0	0	1593	0.0000000
zheyou73v0_A09	28079855	28081066	BnaA09T0278200ZY	0	-	0	0	1211	0.0000000
zheyou73v0_A09	28087603	28088318	BnaA09T0278300ZY	0	+	0	0	715	0.0000000
zheyou73v0_A09	28088477	28090544	BnaA09T0278400ZY	0	-	0	0	2067	0.0000000
zheyou73v0_A09	28096899	28097067	BnaA09T0278500ZY	0	+	0	0	168	0.0000000
zheyou73v0_A09	28097767	28099836	BnaA09T0278600ZY	0	-	0	0	2069	0.0000000
zheyou73v0_A09	28110008	28110218	BnaA09T0278700ZY	0	+	0	0	210	0.0000000
zheyou73v0_A09	28116082	28117675	BnaA09T0278800ZY	0	+	0	0	1593	0.0000000
zheyou73v0_A09	28118075	28119286	BnaA09T0278900ZY	0	-	0	0	1211	0.0000000
zheyou73v0_A09	28139915	28140738	BnaA09T0279000ZY	0	+	0	0	823	0.0000000
zheyou73v0_A09	28140789	28142857	BnaA09T0279100ZY	0	-	0	0	2068	0.0000000
zheyou73v0_A09	28152736	28153559	BnaA09T0279200ZY	0	+	0	0	823	0.0000000
zheyou73v0_A09	28154077	28154544	BnaA09T0279300ZY	0	-	0	0	467	0.0000000
zheyou73v0_A09	28154698	28155909	BnaA09T0279400ZY	0	-	0	0	1211	0.0000000
zheyou73v0_A09	28156166	28156376	BnaA09T0279500ZY	0	+	0	0	210	0.0000000
zheyou73v0_A09	28169546	28169714	BnaA09T0279600ZY	0	+	0	0	168	0.0000000
zheyou73v0_A09	28169899	28175282	BnaA09T0279700ZY	0	-	0	0	5383	0.0000000
zheyou73v0_A09	28175436	28176647	BnaA09T0279800ZY	0	-	0	0	1211	0.0000000
zheyou73v0_A09	28182926	28185038	BnaA09T0279900ZY	0	+	0	0	2112	0.0000000
zheyou73v0_A09	28205555	28206667	BnaA09T0280000ZY	0	+	0	0	1112	0.0000000
zheyou73v0_A09	28223063	28223231	BnaA09T0280100ZY	0	+	0	0	168	0.0000000
zheyou73v0_A09	28238029	28238834	BnaA09T0280200ZY	0	-	0	0	805	0.0000000
zheyou73v0_A09	28239449	28240233	BnaA09T0280300ZY	0	+	0	0	784	0.0000000
zheyou73v0_A09	28243140	28243430	BnaA09T0280400ZY	0	-	0	0	290	0.0000000
zheyou73v0_A09	28284726	28284930	BnaA09T0280500ZY	0	+	0	0	204	0.0000000
zheyou73v0_A09	28286480	28286669	BnaA09T0280600ZY	0	+	0	0	189	0.0000000
zheyou73v0_A09	28286720	28287685	BnaA09T0280700ZY	0	-	0	0	965	0.0000000
zheyou73v0_A09	28287839	28289050	BnaA09T0280800ZY	0	-	0	0	1211	0.0000000
zheyou73v0_A09	28320034	28320202	BnaA09T0280900ZY	0	+	0	0	168	0.0000000
zheyou73v0_A09	28320668	28321627	BnaA09T0281000ZY	0	+	0	0	959	0.0000000
zheyou73v0_A09	28322027	28323238	BnaA09T0281100ZY	0	-	0	0	1211	0.0000000
zheyou73v0_A09	28326222	28326513	BnaA09T0281200ZY	0	-	0	0	291	0.0000000
zheyou73v0_A09	28338594	28338762	BnaA09T0281300ZY	0	+	0	0	168	0.0000000
zheyou73v0_A09	28340206	28340437	BnaA09T0281400ZY	0	-	0	0	231	0.0000000
zheyou73v0_A09	28340592	28341803	BnaA09T0281500ZY	0	-	0	0	1211	0.0000000
zheyou73v0_A09	28387940	28390008	BnaA09T0281600ZY	0	-	0	0	2068	0.0000000
zheyou73v0_A09	28390527	28390737	BnaA09T0281700ZY	0	+	0	0	210	0.0000000
zheyou73v0_A09	28397833	28398001	BnaA09T0281800ZY	0	+	0	0	168	0.0000000
zheyou73v0_A09	28399194	28399661	BnaA09T0281900ZY	0	-	0	0	467	0.0000000
zheyou73v0_A09	28399815	28401026	BnaA09T0282000ZY	0	-	0	0	1211	0.0000000
zheyou73v0_A09	28489363	28489517	BnaA09T0282100ZY	0	+	0	0	154	0.0000000
zheyou73v0_A09	28538746	28538902	BnaA09T0282200ZY	0	-	0	0	156	0.0000000
zheyou73v0_A09	28542953	28544119	BnaA09T0282300ZY	0	-	0	0	1166	0.0000000
zheyou73v0_A09	28548935	28549169	BnaA09T0282400ZY	0	+	0	0	234	0.0000000
zheyou73v0_A09	28565241	28566046	BnaA09T0282500ZY	0	-	0	0	805	0.0000000
zheyou73v0_A09	28569065	28569870	BnaA09T0282600ZY	0	-	0	0	805	0.0000000
zheyou73v0_A09	28573254	28573422	BnaA09T0282700ZY	0	+	0	0	168	0.0000000
zheyou73v0_A09	28574128	28576173	BnaA09T0282800ZY	0	-	0	0	2045	0.0000000
zheyou73v0_A09	28596642	28597289	BnaA09T0282900ZY	0	+	0	0	647	0.0000000
zheyou73v0_A09	28597448	28615172	BnaA09T0283000ZY	0	-	0	0	17724	0.0000000
zheyou73v0_A09	28615326	28616538	BnaA09T0283100ZY	0	-	0	0	1212	0.0000000
zheyou73v0_A09	28766540	28766778	BnaA09T0283200ZY	0	-	0	0	238	0.0000000
zheyou73v0_A09	28766932	28768110	BnaA09T0283300ZY	0	-	0	0	1178	0.0000000
zheyou73v0_A09	28848798	28849590	BnaA09T0283400ZY	0	+	0	0	792	0.0000000
zheyou73v0_A09	28850550	28850868	BnaA09T0283500ZY	0	+	0	0	318	0.0000000
zheyou73v0_A09	28851027	28851742	BnaA09T0283600ZY	0	-	0	0	715	0.0000000
zheyou73v0_A09	29039271	29040813	BnaA09T0283700ZY	0	+	0	0	1542	0.0000000
zheyou73v0_A09	29044944	29052189	BnaA09T0283800ZY	0	-	0	0	7245	0.0000000
zheyou73v0_A09	29056321	29057534	BnaA09T0283900ZY	0	-	0	0	1213	0.0000000
zheyou73v0_A09	29064002	29066070	BnaA09T0284000ZY	0	-	0	0	2068	0.0000000
zheyou73v0_A09	29069158	29076206	BnaA09T0284100ZY	0	-	0	0	7048	0.0000000
zheyou73v0_A09	29076925	29077135	BnaA09T0284200ZY	0	+	0	0	210	0.0000000
zheyou73v0_A09	29079511	29080476	BnaA09T0284300ZY	0	-	0	0	965	0.0000000
zheyou73v0_A09	29080643	29081580	BnaA09T0284400ZY	0	-	0	0	937	0.0000000
zheyou73v0_A09	29115436	29115760	BnaA09T0284500ZY	0	+	0	0	324	0.0000000
zheyou73v0_A09	29116677	29118269	BnaA09T0284600ZY	0	+	0	0	1592	0.0000000
zheyou73v0_A09	29118669	29119880	BnaA09T0284700ZY	0	-	0	0	1211	0.0000000
zheyou73v0_A09	29143038	29143248	BnaA09T0284800ZY	0	-	0	0	210	0.0000000
zheyou73v0_A09	29144919	29146513	BnaA09T0284900ZY	0	-	0	0	1594	0.0000000
zheyou73v0_A09	29150508	29151314	BnaA09T0285000ZY	0	+	0	0	806	0.0000000
zheyou73v0_A09	29154916	29155722	BnaA09T0285100ZY	0	+	0	0	806	0.0000000
zheyou73v0_A09	29207570	29208781	BnaA09T0285200ZY	0	+	0	0	1211	0.0000000
zheyou73v0_A09	29208935	29209900	BnaA09T0285300ZY	0	+	0	0	965	0.0000000
zheyou73v0_A09	29210607	29210775	BnaA09T0285400ZY	0	-	0	0	168	0.0000000
zheyou73v0_A09	29240301	29240511	BnaA09T0285500ZY	0	-	0	0	210	0.0000000
zheyou73v0_A09	29241030	29243079	BnaA09T0285600ZY	0	+	0	0	2049	0.0000000
zheyou73v0_A09	29243130	29243953	BnaA09T0285700ZY	0	-	0	0	823	0.0000000
zheyou73v0_A09	29249384	29251323	BnaA09T0285800ZY	0	+	0	0	1939	0.0000000
zheyou73v0_A09	29251477	29279419	BnaA09T0285900ZY	0	+	0	0	27942	0.0000000
zheyou73v0_A09	29288370	29315311	BnaA09T0286000ZY	0	+	0	0	26941	0.0000000
zheyou73v0_A09	29315471	29316210	BnaA09T0286100ZY	0	-	0	0	739	0.0000000
zheyou73v0_A09	29337403	29338614	BnaA09T0286200ZY	0	+	0	0	1211	0.0000000
zheyou73v0_A09	29339014	29340607	BnaA09T0286300ZY	0	-	0	0	1593	0.0000000
zheyou73v0_A09	29384473	29385474	BnaA09T0286400ZY	0	+	0	0	1001	0.0000000
zheyou73v0_A09	29386356	29386629	BnaA09T0286500ZY	0	+	0	0	273	0.0000000
zheyou73v0_A09	29395852	29403098	BnaA09T0286600ZY	0	+	0	0	7246	0.0000000
zheyou73v0_A09	29403449	29417623	BnaA09T0286700ZY	0	+	0	0	14174	0.0000000
zheyou73v0_A09	29418023	29419616	BnaA09T0286800ZY	0	-	0	0	1593	0.0000000
zheyou73v0_A09	29426663	29428436	BnaA09T0286900ZY	0	+	0	0	1773	0.0000000
zheyou73v0_A09	29438458	29445701	BnaA09T0287000ZY	0	+	0	0	7243	0.0000000
zheyou73v0_A09	29445859	29446839	BnaA09T0287100ZY	0	-	0	0	980	0.0000000
zheyou73v0_A09	29452391	29452601	BnaA09T0287200ZY	0	-	0	0	210	0.0000000
zheyou73v0_A09	29452858	29454069	BnaA09T0287300ZY	0	+	0	0	1211	0.0000000
zheyou73v0_A09	29454223	29454690	BnaA09T0287400ZY	0	+	0	0	467	0.0000000
zheyou73v0_A09	29470203	29470413	BnaA09T0287500ZY	0	-	0	0	210	0.0000000
zheyou73v0_A09	29493570	29522671	BnaA09T0287600ZY	0	+	0	0	29101	0.0000000
zheyou73v0_A09	29522762	29523545	BnaA09T0287700ZY	0	-	0	0	783	0.0000000
zheyou73v0_A09	29563566	29565634	BnaA09T0287800ZY	0	+	0	0	2068	0.0000000
zheyou73v0_A09	29566340	29566508	BnaA09T0287900ZY	0	-	0	0	168	0.0000000
zheyou73v0_A09	29574249	29574581	BnaA09T0288000ZY	0	+	0	0	332	0.0000000
zheyou73v0_A09	29574588	29576089	BnaA09T0288100ZY	0	-	0	0	1501	0.0000000
zheyou73v0_A09	29603547	29604758	BnaA09T0288200ZY	0	+	0	0	1211	0.0000000
zheyou73v0_A09	29616943	29617153	BnaA09T0288300ZY	0	-	0	0	210	0.0000000
zheyou73v0_A09	29617410	29618621	BnaA09T0288400ZY	0	+	0	0	1211	0.0000000
zheyou73v0_A09	29618775	29619242	BnaA09T0288500ZY	0	+	0	0	467	0.0000000
zheyou73v0_A09	29619364	29619765	BnaA09T0288600ZY	0	+	0	0	401	0.0000000
zheyou73v0_A09	29620446	29620614	BnaA09T0288700ZY	0	-	0	0	168	0.0000000
zheyou73v0_A09	29624938	29629392	BnaA09T0288800ZY	0	+	0	0	4454	0.0000000
zheyou73v0_A09	29629546	29630012	BnaA09T0288900ZY	0	+	0	0	466	0.0000000
zheyou73v0_A09	29635567	29635777	BnaA09T0289000ZY	0	-	0	0	210	0.0000000
zheyou73v0_A09	29636034	29637244	BnaA09T0289100ZY	0	+	0	0	1210	0.0000000
zheyou73v0_A09	29637398	29637865	BnaA09T0289200ZY	0	+	0	0	467	0.0000000
zheyou73v0_A09	29639070	29639238	BnaA09T0289300ZY	0	-	0	0	168	0.0000000
zheyou73v0_A09	29646963	29664588	BnaA09T0289400ZY	0	+	0	0	17625	0.0000000
zheyou73v0_A09	29664639	29665462	BnaA09T0289500ZY	0	-	0	0	823	0.0000000
zheyou73v0_A09	29671389	29671599	BnaA09T0289600ZY	0	-	0	0	210	0.0000000
zheyou73v0_A09	29681455	29682666	BnaA09T0289700ZY	0	+	0	0	1211	0.0000000
zheyou73v0_A09	29682820	29683785	BnaA09T0289800ZY	0	+	0	0	965	0.0000000
zheyou73v0_A09	29683836	29684659	BnaA09T0289900ZY	0	-	0	0	823	0.0000000
zheyou73v0_A09	29685576	29685780	BnaA09T0290000ZY	0	-	0	0	204	0.0000000
zheyou73v0_A09	29768053	29769264	BnaA09T0290100ZY	0	+	0	0	1211	0.0000000
zheyou73v0_A09	29776493	29777316	BnaA09T0290200ZY	0	-	0	0	823	0.0000000
zheyou73v0_A09	29783212	29783422	BnaA09T0290300ZY	0	-	0	0	210	0.0000000
zheyou73v0_A09	29783678	29784890	BnaA09T0290400ZY	0	+	0	0	1212	0.0000000
zheyou73v0_A09	29785290	29786884	BnaA09T0290500ZY	0	-	0	0	1594	0.0000000
zheyou73v0_A09	29791204	29792415	BnaA09T0290600ZY	0	+	0	0	1211	0.0000000
zheyou73v0_A09	29793520	29793688	BnaA09T0290700ZY	0	-	0	0	168	0.0000000
zheyou73v0_A09	29800114	29801325	BnaA09T0290800ZY	0	+	0	0	1211	0.0000000
zheyou73v0_A09	29801479	29801946	BnaA09T0290900ZY	0	+	0	0	467	0.0000000
zheyou73v0_A09	29803152	29803320	BnaA09T0291000ZY	0	-	0	0	168	0.0000000
zheyou73v0_A09	29816759	29816963	BnaA09T0291100ZY	0	-	0	0	204	0.0000000
zheyou73v0_A09	29997355	29997577	BnaA09T0291200ZY	0	-	0	0	222	0.0000000
zheyou73v0_A09	29999249	30001428	BnaA09T0291300ZY	0	-	0	0	2179	0.0000000
zheyou73v0_A09	30015349	30015559	BnaA09T0291400ZY	0	-	0	0	210	0.0000000
zheyou73v0_A09	30015816	30017027	BnaA09T0291500ZY	0	+	0	0	1211	0.0000000
zheyou73v0_A09	30017181	30017648	BnaA09T0291600ZY	0	+	0	0	467	0.0000000
zheyou73v0_A09	30060095	30061109	BnaA09T0291700ZY	0	+	0	0	1014	0.0000000
zheyou73v0_A09	30061706	30063299	BnaA09T0291800ZY	0	-	0	0	1593	0.0000000
zheyou73v0_A09	30073735	30074946	BnaA09T0291900ZY	0	+	0	0	1211	0.0000000
zheyou73v0_A09	30075346	30076939	BnaA09T0292000ZY	0	-	0	0	1593	0.0000000
zheyou73v0_A09	30084946	30087014	BnaA09T0292100ZY	0	+	0	0	2068	0.0000000
zheyou73v0_A09	30087720	30087888	BnaA09T0292200ZY	0	-	0	0	168	0.0000000
zheyou73v0_A09	30093688	30094899	BnaA09T0292300ZY	0	+	0	0	1211	0.0000000
zheyou73v0_A09	30095053	30095519	BnaA09T0292400ZY	0	+	0	0	466	0.0000000
zheyou73v0_A09	30096723	30096891	BnaA09T0292500ZY	0	-	0	0	168	0.0000000
zheyou73v0_A09	30130644	30131022	BnaA09T0292600ZY	0	+	0	0	378	0.0000000
zheyou73v0_A09	30132355	30133377	BnaA09T0292700ZY	0	+	0	0	1022	0.0000000
zheyou73v0_A09	30135362	30135530	BnaA09T0292800ZY	0	-	0	0	168	0.0000000
zheyou73v0_A09	30148761	30148929	BnaA09T0292900ZY	0	-	0	0	168	0.0000000
zheyou73v0_A09	30162329	30168686	BnaA09T0293000ZY	0	+	0	0	6357	0.0000000
zheyou73v0_A09	30169086	30170679	BnaA09T0293100ZY	0	-	0	0	1593	0.0000000
zheyou73v0_A09	30240430	30241205	BnaA09T0293200ZY	0	-	0	0	775	0.0000000
zheyou73v0_A09	30339756	30340342	BnaA09T0293300ZY	0	+	0	0	586	0.0000000
zheyou73v0_A09	30352124	30353770	BnaA09T0293400ZY	0	-	0	0	1646	0.0000000
zheyou73v0_A09	30546968	30547625	BnaA09T0293500ZY	0	-	0	0	657	0.0000000
zheyou73v0_A09	30576176	30578244	BnaA09T0293600ZY	0	+	0	0	2068	0.0000000
zheyou73v0_A09	30578295	30579381	BnaA09T0293700ZY	0	-	0	0	1086	0.0000000
zheyou73v0_A09	30580033	30580240	BnaA09T0293800ZY	0	-	0	0	207	0.0000000
zheyou73v0_A09	30584896	30585106	BnaA09T0293900ZY	0	-	0	0	210	0.0000000
zheyou73v0_A09	30585363	30586158	BnaA09T0294000ZY	0	+	0	0	795	0.0000000
zheyou73v0_A09	30586558	30588145	BnaA09T0294100ZY	0	-	0	0	1587	0.0000000
zheyou73v0_A09	30622992	30625060	BnaA09T0294200ZY	0	+	0	0	2068	0.0000000
zheyou73v0_A09	30625219	30633633	BnaA09T0294300ZY	0	-	0	0	8414	0.0000000
zheyou73v0_A09	30645161	30646990	BnaA09T0294400ZY	0	-	0	0	1829	0.0000000
zheyou73v0_A09	30647195	30648116	BnaA09T0294500ZY	0	+	0	0	921	0.0000000
zheyou73v0_A09	30890405	30890618	BnaA09T0294600ZY	0	-	0	0	213	0.0000000
zheyou73v0_A09	30890645	30890996	BnaA09T0294700ZY	0	-	0	0	351	0.0000000
zheyou73v0_A09	30957231	30957399	BnaA09T0294800ZY	0	-	0	0	168	0.0000000
zheyou73v0_A09	31043521	31044743	BnaA09T0294900ZY	0	-	0	0	1222	0.0000000
zheyou73v0_A09	31081763	31082430	BnaA09T0295000ZY	0	-	0	0	667	0.0000000
zheyou73v0_A09	31756196	31756409	BnaA09T0295100ZY	0	+	0	0	213	0.0000000
zheyou73v0_A09	31763165	31763378	BnaA09T0295200ZY	0	+	0	0	213	0.0000000
zheyou73v0_A09	31802881	31804665	BnaA09T0295300ZY	0	-	0	0	1784	0.0000000
zheyou73v0_A09	31899525	31899768	BnaA09T0295400ZY	0	-	0	0	243	0.0000000
zheyou73v0_A09	31969833	31970037	BnaA09T0295500ZY	0	-	0	0	204	0.0000000
zheyou73v0_A09	32557058	32557226	BnaA09T0295600ZY	0	-	0	0	168	0.0000000
zheyou73v0_A09	32586276	32587487	BnaA09T0295700ZY	0	+	0	0	1211	0.0000000
zheyou73v0_A09	32587887	32589480	BnaA09T0295800ZY	0	-	0	0	1593	0.0000000
zheyou73v0_A09	32590397	32590726	BnaA09T0295900ZY	0	-	0	0	329	0.0000000
zheyou73v0_A09	32595365	32595575	BnaA09T0296000ZY	0	-	0	0	210	0.0000000
zheyou73v0_A09	32595833	32597167	BnaA09T0296100ZY	0	+	0	0	1334	0.0000000
zheyou73v0_A09	32605556	32606994	BnaA09T0296200ZY	0	-	0	0	1438	0.0000000
zheyou73v0_A09	32608332	32608488	BnaA09T0296300ZY	0	-	0	0	156	0.0000000
zheyou73v0_A09	32610682	32611254	BnaA09T0296400ZY	0	-	0	0	572	0.0000000
zheyou73v0_A09	32616361	32618244	BnaA09T0296500ZY	0	+	0	0	1883	0.0000000
zheyou73v0_A09	32619794	32620655	BnaA09T0296600ZY	0	+	0	0	861	0.0000000
zheyou73v0_A09	32880878	32882113	BnaA09T0296700ZY	0	-	0	0	1235	0.0000000
zheyou73v0_A09	32882839	32883081	BnaA09T0296800ZY	0	-	0	0	242	0.0000000
zheyou73v0_A09	33089955	33090288	BnaA09T0296900ZY	0	-	0	0	333	0.0000000
zheyou73v0_A09	33291891	33292707	BnaA09T0297000ZY	0	+	0	0	816	0.0000000
zheyou73v0_A09	33412715	33412982	BnaA09T0297100ZY	0	-	0	0	267	0.0000000
zheyou73v0_A09	33438551	33440071	BnaA09T0297200ZY	0	-	0	0	1520	0.0000000
zheyou73v0_A09	33447802	33447970	BnaA09T0297300ZY	0	-	0	0	168	0.0000000
zheyou73v0_A09	33449057	33450163	BnaA09T0297400ZY	0	-	0	0	1106	0.0000000
zheyou73v0_A09	33450494	33451563	BnaA09T0297500ZY	0	+	0	0	1069	0.0000000
zheyou73v0_A09	33453335	33455203	BnaA09T0297600ZY	0	+	0	0	1868	0.0000000
zheyou73v0_A09	33457895	33458210	BnaA09T0297700ZY	0	+	0	0	315	0.0000000
zheyou73v0_A09	33484649	33485614	BnaA09T0297800ZY	0	-	0	0	965	0.0000000
zheyou73v0_A09	33487226	33487436	BnaA09T0297900ZY	0	+	0	0	210	0.0000000
zheyou73v0_A09	33499802	33500767	BnaA09T0298000ZY	0	-	0	0	965	0.0000000
zheyou73v0_A09	33500921	33502132	BnaA09T0298100ZY	0	-	0	0	1211	0.0000000
zheyou73v0_A09	33508431	33510025	BnaA09T0298200ZY	0	+	0	0	1594	0.0000000
zheyou73v0_A09	33510425	33511482	BnaA09T0298300ZY	0	-	0	0	1057	0.0000000
zheyou73v0_A09	33535797	33535965	BnaA09T0298400ZY	0	+	0	0	168	0.0000000
zheyou73v0_A09	33583810	33585678	BnaA09T0298500ZY	0	-	0	0	1868	0.0000000
zheyou73v0_A09	33588660	33591266	BnaA09T0298600ZY	0	+	0	0	2606	0.0000000
zheyou73v0_A09	33606180	33606348	BnaA09T0298700ZY	0	+	0	0	168	0.0000000
zheyou73v0_A09	33624841	33625009	BnaA09T0298800ZY	0	+	0	0	168	0.0000000
zheyou73v0_A09	33625678	33642382	BnaA09T0298900ZY	0	-	0	0	16704	0.0000000
zheyou73v0_A09	33656489	33658355	BnaA09T0299000ZY	0	-	0	0	1866	0.0000000
zheyou73v0_A09	33660753	33660921	BnaA09T0299100ZY	0	+	0	0	168	0.0000000
zheyou73v0_A09	33661627	33663669	BnaA09T0299200ZY	0	-	0	0	2042	0.0000000
zheyou73v0_A09	33664579	33688434	BnaA09T0299300ZY	0	+	0	0	23855	0.0000000
zheyou73v0_A09	33689424	33693077	BnaA09T0299400ZY	0	+	0	0	3653	0.0000000
zheyou73v0_A09	33705296	33705452	BnaA09T0299500ZY	0	+	0	0	156	0.0000000
zheyou73v0_A09	33716959	33717301	BnaA09T0299600ZY	0	+	0	0	342	0.0000000
zheyou73v0_A09	33717352	33738662	BnaA09T0299700ZY	0	-	0	0	21310	0.0000000
zheyou73v0_A09	33738816	33740027	BnaA09T0299800ZY	0	-	0	0	1211	0.0000000
zheyou73v0_A09	33774691	33776283	BnaA09T0299900ZY	0	-	0	0	1592	0.0000000
zheyou73v0_A09	33777598	33778392	BnaA09T0300000ZY	0	-	0	0	794	0.0000000
zheyou73v0_A09	33781897	33782702	BnaA09T0300100ZY	0	-	0	0	805	0.0000000
zheyou73v0_A09	33786328	33787133	BnaA09T0300200ZY	0	-	0	0	805	0.0000000
zheyou73v0_A09	33787464	33788497	BnaA09T0300300ZY	0	+	0	0	1033	0.0000000
zheyou73v0_A09	33798697	33800754	BnaA09T0300400ZY	0	+	0	0	2057	0.0000000
zheyou73v0_A09	33800805	33801628	BnaA09T0300500ZY	0	-	0	0	823	0.0000000
zheyou73v0_A09	33809108	33813620	BnaA09T0300600ZY	0	+	0	0	4512	0.0000000
zheyou73v0_A09	33813671	33814458	BnaA09T0300700ZY	0	-	0	0	787	0.0000000
zheyou73v0_A09	33815375	33817665	BnaA09T0300800ZY	0	-	0	0	2290	0.0000000
zheyou73v0_A09	33828288	33829225	BnaA09T0300900ZY	0	+	0	0	937	0.0000000
zheyou73v0_A09	33829393	33830358	BnaA09T0301000ZY	0	+	0	0	965	0.0000000
zheyou73v0_A09	33830409	33831232	BnaA09T0301100ZY	0	-	0	0	823	0.0000000
zheyou73v0_A09	33832149	33844699	BnaA09T0301200ZY	0	-	0	0	12550	0.0000000
zheyou73v0_A09	33863945	33865643	BnaA09T0301300ZY	0	-	0	0	1698	0.0000000
zheyou73v0_A09	33876159	33876408	BnaA09T0301400ZY	0	-	0	0	249	0.0000000
zheyou73v0_A09	33879989	33880157	BnaA09T0301500ZY	0	+	0	0	168	0.0000000
zheyou73v0_A09	33880827	33881792	BnaA09T0301600ZY	0	-	0	0	965	0.0000000
zheyou73v0_A09	33954470	33954758	BnaA09T0301700ZY	0	-	0	0	288	0.0000000
zheyou73v0_A09	33955262	33957389	BnaA09T0301800ZY	0	+	0	0	2127	0.0000000
zheyou73v0_A09	33958306	33959864	BnaA09T0301900ZY	0	+	0	0	1558	0.0000000
zheyou73v0_A09	34012920	34013725	BnaA09T0302000ZY	0	+	0	0	805	0.0000000
zheyou73v0_A09	34036917	34037876	BnaA09T0302100ZY	0	+	0	0	959	0.0000000
zheyou73v0_A09	34052386	34054254	BnaA09T0302200ZY	0	-	0	0	1868	0.0000000
zheyou73v0_A09	34065005	34065970	BnaA09T0302300ZY	0	-	0	0	965	0.0000000
zheyou73v0_A09	34066282	34067334	BnaA09T0302400ZY	0	-	0	0	1052	0.0000000
zheyou73v0_A09	34087232	34087699	BnaA09T0302500ZY	0	-	0	0	467	0.0000000
zheyou73v0_A09	34087853	34089064	BnaA09T0302600ZY	0	-	0	0	1211	0.0000000
zheyou73v0_A09	34094629	34095508	BnaA09T0302700ZY	0	+	0	0	879	0.0000000
zheyou73v0_A09	34105103	34106314	BnaA09T0302800ZY	0	+	0	0	1211	0.0000000
zheyou73v0_A09	34106468	34106935	BnaA09T0302900ZY	0	+	0	0	467	0.0000000
zheyou73v0_A09	34108048	34109752	BnaA09T0303000ZY	0	-	0	0	1704	0.0000000
zheyou73v0_A09	34110151	34110382	BnaA09T0303100ZY	0	-	0	0	231	0.0000000
zheyou73v0_A09	34130976	34132187	BnaA09T0303200ZY	0	+	0	0	1211	0.0000000
zheyou73v0_A09	34132341	34132793	BnaA09T0303300ZY	0	+	0	0	452	0.0000000
zheyou73v0_A09	34134218	34135429	BnaA09T0303400ZY	0	+	0	0	1211	0.0000000
zheyou73v0_A09	34135583	34135844	BnaA09T0303500ZY	0	+	0	0	261	0.0000000
zheyou73v0_A09	34138178	34140246	BnaA09T0303600ZY	0	+	0	0	2068	0.0000000
zheyou73v0_A09	34140297	34141120	BnaA09T0303700ZY	0	-	0	0	823	0.0000000
zheyou73v0_A09	34146569	34147780	BnaA09T0303800ZY	0	+	0	0	1211	0.0000000
zheyou73v0_A09	34147934	34148401	BnaA09T0303900ZY	0	+	0	0	467	0.0000000
zheyou73v0_A09	34148523	34148898	BnaA09T0304000ZY	0	+	0	0	375	0.0000000
zheyou73v0_A09	34149057	34150926	BnaA09T0304100ZY	0	-	0	0	1869	0.0000000
zheyou73v0_A09	34168833	34171499	BnaA09T0304200ZY	0	-	0	0	2666	0.0000000
zheyou73v0_A09	34171811	34172866	BnaA09T0304300ZY	0	-	0	0	1055	0.0000000
zheyou73v0_A09	34196349	34197836	BnaA09T0304400ZY	0	+	0	0	1487	0.0000000
zheyou73v0_A09	34197862	34198851	BnaA09T0304500ZY	0	-	0	0	989	0.0000000
zheyou73v0_A09	34199162	34201431	BnaA09T0304600ZY	0	-	0	0	2269	0.0000000
zheyou73v0_A09	34209048	34209216	BnaA09T0304700ZY	0	+	0	0	168	0.0000000
zheyou73v0_A09	34209898	34210768	BnaA09T0304800ZY	0	-	0	0	870	0.0000000
zheyou73v0_A09	34234476	34235221	BnaA09T0304900ZY	0	+	0	0	745	0.0000000
zheyou73v0_A09	34235236	34235687	BnaA09T0305000ZY	0	+	0	0	451	0.0000000
zheyou73v0_A09	34236087	34237680	BnaA09T0305100ZY	0	-	0	0	1593	0.0000000
zheyou73v0_A09	34244051	34246960	BnaA09T0305200ZY	0	+	0	0	2909	0.0000000
zheyou73v0_A09	34300343	34301936	BnaA09T0305300ZY	0	-	0	0	1593	0.0000000
zheyou73v0_A09	34308292	34309501	BnaA09T0305400ZY	0	+	0	0	1209	0.0000000
zheyou73v0_A09	34309655	34310134	BnaA09T0305500ZY	0	+	0	0	479	0.0000000
zheyou73v0_A09	34310619	34311268	BnaA09T0305600ZY	0	-	0	0	649	0.0000000
zheyou73v0_A09	34322977	34326623	BnaA09T0305700ZY	0	+	0	0	3646	0.0000000
zheyou73v0_A09	34326674	34327497	BnaA09T0305800ZY	0	-	0	0	823	0.0000000
zheyou73v0_A09	34334073	34335284	BnaA09T0305900ZY	0	+	0	0	1211	0.0000000
zheyou73v0_A09	34335710	34337303	BnaA09T0306000ZY	0	-	0	0	1593	0.0000000
zheyou73v0_A09	34343878	34345946	BnaA09T0306100ZY	0	+	0	0	2068	0.0000000
zheyou73v0_A09	34350540	34351345	BnaA09T0306200ZY	0	-	0	0	805	0.0000000
zheyou73v0_A09	34353815	34354620	BnaA09T0306300ZY	0	-	0	0	805	0.0000000
zheyou73v0_A09	34355235	34356881	BnaA09T0306400ZY	0	+	0	0	1646	0.0000000
zheyou73v0_A09	34362539	34363750	BnaA09T0306500ZY	0	+	0	0	1211	0.0000000
zheyou73v0_A09	34364150	34365744	BnaA09T0306600ZY	0	-	0	0	1594	0.0000000
zheyou73v0_A09	34378562	34379773	BnaA09T0306700ZY	0	+	0	0	1211	0.0000000
zheyou73v0_A09	34379927	34380355	BnaA09T0306800ZY	0	+	0	0	428	0.0000000
zheyou73v0_A09	34381005	34381720	BnaA09T0306900ZY	0	-	0	0	715	0.0000000
zheyou73v0_A09	34407766	34407934	BnaA09T0307000ZY	0	-	0	0	168	0.0000000
zheyou73v0_A09	34426304	34428374	BnaA09T0307100ZY	0	-	0	0	2070	0.0000000
zheyou73v0_A09	34434253	34435076	BnaA09T0307200ZY	0	+	0	0	823	0.0000000
zheyou73v0_A09	34436246	34437457	BnaA09T0307300ZY	0	-	0	0	1211	0.0000000
zheyou73v0_A09	34446658	34447574	BnaA09T0307400ZY	0	-	0	0	916	0.0000000
zheyou73v0_A09	34455845	34456668	BnaA09T0307500ZY	0	+	0	0	823	0.0000000
zheyou73v0_A09	34456719	34459792	BnaA09T0307600ZY	0	-	0	0	3073	0.0000000
zheyou73v0_A09	34491808	34493401	BnaA09T0307700ZY	0	+	0	0	1593	0.0000000
zheyou73v0_A09	34493801	34495012	BnaA09T0307800ZY	0	-	0	0	1211	0.0000000
zheyou73v0_A09	34505025	34505981	BnaA09T0307900ZY	0	+	0	0	956	0.0000000
zheyou73v0_A09	34506032	34508037	BnaA09T0308000ZY	0	-	0	0	2005	0.0000000
zheyou73v0_A09	34582849	34583061	BnaA09T0308100ZY	0	+	0	0	212	0.0000000
zheyou73v0_A09	34583978	34584146	BnaA09T0308200ZY	0	+	0	0	168	0.0000000
zheyou73v0_A09	34584853	34595266	BnaA09T0308300ZY	0	-	0	0	10413	0.0000000
zheyou73v0_A09	34595420	34596631	BnaA09T0308400ZY	0	-	0	0	1211	0.0000000
zheyou73v0_A09	34602719	34603048	BnaA09T0308500ZY	0	+	0	0	329	0.0000000
zheyou73v0_A09	34610370	34611581	BnaA09T0308600ZY	0	+	0	0	1211	0.0000000
zheyou73v0_A09	34611735	34612700	BnaA09T0308700ZY	0	+	0	0	965	0.0000000
zheyou73v0_A09	34613406	34613574	BnaA09T0308800ZY	0	-	0	0	168	0.0000000
zheyou73v0_A09	34636306	34636934	BnaA09T0308900ZY	0	-	0	0	628	0.0000000
zheyou73v0_A09	34640510	34640782	BnaA09T0309000ZY	0	-	0	0	272	0.0000000
zheyou73v0_A09	34649889	34650099	BnaA09T0309100ZY	0	-	0	0	210	0.0000000
zheyou73v0_A09	34654240	34654450	BnaA09T0309200ZY	0	-	0	0	210	0.0000000
zheyou73v0_A09	34654707	34657102	BnaA09T0309300ZY	0	+	0	0	2395	0.0000000
zheyou73v0_A09	34673698	34674909	BnaA09T0309400ZY	0	+	0	0	1211	0.0000000
zheyou73v0_A09	34675599	34684806	BnaA09T0309500ZY	0	+	0	0	9207	0.0000000
zheyou73v0_A09	34684857	34685493	BnaA09T0309600ZY	0	-	0	0	636	0.0000000
zheyou73v0_A09	34685511	34685679	BnaA09T0309700ZY	0	-	0	0	168	0.0000000
zheyou73v0_A09	34686594	34686923	BnaA09T0309800ZY	0	-	0	0	329	0.0000000
zheyou73v0_A09	34691511	34692720	BnaA09T0309900ZY	0	+	0	0	1209	0.0000000
zheyou73v0_A09	34692874	34703491	BnaA09T0310000ZY	0	+	0	0	10617	0.0000000
zheyou73v0_A09	34732006	34732174	BnaA09T0310100ZY	0	-	0	0	168	0.0000000
zheyou73v0_A09	34738797	34740865	BnaA09T0310200ZY	0	+	0	0	2068	0.0000000
zheyou73v0_A09	34740916	34741739	BnaA09T0310300ZY	0	-	0	0	823	0.0000000
zheyou73v0_A09	34742941	34744534	BnaA09T0310400ZY	0	-	0	0	1593	0.0000000
zheyou73v0_A09	34750551	34752881	BnaA09T0310500ZY	0	+	0	0	2330	0.0000000
zheyou73v0_A09	34753587	34753755	BnaA09T0310600ZY	0	-	0	0	168	0.0000000
zheyou73v0_A09	34759780	34762110	BnaA09T0310700ZY	0	+	0	0	2330	0.0000000
zheyou73v0_A09	34762816	34762984	BnaA09T0310800ZY	0	-	0	0	168	0.0000000
zheyou73v0_A09	34769009	34771339	BnaA09T0310900ZY	0	+	0	0	2330	0.0000000
zheyou73v0_A09	34772045	34772213	BnaA09T0311000ZY	0	-	0	0	168	0.0000000
zheyou73v0_A09	34781722	34781878	BnaA09T0311100ZY	0	+	0	0	156	0.0000000
zheyou73v0_A09	34784159	34784501	BnaA09T0311200ZY	0	+	0	0	342	0.0000000
zheyou73v0_A09	34791214	34791424	BnaA09T0311300ZY	0	-	0	0	210	0.0000000
zheyou73v0_A09	34791943	34794011	BnaA09T0311400ZY	0	+	0	0	2068	0.0000000
zheyou73v0_A09	34794717	34794885	BnaA09T0311500ZY	0	-	0	0	168	0.0000000
zheyou73v0_A09	34819395	34821467	BnaA09T0311600ZY	0	+	0	0	2072	0.0000000
zheyou73v0_A09	34821518	34822340	BnaA09T0311700ZY	0	-	0	0	822	0.0000000
zheyou73v0_A09	34900646	34900856	BnaA09T0311800ZY	0	-	0	0	210	0.0000000
zheyou73v0_A09	34901113	34902324	BnaA09T0311900ZY	0	+	0	0	1211	0.0000000
zheyou73v0_A09	34902478	34902945	BnaA09T0312000ZY	0	+	0	0	467	0.0000000
zheyou73v0_A09	34903067	34903443	BnaA09T0312100ZY	0	+	0	0	376	0.0000000
zheyou73v0_A09	34937119	34938036	BnaA09T0312200ZY	0	-	0	0	917	0.0000000
zheyou73v0_A09	34938190	34939401	BnaA09T0312300ZY	0	-	0	0	1211	0.0000000
zheyou73v0_A09	34945686	34945854	BnaA09T0312400ZY	0	+	0	0	168	0.0000000
zheyou73v0_A09	34946560	34947525	BnaA09T0312500ZY	0	-	0	0	965	0.0000000
zheyou73v0_A09	34947679	34948890	BnaA09T0312600ZY	0	-	0	0	1211	0.0000000
zheyou73v0_A09	34955942	34956155	BnaA09T0312700ZY	0	-	0	0	213	0.0000000
zheyou73v0_A09	34968391	34968661	BnaA09T0312800ZY	0	+	0	0	270	0.0000000
zheyou73v0_A09	34989549	34990371	BnaA09T0312900ZY	0	+	0	0	822	0.0000000
zheyou73v0_A09	34995432	34996989	BnaA09T0313000ZY	0	+	0	0	1557	0.0000000
zheyou73v0_A09	35012483	35014065	BnaA09T0313100ZY	0	+	0	0	1582	0.0000000
zheyou73v0_A09	35014465	35015408	BnaA09T0313200ZY	0	-	0	0	943	0.0000000
zheyou73v0_A09	35015665	35015875	BnaA09T0313300ZY	0	+	0	0	210	0.0000000
zheyou73v0_A09	35020385	35021208	BnaA09T0313400ZY	0	+	0	0	823	0.0000000
zheyou73v0_A09	35021259	35023327	BnaA09T0313500ZY	0	-	0	0	2068	0.0000000
zheyou73v0_A09	35028599	35029422	BnaA09T0313600ZY	0	+	0	0	823	0.0000000
zheyou73v0_A09	35029473	35031541	BnaA09T0313700ZY	0	-	0	0	2068	0.0000000
zheyou73v0_A09	35037834	35038002	BnaA09T0313800ZY	0	+	0	0	168	0.0000000
zheyou73v0_A09	35038708	35040777	BnaA09T0313900ZY	0	-	0	0	2069	0.0000000
zheyou73v0_A09	35047082	35047316	BnaA09T0314000ZY	0	+	0	0	234	0.0000000
zheyou73v0_A09	35053135	35053959	BnaA09T0314100ZY	0	+	0	0	824	0.0000000
zheyou73v0_A09	35054010	35056078	BnaA09T0314200ZY	0	-	0	0	2068	0.0000000
zheyou73v0_A09	35067957	35068911	BnaA09T0314300ZY	0	+	0	0	954	0.0000000
zheyou73v0_A09	35117633	35117837	BnaA09T0314400ZY	0	+	0	0	204	0.0000000
zheyou73v0_A09	35135435	35136352	BnaA09T0314500ZY	0	-	0	0	917	0.0000000
zheyou73v0_A09	35136506	35137717	BnaA09T0314600ZY	0	-	0	0	1211	0.0000000
zheyou73v0_A09	35148156	35148378	BnaA09T0314700ZY	0	+	0	0	222	0.0000000
zheyou73v0_A09	35153946	35156125	BnaA09T0314800ZY	0	+	0	0	2179	0.0000000
zheyou73v0_A09	35157796	35158018	BnaA09T0314900ZY	0	+	0	0	222	0.0000000
zheyou73v0_A09	35163583	35165762	BnaA09T0315000ZY	0	+	0	0	2179	0.0000000
zheyou73v0_A09	35174525	35175685	BnaA09T0315100ZY	0	+	0	0	1160	0.0000000
zheyou73v0_A09	35250971	35251321	BnaA09T0315200ZY	0	+	0	0	350	0.0000000
zheyou73v0_A09	35290746	35291400	BnaA09T0315300ZY	0	+	0	0	654	0.0000000
zheyou73v0_A09	35573273	35573504	BnaA09T0315400ZY	0	+	0	0	231	0.0000000
zheyou73v0_A09	35574422	35574590	BnaA09T0315500ZY	0	+	0	0	168	0.0000000
zheyou73v0_A09	35575796	35576263	BnaA09T0315600ZY	0	-	0	0	467	0.0000000
zheyou73v0_A09	35583953	35584121	BnaA09T0315700ZY	0	+	0	0	168	0.0000000
zheyou73v0_A09	35584827	35585792	BnaA09T0315800ZY	0	-	0	0	965	0.0000000
zheyou73v0_A09	35627185	35627353	BnaA09T0315900ZY	0	+	0	0	168	0.0000000
zheyou73v0_A09	35631381	35632204	BnaA09T0316000ZY	0	+	0	0	823	0.0000000
zheyou73v0_A09	35632255	35634323	BnaA09T0316100ZY	0	-	0	0	2068	0.0000000
zheyou73v0_A09	35637247	35637415	BnaA09T0316200ZY	0	+	0	0	168	0.0000000
zheyou73v0_A09	35666421	35666663	BnaA09T0316300ZY	0	+	0	0	242	0.0000000
zheyou73v0_A09	35667580	35668403	BnaA09T0316400ZY	0	+	0	0	823	0.0000000
zheyou73v0_A09	35668454	35670522	BnaA09T0316500ZY	0	-	0	0	2068	0.0000000
zheyou73v0_A09	35676479	35678379	BnaA09T0316600ZY	0	+	0	0	1900	0.0000000
zheyou73v0_A09	35680905	35683651	BnaA09T0316700ZY	0	+	0	0	2746	0.0000000
zheyou73v0_A09	35684571	35685394	BnaA09T0316800ZY	0	+	0	0	823	0.0000000
zheyou73v0_A09	35685445	35687513	BnaA09T0316900ZY	0	-	0	0	2068	0.0000000
zheyou73v0_A09	35692699	35699892	BnaA09T0317000ZY	0	+	0	0	7193	0.0000000
zheyou73v0_A09	35700808	35701021	BnaA09T0317100ZY	0	+	0	0	213	0.0000000
zheyou73v0_A09	35701682	35702251	BnaA09T0317200ZY	0	-	0	0	569	0.0000000
zheyou73v0_A09	35733761	35734380	BnaA09T0317300ZY	0	-	0	0	619	0.0000000
zheyou73v0_A09	35734397	35734550	BnaA09T0317400ZY	0	-	0	0	153	0.0000000
zheyou73v0_A09	35848800	35848998	BnaA09T0317500ZY	0	+	0	0	198	0.0000000
zheyou73v0_A09	35854745	35856924	BnaA09T0317600ZY	0	+	0	0	2179	0.0000000
zheyou73v0_A09	35858596	35858818	BnaA09T0317700ZY	0	+	0	0	222	0.0000000
zheyou73v0_A09	35868678	35868900	BnaA09T0317800ZY	0	-	0	0	222	0.0000000
zheyou73v0_A09	35870572	35872751	BnaA09T0317900ZY	0	-	0	0	2179	0.0000000
zheyou73v0_A09	35873668	35874805	BnaA09T0318000ZY	0	-	0	0	1137	0.0000000
zheyou73v0_A09	35878424	35878646	BnaA09T0318100ZY	0	-	0	0	222	0.0000000
zheyou73v0_A09	35880318	35882497	BnaA09T0318200ZY	0	-	0	0	2179	0.0000000
zheyou73v0_A09	35920076	35920253	BnaA09T0318300ZY	0	+	0	0	177	0.0000000
zheyou73v0_A09	35920566	35945549	BnaA09T0318400ZY	0	+	0	0	24983	0.0000000
zheyou73v0_A09	35945600	35946423	BnaA09T0318500ZY	0	-	0	0	823	0.0000000
zheyou73v0_A09	35966601	35968672	BnaA09T0318600ZY	0	+	0	0	2071	0.0000000
zheyou73v0_A09	35968723	35969064	BnaA09T0318700ZY	0	-	0	0	341	0.0000000
zheyou73v0_A09	35970461	35973204	BnaA09T0318800ZY	0	-	0	0	2743	0.0000000
zheyou73v0_A09	36018116	36018494	BnaA09T0318900ZY	0	+	0	0	378	0.0000000
zheyou73v0_A09	36019474	36023141	BnaA09T0319000ZY	0	+	0	0	3667	0.0000000
zheyou73v0_A09	36027505	36028716	BnaA09T0319100ZY	0	+	0	0	1211	0.0000000
zheyou73v0_A09	36029116	36030709	BnaA09T0319200ZY	0	-	0	0	1593	0.0000000
zheyou73v0_A09	36037557	36039819	BnaA09T0319300ZY	0	+	0	0	2262	0.0000000
zheyou73v0_A09	36044694	36069576	BnaA09T0319400ZY	0	+	0	0	24882	0.0000000
zheyou73v0_A09	36070663	36071486	BnaA09T0319500ZY	0	+	0	0	823	0.0000000
zheyou73v0_A09	36071537	36073605	BnaA09T0319600ZY	0	-	0	0	2068	0.0000000
zheyou73v0_A09	36085612	36087205	BnaA09T0319700ZY	0	-	0	0	1593	0.0000000
zheyou73v0_A09	36097416	36097584	BnaA09T0319800ZY	0	-	0	0	168	0.0000000
zheyou73v0_A09	36103493	36105561	BnaA09T0319900ZY	0	+	0	0	2068	0.0000000
zheyou73v0_A09	36105612	36106435	BnaA09T0320000ZY	0	-	0	0	823	0.0000000
zheyou73v0_A09	36116552	36117763	BnaA09T0320100ZY	0	+	0	0	1211	0.0000000
zheyou73v0_A09	36128863	36129031	BnaA09T0320200ZY	0	-	0	0	168	0.0000000
zheyou73v0_A09	36137277	36139345	BnaA09T0320300ZY	0	+	0	0	2068	0.0000000
zheyou73v0_A09	36173110	36174321	BnaA09T0320400ZY	0	-	0	0	1211	0.0000000
zheyou73v0_A09	36179685	36180906	BnaA09T0320500ZY	0	+	0	0	1221	0.0000000
zheyou73v0_A09	36210089	36212157	BnaA09T0320600ZY	0	+	0	0	2068	0.0000000
zheyou73v0_A09	36212208	36213031	BnaA09T0320700ZY	0	-	0	0	823	0.0000000
zheyou73v0_A09	36237467	36238272	BnaA09T0320800ZY	0	+	0	0	805	0.0000000
zheyou73v0_A09	36240555	36242191	BnaA09T0320900ZY	0	-	0	0	1636	0.0000000
zheyou73v0_A09	36259749	36259917	BnaA09T0321000ZY	0	+	0	0	168	0.0000000
zheyou73v0_A09	36260139	36261356	BnaA09T0321100ZY	0	-	0	0	1217	0.0000000
zheyou73v0_A09	36289674	36291853	BnaA09T0321200ZY	0	+	0	0	2179	0.0000000
zheyou73v0_A09	36299256	36299424	BnaA09T0321300ZY	0	+	0	0	168	0.0000000
zheyou73v0_A09	36300130	36302199	BnaA09T0321400ZY	0	-	0	0	2069	0.0000000
zheyou73v0_A09	36302718	36302928	BnaA09T0321500ZY	0	+	0	0	210	0.0000000
zheyou73v0_A09	36315312	36317103	BnaA09T0321600ZY	0	-	0	0	1791	0.0000000
zheyou73v0_A09	36319804	36321645	BnaA09T0321700ZY	0	-	0	0	1841	0.0000000
zheyou73v0_A09	36355859	36356063	BnaA09T0321800ZY	0	+	0	0	204	0.0000000
zheyou73v0_A09	36356980	36358571	BnaA09T0321900ZY	0	+	0	0	1591	0.0000000
zheyou73v0_A09	36412317	36413629	BnaA09T0322000ZY	0	+	0	0	1312	0.0000000
zheyou73v0_A09	36414335	36414503	BnaA09T0322100ZY	0	-	0	0	168	0.0000000
zheyou73v0_A09	36455327	36456538	BnaA09T0322200ZY	0	+	0	0	1211	0.0000000
zheyou73v0_A09	36456885	36458442	BnaA09T0322300ZY	0	-	0	0	1557	0.0000000
zheyou73v0_A09	36472582	36474649	BnaA09T0322400ZY	0	+	0	0	2067	0.0000000
zheyou73v0_A09	36475355	36475523	BnaA09T0322500ZY	0	-	0	0	168	0.0000000
zheyou73v0_A09	36561614	36561818	BnaA09T0322600ZY	0	+	0	0	204	0.0000000
zheyou73v0_A09	36562735	36563559	BnaA09T0322700ZY	0	+	0	0	824	0.0000000
zheyou73v0_A09	36563610	36565678	BnaA09T0322800ZY	0	-	0	0	2068	0.0000000
zheyou73v0_A09	36570481	36571304	BnaA09T0322900ZY	0	+	0	0	823	0.0000000
zheyou73v0_A09	36571355	36573423	BnaA09T0323000ZY	0	-	0	0	2068	0.0000000
zheyou73v0_A09	36579285	36580108	BnaA09T0323100ZY	0	+	0	0	823	0.0000000
zheyou73v0_A09	36580159	36582227	BnaA09T0323200ZY	0	-	0	0	2068	0.0000000
zheyou73v0_A09	36598859	36600452	BnaA09T0323300ZY	0	-	0	0	1593	0.0000000
zheyou73v0_A09	36606360	36608428	BnaA09T0323400ZY	0	+	0	0	2068	0.0000000
zheyou73v0_A09	36608479	36609302	BnaA09T0323500ZY	0	-	0	0	823	0.0000000
zheyou73v0_A09	36624547	36626615	BnaA09T0323600ZY	0	+	0	0	2068	0.0000000
zheyou73v0_A09	36626666	36627489	BnaA09T0323700ZY	0	-	0	0	823	0.0000000
zheyou73v0_A09	36639943	36642011	BnaA09T0323800ZY	0	+	0	0	2068	0.0000000
zheyou73v0_A09	36642062	36642885	BnaA09T0323900ZY	0	-	0	0	823	0.0000000
zheyou73v0_A09	36643802	36644131	BnaA09T0324000ZY	0	-	0	0	329	0.0000000
zheyou73v0_A09	36648793	36650861	BnaA09T0324100ZY	0	+	0	0	2068	0.0000000
zheyou73v0_A09	36650912	36651735	BnaA09T0324200ZY	0	-	0	0	823	0.0000000
zheyou73v0_A09	36657786	36657954	BnaA09T0324300ZY	0	+	0	0	168	0.0000000
zheyou73v0_A09	36658660	36659624	BnaA09T0324400ZY	0	-	0	0	964	0.0000000
zheyou73v0_A09	36659778	36660988	BnaA09T0324500ZY	0	-	0	0	1210	0.0000000
zheyou73v0_A09	36681885	36682708	BnaA09T0324600ZY	0	+	0	0	823	0.0000000
zheyou73v0_A09	36682759	36687179	BnaA09T0324700ZY	0	-	0	0	4420	0.0000000
zheyou73v0_A09	36692825	36692993	BnaA09T0324800ZY	0	+	0	0	168	0.0000000
zheyou73v0_A09	36693700	36695768	BnaA09T0324900ZY	0	-	0	0	2068	0.0000000
zheyou73v0_A09	36713371	36715550	BnaA09T0325000ZY	0	+	0	0	2179	0.0000000
zheyou73v0_A09	36721099	36721303	BnaA09T0325100ZY	0	+	0	0	204	0.0000000
zheyou73v0_A09	36722220	36724399	BnaA09T0325200ZY	0	+	0	0	2179	0.0000000
zheyou73v0_A09	36750718	36753048	BnaA09T0325300ZY	0	-	0	0	2330	0.0000000
zheyou73v0_A09	36758693	36760286	BnaA09T0325400ZY	0	+	0	0	1593	0.0000000
zheyou73v0_A09	37752951	37757336	BnaA09T0325500ZY	0	-	0	0	4385	0.0000000
zheyou73v0_A09	37844366	37844870	BnaA09T0325600ZY	0	+	0	0	504	0.0000000
zheyou73v0_A09	37893424	37894601	BnaA09T0325700ZY	0	-	0	0	1177	0.0000000
zheyou73v0_A09	39082783	39084562	BnaA09T0325800ZY	0	+	0	0	1779	0.0000000
zheyou73v0_A09	39101623	39102669	BnaA09T0325900ZY	0	-	0	0	1046	0.0000000
zheyou73v0_A09	39176387	39176720	BnaA09T0326000ZY	0	+	0	0	333	0.0000000
zheyou73v0_A09	39206321	39206654	BnaA09T0326100ZY	0	-	0	0	333	0.0000000
zheyou73v0_A09	39257609	39268369	BnaA09T0326200ZY	0	+	0	0	10760	0.0000000
zheyou73v0_A09	39268769	39270361	BnaA09T0326300ZY	0	-	0	0	1592	0.0000000
zheyou73v0_A09	39271892	39275353	BnaA09T0326400ZY	0	+	0	0	3461	0.0000000
zheyou73v0_A09	39276052	39282810	BnaA09T0326500ZY	0	-	0	0	6758	0.0000000
zheyou73v0_A09	39283730	39284059	BnaA09T0326600ZY	0	-	0	0	329	0.0000000
zheyou73v0_A09	39288757	39288967	BnaA09T0326700ZY	0	-	0	0	210	0.0000000
zheyou73v0_A09	39323511	39323715	BnaA09T0326800ZY	0	+	0	0	204	0.0000000
zheyou73v0_A09	39324632	39325463	BnaA09T0326900ZY	0	+	0	0	831	0.0000000
zheyou73v0_A09	39325506	39327292	BnaA09T0327000ZY	0	-	0	0	1786	0.0000000
zheyou73v0_A09	39328149	39328616	BnaA09T0327100ZY	0	-	0	0	467	0.0000000
zheyou73v0_A09	39415185	39416159	BnaA09T0327200ZY	0	-	0	0	974	0.0000000
zheyou73v0_A09	39587184	39587562	BnaA09T0327300ZY	0	-	0	0	378	0.0000000
zheyou73v0_A09	40105687	40105855	BnaA09T0327400ZY	0	-	0	0	168	0.0000000
zheyou73v0_A09	40340227	40348579	BnaA09T0327500ZY	0	+	0	0	8352	0.0000000
zheyou73v0_A09	40473981	40476590	BnaA09T0327600ZY	0	+	0	0	2609	0.0000000
zheyou73v0_A09	40479829	40481592	BnaA09T0327700ZY	0	+	0	0	1763	0.0000000
zheyou73v0_A09	40492747	40493361	BnaA09T0327800ZY	0	+	0	0	614	0.0000000
zheyou73v0_A09	40847229	40849799	BnaA09T0327900ZY	0	-	0	0	2570	0.0000000
zheyou73v0_A09	40872781	40876192	BnaA09T0328000ZY	0	-	0	0	3411	0.0000000
zheyou73v0_A09	40895787	40897719	BnaA09T0328100ZY	0	+	0	0	1932	0.0000000
zheyou73v0_A09	40914795	40915647	BnaA09T0328200ZY	0	-	0	0	852	0.0000000
zheyou73v0_A09	40955562	40958366	BnaA09T0328300ZY	0	-	0	0	2804	0.0000000
zheyou73v0_A09	40959716	40960838	BnaA09T0328400ZY	0	-	0	0	1122	0.0000000
zheyou73v0_A09	40965351	40966014	BnaA09T0328500ZY	0	+	0	0	663	0.0000000
zheyou73v0_A09	41091165	41092352	BnaA09T0328600ZY	0	-	0	0	1187	0.0000000
zheyou73v0_A09	41096920	41097420	BnaA09T0328700ZY	0	-	0	0	500	0.0000000
zheyou73v0_A09	41098429	41099465	BnaA09T0328800ZY	0	+	0	0	1036	0.0000000
zheyou73v0_A09	41139700	41140652	BnaA09T0328900ZY	0	+	0	0	952	0.0000000
zheyou73v0_A09	41163063	41164125	BnaA09T0329000ZY	0	+	0	0	1062	0.0000000
zheyou73v0_A09	41179801	41181432	BnaA09T0329100ZY	0	+	0	0	1631	0.0000000
zheyou73v0_A09	41186924	41188385	BnaA09T0329200ZY	0	-	0	0	1461	0.0000000
zheyou73v0_A09	41397670	41399319	BnaA09T0329300ZY	0	-	0	0	1649	0.0000000
zheyou73v0_A09	41474735	41475818	BnaA09T0329400ZY	0	-	0	0	1083	0.0000000
zheyou73v0_A09	41479105	41482653	BnaA09T0329500ZY	0	+	0	0	3548	0.0000000
zheyou73v0_A09	41486622	41488772	BnaA09T0329600ZY	0	-	0	0	2150	0.0000000
zheyou73v0_A09	41549984	41550866	BnaA09T0329700ZY	0	+	0	0	882	0.0000000
zheyou73v0_A09	41554193	41554409	BnaA09T0329800ZY	0	+	0	0	216	0.0000000
zheyou73v0_A09	41554520	41554715	BnaA09T0329900ZY	0	+	0	0	195	0.0000000
zheyou73v0_A09	41557427	41565283	BnaA09T0330000ZY	0	+	0	0	7856	0.0000000
zheyou73v0_A09	41566772	41568449	BnaA09T0330100ZY	0	+	0	0	1677	0.0000000
zheyou73v0_A09	41574470	41576979	BnaA09T0330200ZY	0	-	0	0	2509	0.0000000
zheyou73v0_A09	41587406	41588296	BnaA09T0330300ZY	0	-	0	0	890	0.0000000
zheyou73v0_A09	41597989	41604250	BnaA09T0330400ZY	0	+	0	0	6261	0.0000000
zheyou73v0_A09	41610392	41611789	BnaA09T0330500ZY	0	-	0	0	1397	0.0000000
zheyou73v0_A09	41624566	41626504	BnaA09T0330600ZY	0	+	0	0	1938	0.0000000
zheyou73v0_A09	41631350	41635525	BnaA09T0330700ZY	0	+	0	0	4175	0.0000000
zheyou73v0_A09	41636840	41639174	BnaA09T0330800ZY	0	+	0	0	2334	0.0000000
zheyou73v0_A09	41639814	41642396	BnaA09T0330900ZY	0	+	0	0	2582	0.0000000
zheyou73v0_A09	41641713	41643521	BnaA09T0331000ZY	0	-	0	0	1808	0.0000000
zheyou73v0_A09	41648377	41649144	BnaA09T0331100ZY	0	+	0	0	767	0.0000000
zheyou73v0_A09	41651208	41667861	BnaA09T0331200ZY	0	-	0	0	16653	0.0000000
zheyou73v0_A09	41674140	41677451	BnaA09T0331300ZY	0	-	0	0	3311	0.0000000
zheyou73v0_A09	41678836	41682633	BnaA09T0331400ZY	0	-	0	0	3797	0.0000000
zheyou73v0_A09	41698283	41701001	BnaA09T0331500ZY	0	-	0	0	2718	0.0000000
zheyou73v0_A09	41702063	41702699	BnaA09T0331600ZY	0	+	0	0	636	0.0000000
zheyou73v0_A09	41705040	41705622	BnaA09T0331700ZY	0	-	0	0	582	0.0000000
zheyou73v0_A09	41726971	41728783	BnaA09T0331800ZY	0	+	0	0	1812	0.0000000
zheyou73v0_A09	41728993	41730680	BnaA09T0331900ZY	0	-	0	0	1687	0.0000000
zheyou73v0_A09	41730693	41737348	BnaA09T0332000ZY	0	-	0	0	6655	0.0000000
zheyou73v0_A09	41754841	41756320	BnaA09T0332100ZY	0	-	0	0	1479	0.0000000
zheyou73v0_A09	41762947	41764018	BnaA09T0332200ZY	0	-	0	0	1071	0.0000000
zheyou73v0_A09	41773315	41774945	BnaA09T0332300ZY	0	-	0	0	1630	0.0000000
zheyou73v0_A09	41790557	41792156	BnaA09T0332400ZY	0	-	0	0	1599	0.0000000
zheyou73v0_A09	41800786	41801080	BnaA09T0332500ZY	0	+	0	0	294	0.0000000
zheyou73v0_A09	41801180	41801756	BnaA09T0332600ZY	0	+	0	0	576	0.0000000
zheyou73v0_A09	41804737	41807083	BnaA09T0332700ZY	0	-	0	0	2346	0.0000000
zheyou73v0_A09	41820685	41822571	BnaA09T0332800ZY	0	-	0	0	1886	0.0000000
zheyou73v0_A09	41835781	41836823	BnaA09T0332900ZY	0	-	0	0	1042	0.0000000
zheyou73v0_A09	41838684	41839221	BnaA09T0333000ZY	0	+	0	0	537	0.0000000
zheyou73v0_A09	41841667	41844140	BnaA09T0333100ZY	0	-	0	0	2473	0.0000000
zheyou73v0_A09	41893005	41894848	BnaA09T0333200ZY	0	-	0	0	1843	0.0000000
zheyou73v0_A09	41895129	41898284	BnaA09T0333300ZY	0	-	0	0	3155	0.0000000
zheyou73v0_A09	41928981	41930926	BnaA09T0333400ZY	0	-	0	0	1945	0.0000000
zheyou73v0_A09	41952387	41952891	BnaA09T0333500ZY	0	+	0	0	504	0.0000000
zheyou73v0_A09	41969607	41970840	BnaA09T0333600ZY	0	+	0	0	1233	0.0000000
zheyou73v0_A09	41971676	41973967	BnaA09T0333700ZY	0	-	0	0	2291	0.0000000
zheyou73v0_A09	41999077	42001501	BnaA09T0333800ZY	0	-	0	0	2424	0.0000000
zheyou73v0_A09	41999077	42001501	BnaA09T0333800ZY.1	0	-	0	0	2424	0.0000000
zheyou73v0_A09	42001898	42004322	BnaA09T0333900ZY	0	+	0	0	2424	0.0000000
zheyou73v0_A09	42001898	42004322	BnaA09T0333900ZY.2	0	+	0	0	2424	0.0000000
zheyou73v0_A09	42002173	42004322	BnaA09T0333900ZY.1	0	+	0	0	2149	0.0000000
zheyou73v0_A09	42015151	42017010	BnaA09T0334000ZY	0	+	0	0	1859	0.0000000
zheyou73v0_A09	42036640	42039372	BnaA09T0334100ZY	0	+	0	0	2732	0.0000000
zheyou73v0_A09	42039821	42041382	BnaA09T0334200ZY	0	-	0	0	1561	0.0000000
zheyou73v0_A09	42051091	42052745	BnaA09T0334300ZY	0	+	0	0	1654	0.0000000
zheyou73v0_A09	42051091	42052745	BnaA09T0334300ZY.1	0	+	0	0	1654	0.0000000
zheyou73v0_A09	42052788	42054359	BnaA09T0334400ZY	0	+	0	0	1571	0.0000000
zheyou73v0_A09	42054286	42056169	BnaA09T0334500ZY	0	-	0	0	1883	0.0000000
zheyou73v0_A09	42057675	42058309	BnaA09T0334600ZY	0	+	0	0	634	0.0000000
zheyou73v0_A09	42060343	42061224	BnaA09T0334700ZY	0	-	0	0	881	0.0000000
zheyou73v0_A09	42067203	42067698	BnaA09T0334800ZY	0	-	0	0	495	0.0000000
zheyou73v0_A09	42068698	42069573	BnaA09T0334900ZY	0	+	0	0	875	0.0000000
zheyou73v0_A09	42070387	42071245	BnaA09T0335000ZY	0	+	0	0	858	0.0000000
zheyou73v0_A09	42074744	42089328	BnaA09T0335100ZY	0	-	0	0	14584	0.0000000
zheyou73v0_A09	42102937	42103126	BnaA09T0335200ZY	0	+	0	0	189	0.0000000
zheyou73v0_A09	42119239	42119565	BnaA09T0335300ZY	0	-	0	0	326	0.0000000
zheyou73v0_A09	42119687	42122159	BnaA09T0335400ZY	0	-	0	0	2472	0.0000000
zheyou73v0_A09	42135688	42137406	BnaA09T0335500ZY	0	+	0	0	1718	0.0000000
zheyou73v0_A09	42137275	42138276	BnaA09T0335600ZY	0	-	0	0	1001	0.0000000
zheyou73v0_A09	42151733	42152258	BnaA09T0335700ZY	0	-	0	0	525	0.0000000
zheyou73v0_A09	42155153	42156455	BnaA09T0335800ZY	0	-	0	0	1302	0.0000000
zheyou73v0_A09	42165699	42167248	BnaA09T0335900ZY	0	+	0	0	1549	0.0000000
zheyou73v0_A09	42167272	42169632	BnaA09T0336000ZY	0	-	0	0	2360	0.0000000
zheyou73v0_A09	42199039	42199591	BnaA09T0336100ZY	0	-	0	0	552	0.0000000
zheyou73v0_A09	42228328	42233587	BnaA09T0336200ZY	0	+	0	0	5259	0.0000000
zheyou73v0_A09	42234680	42238693	BnaA09T0336300ZY	0	-	0	0	4013	0.0000000
zheyou73v0_A09	42244212	42245904	BnaA09T0336400ZY	0	-	0	0	1692	0.0000000
zheyou73v0_A09	42261425	42266631	BnaA09T0336500ZY	0	+	0	0	5206	0.0000000
zheyou73v0_A09	42267202	42268681	BnaA09T0336600ZY	0	+	0	0	1479	0.0000000
zheyou73v0_A09	42270780	42272236	BnaA09T0336700ZY	0	+	0	0	1456	0.0000000
zheyou73v0_A09	42273938	42275074	BnaA09T0336800ZY	0	+	0	0	1136	0.0000000
zheyou73v0_A09	42293743	42296879	BnaA09T0336900ZY	0	+	0	0	3136	0.0000000
zheyou73v0_A09	42312448	42313961	BnaA09T0337000ZY	0	+	0	0	1513	0.0000000
zheyou73v0_A09	42312448	42313961	BnaA09T0337000ZY.1	0	+	0	0	1513	0.0000000
zheyou73v0_A09	42312448	42313961	BnaA09T0337000ZY.2	0	+	0	0	1513	0.0000000
zheyou73v0_A09	42315013	42316266	BnaA09T0337100ZY	0	+	0	0	1253	0.0000000
zheyou73v0_A09	42317983	42318502	BnaA09T0337200ZY	0	+	0	0	519	0.0000000
zheyou73v0_A09	42318885	42320681	BnaA09T0337300ZY	0	-	0	0	1796	0.0000000
zheyou73v0_A09	42320944	42324445	BnaA09T0337400ZY	0	+	0	0	3501	0.0000000
zheyou73v0_A09	42382266	42382449	BnaA09T0337500ZY	0	-	0	0	183	0.0000000
zheyou73v0_A09	42424687	42424957	BnaA09T0337600ZY	0	-	0	0	270	0.0000000
zheyou73v0_A09	42425972	42438886	BnaA09T0337700ZY	0	-	0	0	12914	0.0000000
zheyou73v0_A09	42438893	42439184	BnaA09T0337800ZY	0	-	0	0	291	0.0000000
zheyou73v0_A09	42465029	42467110	BnaA09T0337900ZY	0	-	0	0	2081	0.0000000
zheyou73v0_A09	42465029	42467110	BnaA09T0337900ZY.1	0	-	0	0	2081	0.0000000
zheyou73v0_A09	42465029	42467110	BnaA09T0337900ZY.2	0	-	0	0	2081	0.0000000
zheyou73v0_A09	42465029	42467110	BnaA09T0337900ZY.3	0	-	0	0	2081	0.0000000
zheyou73v0_A09	42494546	42495641	BnaA09T0338000ZY	0	+	0	0	1095	0.0000000
zheyou73v0_A09	42495847	42497851	BnaA09T0338100ZY	0	-	0	0	2004	0.0000000
zheyou73v0_A09	42536461	42537166	BnaA09T0338200ZY	0	+	0	0	705	0.0000000
zheyou73v0_A09	42544758	42546568	BnaA09T0338300ZY	0	-	0	0	1810	0.0000000
zheyou73v0_A09	42582435	42584223	BnaA09T0338400ZY	0	+	0	0	1788	0.0000000
zheyou73v0_A09	42597735	42600260	BnaA09T0338500ZY	0	+	0	0	2525	0.0000000
zheyou73v0_A09	42605478	42609147	BnaA09T0338600ZY	0	-	0	0	3669	0.0000000
zheyou73v0_A09	42614567	42616037	BnaA09T0338700ZY	0	+	0	0	1470	0.0000000
zheyou73v0_A09	42621386	42622428	BnaA09T0338800ZY	0	-	0	0	1042	0.0000000
zheyou73v0_A09	42623225	42623514	BnaA09T0338900ZY	0	-	0	0	289	0.0000000
zheyou73v0_A09	42639213	42640434	BnaA09T0339000ZY	0	+	0	0	1221	0.0000000
zheyou73v0_A09	42642526	42643875	BnaA09T0339100ZY	0	+	0	0	1349	0.0000000
zheyou73v0_A09	42648044	42648589	BnaA09T0339200ZY	0	-	0	0	545	0.0000000
zheyou73v0_A09	42657069	42674713	BnaA09T0339300ZY	0	+	0	0	17644	0.0000000
zheyou73v0_A09	42694890	42695217	BnaA09T0339400ZY	0	-	0	0	327	0.0000000
zheyou73v0_A09	42695892	42701330	BnaA09T0339500ZY	0	+	0	0	5438	0.0000000
zheyou73v0_A09	42722169	42723635	BnaA09T0339600ZY	0	+	0	0	1466	0.0000000
zheyou73v0_A09	42754753	42757648	BnaA09T0339700ZY	0	+	0	0	2895	0.0000000
zheyou73v0_A09	42754753	42757648	BnaA09T0339700ZY.1	0	+	0	0	2895	0.0000000
zheyou73v0_A09	42762799	42763723	BnaA09T0339800ZY	0	+	0	0	924	0.0000000
zheyou73v0_A09	42770709	42773304	BnaA09T0339900ZY	0	+	0	0	2595	0.0000000
zheyou73v0_A09	42798056	42798573	BnaA09T0340000ZY	0	+	0	0	517	0.0000000
zheyou73v0_A09	42806722	42807160	BnaA09T0340100ZY	0	-	0	0	438	0.0000000
zheyou73v0_A09	42807635	42808211	BnaA09T0340200ZY	0	-	0	0	576	0.0000000
zheyou73v0_A09	42812769	42814090	BnaA09T0340300ZY	0	+	0	0	1321	0.0000000
zheyou73v0_A09	42821720	42841378	BnaA09T0340400ZY	0	-	0	0	19658	0.0000000
zheyou73v0_A09	42858173	42879307	BnaA09T0340500ZY	0	-	0	0	21134	0.0000000
zheyou73v0_A09	42898577	42898904	BnaA09T0340600ZY	0	+	0	0	327	0.0000000
zheyou73v0_A09	42903340	42905685	BnaA09T0340700ZY	0	+	0	0	2345	0.0000000
zheyou73v0_A09	42905870	42906286	BnaA09T0340800ZY	0	-	0	0	416	0.0000000
zheyou73v0_A09	42908237	42908846	BnaA09T0340900ZY	0	-	0	0	609	0.0000000
zheyou73v0_A09	42914700	42916740	BnaA09T0341000ZY	0	+	0	0	2040	0.0000000
zheyou73v0_A09	42916757	42920788	BnaA09T0341100ZY	0	-	0	0	4031	0.0000000
zheyou73v0_A09	42952157	42953569	BnaA09T0341200ZY	0	-	0	0	1412	0.0000000
zheyou73v0_A09	42960146	42962240	BnaA09T0341300ZY	0	+	0	0	2094	0.0000000
zheyou73v0_A09	42965351	42968249	BnaA09T0341400ZY	0	+	0	0	2898	0.0000000
zheyou73v0_A09	42972345	42975263	BnaA09T0341500ZY	0	-	0	0	2918	0.0000000
zheyou73v0_A09	42987160	42989033	BnaA09T0341600ZY	0	+	0	0	1873	0.0000000
zheyou73v0_A09	43033100	43034235	BnaA09T0341700ZY	0	-	0	0	1135	0.0000000
zheyou73v0_A09	43042743	43044508	BnaA09T0341800ZY	0	+	0	0	1765	0.0000000
zheyou73v0_A09	43042743	43044508	BnaA09T0341800ZY.1	0	+	0	0	1765	0.0000000
zheyou73v0_A09	43042743	43044508	BnaA09T0341800ZY.2	0	+	0	0	1765	0.0000000
zheyou73v0_A09	43081941	43084303	BnaA09T0341900ZY	0	-	0	0	2362	0.0000000
zheyou73v0_A09	43090922	43096585	BnaA09T0342000ZY	0	+	0	0	5663	0.0000000
zheyou73v0_A09	43099027	43099279	BnaA09T0342100ZY	0	-	0	0	252	0.0000000
zheyou73v0_A09	43107288	43108266	BnaA09T0342200ZY	0	-	0	0	978	0.0000000
zheyou73v0_A09	43121857	43122357	BnaA09T0342300ZY	0	-	0	0	500	0.0000000
zheyou73v0_A09	43122722	43124689	BnaA09T0342400ZY	0	+	0	0	1967	0.0000000
zheyou73v0_A09	43131833	43132193	BnaA09T0342500ZY	0	+	0	0	360	0.0000000
zheyou73v0_A09	43138096	43141054	BnaA09T0342600ZY	0	+	0	0	2958	0.0000000
zheyou73v0_A09	43138096	43141054	BnaA09T0342600ZY.1	0	+	0	0	2958	0.0000000
zheyou73v0_A09	43138096	43141054	BnaA09T0342600ZY.2	0	+	0	0	2958	0.0000000
zheyou73v0_A09	43141107	43142018	BnaA09T0342700ZY	0	+	0	0	911	0.0000000
zheyou73v0_A09	43144476	43146143	BnaA09T0342800ZY.1	0	-	0	0	1667	0.0000000
zheyou73v0_A09	43144679	43146143	BnaA09T0342800ZY	0	-	0	0	1464	0.0000000
zheyou73v0_A09	43147691	43149437	BnaA09T0342900ZY	0	-	0	0	1746	0.0000000
zheyou73v0_A09	43157378	43159372	BnaA09T0343000ZY	0	+	0	0	1994	0.0000000
zheyou73v0_A09	43158523	43158769	BnaA09T0343100ZY	0	-	0	0	246	0.0000000
zheyou73v0_A09	43167127	43169172	BnaA09T0343200ZY	0	+	0	0	2045	0.0000000
zheyou73v0_A09	43203883	43208520	BnaA09T0343300ZY	0	+	0	0	4637	0.0000000
zheyou73v0_A09	43203883	43208520	BnaA09T0343300ZY.1	0	+	0	0	4637	0.0000000
zheyou73v0_A09	43208788	43211053	BnaA09T0343400ZY	0	-	0	0	2265	0.0000000
zheyou73v0_A09	43213004	43213816	BnaA09T0343500ZY	0	-	0	0	812	0.0000000
zheyou73v0_A09	43218550	43220749	BnaA09T0343600ZY	0	+	0	0	2199	0.0000000
zheyou73v0_A09	43221997	43224291	BnaA09T0343700ZY	0	-	0	0	2294	0.0000000
zheyou73v0_A09	43225252	43227007	BnaA09T0343800ZY	0	-	0	0	1755	0.0000000
zheyou73v0_A09	43227173	43228259	BnaA09T0343900ZY	0	-	0	0	1086	0.0000000
zheyou73v0_A09	43229148	43231266	BnaA09T0344000ZY	0	-	0	0	2118	0.0000000
zheyou73v0_A09	43231208	43232986	BnaA09T0344100ZY	0	+	0	0	1778	0.0000000
zheyou73v0_A09	43241892	43245022	BnaA09T0344200ZY	0	+	0	0	3130	0.0000000
zheyou73v0_A09	43245293	43246220	BnaA09T0344300ZY	0	-	0	0	927	0.0000000
zheyou73v0_A09	43246727	43248592	BnaA09T0344400ZY	0	-	0	0	1865	0.0000000
zheyou73v0_A09	43246727	43248592	BnaA09T0344400ZY.1	0	-	0	0	1865	0.0000000
zheyou73v0_A09	43248823	43249985	BnaA09T0344500ZY	0	+	0	0	1162	0.0000000
zheyou73v0_A09	43282398	43286506	BnaA09T0344600ZY	0	+	0	0	4108	0.0000000
zheyou73v0_A09	43313628	43315205	BnaA09T0344700ZY	0	+	0	0	1577	0.0000000
zheyou73v0_A09	43326354	43328763	BnaA09T0344800ZY	0	-	0	0	2409	0.0000000
zheyou73v0_A09	43329069	43335137	BnaA09T0344900ZY	0	-	0	0	6068	0.0000000
zheyou73v0_A09	43345087	43346858	BnaA09T0345000ZY	0	-	0	0	1771	0.0000000
zheyou73v0_A09	43345087	43346580	BnaA09T0345000ZY.1	0	-	0	0	1493	0.0000000
zheyou73v0_A09	43347098	43348953	BnaA09T0345100ZY	0	+	0	0	1855	0.0000000
zheyou73v0_A09	43350203	43353187	BnaA09T0345200ZY	0	+	0	0	2984	0.0000000
zheyou73v0_A09	43350203	43353187	BnaA09T0345200ZY.1	0	+	0	0	2984	0.0000000
zheyou73v0_A09	43378273	43381058	BnaA09T0345300ZY	0	+	0	0	2785	0.0000000
zheyou73v0_A09	43447896	43450024	BnaA09T0345400ZY	0	-	0	0	2128	0.0000000
zheyou73v0_A09	43454350	43457529	BnaA09T0345500ZY	0	+	0	0	3179	0.0000000
zheyou73v0_A09	43457425	43457899	BnaA09T0345600ZY	0	-	0	0	474	0.0000000
zheyou73v0_A09	43457980	43458584	BnaA09T0345700ZY	0	-	0	0	604	0.0000000
zheyou73v0_A09	43459021	43462034	BnaA09T0345800ZY	0	-	0	0	3013	0.0000000
zheyou73v0_A09	43464457	43465229	BnaA09T0345900ZY	0	+	0	0	772	0.0000000
zheyou73v0_A09	43470650	43474028	BnaA09T0346000ZY	0	-	0	0	3378	0.0000000
zheyou73v0_A09	43470650	43474028	BnaA09T0346000ZY.1	0	-	0	0	3378	0.0000000
zheyou73v0_A09	43492407	43494267	BnaA09T0346100ZY	0	+	0	0	1860	0.0000000
zheyou73v0_A09	43501739	43502484	BnaA09T0346200ZY	0	+	0	0	745	0.0000000
zheyou73v0_A09	43511716	43514134	BnaA09T0346300ZY	0	+	0	0	2418	0.0000000
zheyou73v0_A09	43520003	43521967	BnaA09T0346400ZY	0	-	0	0	1964	0.0000000
zheyou73v0_A09	43524751	43527303	BnaA09T0346500ZY	0	-	0	0	2552	0.0000000
zheyou73v0_A09	43534486	43534903	BnaA09T0346600ZY	0	-	0	0	417	0.0000000
zheyou73v0_A09	43541647	43542312	BnaA09T0346700ZY	0	-	0	0	665	0.0000000
zheyou73v0_A09	43543126	43544843	BnaA09T0346800ZY	0	-	0	0	1717	0.0000000
zheyou73v0_A09	43553453	43555184	BnaA09T0346900ZY	0	+	0	0	1731	0.0000000
zheyou73v0_A09	43561210	43561684	BnaA09T0347000ZY	0	-	0	0	474	0.0000000
zheyou73v0_A09	43565718	43566720	BnaA09T0347100ZY	0	-	0	0	1002	0.0000000
zheyou73v0_A09	43573116	43576032	BnaA09T0347200ZY	0	-	0	0	2916	0.0000000
zheyou73v0_A09	43584765	43586854	BnaA09T0347300ZY	0	+	0	0	2089	0.0000000
zheyou73v0_A09	43590567	43591669	BnaA09T0347400ZY	0	+	0	0	1102	0.0000000
zheyou73v0_A09	43592084	43594554	BnaA09T0347500ZY	0	-	0	0	2470	0.0000000
zheyou73v0_A09	43608183	43609993	BnaA09T0347600ZY	0	-	0	0	1810	0.0000000
zheyou73v0_A09	43629399	43630071	BnaA09T0347700ZY	0	+	0	0	672	0.0000000
zheyou73v0_A09	43639406	43643107	BnaA09T0347800ZY	0	-	0	0	3701	0.0000000
zheyou73v0_A09	43648692	43651455	BnaA09T0347900ZY	0	-	0	0	2763	0.0000000
zheyou73v0_A09	43667359	43667633	BnaA09T0348000ZY	0	-	0	0	274	0.0000000
zheyou73v0_A09	43677814	43679068	BnaA09T0348100ZY	0	+	0	0	1254	0.0000000
zheyou73v0_A09	43687472	43688094	BnaA09T0348200ZY	0	+	0	0	622	0.0000000
zheyou73v0_A09	43698844	43702621	BnaA09T0348300ZY	0	-	0	0	3777	0.0000000
zheyou73v0_A09	43698844	43702621	BnaA09T0348300ZY.1	0	-	0	0	3777	0.0000000
zheyou73v0_A09	43712049	43712202	BnaA09T0348400ZY	0	+	0	0	153	0.0000000
zheyou73v0_A09	43740127	43741130	BnaA09T0348500ZY	0	-	0	0	1003	0.0000000
zheyou73v0_A09	43748865	43750872	BnaA09T0348600ZY.1	0	+	0	0	2007	0.0000000
zheyou73v0_A09	43748865	43750872	BnaA09T0348600ZY.2	0	+	0	0	2007	0.0000000
zheyou73v0_A09	43748885	43750872	BnaA09T0348600ZY	0	+	0	0	1987	0.0000000
zheyou73v0_A09	43751165	43752835	BnaA09T0348700ZY	0	+	0	0	1670	0.0000000
zheyou73v0_A09	43753143	43754484	BnaA09T0348800ZY	0	+	0	0	1341	0.0000000
zheyou73v0_A09	43762962	43764525	BnaA09T0348900ZY	0	+	0	0	1563	0.0000000
zheyou73v0_A09	43764832	43765880	BnaA09T0349000ZY	0	+	0	0	1048	0.0000000
zheyou73v0_A09	43767001	43768168	BnaA09T0349100ZY	0	+	0	0	1167	0.0000000
zheyou73v0_A09	43771638	43777600	BnaA09T0349200ZY	0	+	0	0	5962	0.0000000
zheyou73v0_A09	43781351	43784423	BnaA09T0349300ZY	0	-	0	0	3072	0.0000000
zheyou73v0_A09	43784869	43786208	BnaA09T0349400ZY	0	+	0	0	1339	0.0000000
zheyou73v0_A09	43825887	43829577	BnaA09T0349500ZY	0	+	0	0	3690	0.0000000
zheyou73v0_A09	43838681	43839395	BnaA09T0349600ZY	0	+	0	0	714	0.0000000
zheyou73v0_A09	43860855	43871917	BnaA09T0349700ZY	0	-	0	0	11062	0.0000000
zheyou73v0_A09	43874732	43879322	BnaA09T0349800ZY	0	-	0	0	4590	0.0000000
zheyou73v0_A09	43882089	43912401	BnaA09T0349900ZY	0	+	0	0	30312	0.0000000
zheyou73v0_A09	43920292	43922680	BnaA09T0350000ZY	0	+	0	0	2388	0.0000000
zheyou73v0_A09	43934491	43935814	BnaA09T0350100ZY	0	+	0	0	1323	0.0000000
zheyou73v0_A09	43935975	43941071	BnaA09T0350200ZY	0	-	0	0	5096	0.0000000
zheyou73v0_A09	43944174	43944660	BnaA09T0350300ZY	0	-	0	0	486	0.0000000
zheyou73v0_A09	43945993	43949101	BnaA09T0350400ZY	0	+	0	0	3108	0.0000000
zheyou73v0_A09	43951828	43953599	BnaA09T0350500ZY	0	+	0	0	1771	0.0000000
zheyou73v0_A09	43958932	43960638	BnaA09T0350600ZY	0	-	0	0	1706	0.0000000
zheyou73v0_A09	43963699	43965183	BnaA09T0350700ZY	0	+	0	0	1484	0.0000000
zheyou73v0_A09	43968762	43969053	BnaA09T0350800ZY	0	+	0	0	291	0.0000000
zheyou73v0_A09	43986090	43987064	BnaA09T0350900ZY	0	-	0	0	974	0.0000000
zheyou73v0_A09	44021565	44023075	BnaA09T0351000ZY	0	+	0	0	1510	0.0000000
zheyou73v0_A09	44034668	44034896	BnaA09T0351100ZY	0	+	0	0	228	0.0000000
zheyou73v0_A09	44035957	44036775	BnaA09T0351200ZY	0	+	0	0	818	0.0000000
zheyou73v0_A09	44036842	44037349	BnaA09T0351300ZY	0	+	0	0	507	0.0000000
zheyou73v0_A09	44037545	44037875	BnaA09T0351400ZY	0	-	0	0	330	0.0000000
zheyou73v0_A09	44041881	44044393	BnaA09T0351500ZY	0	+	0	0	2512	0.0000000
zheyou73v0_A09	44041987	44044393	BnaA09T0351500ZY.1	0	+	0	0	2406	0.0000000
zheyou73v0_A09	44058580	44059213	BnaA09T0351600ZY	0	+	0	0	633	0.0000000
zheyou73v0_A09	44063235	44064640	BnaA09T0351700ZY	0	+	0	0	1405	0.0000000
zheyou73v0_A09	44088572	44090165	BnaA09T0351800ZY	0	+	0	0	1593	0.0000000
zheyou73v0_A09	44102918	44104946	BnaA09T0351900ZY	0	-	0	0	2028	0.0000000
zheyou73v0_A09	44102918	44104946	BnaA09T0351900ZY.1	0	-	0	0	2028	0.0000000
zheyou73v0_A09	44102918	44104946	BnaA09T0351900ZY.2	0	-	0	0	2028	0.0000000
zheyou73v0_A09	44109059	44112479	BnaA09T0352000ZY	0	-	0	0	3420	0.0000000
zheyou73v0_A09	44137387	44141058	BnaA09T0352100ZY	0	+	0	0	3671	0.0000000
zheyou73v0_A09	44160619	44161632	BnaA09T0352200ZY	0	+	0	0	1013	0.0000000
zheyou73v0_A09	44162447	44166762	BnaA09T0352300ZY	0	+	0	0	4315	0.0000000
zheyou73v0_A09	44168392	44170107	BnaA09T0352400ZY	0	-	0	0	1715	0.0000000
zheyou73v0_A09	44177961	44178598	BnaA09T0352500ZY	0	-	0	0	637	0.0000000
zheyou73v0_A09	44179372	44180101	BnaA09T0352600ZY	0	+	0	0	729	0.0000000
zheyou73v0_A09	44180197	44182055	BnaA09T0352700ZY	0	-	0	0	1858	0.0000000
zheyou73v0_A09	44182211	44183081	BnaA09T0352800ZY	0	-	0	0	870	0.0000000
zheyou73v0_A09	44210330	44217765	BnaA09T0352900ZY	0	-	0	0	7435	0.0000000
zheyou73v0_A09	44219458	44220817	BnaA09T0353000ZY	0	+	0	0	1359	0.0000000
zheyou73v0_A09	44222706	44223477	BnaA09T0353100ZY	0	-	0	0	771	0.0000000
zheyou73v0_A09	44242271	44246146	BnaA09T0353200ZY	0	-	0	0	3875	0.0000000
zheyou73v0_A09	44242271	44246146	BnaA09T0353200ZY.1	0	-	0	0	3875	0.0000000
zheyou73v0_A09	44242271	44246146	BnaA09T0353200ZY.2	0	-	0	0	3875	0.0000000
zheyou73v0_A09	44274764	44275864	BnaA09T0353300ZY	0	-	0	0	1100	0.0000000
zheyou73v0_A09	44277752	44281972	BnaA09T0353400ZY	0	+	0	0	4220	0.0000000
zheyou73v0_A09	44277752	44281972	BnaA09T0353400ZY.1	0	+	0	0	4220	0.0000000
zheyou73v0_A09	44277752	44281972	BnaA09T0353400ZY.2	0	+	0	0	4220	0.0000000
zheyou73v0_A09	44277752	44281972	BnaA09T0353400ZY.3	0	+	0	0	4220	0.0000000
zheyou73v0_A09	44282718	44283138	BnaA09T0353500ZY	0	-	0	0	420	0.0000000
zheyou73v0_A09	44283737	44284235	BnaA09T0353600ZY	0	-	0	0	498	0.0000000
zheyou73v0_A09	44292715	44298684	BnaA09T0353700ZY	0	+	0	0	5969	0.0000000
zheyou73v0_A09	44317401	44318687	BnaA09T0353800ZY	0	-	0	0	1286	0.0000000
zheyou73v0_A09	44321102	44322827	BnaA09T0353900ZY	0	+	0	0	1725	0.0000000
zheyou73v0_A09	44323229	44324108	BnaA09T0354000ZY	0	-	0	0	879	0.0000000
zheyou73v0_A09	44330627	44333219	BnaA09T0354100ZY	0	+	0	0	2592	0.0000000
zheyou73v0_A09	44330627	44333219	BnaA09T0354100ZY.1	0	+	0	0	2592	0.0000000
zheyou73v0_A09	44338561	44340532	BnaA09T0354200ZY	0	+	0	0	1971	0.0000000
zheyou73v0_A09	44342194	44345974	BnaA09T0354300ZY	0	-	0	0	3780	0.0000000
zheyou73v0_A09	44347518	44348264	BnaA09T0354400ZY	0	+	0	0	746	0.0000000
zheyou73v0_A09	44348460	44350013	BnaA09T0354500ZY	0	-	0	0	1553	0.0000000
zheyou73v0_A09	44372194	44374890	BnaA09T0354600ZY	0	+	0	0	2696	0.0000000
zheyou73v0_A09	44381139	44386292	BnaA09T0354700ZY	0	+	0	0	5153	0.0000000
zheyou73v0_A09	44395551	44396451	BnaA09T0354800ZY	0	-	0	0	900	0.0000000
zheyou73v0_A09	44401818	44402384	BnaA09T0354900ZY	0	-	0	0	566	0.0000000
zheyou73v0_A09	44413731	44414350	BnaA09T0355000ZY	0	-	0	0	619	0.0000000
zheyou73v0_A09	44441882	44443178	BnaA09T0355100ZY	0	-	0	0	1296	0.0000000
zheyou73v0_A09	44451363	44452021	BnaA09T0355200ZY	0	-	0	0	658	0.0000000
zheyou73v0_A09	44471591	44472887	BnaA09T0355300ZY	0	-	0	0	1296	0.0000000
zheyou73v0_A09	44492292	44494516	BnaA09T0355400ZY	0	-	0	0	2224	0.0000000
zheyou73v0_A09	44504223	44504712	BnaA09T0355500ZY	0	-	0	0	489	0.0000000
zheyou73v0_A09	44507331	44509244	BnaA09T0355600ZY	0	+	0	0	1913	0.0000000
zheyou73v0_A09	44516717	44519082	BnaA09T0355700ZY	0	-	0	0	2365	0.0000000
zheyou73v0_A09	44519793	44520333	BnaA09T0355800ZY	0	-	0	0	540	0.0000000
zheyou73v0_A09	44552585	44555489	BnaA09T0355900ZY	0	+	0	0	2904	0.0000000
zheyou73v0_A09	44552585	44555369	BnaA09T0355900ZY.1	0	+	0	0	2784	0.0000000
zheyou73v0_A09	44571043	44575043	BnaA09T0356000ZY	0	+	0	0	4000	0.0000000
zheyou73v0_A09	44571043	44575043	BnaA09T0356000ZY.1	0	+	0	0	4000	0.0000000
zheyou73v0_A09	44581141	44582352	BnaA09T0356100ZY	0	+	0	0	1211	0.0000000
zheyou73v0_A09	44584641	44588945	BnaA09T0356200ZY	0	+	0	0	4304	0.0000000
zheyou73v0_A09	44584814	44588945	BnaA09T0356200ZY.1	0	+	0	0	4131	0.0000000
zheyou73v0_A09	44590686	44591115	BnaA09T0356300ZY	0	+	0	0	429	0.0000000
zheyou73v0_A09	44600581	44600767	BnaA09T0356400ZY	0	-	0	0	186	0.0000000
zheyou73v0_A09	44607315	44607507	BnaA09T0356500ZY	0	+	0	0	192	0.0000000
zheyou73v0_A09	44617859	44618997	BnaA09T0356600ZY	0	+	0	0	1138	0.0000000
zheyou73v0_A09	44624489	44627020	BnaA09T0356700ZY	0	-	0	0	2531	0.0000000
zheyou73v0_A09	44644199	44647174	BnaA09T0356800ZY	0	+	0	0	2975	0.0000000
zheyou73v0_A09	44647378	44648120	BnaA09T0356900ZY	0	+	0	0	742	0.0000000
zheyou73v0_A09	44650655	44651459	BnaA09T0357000ZY	0	+	0	0	804	0.0000000
zheyou73v0_A09	44650815	44651459	BnaA09T0357000ZY.1	0	+	0	0	644	0.0000000
zheyou73v0_A09	44675178	44677028	BnaA09T0357100ZY	0	-	0	0	1850	0.0000000
zheyou73v0_A09	44679478	44681215	BnaA09T0357200ZY	0	-	0	0	1737	0.0000000
zheyou73v0_A09	44684547	44685088	BnaA09T0357300ZY	0	-	0	0	541	0.0000000
zheyou73v0_A09	44686715	44688311	BnaA09T0357400ZY	0	-	0	0	1596	0.0000000
zheyou73v0_A09	44697874	44699819	BnaA09T0357500ZY	0	-	0	0	1945	0.0000000
zheyou73v0_A09	44723477	44725428	BnaA09T0357600ZY	0	-	0	0	1951	0.0000000
zheyou73v0_A09	44726992	44729968	BnaA09T0357700ZY	0	-	0	0	2976	0.0000000
zheyou73v0_A09	44731255	44733155	BnaA09T0357800ZY	0	-	0	0	1900	0.0000000
zheyou73v0_A09	44743121	44747241	BnaA09T0357900ZY	0	-	0	0	4120	0.0000000
zheyou73v0_A09	44806662	44807809	BnaA09T0358000ZY	0	-	0	0	1147	0.0000000
zheyou73v0_A09	44814945	44816301	BnaA09T0358100ZY	0	+	0	0	1356	0.0000000
zheyou73v0_A09	44818118	44820419	BnaA09T0358200ZY	0	-	0	0	2301	0.0000000
zheyou73v0_A09	44829647	44830205	BnaA09T0358300ZY	0	+	0	0	558	0.0000000
zheyou73v0_A09	44834608	44838006	BnaA09T0358400ZY	0	-	0	0	3398	0.0000000
zheyou73v0_A09	44839027	44840933	BnaA09T0358500ZY	0	+	0	0	1906	0.0000000
zheyou73v0_A09	44841186	44844397	BnaA09T0358600ZY	0	-	0	0	3211	0.0000000
zheyou73v0_A09	44841186	44844077	BnaA09T0358600ZY.1	0	-	0	0	2891	0.0000000
zheyou73v0_A09	44845115	44845346	BnaA09T0358700ZY	0	-	0	0	231	0.0000000
zheyou73v0_A09	44853751	44857460	BnaA09T0358800ZY	0	-	0	0	3709	0.0000000
zheyou73v0_A09	44858730	44862634	BnaA09T0358900ZY	0	+	0	0	3904	0.0000000
zheyou73v0_A09	44864861	44866006	BnaA09T0359000ZY	0	+	0	0	1145	0.0000000
zheyou73v0_A09	44875763	44879020	BnaA09T0359100ZY	0	+	0	0	3257	0.0000000
zheyou73v0_A09	44879171	44882097	BnaA09T0359200ZY	0	-	0	0	2926	0.0000000
zheyou73v0_A09	44889942	44890741	BnaA09T0359300ZY	0	+	0	0	799	0.0000000
zheyou73v0_A09	44891265	44893341	BnaA09T0359400ZY	0	-	0	0	2076	0.0000000
zheyou73v0_A09	44896613	44897862	BnaA09T0359500ZY	0	-	0	0	1249	0.0000000
zheyou73v0_A09	44910093	44912394	BnaA09T0359600ZY	0	+	0	0	2301	0.0000000
zheyou73v0_A09	44910093	44912394	BnaA09T0359600ZY.1	0	+	0	0	2301	0.0000000
zheyou73v0_A09	44912315	44914779	BnaA09T0359700ZY	0	-	0	0	2464	0.0000000
zheyou73v0_A09	44918905	44921752	BnaA09T0359800ZY	0	-	0	0	2847	0.0000000
zheyou73v0_A09	44918905	44921752	BnaA09T0359800ZY.1	0	-	0	0	2847	0.0000000
zheyou73v0_A09	44918905	44921752	BnaA09T0359800ZY.2	0	-	0	0	2847	0.0000000
zheyou73v0_A09	44922483	44923081	BnaA09T0359900ZY	0	+	0	0	598	0.0000000
zheyou73v0_A09	44928542	44930722	BnaA09T0360000ZY	0	+	0	0	2180	0.0000000
zheyou73v0_A09	44931355	44933204	BnaA09T0360100ZY	0	+	0	0	1849	0.0000000
zheyou73v0_A09	44931355	44933204	BnaA09T0360100ZY.1	0	+	0	0	1849	0.0000000
zheyou73v0_A09	44931355	44933204	BnaA09T0360100ZY.2	0	+	0	0	1849	0.0000000
zheyou73v0_A09	44944980	44949652	BnaA09T0360200ZY	0	+	0	0	4672	0.0000000
zheyou73v0_A09	44955099	44957237	BnaA09T0360300ZY	0	-	0	0	2138	0.0000000
zheyou73v0_A09	44959573	44964857	BnaA09T0360400ZY	0	-	0	0	5284	0.0000000
zheyou73v0_A09	44959573	44964857	BnaA09T0360400ZY.1	0	-	0	0	5284	0.0000000
zheyou73v0_A09	44970920	44974151	BnaA09T0360500ZY	0	-	0	0	3231	0.0000000
zheyou73v0_A09	44977754	44979771	BnaA09T0360600ZY	0	-	0	0	2017	0.0000000
zheyou73v0_A09	44994484	44995173	BnaA09T0360700ZY	0	+	0	0	689	0.0000000
zheyou73v0_A09	44999125	45007763	BnaA09T0360800ZY	0	-	0	0	8638	0.0000000
zheyou73v0_A09	45017665	45018253	BnaA09T0360900ZY	0	+	0	0	588	0.0000000
zheyou73v0_A09	45022527	45032262	BnaA09T0361000ZY	0	-	0	0	9735	0.0000000
zheyou73v0_A09	45022527	45031586	BnaA09T0361000ZY.1	0	-	0	0	9059	0.0000000
zheyou73v0_A09	45058957	45059951	BnaA09T0361100ZY	0	-	0	0	994	0.0000000
zheyou73v0_A09	45061138	45062925	BnaA09T0361200ZY	0	+	0	0	1787	0.0000000
zheyou73v0_A09	45063264	45066898	BnaA09T0361300ZY	0	-	0	0	3634	0.0000000
zheyou73v0_A09	45130812	45134703	BnaA09T0361400ZY	0	+	0	0	3891	0.0000000
zheyou73v0_A09	45130812	45134964	BnaA09T0361400ZY.1	0	+	0	0	4152	0.0000000
zheyou73v0_A09	45148821	45150398	BnaA09T0361500ZY	0	-	0	0	1577	0.0000000
zheyou73v0_A09	45155802	45158338	BnaA09T0361600ZY	0	-	0	0	2536	0.0000000
zheyou73v0_A09	45170572	45172538	BnaA09T0361700ZY	0	-	0	0	1966	0.0000000
zheyou73v0_A09	45173096	45176121	BnaA09T0361800ZY	0	+	0	0	3025	0.0000000
zheyou73v0_A09	45202619	45203893	BnaA09T0361900ZY	0	+	0	0	1274	0.0000000
zheyou73v0_A09	45206618	45207224	BnaA09T0362000ZY	0	+	0	0	606	0.0000000
zheyou73v0_A09	45229044	45230706	BnaA09T0362100ZY	0	+	0	0	1662	0.0000000
zheyou73v0_A09	45234005	45236676	BnaA09T0362200ZY	0	-	0	0	2671	0.0000000
zheyou73v0_A09	45258842	45265131	BnaA09T0362300ZY	0	+	0	0	6289	0.0000000
zheyou73v0_A09	45279006	45279721	BnaA09T0362400ZY	0	-	0	0	715	0.0000000
zheyou73v0_A09	45284831	45285374	BnaA09T0362500ZY	0	+	0	0	543	0.0000000
zheyou73v0_A09	45287735	45291845	BnaA09T0362600ZY	0	+	0	0	4110	0.0000000
zheyou73v0_A09	45296299	45300087	BnaA09T0362700ZY	0	+	0	0	3788	0.0000000
zheyou73v0_A09	45300842	45301882	BnaA09T0362800ZY	0	-	0	0	1040	0.0000000
zheyou73v0_A09	45304378	45306062	BnaA09T0362900ZY	0	-	0	0	1684	0.0000000
zheyou73v0_A09	45310316	45311273	BnaA09T0363000ZY	0	+	0	0	957	0.0000000
zheyou73v0_A09	45313020	45315043	BnaA09T0363100ZY	0	-	0	0	2023	0.0000000
zheyou73v0_A09	45323572	45324400	BnaA09T0363200ZY	0	-	0	0	828	0.0000000
zheyou73v0_A09	45333294	45334035	BnaA09T0363300ZY	0	-	0	0	741	0.0000000
zheyou73v0_A09	45357546	45359574	BnaA09T0363400ZY	0	+	0	0	2028	0.0000000
zheyou73v0_A09	45359983	45361743	BnaA09T0363500ZY	0	-	0	0	1760	0.0000000
zheyou73v0_A09	45359983	45361615	BnaA09T0363500ZY.1	0	-	0	0	1632	0.0000000
zheyou73v0_A09	45359983	45361743	BnaA09T0363500ZY.2	0	-	0	0	1760	0.0000000
zheyou73v0_A09	45359983	45361743	BnaA09T0363500ZY.3	0	-	0	0	1760	0.0000000
zheyou73v0_A09	45364957	45365950	BnaA09T0363600ZY	0	+	0	0	993	0.0000000
zheyou73v0_A09	45393532	45395834	BnaA09T0363700ZY	0	-	0	0	2302	0.0000000
zheyou73v0_A09	45421616	45423508	BnaA09T0363800ZY	0	+	0	0	1892	0.0000000
zheyou73v0_A09	45440298	45442633	BnaA09T0363900ZY	0	+	0	0	2335	0.0000000
zheyou73v0_A09	45472503	45473699	BnaA09T0364000ZY	0	+	0	0	1196	0.0000000
zheyou73v0_A09	45475538	45477127	BnaA09T0364100ZY	0	-	0	0	1589	0.0000000
zheyou73v0_A09	45477643	45479791	BnaA09T0364200ZY	0	-	0	0	2148	0.0000000
zheyou73v0_A09	45514859	45517317	BnaA09T0364300ZY	0	-	0	0	2458	0.0000000
zheyou73v0_A09	45564882	45567576	BnaA09T0364400ZY	0	+	0	0	2694	0.0000000
zheyou73v0_A09	45567376	45569156	BnaA09T0364500ZY	0	-	0	0	1780	0.0000000
zheyou73v0_A09	45586317	45589451	BnaA09T0364600ZY	0	+	0	0	3134	0.0000000
zheyou73v0_A09	45595406	45596923	BnaA09T0364700ZY	0	+	0	0	1517	0.0000000
zheyou73v0_A09	45595406	45596923	BnaA09T0364700ZY.1	0	+	0	0	1517	0.0000000
zheyou73v0_A09	45597949	45598507	BnaA09T0364800ZY	0	-	0	0	558	0.0000000
zheyou73v0_A09	45617106	45618258	BnaA09T0364900ZY	0	+	0	0	1152	0.0000000
zheyou73v0_A09	45618261	45622457	BnaA09T0365000ZY	0	-	0	0	4196	0.0000000
zheyou73v0_A09	45634356	45637673	BnaA09T0365100ZY	0	+	0	0	3317	0.0000000
zheyou73v0_A09	45638270	45639353	BnaA09T0365200ZY	0	-	0	0	1083	0.0000000
zheyou73v0_A09	45647371	45648841	BnaA09T0365300ZY.1	0	-	0	0	1470	0.0000000
zheyou73v0_A09	45647547	45648841	BnaA09T0365300ZY	0	-	0	0	1294	0.0000000
zheyou73v0_A09	45650968	45652401	BnaA09T0365400ZY	0	+	0	0	1433	0.0000000
zheyou73v0_A09	45653119	45655555	BnaA09T0365500ZY	0	-	0	0	2436	0.0000000
zheyou73v0_A09	45656088	45657678	BnaA09T0365600ZY	0	-	0	0	1590	0.0000000
zheyou73v0_A09	45661119	45661962	BnaA09T0365700ZY	0	-	0	0	843	0.0000000
zheyou73v0_A09	45662408	45664204	BnaA09T0365800ZY	0	-	0	0	1796	0.0000000
zheyou73v0_A09	45673994	45679959	BnaA09T0365900ZY	0	+	0	0	5965	0.0000000
zheyou73v0_A09	45688286	45694748	BnaA09T0366000ZY	0	+	0	0	6462	0.0000000
zheyou73v0_A09	45695389	45695901	BnaA09T0366100ZY	0	+	0	0	512	0.0000000
zheyou73v0_A09	45708517	45710181	BnaA09T0366200ZY	0	+	0	0	1664	0.0000000
zheyou73v0_A09	45714787	45715783	BnaA09T0366300ZY	0	+	0	0	996	0.0000000
zheyou73v0_A09	45737872	45738555	BnaA09T0366400ZY	0	+	0	0	683	0.0000000
zheyou73v0_A09	45752184	45757072	BnaA09T0366500ZY	0	-	0	0	4888	0.0000000
zheyou73v0_A09	45761734	45762881	BnaA09T0366600ZY	0	-	0	0	1147	0.0000000
zheyou73v0_A09	45770207	45773280	BnaA09T0366700ZY	0	-	0	0	3073	0.0000000
zheyou73v0_A09	45773676	45774338	BnaA09T0366800ZY	0	-	0	0	662	0.0000000
zheyou73v0_A09	45774702	45776266	BnaA09T0366900ZY	0	-	0	0	1564	0.0000000
zheyou73v0_A09	45778455	45780573	BnaA09T0367000ZY	0	+	0	0	2118	0.0000000
zheyou73v0_A09	45780738	45781565	BnaA09T0367100ZY	0	-	0	0	827	0.0000000
zheyou73v0_A09	45782187	45782519	BnaA09T0367200ZY	0	-	0	0	332	0.0000000
zheyou73v0_A09	45785212	45785620	BnaA09T0367300ZY	0	-	0	0	408	0.0000000
zheyou73v0_A09	45786382	45787532	BnaA09T0367400ZY	0	-	0	0	1150	0.0000000
zheyou73v0_A09	45787802	45791570	BnaA09T0367500ZY	0	+	0	0	3768	0.0000000
zheyou73v0_A09	45792912	45793536	BnaA09T0367600ZY	0	+	0	0	624	0.0000000
zheyou73v0_A09	45794886	45795413	BnaA09T0367700ZY	0	+	0	0	527	0.0000000
zheyou73v0_A09	45811234	45815756	BnaA09T0367800ZY	0	+	0	0	4522	0.0000000
zheyou73v0_A09	45811961	45815756	BnaA09T0367800ZY.1	0	+	0	0	3795	0.0000000
zheyou73v0_A09	45816221	45817844	BnaA09T0367900ZY	0	+	0	0	1623	0.0000000
zheyou73v0_A09	45817847	45819963	BnaA09T0368000ZY	0	-	0	0	2116	0.0000000
zheyou73v0_A09	45826107	45831388	BnaA09T0368100ZY	0	+	0	0	5281	0.0000000
zheyou73v0_A09	45832594	45834971	BnaA09T0368200ZY	0	-	0	0	2377	0.0000000
zheyou73v0_A09	45842784	45845441	BnaA09T0368300ZY	0	+	0	0	2657	0.0000000
zheyou73v0_A09	45845427	45847668	BnaA09T0368400ZY	0	-	0	0	2241	0.0000000
zheyou73v0_A09	45851971	45861762	BnaA09T0368500ZY	0	-	0	0	9791	0.0000000
zheyou73v0_A09	45863318	45863938	BnaA09T0368600ZY	0	+	0	0	620	0.0000000
zheyou73v0_A09	45875636	45876283	BnaA09T0368700ZY	0	-	0	0	647	0.0000000
zheyou73v0_A09	45876513	45876901	BnaA09T0368800ZY	0	-	0	0	388	0.0000000
zheyou73v0_A09	45882060	45884310	BnaA09T0368900ZY	0	-	0	0	2250	0.0000000
zheyou73v0_A09	45888644	45888919	BnaA09T0369000ZY	0	+	0	0	275	0.0000000
zheyou73v0_A09	45889491	45890841	BnaA09T0369100ZY	0	+	0	0	1350	0.0000000
zheyou73v0_A09	45900269	45900590	BnaA09T0369200ZY	0	-	0	0	321	0.0000000
zheyou73v0_A09	45911232	45912462	BnaA09T0369300ZY	0	-	0	0	1230	0.0000000
zheyou73v0_A09	45919929	45920256	BnaA09T0369400ZY	0	-	0	0	327	0.0000000
zheyou73v0_A09	45923970	45925087	BnaA09T0369500ZY	0	-	0	0	1117	0.0000000
zheyou73v0_A09	45942646	45942835	BnaA09T0369600ZY	0	-	0	0	189	0.0000000
zheyou73v0_A09	45946372	45946810	BnaA09T0369700ZY	0	+	0	0	438	0.0000000
zheyou73v0_A09	45950776	45953421	BnaA09T0369800ZY	0	+	0	0	2645	0.0000000
zheyou73v0_A09	45953579	45955448	BnaA09T0369900ZY	0	-	0	0	1869	0.0000000
zheyou73v0_A09	45958050	45959202	BnaA09T0370000ZY	0	-	0	0	1152	0.0000000
zheyou73v0_A09	45959417	45960634	BnaA09T0370100ZY	0	+	0	0	1217	0.0000000
zheyou73v0_A09	45971460	45972830	BnaA09T0370200ZY	0	+	0	0	1370	0.0000000
zheyou73v0_A09	45974248	45980368	BnaA09T0370300ZY	0	+	0	0	6120	0.0000000
zheyou73v0_A09	45996894	45997755	BnaA09T0370400ZY	0	+	0	0	861	0.0000000
zheyou73v0_A09	46001505	46003450	BnaA09T0370500ZY	0	-	0	0	1945	0.0000000
zheyou73v0_A09	46004321	46005578	BnaA09T0370600ZY	0	-	0	0	1257	0.0000000
zheyou73v0_A09	46107632	46108848	BnaA09T0370700ZY	0	+	0	0	1216	0.0000000
zheyou73v0_A09	46113945	46114903	BnaA09T0370800ZY	0	-	0	0	958	0.0000000
zheyou73v0_A09	46115120	46116191	BnaA09T0370900ZY	0	-	0	0	1071	0.0000000
zheyou73v0_A09	46135040	46138103	BnaA09T0371000ZY	0	+	0	0	3063	0.0000000
zheyou73v0_A09	46149388	46149803	BnaA09T0371100ZY	0	+	0	0	415	0.0000000
zheyou73v0_A09	46155182	46157979	BnaA09T0371200ZY	0	+	0	0	2797	0.0000000
zheyou73v0_A09	46158409	46159639	BnaA09T0371300ZY	0	-	0	0	1230	0.0000000
zheyou73v0_A09	46170824	46171925	BnaA09T0371400ZY	0	-	0	0	1101	0.0000000
zheyou73v0_A09	46175275	46180902	BnaA09T0371500ZY	0	-	0	0	5627	0.0000000
zheyou73v0_A09	46183098	46183359	BnaA09T0371600ZY	0	+	0	0	261	0.0000000
zheyou73v0_A09	46190464	46190971	BnaA09T0371700ZY	0	-	0	0	507	0.0000000
zheyou73v0_A09	46204565	46205774	BnaA09T0371800ZY	0	+	0	0	1209	0.0000000
zheyou73v0_A09	46207530	46211613	BnaA09T0371900ZY	0	+	0	0	4083	0.0000000
zheyou73v0_A09	46211932	46213698	BnaA09T0372000ZY	0	-	0	0	1766	0.0000000
zheyou73v0_A09	46253300	46255776	BnaA09T0372100ZY	0	+	0	0	2476	0.0000000
zheyou73v0_A09	46276590	46278514	BnaA09T0372200ZY	0	+	0	0	1924	0.0000000
zheyou73v0_A09	46282780	46284451	BnaA09T0372300ZY	0	-	0	0	1671	0.0000000
zheyou73v0_A09	46289721	46291059	BnaA09T0372400ZY	0	+	0	0	1338	0.0000000
zheyou73v0_A09	46292382	46294752	BnaA09T0372500ZY	0	+	0	0	2370	0.0000000
zheyou73v0_A09	46295314	46296039	BnaA09T0372600ZY	0	+	0	0	725	0.0000000
zheyou73v0_A09	46297345	46299998	BnaA09T0372700ZY	0	-	0	0	2653	0.0000000
zheyou73v0_A09	46297345	46299998	BnaA09T0372700ZY.1	0	-	0	0	2653	0.0000000
zheyou73v0_A09	46297345	46299998	BnaA09T0372700ZY.2	0	-	0	0	2653	0.0000000
zheyou73v0_A09	46310667	46312513	BnaA09T0372800ZY	0	-	0	0	1846	0.0000000
zheyou73v0_A09	46321812	46322347	BnaA09T0372900ZY	0	+	0	0	535	0.0000000
zheyou73v0_A09	46347286	46348049	BnaA09T0373000ZY	0	+	0	0	763	0.0000000
zheyou73v0_A09	46357688	46358554	BnaA09T0373100ZY	0	+	0	0	866	0.0000000
zheyou73v0_A09	46369762	46371734	BnaA09T0373200ZY	0	-	0	0	1972	0.0000000
zheyou73v0_A09	46369762	46371734	BnaA09T0373200ZY.1	0	-	0	0	1972	0.0000000
zheyou73v0_A09	46378670	46382403	BnaA09T0373300ZY	0	-	0	0	3733	0.0000000
zheyou73v0_A09	46396989	46404074	BnaA09T0373400ZY	0	-	0	0	7085	0.0000000
zheyou73v0_A09	46405020	46405254	BnaA09T0373500ZY	0	-	0	0	234	0.0000000
zheyou73v0_A09	46405978	46407703	BnaA09T0373600ZY	0	+	0	0	1725	0.0000000
zheyou73v0_A09	46412168	46413478	BnaA09T0373700ZY	0	+	0	0	1310	0.0000000
zheyou73v0_A09	46420324	46421470	BnaA09T0373800ZY	0	+	0	0	1146	0.0000000
zheyou73v0_A09	46422128	46425335	BnaA09T0373900ZY	0	-	0	0	3207	0.0000000
zheyou73v0_A09	46442137	46442812	BnaA09T0374000ZY	0	+	0	0	675	0.0000000
zheyou73v0_A09	46445397	46445874	BnaA09T0374100ZY	0	+	0	0	477	0.0000000
zheyou73v0_A09	46466285	46467044	BnaA09T0374200ZY	0	-	0	0	759	0.0000000
zheyou73v0_A09	46476069	46478947	BnaA09T0374300ZY	0	-	0	0	2878	0.0000000
zheyou73v0_A09	46486964	46488741	BnaA09T0374400ZY	0	+	0	0	1777	0.0000000
zheyou73v0_A09	46486964	46488741	BnaA09T0374400ZY.1	0	+	0	0	1777	0.0000000
zheyou73v0_A09	46486964	46488741	BnaA09T0374400ZY.2	0	+	0	0	1777	0.0000000
zheyou73v0_A09	46491765	46496128	BnaA09T0374500ZY	0	+	0	0	4363	0.0000000
zheyou73v0_A09	46511781	46513990	BnaA09T0374600ZY	0	+	0	0	2209	0.0000000
zheyou73v0_A09	46522036	46523626	BnaA09T0374700ZY	0	+	0	0	1590	0.0000000
zheyou73v0_A09	46534484	46538179	BnaA09T0374800ZY	0	+	0	0	3695	0.0000000
zheyou73v0_A09	46552968	46555113	BnaA09T0374900ZY	0	+	0	0	2145	0.0000000
zheyou73v0_A09	46566241	46567076	BnaA09T0375000ZY	0	-	0	0	835	0.0000000
zheyou73v0_A09	46576581	46580082	BnaA09T0375100ZY	0	+	0	0	3501	0.0000000
zheyou73v0_A09	46576581	46580082	BnaA09T0375100ZY.1	0	+	0	0	3501	0.0000000
zheyou73v0_A09	46576581	46580082	BnaA09T0375100ZY.3	0	+	0	0	3501	0.0000000
zheyou73v0_A09	46576644	46580082	BnaA09T0375100ZY.2	0	+	0	0	3438	0.0000000
zheyou73v0_A09	46580111	46581184	BnaA09T0375200ZY	0	-	0	0	1073	0.0000000
zheyou73v0_A09	46580111	46581184	BnaA09T0375200ZY.1	0	-	0	0	1073	0.0000000
zheyou73v0_A09	46585767	46588723	BnaA09T0375300ZY	0	+	0	0	2956	0.0000000
zheyou73v0_A09	46588997	46590282	BnaA09T0375400ZY	0	+	0	0	1285	0.0000000
zheyou73v0_A09	46595070	46596877	BnaA09T0375500ZY	0	-	0	0	1807	0.0000000
zheyou73v0_A09	46597866	46598988	BnaA09T0375600ZY	0	-	0	0	1122	0.0000000
zheyou73v0_A09	46611381	46612415	BnaA09T0375700ZY	0	+	0	0	1034	0.0000000
zheyou73v0_A09	46622743	46623178	BnaA09T0375800ZY	0	-	0	0	435	0.0000000
zheyou73v0_A09	46629950	46630603	BnaA09T0375900ZY	0	-	0	0	653	0.0000000
zheyou73v0_A09	46639740	46640595	BnaA09T0376000ZY	0	+	0	0	855	0.0000000
zheyou73v0_A09	46642787	46644332	BnaA09T0376100ZY	0	+	0	0	1545	0.0000000
zheyou73v0_A09	46642787	46644826	BnaA09T0376100ZY.1	0	+	0	0	2039	0.0000000
zheyou73v0_A09	46646576	46647412	BnaA09T0376200ZY	0	-	0	0	836	0.0000000
zheyou73v0_A09	46661338	46664140	BnaA09T0376300ZY	0	-	0	0	2802	0.0000000
zheyou73v0_A09	46690980	46693572	BnaA09T0376400ZY	0	+	0	0	2592	0.0000000
zheyou73v0_A09	46693757	46696212	BnaA09T0376500ZY	0	-	0	0	2455	0.0000000
zheyou73v0_A09	46701101	46705624	BnaA09T0376600ZY	0	-	0	0	4523	0.0000000
zheyou73v0_A09	46731052	46731838	BnaA09T0376700ZY	0	-	0	0	786	0.0000000
zheyou73v0_A09	46739463	46740801	BnaA09T0376800ZY	0	-	0	0	1338	0.0000000
zheyou73v0_A09	46741288	46744865	BnaA09T0376900ZY	0	-	0	0	3577	0.0000000
zheyou73v0_A09	46752432	46753747	BnaA09T0377000ZY	0	+	0	0	1315	0.0000000
zheyou73v0_A09	46778316	46780159	BnaA09T0377100ZY	0	+	0	0	1843	0.0000000
zheyou73v0_A09	46809655	46811099	BnaA09T0377200ZY	0	+	0	0	1444	0.0000000
zheyou73v0_A09	46820026	46828091	BnaA09T0377300ZY	0	-	0	0	8065	0.0000000
zheyou73v0_A09	46832348	46834708	BnaA09T0377400ZY	0	+	0	0	2360	0.0000000
zheyou73v0_A09	46840595	46842612	BnaA09T0377500ZY	0	-	0	0	2017	0.0000000
zheyou73v0_A09	46843501	46844370	BnaA09T0377600ZY	0	+	0	0	869	0.0000000
zheyou73v0_A09	46844462	46844729	BnaA09T0377700ZY	0	+	0	0	267	0.0000000
zheyou73v0_A09	46845557	46846837	BnaA09T0377800ZY	0	+	0	0	1280	0.0000000
zheyou73v0_A09	46848560	46849290	BnaA09T0377900ZY	0	-	0	0	730	0.0000000
zheyou73v0_A09	46853703	46854612	BnaA09T0378000ZY	0	+	0	0	909	0.0000000
zheyou73v0_A09	46857685	46857989	BnaA09T0378100ZY	0	-	0	0	304	0.0000000
zheyou73v0_A09	46860916	46862080	BnaA09T0378200ZY	0	+	0	0	1164	0.0000000
zheyou73v0_A09	46870421	46875005	BnaA09T0378300ZY	0	-	0	0	4584	0.0000000
zheyou73v0_A09	46892528	46897526	BnaA09T0378400ZY	0	+	0	0	4998	0.0000000
zheyou73v0_A09	46898000	46899254	BnaA09T0378500ZY	0	+	0	0	1254	0.0000000
zheyou73v0_A09	46904677	46907597	BnaA09T0378600ZY	0	-	0	0	2920	0.0000000
zheyou73v0_A09	46916688	46920946	BnaA09T0378700ZY	0	+	0	0	4258	0.0000000
zheyou73v0_A09	46922283	46926337	BnaA09T0378800ZY	0	-	0	0	4054	0.0000000
zheyou73v0_A09	46940984	46943371	BnaA09T0378900ZY	0	+	0	0	2387	0.0000000
zheyou73v0_A09	46943695	46946678	BnaA09T0379000ZY	0	-	0	0	2983	0.0000000
zheyou73v0_A09	46948519	46953284	BnaA09T0379100ZY	0	-	0	0	4765	0.0000000
zheyou73v0_A09	46954429	46955452	BnaA09T0379200ZY	0	-	0	0	1023	0.0000000
zheyou73v0_A09	46962860	46963831	BnaA09T0379300ZY	0	+	0	0	971	0.0000000
zheyou73v0_A09	46964913	46965357	BnaA09T0379400ZY	0	-	0	0	444	0.0000000
zheyou73v0_A09	46965934	46966605	BnaA09T0379500ZY	0	-	0	0	671	0.0000000
zheyou73v0_A09	46967923	46969789	BnaA09T0379600ZY	0	-	0	0	1866	0.0000000
zheyou73v0_A09	46972833	46976315	BnaA09T0379700ZY	0	-	0	0	3482	0.0000000
zheyou73v0_A09	46984197	46985210	BnaA09T0379800ZY	0	+	0	0	1013	0.0000000
zheyou73v0_A09	46987065	46989510	BnaA09T0379900ZY	0	-	0	0	2445	0.0000000
zheyou73v0_A09	46991348	46993244	BnaA09T0380000ZY.2	0	+	0	0	1896	0.0000000
zheyou73v0_A09	46991576	46993244	BnaA09T0380000ZY	0	+	0	0	1668	0.0000000
zheyou73v0_A09	46991576	46993244	BnaA09T0380000ZY.1	0	+	0	0	1668	0.0000000
zheyou73v0_A09	47000856	47001926	BnaA09T0380100ZY	0	+	0	0	1070	0.0000000
zheyou73v0_A09	47003148	47004000	BnaA09T0380200ZY	0	+	0	0	852	0.0000000
zheyou73v0_A09	47006130	47016299	BnaA09T0380300ZY	0	-	0	0	10169	0.0000000
zheyou73v0_A09	47010150	47016144	BnaA09T0380300ZY.1	0	-	0	0	5994	0.0000000
zheyou73v0_A09	47020356	47021890	BnaA09T0380400ZY	0	-	0	0	1534	0.0000000
zheyou73v0_A09	47024010	47027814	BnaA09T0380500ZY	0	-	0	0	3804	0.0000000
zheyou73v0_A09	47036304	47038557	BnaA09T0380600ZY	0	+	0	0	2253	0.0000000
zheyou73v0_A09	47039368	47045653	BnaA09T0380700ZY	0	+	0	0	6285	0.0000000
zheyou73v0_A09	47046693	47048119	BnaA09T0380800ZY	0	-	0	0	1426	0.0000000
zheyou73v0_A09	47050490	47052035	BnaA09T0380900ZY	0	-	0	0	1545	0.0000000
zheyou73v0_A09	47055031	47061316	BnaA09T0381000ZY	0	+	0	0	6285	0.0000000
zheyou73v0_A09	47063829	47065361	BnaA09T0381100ZY	0	+	0	0	1532	0.0000000
zheyou73v0_A09	47076777	47079060	BnaA09T0381200ZY	0	+	0	0	2283	0.0000000
zheyou73v0_A09	47079857	47080575	BnaA09T0381300ZY	0	+	0	0	718	0.0000000
zheyou73v0_A09	47082054	47083301	BnaA09T0381400ZY	0	+	0	0	1247	0.0000000
zheyou73v0_A09	47083820	47085856	BnaA09T0381500ZY	0	-	0	0	2036	0.0000000
zheyou73v0_A09	47083820	47085856	BnaA09T0381500ZY.1	0	-	0	0	2036	0.0000000
zheyou73v0_A09	47087452	47087884	BnaA09T0381600ZY	0	+	0	0	432	0.0000000
zheyou73v0_A09	47092293	47093545	BnaA09T0381700ZY	0	+	0	0	1252	0.0000000
zheyou73v0_A09	47093563	47095672	BnaA09T0381800ZY	0	-	0	0	2109	0.0000000
zheyou73v0_A09	47097169	47098434	BnaA09T0381900ZY	0	-	0	0	1265	0.0000000
zheyou73v0_A09	47100869	47101650	BnaA09T0382000ZY	0	+	0	0	781	0.0000000
zheyou73v0_A09	47102003	47103158	BnaA09T0382100ZY	0	-	0	0	1155	0.0000000
zheyou73v0_A09	47104016	47104946	BnaA09T0382200ZY	0	-	0	0	930	0.0000000
zheyou73v0_A09	47106196	47108338	BnaA09T0382300ZY	0	-	0	0	2142	0.0000000
zheyou73v0_A09	47114479	47116796	BnaA09T0382400ZY	0	+	0	0	2317	0.0000000
zheyou73v0_A09	47117414	47120134	BnaA09T0382500ZY	0	-	0	0	2720	0.0000000
zheyou73v0_A09	47124904	47126102	BnaA09T0382600ZY	0	+	0	0	1198	0.0000000
zheyou73v0_A09	47129405	47130388	BnaA09T0382700ZY	0	-	0	0	983	0.0000000
zheyou73v0_A09	47131917	47132434	BnaA09T0382800ZY	0	-	0	0	517	0.0000000
zheyou73v0_A09	47136324	47139107	BnaA09T0382900ZY	0	+	0	0	2783	0.0000000
zheyou73v0_A09	47139390	47141599	BnaA09T0383000ZY	0	-	0	0	2209	0.0000000
zheyou73v0_A09	47151797	47152242	BnaA09T0383100ZY	0	+	0	0	445	0.0000000
zheyou73v0_A09	47153047	47154355	BnaA09T0383200ZY	0	+	0	0	1308	0.0000000
zheyou73v0_A09	47156698	47158124	BnaA09T0383300ZY	0	+	0	0	1426	0.0000000
zheyou73v0_A09	47158892	47160058	BnaA09T0383400ZY	0	+	0	0	1166	0.0000000
zheyou73v0_A09	47160777	47167545	BnaA09T0383500ZY	0	+	0	0	6768	0.0000000
zheyou73v0_A09	47169687	47173107	BnaA09T0383600ZY	0	+	0	0	3420	0.0000000
zheyou73v0_A09	47181650	47188740	BnaA09T0383700ZY	0	-	0	0	7090	0.0000000
zheyou73v0_A09	47189044	47191732	BnaA09T0383800ZY	0	+	0	0	2688	0.0000000
zheyou73v0_A09	47196908	47197658	BnaA09T0383900ZY	0	+	0	0	750	0.0000000
zheyou73v0_A09	47197972	47200823	BnaA09T0384000ZY	0	-	0	0	2851	0.0000000
zheyou73v0_A09	47202134	47202729	BnaA09T0384100ZY	0	+	0	0	595	0.0000000
zheyou73v0_A09	47207210	47208616	BnaA09T0384200ZY	0	+	0	0	1406	0.0000000
zheyou73v0_A09	47219451	47221193	BnaA09T0384300ZY	0	+	0	0	1742	0.0000000
zheyou73v0_A09	47221221	47223580	BnaA09T0384400ZY	0	-	0	0	2359	0.0000000
zheyou73v0_A09	47225876	47228849	BnaA09T0384500ZY	0	+	0	0	2973	0.0000000
zheyou73v0_A09	47234497	47236758	BnaA09T0384600ZY	0	+	0	0	2261	0.0000000
zheyou73v0_A09	47239845	47240418	BnaA09T0384700ZY	0	-	0	0	573	0.0000000
zheyou73v0_A09	47246931	47249305	BnaA09T0384800ZY	0	+	0	0	2374	0.0000000
zheyou73v0_A09	47251006	47251603	BnaA09T0384900ZY	0	-	0	0	597	0.0000000
zheyou73v0_A09	47283700	47283874	BnaA09T0385000ZY	0	-	0	0	174	0.0000000
zheyou73v0_A09	47303454	47303694	BnaA09T0385100ZY	0	+	0	0	240	0.0000000
zheyou73v0_A09	47303885	47305835	BnaA09T0385200ZY	0	-	0	0	1950	0.0000000
zheyou73v0_A09	47311311	47313265	BnaA09T0385300ZY	0	-	0	0	1954	0.0000000
zheyou73v0_A09	47314728	47315646	BnaA09T0385400ZY	0	-	0	0	918	0.0000000
zheyou73v0_A09	47322107	47325841	BnaA09T0385500ZY	0	-	0	0	3734	0.0000000
zheyou73v0_A09	47322107	47325762	BnaA09T0385500ZY.1	0	-	0	0	3655	0.0000000
zheyou73v0_A09	47333263	47335346	BnaA09T0385600ZY	0	-	0	0	2083	0.0000000
zheyou73v0_A09	47373662	47374353	BnaA09T0385700ZY	0	+	0	0	691	0.0000000
zheyou73v0_A09	47377696	47378587	BnaA09T0385800ZY	0	+	0	0	891	0.0000000
zheyou73v0_A09	47378559	47379375	BnaA09T0385900ZY	0	-	0	0	816	0.0000000
zheyou73v0_A09	47381482	47382758	BnaA09T0386000ZY	0	+	0	0	1276	0.0000000
zheyou73v0_A09	47403791	47406355	BnaA09T0386100ZY	0	+	0	0	2564	0.0000000
zheyou73v0_A09	47409261	47417398	BnaA09T0386200ZY	0	-	0	0	8137	0.0000000
zheyou73v0_A09	47425329	47425533	BnaA09T0386300ZY	0	+	0	0	204	0.0000000
zheyou73v0_A09	47426015	47428858	BnaA09T0386400ZY	0	+	0	0	2843	0.0000000
zheyou73v0_A09	47429642	47429810	BnaA09T0386500ZY	0	+	0	0	168	0.0000000
zheyou73v0_A09	47434493	47437308	BnaA09T0386600ZY	0	+	0	0	2815	0.0000000
zheyou73v0_A09	47440098	47441004	BnaA09T0386700ZY.1	0	+	0	0	906	0.0000000
zheyou73v0_A09	47440130	47441004	BnaA09T0386700ZY	0	+	0	0	874	0.0000000
zheyou73v0_A09	47449898	47451863	BnaA09T0386800ZY	0	+	0	0	1965	0.0000000
zheyou73v0_A09	47451939	47452977	BnaA09T0386900ZY	0	-	0	0	1038	0.0000000
zheyou73v0_A09	47454973	47455405	BnaA09T0387000ZY	0	+	0	0	432	0.0000000
zheyou73v0_A09	47456237	47458268	BnaA09T0387100ZY	0	+	0	0	2031	0.0000000
zheyou73v0_A09	47469711	47472575	BnaA09T0387200ZY	0	+	0	0	2864	0.0000000
zheyou73v0_A09	47472838	47473892	BnaA09T0387300ZY	0	+	0	0	1054	0.0000000
zheyou73v0_A09	47486775	47488387	BnaA09T0387400ZY	0	+	0	0	1612	0.0000000
zheyou73v0_A09	47493079	47498364	BnaA09T0387500ZY	0	-	0	0	5285	0.0000000
zheyou73v0_A09	47502139	47503090	BnaA09T0387600ZY	0	-	0	0	951	0.0000000
zheyou73v0_A09	47506833	47509925	BnaA09T0387700ZY	0	-	0	0	3092	0.0000000
zheyou73v0_A09	47517344	47519549	BnaA09T0387800ZY	0	+	0	0	2205	0.0000000
zheyou73v0_A09	47520132	47522907	BnaA09T0387900ZY	0	-	0	0	2775	0.0000000
zheyou73v0_A09	47526736	47537823	BnaA09T0388000ZY	0	-	0	0	11087	0.0000000
zheyou73v0_A09	47548956	47549698	BnaA09T0388100ZY	0	+	0	0	742	0.0000000
zheyou73v0_A09	47582822	47583242	BnaA09T0388200ZY	0	+	0	0	420	0.0000000
zheyou73v0_A09	47602617	47604593	BnaA09T0388300ZY	0	-	0	0	1976	0.0000000
zheyou73v0_A09	47608592	47610704	BnaA09T0388400ZY	0	-	0	0	2112	0.0000000
zheyou73v0_A09	47615033	47616566	BnaA09T0388500ZY	0	-	0	0	1533	0.0000000
zheyou73v0_A09	47622252	47629608	BnaA09T0388600ZY	0	+	0	0	7356	0.0000000
zheyou73v0_A09	47635560	47635912	BnaA09T0388700ZY	0	+	0	0	352	0.0000000
zheyou73v0_A09	47645263	47647052	BnaA09T0388800ZY	0	+	0	0	1789	0.0000000
zheyou73v0_A09	47645263	47647052	BnaA09T0388800ZY.1	0	+	0	0	1789	0.0000000
zheyou73v0_A09	47647415	47648036	BnaA09T0388900ZY	0	-	0	0	621	0.0000000
zheyou73v0_A09	47648098	47648407	BnaA09T0389000ZY	0	-	0	0	309	0.0000000
zheyou73v0_A09	47650221	47653658	BnaA09T0389100ZY	0	+	0	0	3437	0.0000000
zheyou73v0_A09	47654554	47657640	BnaA09T0389200ZY	0	+	0	0	3086	0.0000000
zheyou73v0_A09	47658451	47660550	BnaA09T0389300ZY	0	+	0	0	2099	0.0000000
zheyou73v0_A09	47658451	47660550	BnaA09T0389300ZY.1	0	+	0	0	2099	0.0000000
zheyou73v0_A09	47660622	47665145	BnaA09T0389400ZY	0	-	0	0	4523	0.0000000
zheyou73v0_A09	47668091	47671383	BnaA09T0389500ZY	0	-	0	0	3292	0.0000000
zheyou73v0_A09	47684206	47689359	BnaA09T0389600ZY	0	-	0	0	5153	0.0000000
zheyou73v0_A09	47697887	47699998	BnaA09T0389700ZY	0	+	0	0	2111	0.0000000
zheyou73v0_A09	47729064	47730720	BnaA09T0389800ZY	0	+	0	0	1656	0.0000000
zheyou73v0_A09	47740486	47742333	BnaA09T0389900ZY	0	+	0	0	1847	0.0000000
zheyou73v0_A09	47752480	47753993	BnaA09T0390000ZY	0	-	0	0	1513	0.0000000
zheyou73v0_A09	47764307	47765411	BnaA09T0390100ZY	0	+	0	0	1104	0.0000000
zheyou73v0_A09	47766210	47769449	BnaA09T0390200ZY	0	-	0	0	3239	0.0000000
zheyou73v0_A09	47771277	47774071	BnaA09T0390300ZY	0	-	0	0	2794	0.0000000
zheyou73v0_A09	47774468	47776385	BnaA09T0390400ZY	0	-	0	0	1917	0.0000000
zheyou73v0_A09	47781902	47787937	BnaA09T0390500ZY	0	+	0	0	6035	0.0000000
zheyou73v0_A09	47781902	47787937	BnaA09T0390500ZY.1	0	+	0	0	6035	0.0000000
zheyou73v0_A09	47787952	47790752	BnaA09T0390600ZY	0	-	0	0	2800	0.0000000
zheyou73v0_A09	47792794	47793659	BnaA09T0390700ZY	0	-	0	0	865	0.0000000
zheyou73v0_A09	47797871	47799262	BnaA09T0390800ZY	0	-	0	0	1391	0.0000000
zheyou73v0_A09	47801677	47803001	BnaA09T0390900ZY	0	-	0	0	1324	0.0000000
zheyou73v0_A09	47809294	47811022	BnaA09T0391000ZY	0	-	0	0	1728	0.0000000
zheyou73v0_A09	47817995	47821721	BnaA09T0391100ZY	0	-	0	0	3726	0.0000000
zheyou73v0_A09	47835337	47837592	BnaA09T0391200ZY	0	-	0	0	2255	0.0000000
zheyou73v0_A09	47845189	47847433	BnaA09T0391300ZY	0	+	0	0	2244	0.0000000
zheyou73v0_A09	47847852	47854115	BnaA09T0391400ZY	0	+	0	0	6263	0.0000000
zheyou73v0_A09	47854314	47855259	BnaA09T0391500ZY	0	+	0	0	945	0.0000000
zheyou73v0_A09	47857105	47860430	BnaA09T0391600ZY	0	-	0	0	3325	0.0000000
zheyou73v0_A09	47857804	47860430	BnaA09T0391600ZY.1	0	-	0	0	2626	0.0000000
zheyou73v0_A09	47866390	47868366	BnaA09T0391700ZY	0	-	0	0	1976	0.0000000
zheyou73v0_A09	47877445	47879076	BnaA09T0391800ZY	0	-	0	0	1631	0.0000000
zheyou73v0_A09	47884533	47886696	BnaA09T0391900ZY	0	-	0	0	2163	0.0000000
zheyou73v0_A09	47884533	47886696	BnaA09T0391900ZY.1	0	-	0	0	2163	0.0000000
zheyou73v0_A09	47887983	47890710	BnaA09T0392000ZY	0	+	0	0	2727	0.0000000
zheyou73v0_A09	47891326	47892158	BnaA09T0392100ZY	0	+	0	0	832	0.0000000
zheyou73v0_A09	47892691	47893895	BnaA09T0392200ZY	0	-	0	0	1204	0.0000000
zheyou73v0_A09	47894341	47896127	BnaA09T0392300ZY	0	+	0	0	1786	0.0000000
zheyou73v0_A09	47896166	47898450	BnaA09T0392400ZY	0	-	0	0	2284	0.0000000
zheyou73v0_A09	47896166	47898450	BnaA09T0392400ZY.1	0	-	0	0	2284	0.0000000
zheyou73v0_A09	47898647	47900179	BnaA09T0392500ZY.1	0	+	0	0	1532	0.0000000
zheyou73v0_A09	47898819	47900179	BnaA09T0392500ZY	0	+	0	0	1360	0.0000000
zheyou73v0_A09	47903786	47907032	BnaA09T0392600ZY	0	+	0	0	3246	0.0000000
zheyou73v0_A09	47907632	47909664	BnaA09T0392700ZY	0	+	0	0	2032	0.0000000
zheyou73v0_A09	47909892	47912527	BnaA09T0392800ZY	0	+	0	0	2635	0.0000000
zheyou73v0_A09	47909892	47912527	BnaA09T0392800ZY.1	0	+	0	0	2635	0.0000000
zheyou73v0_A09	47909892	47912527	BnaA09T0392800ZY.2	0	+	0	0	2635	0.0000000
zheyou73v0_A09	47910646	47912527	BnaA09T0392800ZY.3	0	+	0	0	1881	0.0000000
zheyou73v0_A09	47916118	47917096	BnaA09T0392900ZY	0	+	0	0	978	0.0000000
zheyou73v0_A09	47917953	47918307	BnaA09T0393000ZY	0	+	0	0	354	0.0000000
zheyou73v0_A09	47919958	47921441	BnaA09T0393100ZY	0	+	0	0	1483	0.0000000
zheyou73v0_A09	47921763	47925314	BnaA09T0393200ZY	0	-	0	0	3551	0.0000000
zheyou73v0_A09	47921763	47925314	BnaA09T0393200ZY.1	0	-	0	0	3551	0.0000000
zheyou73v0_A09	47948474	47949710	BnaA09T0393300ZY	0	+	0	0	1236	0.0000000
zheyou73v0_A09	47948474	47949710	BnaA09T0393300ZY.1	0	+	0	0	1236	0.0000000
zheyou73v0_A09	47949879	47952202	BnaA09T0393400ZY	0	-	0	0	2323	0.0000000
zheyou73v0_A09	47952491	47954044	BnaA09T0393500ZY	0	+	0	0	1553	0.0000000
zheyou73v0_A09	47956453	47956903	BnaA09T0393600ZY	0	+	0	0	450	0.0000000
zheyou73v0_A09	47963459	47966497	BnaA09T0393700ZY	0	+	0	0	3038	0.0000000
zheyou73v0_A09	47966674	47967171	BnaA09T0393800ZY	0	-	0	0	497	0.0000000
zheyou73v0_A09	47979133	47980307	BnaA09T0393900ZY	0	-	0	0	1174	0.0000000
zheyou73v0_A09	47982587	47988357	BnaA09T0394000ZY	0	+	0	0	5770	0.0000000
zheyou73v0_A09	47991252	47994552	BnaA09T0394100ZY	0	+	0	0	3300	0.0000000
zheyou73v0_A09	47994807	47996903	BnaA09T0394200ZY	0	-	0	0	2096	0.0000000
zheyou73v0_A09	47997218	47998400	BnaA09T0394300ZY	0	+	0	0	1182	0.0000000
zheyou73v0_A09	47998415	48000079	BnaA09T0394400ZY	0	-	0	0	1664	0.0000000
zheyou73v0_A09	48000456	48001758	BnaA09T0394500ZY	0	-	0	0	1302	0.0000000
zheyou73v0_A09	48027800	48029583	BnaA09T0394600ZY.1	0	+	0	0	1783	0.0000000
zheyou73v0_A09	48027828	48029583	BnaA09T0394600ZY	0	+	0	0	1755	0.0000000
zheyou73v0_A09	48032154	48032792	BnaA09T0394700ZY	0	+	0	0	638	0.0000000
zheyou73v0_A09	48035436	48037522	BnaA09T0394800ZY	0	+	0	0	2086	0.0000000
zheyou73v0_A09	48049436	48050039	BnaA09T0394900ZY	0	-	0	0	603	0.0000000
zheyou73v0_A09	48054868	48057494	BnaA09T0395000ZY	0	+	0	0	2626	0.0000000
zheyou73v0_A09	48058091	48059931	BnaA09T0395100ZY	0	+	0	0	1840	0.0000000
zheyou73v0_A09	48060547	48063131	BnaA09T0395200ZY	0	-	0	0	2584	0.0000000
zheyou73v0_A09	48090625	48092612	BnaA09T0395300ZY	0	+	0	0	1987	0.0000000
zheyou73v0_A09	48108990	48109268	BnaA09T0395400ZY	0	-	0	0	278	0.0000000
zheyou73v0_A09	48109357	48110368	BnaA09T0395500ZY	0	-	0	0	1011	0.0000000
zheyou73v0_A09	48122139	48122919	BnaA09T0395600ZY	0	+	0	0	780	0.0000000
zheyou73v0_A09	48132579	48134298	BnaA09T0395700ZY	0	-	0	0	1719	0.0000000
zheyou73v0_A09	48148006	48149761	BnaA09T0395800ZY	0	+	0	0	1755	0.0000000
zheyou73v0_A09	48165666	48167057	BnaA09T0395900ZY	0	+	0	0	1391	0.0000000
zheyou73v0_A09	48180570	48182822	BnaA09T0396000ZY	0	-	0	0	2252	0.0000000
zheyou73v0_A09	48186879	48192883	BnaA09T0396100ZY	0	+	0	0	6004	0.0000000
zheyou73v0_A09	48186879	48192883	BnaA09T0396100ZY.1	0	+	0	0	6004	0.0000000
zheyou73v0_A09	48193625	48204556	BnaA09T0396200ZY	0	+	0	0	10931	0.0000000
zheyou73v0_A09	48205207	48219185	BnaA09T0396300ZY	0	+	0	0	13978	0.0000000
zheyou73v0_A09	48220659	48222224	BnaA09T0396400ZY	0	+	0	0	1565	0.0000000
zheyou73v0_A09	48225287	48226470	BnaA09T0396500ZY	0	+	0	0	1183	0.0000000
zheyou73v0_A09	48225287	48226470	BnaA09T0396500ZY.1	0	+	0	0	1183	0.0000000
zheyou73v0_A09	48227210	48228877	BnaA09T0396600ZY	0	+	0	0	1667	0.0000000
zheyou73v0_A09	48229152	48231587	BnaA09T0396700ZY	0	-	0	0	2435	0.0000000
zheyou73v0_A09	48231795	48234051	BnaA09T0396800ZY	0	-	0	0	2256	0.0000000
zheyou73v0_A09	48234640	48238957	BnaA09T0396900ZY	0	-	0	0	4317	0.0000000
zheyou73v0_A09	48252485	48253092	BnaA09T0397000ZY	0	-	0	0	607	0.0000000
zheyou73v0_A09	48254379	48256988	BnaA09T0397100ZY	0	+	0	0	2609	0.0000000
zheyou73v0_A09	48259139	48260218	BnaA09T0397200ZY	0	+	0	0	1079	0.0000000
zheyou73v0_A09	48261733	48264287	BnaA09T0397300ZY	0	+	0	0	2554	0.0000000
zheyou73v0_A09	48277394	48278269	BnaA09T0397400ZY	0	+	0	0	875	0.0000000
zheyou73v0_A09	48280674	48280933	BnaA09T0397500ZY	0	+	0	0	259	0.0000000
zheyou73v0_A09	48283095	48283681	BnaA09T0397600ZY	0	+	0	0	586	0.0000000
zheyou73v0_A09	48288294	48288814	BnaA09T0397700ZY	0	-	0	0	520	0.0000000
zheyou73v0_A09	48297652	48302703	BnaA09T0397800ZY	0	+	0	0	5051	0.0000000
zheyou73v0_A09	48298463	48302703	BnaA09T0397800ZY.1	0	+	0	0	4240	0.0000000
zheyou73v0_A09	48305799	48309901	BnaA09T0397900ZY	0	+	0	0	4102	0.0000000
zheyou73v0_A09	48310237	48312360	BnaA09T0398000ZY	0	-	0	0	2123	0.0000000
zheyou73v0_A09	48313268	48315175	BnaA09T0398100ZY	0	-	0	0	1907	0.0000000
zheyou73v0_A09	48322981	48324756	BnaA09T0398200ZY	0	+	0	0	1775	0.0000000
zheyou73v0_A09	48325752	48326844	BnaA09T0398300ZY	0	+	0	0	1092	0.0000000
zheyou73v0_A09	48327197	48330056	BnaA09T0398400ZY	0	-	0	0	2859	0.0000000
zheyou73v0_A09	48334208	48335229	BnaA09T0398500ZY	0	+	0	0	1021	0.0000000
zheyou73v0_A09	48345174	48345716	BnaA09T0398600ZY	0	+	0	0	542	0.0000000
zheyou73v0_A09	48351074	48352653	BnaA09T0398700ZY	0	+	0	0	1579	0.0000000
zheyou73v0_A09	48352788	48354874	BnaA09T0398800ZY	0	+	0	0	2086	0.0000000
zheyou73v0_A09	48356844	48358402	BnaA09T0398900ZY	0	+	0	0	1558	0.0000000
zheyou73v0_A09	48359046	48361571	BnaA09T0399000ZY.1	0	+	0	0	2525	0.0000000
zheyou73v0_A09	48359120	48361571	BnaA09T0399000ZY	0	+	0	0	2451	0.0000000
zheyou73v0_A09	48362045	48364647	BnaA09T0399100ZY	0	-	0	0	2602	0.0000000
zheyou73v0_A09	48375334	48376810	BnaA09T0399200ZY	0	+	0	0	1476	0.0000000
zheyou73v0_A09	48377701	48379101	BnaA09T0399300ZY	0	+	0	0	1400	0.0000000
zheyou73v0_A09	48381670	48384662	BnaA09T0399400ZY	0	+	0	0	2992	0.0000000
zheyou73v0_A09	48384773	48386027	BnaA09T0399500ZY	0	-	0	0	1254	0.0000000
zheyou73v0_A09	48387568	48389360	BnaA09T0399600ZY	0	+	0	0	1792	0.0000000
zheyou73v0_A09	48391756	48396578	BnaA09T0399700ZY	0	-	0	0	4822	0.0000000
zheyou73v0_A09	48396788	48399729	BnaA09T0399800ZY	0	+	0	0	2941	0.0000000
zheyou73v0_A09	48396788	48399729	BnaA09T0399800ZY.1	0	+	0	0	2941	0.0000000
zheyou73v0_A09	48396788	48399729	BnaA09T0399800ZY.2	0	+	0	0	2941	0.0000000
zheyou73v0_A09	48398491	48400274	BnaA09T0399900ZY	0	-	0	0	1783	0.0000000
zheyou73v0_A09	48416797	48417925	BnaA09T0400000ZY	0	-	0	0	1128	0.0000000
zheyou73v0_A09	48421597	48422061	BnaA09T0400100ZY	0	+	0	0	464	0.0000000
zheyou73v0_A09	48432651	48433752	BnaA09T0400200ZY	0	+	0	0	1101	0.0000000
zheyou73v0_A09	48442976	48447893	BnaA09T0400300ZY	0	-	0	0	4917	0.0000000
zheyou73v0_A09	48448628	48450203	BnaA09T0400400ZY	0	+	0	0	1575	0.0000000
zheyou73v0_A09	48450388	48452667	BnaA09T0400500ZY	0	-	0	0	2279	0.0000000
zheyou73v0_A09	48460307	48462946	BnaA09T0400600ZY	0	+	0	0	2639	0.0000000
zheyou73v0_A09	48474790	48475523	BnaA09T0400700ZY	0	-	0	0	733	0.0000000
zheyou73v0_A09	48495341	48497725	BnaA09T0400800ZY	0	-	0	0	2384	0.0000000
zheyou73v0_A09	48504144	48511995	BnaA09T0400900ZY	0	+	0	0	7851	0.0000000
zheyou73v0_A09	48512340	48514199	BnaA09T0401000ZY	0	-	0	0	1859	0.0000000
zheyou73v0_A09	48515518	48516051	BnaA09T0401100ZY	0	-	0	0	533	0.0000000
zheyou73v0_A09	48516594	48518346	BnaA09T0401200ZY	0	+	0	0	1752	0.0000000
zheyou73v0_A09	48518416	48520369	BnaA09T0401300ZY	0	-	0	0	1953	0.0000000
zheyou73v0_A09	48536883	48539628	BnaA09T0401400ZY	0	-	0	0	2745	0.0000000
zheyou73v0_A09	48545730	48548842	BnaA09T0401500ZY	0	-	0	0	3112	0.0000000
zheyou73v0_A09	48545730	48548842	BnaA09T0401500ZY.1	0	-	0	0	3112	0.0000000
zheyou73v0_A09	48554354	48554794	BnaA09T0401600ZY	0	-	0	0	440	0.0000000
zheyou73v0_A09	48577508	48578770	BnaA09T0401700ZY	0	-	0	0	1262	0.0000000
zheyou73v0_A09	48581764	48583938	BnaA09T0401800ZY	0	+	0	0	2174	0.0000000
zheyou73v0_A09	48585405	48587251	BnaA09T0401900ZY	0	-	0	0	1846	0.0000000
zheyou73v0_A09	48588557	48592188	BnaA09T0402000ZY	0	+	0	0	3631	0.0000000
zheyou73v0_A09	48592320	48593164	BnaA09T0402100ZY	0	-	0	0	844	0.0000000
zheyou73v0_A09	48594830	48595163	BnaA09T0402200ZY	0	+	0	0	333	0.0000000
zheyou73v0_A09	48597308	48599027	BnaA09T0402300ZY	0	+	0	0	1719	0.0000000
zheyou73v0_A09	48610709	48612209	BnaA09T0402400ZY	0	-	0	0	1500	0.0000000
zheyou73v0_A09	48612844	48614651	BnaA09T0402500ZY	0	-	0	0	1807	0.0000000
zheyou73v0_A09	48617206	48619975	BnaA09T0402600ZY	0	-	0	0	2769	0.0000000
zheyou73v0_A09	48621938	48624449	BnaA09T0402700ZY	0	-	0	0	2511	0.0000000
zheyou73v0_A09	48624733	48626832	BnaA09T0402800ZY	0	-	0	0	2099	0.0000000
zheyou73v0_A09	48631305	48633106	BnaA09T0402900ZY	0	-	0	0	1801	0.0000000
zheyou73v0_A09	48636398	48638273	BnaA09T0403000ZY	0	-	0	0	1875	0.0000000
zheyou73v0_A09	48641087	48641866	BnaA09T0403100ZY	0	-	0	0	779	0.0000000
zheyou73v0_A09	48643557	48646572	BnaA09T0403200ZY	0	+	0	0	3015	0.0000000
zheyou73v0_A09	48662510	48663936	BnaA09T0403300ZY	0	+	0	0	1426	0.0000000
zheyou73v0_A09	48689638	48698863	BnaA09T0403400ZY	0	+	0	0	9225	0.0000000
zheyou73v0_A09	48704168	48706602	BnaA09T0403500ZY	0	-	0	0	2434	0.0000000
zheyou73v0_A09	48707784	48708662	BnaA09T0403600ZY	0	+	0	0	878	0.0000000
zheyou73v0_A09	48719608	48722159	BnaA09T0403700ZY	0	+	0	0	2551	0.0000000
zheyou73v0_A09	48723017	48725205	BnaA09T0403800ZY	0	+	0	0	2188	0.0000000
zheyou73v0_A09	48782748	48783432	BnaA09T0403900ZY	0	-	0	0	684	0.0000000
zheyou73v0_A09	48788826	48791426	BnaA09T0404000ZY	0	+	0	0	2600	0.0000000
zheyou73v0_A09	48796252	48796692	BnaA09T0404100ZY	0	+	0	0	440	0.0000000
zheyou73v0_A09	48800136	48801493	BnaA09T0404200ZY	0	-	0	0	1357	0.0000000
zheyou73v0_A09	48802968	48803697	BnaA09T0404300ZY	0	+	0	0	729	0.0000000
zheyou73v0_A09	48806630	48808207	BnaA09T0404400ZY	0	+	0	0	1577	0.0000000
zheyou73v0_A09	48808635	48815560	BnaA09T0404500ZY	0	-	0	0	6925	0.0000000
zheyou73v0_A09	48808635	48815560	BnaA09T0404500ZY.1	0	-	0	0	6925	0.0000000
zheyou73v0_A09	48816606	48818327	BnaA09T0404600ZY	0	-	0	0	1721	0.0000000
zheyou73v0_A09	48820405	48822539	BnaA09T0404700ZY	0	-	0	0	2134	0.0000000
zheyou73v0_A09	48826683	48827672	BnaA09T0404800ZY	0	+	0	0	989	0.0000000
zheyou73v0_A09	48832328	48834665	BnaA09T0404900ZY	0	-	0	0	2337	0.0000000
zheyou73v0_A09	48838469	48841241	BnaA09T0405000ZY	0	-	0	0	2772	0.0000000
zheyou73v0_A09	48843432	48846282	BnaA09T0405100ZY	0	-	0	0	2850	0.0000000
zheyou73v0_A09	48854208	48854906	BnaA09T0405200ZY	0	-	0	0	698	0.0000000
zheyou73v0_A09	48854964	48855117	BnaA09T0405300ZY	0	-	0	0	153	0.0000000
zheyou73v0_A09	48856842	48857828	BnaA09T0405400ZY	0	+	0	0	986	0.0000000
zheyou73v0_A09	48856842	48857828	BnaA09T0405400ZY.1	0	+	0	0	986	0.0000000
zheyou73v0_A09	48860226	48861339	BnaA09T0405500ZY	0	-	0	0	1113	0.0000000
zheyou73v0_A09	48881437	48885590	BnaA09T0405600ZY	0	+	0	0	4153	0.0000000
zheyou73v0_A09	48886250	48887025	BnaA09T0405700ZY	0	-	0	0	775	0.0000000
zheyou73v0_A09	48894694	48895280	BnaA09T0405800ZY	0	-	0	0	586	0.0000000
zheyou73v0_A09	48905147	48907704	BnaA09T0405900ZY	0	-	0	0	2557	0.0000000
zheyou73v0_A09	48911627	48914571	BnaA09T0406000ZY	0	-	0	0	2944	0.0000000
zheyou73v0_A09	48923499	48924964	BnaA09T0406100ZY	0	-	0	0	1465	0.0000000
zheyou73v0_A09	48929380	48930394	BnaA09T0406200ZY	0	-	0	0	1014	0.0000000
zheyou73v0_A09	48939121	48940502	BnaA09T0406300ZY	0	+	0	0	1381	0.0000000
zheyou73v0_A09	48941184	48944110	BnaA09T0406400ZY	0	+	0	0	2926	0.0000000
zheyou73v0_A09	48944614	48946793	BnaA09T0406500ZY	0	+	0	0	2179	0.0000000
zheyou73v0_A09	48947141	48949429	BnaA09T0406600ZY	0	-	0	0	2288	0.0000000
zheyou73v0_A09	48953450	48957811	BnaA09T0406700ZY	0	-	0	0	4361	0.0000000
zheyou73v0_A09	48962398	48964661	BnaA09T0406800ZY	0	+	0	0	2263	0.0000000
zheyou73v0_A09	48964760	48968140	BnaA09T0406900ZY	0	-	0	0	3380	0.0000000
zheyou73v0_A09	48974700	48975286	BnaA09T0407000ZY	0	+	0	0	586	0.0000000
zheyou73v0_A09	48985556	48986564	BnaA09T0407100ZY	0	+	0	0	1008	0.0000000
zheyou73v0_A09	48990958	48991536	BnaA09T0407200ZY	0	-	0	0	578	0.0000000
zheyou73v0_A09	48991732	48994460	BnaA09T0407300ZY	0	-	0	0	2728	0.0000000
zheyou73v0_A09	48995757	49000840	BnaA09T0407400ZY	0	-	0	0	5083	0.0000000
zheyou73v0_A09	49000847	49006253	BnaA09T0407500ZY	0	-	0	0	5406	0.0000000
zheyou73v0_A09	49000847	49006253	BnaA09T0407500ZY.1	0	-	0	0	5406	0.0000000
zheyou73v0_A09	49000847	49006253	BnaA09T0407500ZY.2	0	-	0	0	5406	0.0000000
zheyou73v0_A09	49009059	49011256	BnaA09T0407600ZY	0	+	0	0	2197	0.0000000
zheyou73v0_A09	49011597	49012340	BnaA09T0407700ZY	0	-	0	0	743	0.0000000
zheyou73v0_A09	49012681	49014787	BnaA09T0407800ZY	0	-	0	0	2106	0.0000000
zheyou73v0_A09	49025226	49025661	BnaA09T0407900ZY	0	+	0	0	435	0.0000000
zheyou73v0_A09	49025246	49028455	BnaA09T0408000ZY	0	-	0	0	3209	0.0000000
zheyou73v0_A09	49029173	49030769	BnaA09T0408100ZY	0	-	0	0	1596	0.0000000
zheyou73v0_A09	49031973	49036781	BnaA09T0408200ZY	0	-	0	0	4808	0.0000000
zheyou73v0_A09	49043443	49045442	BnaA09T0408300ZY.3	0	-	0	0	1999	0.0000000
zheyou73v0_A09	49043607	49045442	BnaA09T0408300ZY	0	-	0	0	1835	0.0000000
zheyou73v0_A09	49043607	49045442	BnaA09T0408300ZY.1	0	-	0	0	1835	0.0000000
zheyou73v0_A09	49043607	49045442	BnaA09T0408300ZY.2	0	-	0	0	1835	0.0000000
zheyou73v0_A09	49043607	49045442	BnaA09T0408300ZY.4	0	-	0	0	1835	0.0000000
zheyou73v0_A09	49046737	49049764	BnaA09T0408400ZY	0	-	0	0	3027	0.0000000
zheyou73v0_A09	49050643	49051591	BnaA09T0408500ZY	0	-	0	0	948	0.0000000
zheyou73v0_A09	49074989	49077403	BnaA09T0408600ZY	0	+	0	0	2414	0.0000000
zheyou73v0_A09	49078105	49080449	BnaA09T0408700ZY	0	+	0	0	2344	0.0000000
zheyou73v0_A09	49079053	49080453	BnaA09T0408800ZY	0	-	0	0	1400	0.0000000
zheyou73v0_A09	49086291	49087966	BnaA09T0408900ZY	0	+	0	0	1675	0.0000000
zheyou73v0_A09	49087989	49091866	BnaA09T0409000ZY	0	-	0	0	3877	0.0000000
zheyou73v0_A09	49095734	49099412	BnaA09T0409100ZY	0	+	0	0	3678	0.0000000
zheyou73v0_A09	49112100	49113429	BnaA09T0409200ZY	0	-	0	0	1329	0.0000000
zheyou73v0_A09	49112100	49113429	BnaA09T0409200ZY.1	0	-	0	0	1329	0.0000000
zheyou73v0_A09	49116617	49117445	BnaA09T0409300ZY	0	+	0	0	828	0.0000000
zheyou73v0_A09	49117479	49117922	BnaA09T0409400ZY	0	+	0	0	443	0.0000000
zheyou73v0_A09	49118895	49120711	BnaA09T0409500ZY	0	+	0	0	1816	0.0000000
zheyou73v0_A09	49120942	49124593	BnaA09T0409600ZY	0	-	0	0	3651	0.0000000
zheyou73v0_A09	49135665	49136315	BnaA09T0409700ZY	0	-	0	0	650	0.0000000
zheyou73v0_A09	49149807	49152721	BnaA09T0409800ZY	0	+	0	0	2914	0.0000000
zheyou73v0_A09	49153870	49155032	BnaA09T0409900ZY	0	-	0	0	1162	0.0000000
zheyou73v0_A09	49156581	49162716	BnaA09T0410000ZY	0	+	0	0	6135	0.0000000
zheyou73v0_A09	49166923	49167905	BnaA09T0410100ZY	0	+	0	0	982	0.0000000
zheyou73v0_A09	49168111	49169150	BnaA09T0410200ZY	0	+	0	0	1039	0.0000000
zheyou73v0_A09	49189150	49193026	BnaA09T0410300ZY	0	+	0	0	3876	0.0000000
zheyou73v0_A09	49195257	49196388	BnaA09T0410400ZY	0	-	0	0	1131	0.0000000
zheyou73v0_A09	49209887	49212187	BnaA09T0410500ZY	0	+	0	0	2300	0.0000000
zheyou73v0_A09	49217708	49218786	BnaA09T0410600ZY	0	+	0	0	1078	0.0000000
zheyou73v0_A09	49221868	49222506	BnaA09T0410700ZY	0	+	0	0	638	0.0000000
zheyou73v0_A09	49234706	49237832	BnaA09T0410800ZY	0	+	0	0	3126	0.0000000
zheyou73v0_A09	49241641	49243150	BnaA09T0410900ZY	0	-	0	0	1509	0.0000000
zheyou73v0_A09	49244427	49246704	BnaA09T0411000ZY	0	-	0	0	2277	0.0000000
zheyou73v0_A09	49244696	49246704	BnaA09T0411000ZY.1	0	-	0	0	2008	0.0000000
zheyou73v0_A09	49260695	49263620	BnaA09T0411100ZY	0	-	0	0	2925	0.0000000
zheyou73v0_A09	49260695	49263620	BnaA09T0411100ZY.1	0	-	0	0	2925	0.0000000
zheyou73v0_A09	49268197	49269785	BnaA09T0411200ZY	0	+	0	0	1588	0.0000000
zheyou73v0_A09	49275947	49278714	BnaA09T0411300ZY	0	+	0	0	2767	0.0000000
zheyou73v0_A09	49280544	49281072	BnaA09T0411400ZY	0	+	0	0	528	0.0000000
zheyou73v0_A09	49281311	49282191	BnaA09T0411500ZY	0	+	0	0	880	0.0000000
zheyou73v0_A09	49283652	49283838	BnaA09T0411600ZY	0	+	0	0	186	0.0000000
zheyou73v0_A09	49287311	49290339	BnaA09T0411700ZY	0	-	0	0	3028	0.0000000
zheyou73v0_A09	49294878	49295256	BnaA09T0411800ZY	0	+	0	0	378	0.0000000
zheyou73v0_A09	49296357	49297999	BnaA09T0411900ZY	0	+	0	0	1642	0.0000000
zheyou73v0_A09	49298648	49300038	BnaA09T0412000ZY	0	-	0	0	1390	0.0000000
zheyou73v0_A09	49303970	49306126	BnaA09T0412100ZY	0	-	0	0	2156	0.0000000
zheyou73v0_A09	49319735	49320310	BnaA09T0412200ZY	0	+	0	0	575	0.0000000
zheyou73v0_A09	49320680	49321743	BnaA09T0412300ZY	0	-	0	0	1063	0.0000000
zheyou73v0_A09	49327653	49329222	BnaA09T0412400ZY	0	-	0	0	1569	0.0000000
zheyou73v0_A09	49330434	49331379	BnaA09T0412500ZY	0	-	0	0	945	0.0000000
zheyou73v0_A09	49338174	49339197	BnaA09T0412600ZY	0	-	0	0	1023	0.0000000
zheyou73v0_A09	49343016	49345810	BnaA09T0412700ZY	0	+	0	0	2794	0.0000000
zheyou73v0_A09	49346592	49347834	BnaA09T0412800ZY	0	-	0	0	1242	0.0000000
zheyou73v0_A09	49371315	49373864	BnaA09T0412900ZY	0	+	0	0	2549	0.0000000
zheyou73v0_A09	49371987	49373864	BnaA09T0412900ZY.1	0	+	0	0	1877	0.0000000
zheyou73v0_A09	49375278	49375876	BnaA09T0413000ZY	0	-	0	0	598	0.0000000
zheyou73v0_A09	49377578	49382785	BnaA09T0413100ZY	0	-	0	0	5207	0.0000000
zheyou73v0_A09	49385359	49390921	BnaA09T0413200ZY	0	+	0	0	5562	0.0000000
zheyou73v0_A09	49401291	49404207	BnaA09T0413300ZY	0	+	0	0	2916	0.0000000
zheyou73v0_A09	49416844	49417901	BnaA09T0413400ZY	0	+	0	0	1057	0.0000000
zheyou73v0_A09	49426389	49428947	BnaA09T0413500ZY.1	0	-	0	0	2558	0.0000000
zheyou73v0_A09	49426672	49428947	BnaA09T0413500ZY	0	-	0	0	2275	0.0000000
zheyou73v0_A09	49452893	49453572	BnaA09T0413600ZY	0	-	0	0	679	0.0000000
zheyou73v0_A09	49464404	49470922	BnaA09T0413700ZY	0	+	0	0	6518	0.0000000
zheyou73v0_A09	49471454	49472557	BnaA09T0413800ZY	0	-	0	0	1103	0.0000000
zheyou73v0_A09	49474018	49476028	BnaA09T0413900ZY	0	-	0	0	2010	0.0000000
zheyou73v0_A09	49474018	49476034	BnaA09T0413900ZY.1	0	-	0	0	2016	0.0000000
zheyou73v0_A09	49485601	49487039	BnaA09T0414000ZY	0	+	0	0	1438	0.0000000
zheyou73v0_A09	49489000	49491994	BnaA09T0414100ZY	0	-	0	0	2994	0.0000000
zheyou73v0_A09	49496859	49498707	BnaA09T0414200ZY	0	+	0	0	1848	0.0000000
zheyou73v0_A09	49514570	49518907	BnaA09T0414300ZY	0	+	0	0	4337	0.0000000
zheyou73v0_A09	49530927	49532544	BnaA09T0414400ZY	0	+	0	0	1617	0.0000000
zheyou73v0_A09	49547506	49548519	BnaA09T0414500ZY	0	-	0	0	1013	0.0000000
zheyou73v0_A09	49572688	49572955	BnaA09T0414600ZY	0	-	0	0	267	0.0000000
zheyou73v0_A09	49575760	49576776	BnaA09T0414700ZY	0	-	0	0	1016	0.0000000
zheyou73v0_A09	49581102	49583000	BnaA09T0414800ZY	0	+	0	0	1898	0.0000000
zheyou73v0_A09	49592344	49592683	BnaA09T0414900ZY	0	-	0	0	339	0.0000000
zheyou73v0_A09	49596822	49597395	BnaA09T0415000ZY	0	-	0	0	573	0.0000000
zheyou73v0_A09	49608619	49609248	BnaA09T0415100ZY	0	-	0	0	629	0.0000000
zheyou73v0_A09	49620703	49621739	BnaA09T0415200ZY	0	+	0	0	1036	0.0000000
zheyou73v0_A09	49623563	49624403	BnaA09T0415300ZY	0	-	0	0	840	0.0000000
zheyou73v0_A09	49626222	49627248	BnaA09T0415400ZY	0	-	0	0	1026	0.0000000
zheyou73v0_A09	49628533	49629768	BnaA09T0415500ZY	0	-	0	0	1235	0.0000000
zheyou73v0_A09	49631006	49632158	BnaA09T0415600ZY	0	-	0	0	1152	0.0000000
zheyou73v0_A09	49636240	49637686	BnaA09T0415700ZY	0	-	0	0	1446	0.0000000
zheyou73v0_A09	49646958	49648146	BnaA09T0415800ZY	0	-	0	0	1188	0.0000000
zheyou73v0_A09	49657449	49666664	BnaA09T0415900ZY	0	-	0	0	9215	0.0000000
zheyou73v0_A09	49668167	49668794	BnaA09T0416000ZY	0	+	0	0	627	0.0000000
zheyou73v0_A09	49679328	49680566	BnaA09T0416100ZY	0	+	0	0	1238	0.0000000
zheyou73v0_A09	49688628	49691348	BnaA09T0416200ZY	0	+	0	0	2720	0.0000000
zheyou73v0_A09	49692500	49694613	BnaA09T0416300ZY	0	-	0	0	2113	0.0000000
zheyou73v0_A09	49695977	49696706	BnaA09T0416400ZY	0	+	0	0	729	0.0000000
zheyou73v0_A09	49703615	49704477	BnaA09T0416500ZY	0	+	0	0	862	0.0000000
zheyou73v0_A09	49711559	49712064	BnaA09T0416600ZY	0	+	0	0	505	0.0000000
zheyou73v0_A09	49724302	49725559	BnaA09T0416700ZY	0	+	0	0	1257	0.0000000
zheyou73v0_A09	49729111	49730432	BnaA09T0416800ZY	0	-	0	0	1321	0.0000000
zheyou73v0_A09	49734414	49738208	BnaA09T0416900ZY	0	-	0	0	3794	0.0000000
zheyou73v0_A09	49740644	49742924	BnaA09T0417000ZY	0	+	0	0	2280	0.0000000
zheyou73v0_A09	49747334	49747981	BnaA09T0417100ZY	0	+	0	0	647	0.0000000
zheyou73v0_A09	49748037	49750966	BnaA09T0417200ZY	0	-	0	0	2929	0.0000000
zheyou73v0_A09	49752276	49753264	BnaA09T0417300ZY	0	-	0	0	988	0.0000000
zheyou73v0_A09	49755128	49758021	BnaA09T0417400ZY	0	-	0	0	2893	0.0000000
zheyou73v0_A09	49786328	49787947	BnaA09T0417500ZY	0	-	0	0	1619	0.0000000
zheyou73v0_A09	49803727	49806445	BnaA09T0417600ZY	0	-	0	0	2718	0.0000000
zheyou73v0_A09	49818187	49820601	BnaA09T0417700ZY	0	+	0	0	2414	0.0000000
zheyou73v0_A09	49825107	49827230	BnaA09T0417800ZY	0	-	0	0	2123	0.0000000
zheyou73v0_A09	49828316	49835074	BnaA09T0417900ZY	0	-	0	0	6758	0.0000000
zheyou73v0_A09	49842951	49845231	BnaA09T0418000ZY	0	-	0	0	2280	0.0000000
zheyou73v0_A09	49842951	49845231	BnaA09T0418000ZY.1	0	-	0	0	2280	0.0000000
zheyou73v0_A09	49846181	49847324	BnaA09T0418100ZY	0	-	0	0	1143	0.0000000
zheyou73v0_A09	49850172	49855768	BnaA09T0418200ZY	0	-	0	0	5596	0.0000000
zheyou73v0_A09	49862775	49863599	BnaA09T0418300ZY	0	+	0	0	824	0.0000000
zheyou73v0_A09	49865028	49866557	BnaA09T0418400ZY	0	+	0	0	1529	0.0000000
zheyou73v0_A09	49867585	49868940	BnaA09T0418500ZY	0	-	0	0	1355	0.0000000
zheyou73v0_A09	49877624	49878266	BnaA09T0418600ZY	0	-	0	0	642	0.0000000
zheyou73v0_A09	49897704	49899043	BnaA09T0418700ZY	0	-	0	0	1339	0.0000000
zheyou73v0_A09	49909928	49910768	BnaA09T0418800ZY	0	+	0	0	840	0.0000000
zheyou73v0_A09	49911655	49918842	BnaA09T0418900ZY	0	-	0	0	7187	0.0000000
zheyou73v0_A09	49922896	49923256	BnaA09T0419000ZY	0	-	0	0	360	0.0000000
zheyou73v0_A09	49923730	49924537	BnaA09T0419100ZY	0	+	0	0	807	0.0000000
zheyou73v0_A09	49934000	49934903	BnaA09T0419200ZY	0	+	0	0	903	0.0000000
zheyou73v0_A09	49938545	49939682	BnaA09T0419300ZY	0	+	0	0	1137	0.0000000
zheyou73v0_A09	49940292	49941581	BnaA09T0419400ZY	0	+	0	0	1289	0.0000000
zheyou73v0_A09	49944283	49945669	BnaA09T0419500ZY	0	-	0	0	1386	0.0000000
zheyou73v0_A09	49948265	49949112	BnaA09T0419600ZY	0	+	0	0	847	0.0000000
zheyou73v0_A09	49950309	49951698	BnaA09T0419700ZY	0	+	0	0	1389	0.0000000
zheyou73v0_A09	49959205	49959930	BnaA09T0419800ZY	0	+	0	0	725	0.0000000
zheyou73v0_A09	49967806	49968475	BnaA09T0419900ZY	0	+	0	0	669	0.0000000
zheyou73v0_A09	49994728	49997931	BnaA09T0420000ZY	0	-	0	0	3203	0.0000000
zheyou73v0_A09	50000446	50008334	BnaA09T0420100ZY	0	-	0	0	7888	0.0000000
zheyou73v0_A09	50012108	50015693	BnaA09T0420200ZY	0	+	0	0	3585	0.0000000
zheyou73v0_A09	50017976	50020872	BnaA09T0420300ZY	0	-	0	0	2896	0.0000000
zheyou73v0_A09	50028370	50029087	BnaA09T0420400ZY	0	-	0	0	717	0.0000000
zheyou73v0_A09	50034249	50042411	BnaA09T0420500ZY	0	+	0	0	8162	0.0000000
zheyou73v0_A09	50045761	50046493	BnaA09T0420600ZY	0	-	0	0	732	0.0000000
zheyou73v0_A09	50055121	50056799	BnaA09T0420700ZY	0	-	0	0	1678	0.0000000
zheyou73v0_A09	50074998	50077027	BnaA09T0420800ZY	0	+	0	0	2029	0.0000000
zheyou73v0_A09	50107454	50108428	BnaA09T0420900ZY	0	+	0	0	974	0.0000000
zheyou73v0_A09	50111219	50111807	BnaA09T0421000ZY	0	-	0	0	588	0.0000000
zheyou73v0_A09	50128591	50131534	BnaA09T0421100ZY	0	-	0	0	2943	0.0000000
zheyou73v0_A09	50165784	50166939	BnaA09T0421200ZY	0	-	0	0	1155	0.0000000
zheyou73v0_A09	50173908	50174341	BnaA09T0421300ZY	0	+	0	0	433	0.0000000
zheyou73v0_A09	50182587	50184760	BnaA09T0421400ZY	0	+	0	0	2173	0.0000000
zheyou73v0_A09	50186550	50192322	BnaA09T0421500ZY	0	+	0	0	5772	0.0000000
zheyou73v0_A09	50220665	50221256	BnaA09T0421600ZY	0	-	0	0	591	0.0000000
zheyou73v0_A09	50269131	50270325	BnaA09T0421700ZY	0	-	0	0	1194	0.0000000
zheyou73v0_A09	50282688	50288158	BnaA09T0421800ZY	0	-	0	0	5470	0.0000000
zheyou73v0_A09	50292038	50294515	BnaA09T0421900ZY	0	-	0	0	2477	0.0000000
zheyou73v0_A09	50295772	50296443	BnaA09T0422000ZY	0	-	0	0	671	0.0000000
zheyou73v0_A09	50300550	50301366	BnaA09T0422100ZY	0	-	0	0	816	0.0000000
zheyou73v0_A09	50301464	50303579	BnaA09T0422200ZY	0	-	0	0	2115	0.0000000
zheyou73v0_A09	50310832	50312106	BnaA09T0422300ZY	0	-	0	0	1274	0.0000000
zheyou73v0_A09	50310832	50312192	BnaA09T0422300ZY.1	0	-	0	0	1360	0.0000000
zheyou73v0_A09	50320825	50322167	BnaA09T0422400ZY	0	-	0	0	1342	0.0000000
zheyou73v0_A09	50323954	50326002	BnaA09T0422500ZY	0	-	0	0	2048	0.0000000
zheyou73v0_A09	50327393	50332087	BnaA09T0422600ZY	0	-	0	0	4694	0.0000000
zheyou73v0_A09	50335223	50335993	BnaA09T0422700ZY	0	-	0	0	770	0.0000000
zheyou73v0_A09	50341945	50342180	BnaA09T0422800ZY	0	+	0	0	235	0.0000000
zheyou73v0_A09	50352034	50353354	BnaA09T0422900ZY	0	+	0	0	1320	0.0000000
zheyou73v0_A09	50354710	50356205	BnaA09T0423000ZY	0	+	0	0	1495	0.0000000
zheyou73v0_A09	50354710	50356205	BnaA09T0423000ZY.1	0	+	0	0	1495	0.0000000
zheyou73v0_A09	50357702	50358362	BnaA09T0423100ZY	0	+	0	0	660	0.0000000
zheyou73v0_A09	50359879	50361869	BnaA09T0423200ZY	0	+	0	0	1990	0.0000000
zheyou73v0_A09	50362120	50364279	BnaA09T0423300ZY	0	+	0	0	2159	0.0000000
zheyou73v0_A09	50364290	50365184	BnaA09T0423400ZY	0	-	0	0	894	0.0000000
zheyou73v0_A09	50369793	50370845	BnaA09T0423500ZY	0	+	0	0	1052	0.0000000
zheyou73v0_A09	50377223	50378072	BnaA09T0423600ZY	0	+	0	0	849	0.0000000
zheyou73v0_A09	50390964	50392694	BnaA09T0423700ZY	0	+	0	0	1730	0.0000000
zheyou73v0_A09	50396280	50401401	BnaA09T0423800ZY	0	+	0	0	5121	0.0000000
zheyou73v0_A09	50400927	50403038	BnaA09T0423900ZY	0	-	0	0	2111	0.0000000
zheyou73v0_A09	50403450	50404462	BnaA09T0424000ZY	0	+	0	0	1012	0.0000000
zheyou73v0_A09	50405234	50406846	BnaA09T0424100ZY	0	+	0	0	1612	0.0000000
zheyou73v0_A09	50407495	50410045	BnaA09T0424200ZY	0	-	0	0	2550	0.0000000
zheyou73v0_A09	50410414	50411822	BnaA09T0424300ZY	0	-	0	0	1408	0.0000000
zheyou73v0_A09	50412600	50413252	BnaA09T0424400ZY	0	+	0	0	652	0.0000000
zheyou73v0_A09	50414829	50415953	BnaA09T0424500ZY	0	-	0	0	1124	0.0000000
zheyou73v0_A09	50422104	50422578	BnaA09T0424600ZY	0	+	0	0	474	0.0000000
zheyou73v0_A09	50436539	50438653	BnaA09T0424700ZY	0	+	0	0	2114	0.0000000
zheyou73v0_A09	50443341	50446747	BnaA09T0424800ZY	0	+	0	0	3406	0.0000000
zheyou73v0_A09	50454539	50460421	BnaA09T0424900ZY	0	-	0	0	5882	0.0000000
zheyou73v0_A09	50468746	50476657	BnaA09T0425000ZY	0	+	0	0	7911	0.0000000
zheyou73v0_A09	50477679	50482911	BnaA09T0425100ZY	0	+	0	0	5232	0.0000000
zheyou73v0_A09	50483384	50484748	BnaA09T0425200ZY	0	-	0	0	1364	0.0000000
zheyou73v0_A09	50511015	50513563	BnaA09T0425300ZY	0	+	0	0	2548	0.0000000
zheyou73v0_A09	50513846	50514495	BnaA09T0425400ZY	0	-	0	0	649	0.0000000
zheyou73v0_A09	50518125	50519450	BnaA09T0425500ZY	0	-	0	0	1325	0.0000000
zheyou73v0_A09	50523589	50524317	BnaA09T0425600ZY	0	-	0	0	728	0.0000000
zheyou73v0_A09	50526366	50527964	BnaA09T0425700ZY	0	+	0	0	1598	0.0000000
zheyou73v0_A09	50530551	50532919	BnaA09T0425800ZY	0	+	0	0	2368	0.0000000
zheyou73v0_A09	50530551	50532252	BnaA09T0425800ZY.1	0	+	0	0	1701	0.0000000
zheyou73v0_A09	50533045	50533918	BnaA09T0425900ZY	0	-	0	0	873	0.0000000
zheyou73v0_A09	50544782	50545627	BnaA09T0426000ZY	0	+	0	0	845	0.0000000
zheyou73v0_A09	50546597	50548529	BnaA09T0426100ZY	0	+	0	0	1932	0.0000000
zheyou73v0_A09	50549817	50552771	BnaA09T0426200ZY	0	+	0	0	2954	0.0000000
zheyou73v0_A09	50559072	50560973	BnaA09T0426300ZY	0	+	0	0	1901	0.0000000
zheyou73v0_A09	50563486	50565946	BnaA09T0426400ZY	0	+	0	0	2460	0.0000000
zheyou73v0_A09	50566126	50566951	BnaA09T0426500ZY	0	-	0	0	825	0.0000000
zheyou73v0_A09	50569275	50570741	BnaA09T0426600ZY	0	+	0	0	1466	0.0000000
zheyou73v0_A09	50571171	50575834	BnaA09T0426700ZY	0	-	0	0	4663	0.0000000
zheyou73v0_A09	50576807	50578777	BnaA09T0426800ZY	0	-	0	0	1970	0.0000000
zheyou73v0_A09	50580113	50580380	BnaA09T0426900ZY	0	+	0	0	267	0.0000000
zheyou73v0_A09	50581232	50581683	BnaA09T0427000ZY	0	+	0	0	451	0.0000000
zheyou73v0_A09	50582720	50586262	BnaA09T0427100ZY	0	-	0	0	3542	0.0000000
zheyou73v0_A09	50587086	50589866	BnaA09T0427200ZY	0	-	0	0	2780	0.0000000
zheyou73v0_A09	50591560	50592347	BnaA09T0427300ZY	0	-	0	0	787	0.0000000
zheyou73v0_A09	50592900	50595515	BnaA09T0427400ZY	0	+	0	0	2615	0.0000000
zheyou73v0_A09	50598521	50598725	BnaA09T0427500ZY	0	+	0	0	204	0.0000000
zheyou73v0_A09	50602329	50602719	BnaA09T0427600ZY	0	-	0	0	390	0.0000000
zheyou73v0_A09	50604977	50608104	BnaA09T0427700ZY	0	+	0	0	3127	0.0000000
zheyou73v0_A09	50604977	50608104	BnaA09T0427700ZY.1	0	+	0	0	3127	0.0000000
zheyou73v0_A09	50607253	50608078	BnaA09T0427800ZY	0	-	0	0	825	0.0000000
zheyou73v0_A09	50611077	50611848	BnaA09T0427900ZY	0	-	0	0	771	0.0000000
zheyou73v0_A09	50632539	50632743	BnaA09T0428000ZY	0	-	0	0	204	0.0000000
zheyou73v0_A09	50634007	50636898	BnaA09T0428100ZY	0	+	0	0	2891	0.0000000
zheyou73v0_A09	50637377	50639146	BnaA09T0428200ZY	0	+	0	0	1769	0.0000000
zheyou73v0_A09	50637377	50639146	BnaA09T0428200ZY.1	0	+	0	0	1769	0.0000000
zheyou73v0_A09	50637377	50639146	BnaA09T0428200ZY.2	0	+	0	0	1769	0.0000000
zheyou73v0_A09	50646159	50658778	BnaA09T0428300ZY	0	-	0	0	12619	0.0000000
zheyou73v0_A09	50658963	50659378	BnaA09T0428400ZY	0	-	0	0	415	0.0000000
zheyou73v0_A09	50660061	50660928	BnaA09T0428500ZY	0	-	0	0	867	0.0000000
zheyou73v0_A09	50689331	50691544	BnaA09T0428600ZY	0	-	0	0	2213	0.0000000
zheyou73v0_A09	50704335	50708380	BnaA09T0428700ZY	0	-	0	0	4045	0.0000000
zheyou73v0_A09	50713591	50715149	BnaA09T0428800ZY	0	+	0	0	1558	0.0000000
zheyou73v0_A09	50713591	50715149	BnaA09T0428800ZY.1	0	+	0	0	1558	0.0000000
zheyou73v0_A09	50728339	50732545	BnaA09T0428900ZY	0	+	0	0	4206	0.0000000
zheyou73v0_A09	50728403	50732545	BnaA09T0428900ZY.1	0	+	0	0	4142	0.0000000
zheyou73v0_A09	50729204	50732801	BnaA09T0428900ZY.2	0	+	0	0	3597	0.0000000
zheyou73v0_A09	50733407	50735075	BnaA09T0429000ZY	0	-	0	0	1668	0.0000000
zheyou73v0_A09	50736014	50739394	BnaA09T0429100ZY	0	+	0	0	3380	0.0000000
zheyou73v0_A09	50740063	50743313	BnaA09T0429200ZY	0	-	0	0	3250	0.0000000
zheyou73v0_A09	50744200	50745327	BnaA09T0429300ZY	0	+	0	0	1127	0.0000000
zheyou73v0_A09	50746541	50749660	BnaA09T0429400ZY	0	+	0	0	3119	0.0000000
zheyou73v0_A09	50750530	50753833	BnaA09T0429500ZY	0	-	0	0	3303	0.0000000
zheyou73v0_A09	50755669	50762058	BnaA09T0429600ZY	0	-	0	0	6389	0.0000000
zheyou73v0_A09	50762558	50766737	BnaA09T0429700ZY	0	+	0	0	4179	0.0000000
zheyou73v0_A09	50768387	50768846	BnaA09T0429800ZY	0	-	0	0	459	0.0000000
zheyou73v0_A09	50779394	50779745	BnaA09T0429900ZY	0	-	0	0	351	0.0000000
zheyou73v0_A09	50783902	50784103	BnaA09T0430000ZY	0	+	0	0	201	0.0000000
zheyou73v0_A09	50784253	50786863	BnaA09T0430100ZY	0	+	0	0	2610	0.0000000
zheyou73v0_A09	50788695	50791602	BnaA09T0430200ZY	0	+	0	0	2907	0.0000000
zheyou73v0_A09	50796445	50796963	BnaA09T0430300ZY	0	+	0	0	518	0.0000000
zheyou73v0_A09	50797030	50799562	BnaA09T0430400ZY	0	+	0	0	2532	0.0000000
zheyou73v0_A09	50805255	50806328	BnaA09T0430500ZY	0	-	0	0	1073	0.0000000
zheyou73v0_A09	50815407	50815950	BnaA09T0430600ZY	0	+	0	0	543	0.0000000
zheyou73v0_A09	50822561	50824940	BnaA09T0430700ZY	0	+	0	0	2379	0.0000000
zheyou73v0_A09	50822561	50824940	BnaA09T0430700ZY.1	0	+	0	0	2379	0.0000000
zheyou73v0_A09	50829308	50830392	BnaA09T0430800ZY	0	-	0	0	1084	0.0000000
zheyou73v0_A09	50841439	50843067	BnaA09T0430900ZY	0	+	0	0	1628	0.0000000
zheyou73v0_A09	50846068	50849832	BnaA09T0431000ZY	0	+	0	0	3764	0.0000000
zheyou73v0_A09	50861021	50862738	BnaA09T0431100ZY	0	+	0	0	1717	0.0000000
zheyou73v0_A09	50861021	50862738	BnaA09T0431100ZY.1	0	+	0	0	1717	0.0000000
zheyou73v0_A09	50862971	50866097	BnaA09T0431200ZY	0	-	0	0	3126	0.0000000
zheyou73v0_A09	50867988	50868362	BnaA09T0431300ZY	0	-	0	0	374	0.0000000
zheyou73v0_A09	50870740	50871025	BnaA09T0431400ZY	0	-	0	0	285	0.0000000
zheyou73v0_A09	50873143	50875973	BnaA09T0431500ZY	0	-	0	0	2830	0.0000000
zheyou73v0_A09	50877484	50878536	BnaA09T0431600ZY	0	-	0	0	1052	0.0000000
zheyou73v0_A09	50879123	50882854	BnaA09T0431700ZY	0	-	0	0	3731	0.0000000
zheyou73v0_A09	50884251	50885981	BnaA09T0431800ZY	0	-	0	0	1730	0.0000000
zheyou73v0_A09	50886599	50887779	BnaA09T0431900ZY	0	-	0	0	1180	0.0000000
zheyou73v0_A09	50888518	50894698	BnaA09T0432000ZY	0	-	0	0	6180	0.0000000
zheyou73v0_A09	50894902	50898076	BnaA09T0432100ZY	0	-	0	0	3174	0.0000000
zheyou73v0_A09	50914785	50918031	BnaA09T0432200ZY	0	+	0	0	3246	0.0000000
zheyou73v0_A09	50919265	50920693	BnaA09T0432300ZY	0	-	0	0	1428	0.0000000
zheyou73v0_A09	50921140	50925688	BnaA09T0432400ZY	0	-	0	0	4548	0.0000000
zheyou73v0_A09	50957222	50958525	BnaA09T0432500ZY	0	+	0	0	1303	0.0000000
zheyou73v0_A09	50959335	50960682	BnaA09T0432600ZY	0	-	0	0	1347	0.0000000
zheyou73v0_A09	50975861	50979218	BnaA09T0432700ZY	0	-	0	0	3357	0.0000000
zheyou73v0_A09	50981003	50981660	BnaA09T0432800ZY	0	-	0	0	657	0.0000000
zheyou73v0_A09	50982111	50983152	BnaA09T0432900ZY	0	+	0	0	1041	0.0000000
zheyou73v0_A09	50984968	50985997	BnaA09T0433000ZY	0	+	0	0	1029	0.0000000
zheyou73v0_A09	50986017	50987988	BnaA09T0433100ZY	0	-	0	0	1971	0.0000000
zheyou73v0_A09	50986017	50987988	BnaA09T0433100ZY.1	0	-	0	0	1971	0.0000000
zheyou73v0_A09	50988765	50990251	BnaA09T0433200ZY	0	+	0	0	1486	0.0000000
zheyou73v0_A09	50991296	50991954	BnaA09T0433300ZY	0	-	0	0	658	0.0000000
zheyou73v0_A09	50992646	50996544	BnaA09T0433400ZY	0	+	0	0	3898	0.0000000
zheyou73v0_A09	50996917	50998367	BnaA09T0433500ZY	0	-	0	0	1450	0.0000000
zheyou73v0_A09	50999486	50999828	BnaA09T0433600ZY	0	+	0	0	342	0.0000000
zheyou73v0_A09	50999489	51002414	BnaA09T0433700ZY	0	-	0	0	2925	0.0000000
zheyou73v0_A09	51009806	51010558	BnaA09T0433800ZY	0	-	0	0	752	0.0000000
zheyou73v0_A09	51010883	51014459	BnaA09T0433900ZY	0	+	0	0	3576	0.0000000
zheyou73v0_A09	51010999	51014259	BnaA09T0433900ZY.1	0	+	0	0	3260	0.0000000
zheyou73v0_A09	51017295	51017958	BnaA09T0434000ZY	0	+	0	0	663	0.0000000
zheyou73v0_A09	51018070	51019595	BnaA09T0434100ZY	0	-	0	0	1525	0.0000000
zheyou73v0_A09	51020446	51023156	BnaA09T0434200ZY	0	+	0	0	2710	0.0000000
zheyou73v0_A09	51020446	51023156	BnaA09T0434200ZY.1	0	+	0	0	2710	0.0000000
zheyou73v0_A09	51023026	51023563	BnaA09T0434300ZY	0	-	0	0	537	0.0000000
zheyou73v0_A09	51024267	51032406	BnaA09T0434400ZY	0	+	0	0	8139	0.0000000
zheyou73v0_A09	51036867	51038126	BnaA09T0434500ZY	0	+	0	0	1259	0.0000000
zheyou73v0_A09	51038459	51038971	BnaA09T0434600ZY	0	-	0	0	512	0.0000000
zheyou73v0_A09	51053147	51054406	BnaA09T0434700ZY	0	+	0	0	1259	0.0000000
zheyou73v0_A09	51054739	51061172	BnaA09T0434800ZY	0	-	0	0	6433	0.0000000
zheyou73v0_A09	51066258	51068683	BnaA09T0434900ZY	0	+	0	0	2425	0.0000000
zheyou73v0_A09	51069018	51070875	BnaA09T0435000ZY	0	-	0	0	1857	0.0000000
zheyou73v0_A09	51071311	51072298	BnaA09T0435100ZY	0	+	0	0	987	0.0000000
zheyou73v0_A09	51072632	51075125	BnaA09T0435200ZY	0	-	0	0	2493	0.0000000
zheyou73v0_A09	51080101	51086667	BnaA09T0435300ZY	0	+	0	0	6566	0.0000000
zheyou73v0_A09	51086907	51087603	BnaA09T0435400ZY	0	-	0	0	696	0.0000000
zheyou73v0_A09	51087971	51090651	BnaA09T0435500ZY	0	-	0	0	2680	0.0000000
zheyou73v0_A09	51091434	51092665	BnaA09T0435600ZY	0	+	0	0	1231	0.0000000
zheyou73v0_A09	51095014	51096432	BnaA09T0435700ZY	0	+	0	0	1418	0.0000000
zheyou73v0_A09	51110704	51111060	BnaA09T0435800ZY	0	+	0	0	356	0.0000000
zheyou73v0_A09	51115701	51128756	BnaA09T0435900ZY	0	+	0	0	13055	0.0000000
zheyou73v0_A09	51130368	51131049	BnaA09T0436000ZY	0	+	0	0	681	0.0000000
zheyou73v0_A09	51140266	51144986	BnaA09T0436100ZY	0	+	0	0	4720	0.0000000
zheyou73v0_A09	51147985	51165816	BnaA09T0436200ZY	0	+	0	0	17831	0.0000000
zheyou73v0_A09	51166587	51166998	BnaA09T0436300ZY	0	-	0	0	411	0.0000000
zheyou73v0_A09	51171230	51172475	BnaA09T0436400ZY	0	+	0	0	1245	0.0000000
zheyou73v0_A09	51179278	51180769	BnaA09T0436500ZY	0	-	0	0	1491	0.0000000
zheyou73v0_A09	51190285	51191285	BnaA09T0436600ZY	0	+	0	0	1000	0.0000000
zheyou73v0_A09	51193203	51194365	BnaA09T0436700ZY	0	+	0	0	1162	0.0000000
zheyou73v0_A09	51203479	51204138	BnaA09T0436800ZY	0	+	0	0	659	0.0000000
zheyou73v0_A09	51206491	51207045	BnaA09T0436900ZY	0	-	0	0	554	0.0000000
zheyou73v0_A09	51207049	51209371	BnaA09T0437000ZY	0	-	0	0	2322	0.0000000
zheyou73v0_A09	51219385	51220111	BnaA09T0437100ZY	0	-	0	0	726	0.0000000
zheyou73v0_A09	51220115	51222038	BnaA09T0437200ZY	0	-	0	0	1923	0.0000000
zheyou73v0_A09	51226258	51227059	BnaA09T0437300ZY	0	-	0	0	801	0.0000000
zheyou73v0_A09	51231765	51232281	BnaA09T0437400ZY	0	-	0	0	516	0.0000000
zheyou73v0_A09	51245036	51246658	BnaA09T0437500ZY	0	-	0	0	1622	0.0000000
zheyou73v0_A09	51245036	51246658	BnaA09T0437500ZY.1	0	-	0	0	1622	0.0000000
zheyou73v0_A09	51251346	51251637	BnaA09T0437600ZY	0	-	0	0	291	0.0000000
zheyou73v0_A09	51254917	51259375	BnaA09T0437700ZY	0	+	0	0	4458	0.0000000
zheyou73v0_A09	51261379	51262111	BnaA09T0437800ZY	0	+	0	0	732	0.0000000
zheyou73v0_A09	51263014	51264194	BnaA09T0437900ZY	0	+	0	0	1180	0.0000000
zheyou73v0_A09	51265303	51267374	BnaA09T0438000ZY	0	+	0	0	2071	0.0000000
zheyou73v0_A09	51268042	51269356	BnaA09T0438100ZY	0	+	0	0	1314	0.0000000
zheyou73v0_A09	51276949	51279964	BnaA09T0438200ZY	0	+	0	0	3015	0.0000000
zheyou73v0_A09	51276949	51279964	BnaA09T0438200ZY.1	0	+	0	0	3015	0.0000000
zheyou73v0_A09	51282737	51284218	BnaA09T0438300ZY	0	+	0	0	1481	0.0000000
zheyou73v0_A09	51285570	51287138	BnaA09T0438400ZY	0	-	0	0	1568	0.0000000
zheyou73v0_A09	51288929	51289297	BnaA09T0438500ZY	0	-	0	0	368	0.0000000
zheyou73v0_A09	51297343	51299999	BnaA09T0438600ZY	0	+	0	0	2656	0.0000000
zheyou73v0_A09	51310331	51311668	BnaA09T0438700ZY	0	+	0	0	1337	0.0000000
zheyou73v0_A09	51319657	51322581	BnaA09T0438800ZY	0	-	0	0	2924	0.0000000
zheyou73v0_A09	51319657	51322710	BnaA09T0438800ZY.1	0	-	0	0	3053	0.0000000
zheyou73v0_A09	51326778	51328200	BnaA09T0438900ZY	0	-	0	0	1422	0.0000000
zheyou73v0_A09	51329286	51330257	BnaA09T0439000ZY	0	-	0	0	971	0.0000000
zheyou73v0_A09	51334383	51337802	BnaA09T0439100ZY	0	-	0	0	3419	0.0000000
zheyou73v0_A09	51334383	51337555	BnaA09T0439100ZY.1	0	-	0	0	3172	0.0000000
zheyou73v0_A09	51334387	51334701	BnaA09T0439200ZY	0	+	0	0	314	0.0000000
zheyou73v0_A09	51342226	51343410	BnaA09T0439300ZY	0	-	0	0	1184	0.0000000
zheyou73v0_A09	51345659	51351008	BnaA09T0439400ZY	0	-	0	0	5349	0.0000000
zheyou73v0_A09	51365666	51366900	BnaA09T0439500ZY	0	+	0	0	1234	0.0000000
zheyou73v0_A09	51365666	51366540	BnaA09T0439500ZY.1	0	+	0	0	874	0.0000000
zheyou73v0_A09	51372356	51375683	BnaA09T0439600ZY	0	-	0	0	3327	0.0000000
zheyou73v0_A09	51376642	51377636	BnaA09T0439700ZY	0	+	0	0	994	0.0000000
zheyou73v0_A09	51384513	51388229	BnaA09T0439800ZY	0	+	0	0	3716	0.0000000
zheyou73v0_A09	51388504	51389702	BnaA09T0439900ZY	0	-	0	0	1198	0.0000000
zheyou73v0_A09	51390048	51392812	BnaA09T0440000ZY	0	-	0	0	2764	0.0000000
zheyou73v0_A09	51402174	51406464	BnaA09T0440100ZY	0	+	0	0	4290	0.0000000
zheyou73v0_A09	51407553	51409949	BnaA09T0440200ZY	0	-	0	0	2396	0.0000000
zheyou73v0_A09	51414237	51416195	BnaA09T0440300ZY	0	+	0	0	1958	0.0000000
zheyou73v0_A09	51417912	51418886	BnaA09T0440400ZY	0	-	0	0	974	0.0000000
zheyou73v0_A09	51444594	51444972	BnaA09T0440500ZY	0	+	0	0	378	0.0000000
zheyou73v0_A09	51450845	51452414	BnaA09T0440600ZY	0	+	0	0	1569	0.0000000
zheyou73v0_A09	51453048	51454940	BnaA09T0440700ZY	0	-	0	0	1892	0.0000000
zheyou73v0_A09	51460887	51462085	BnaA09T0440800ZY	0	+	0	0	1198	0.0000000
zheyou73v0_A09	51463024	51464823	BnaA09T0440900ZY	0	-	0	0	1799	0.0000000
zheyou73v0_A09	51467392	51467881	BnaA09T0441000ZY	0	-	0	0	489	0.0000000
zheyou73v0_A09	51479263	51480264	BnaA09T0441100ZY	0	+	0	0	1001	0.0000000
zheyou73v0_A09	51481547	51485160	BnaA09T0441200ZY	0	+	0	0	3613	0.0000000
zheyou73v0_A09	51488623	51490700	BnaA09T0441300ZY	0	+	0	0	2077	0.0000000
zheyou73v0_A09	51488623	51490171	BnaA09T0441300ZY.1	0	+	0	0	1548	0.0000000
zheyou73v0_A09	51490313	51492026	BnaA09T0441400ZY	0	-	0	0	1713	0.0000000
zheyou73v0_A09	51493637	51494145	BnaA09T0441500ZY	0	-	0	0	508	0.0000000
zheyou73v0_A09	51494761	51495460	BnaA09T0441600ZY	0	+	0	0	699	0.0000000
zheyou73v0_A09	51496890	51498213	BnaA09T0441700ZY	0	-	0	0	1323	0.0000000
zheyou73v0_A09	51498627	51500655	BnaA09T0441800ZY	0	+	0	0	2028	0.0000000
zheyou73v0_A09	51503292	51504294	BnaA09T0441900ZY	0	-	0	0	1002	0.0000000
zheyou73v0_A09	51506608	51509647	BnaA09T0442000ZY	0	-	0	0	3039	0.0000000
zheyou73v0_A09	51522040	51523591	BnaA09T0442100ZY	0	-	0	0	1551	0.0000000
zheyou73v0_A09	51534653	51536196	BnaA09T0442200ZY	0	-	0	0	1543	0.0000000
zheyou73v0_A09	51540967	51543155	BnaA09T0442300ZY	0	-	0	0	2188	0.0000000
zheyou73v0_A09	51543695	51548352	BnaA09T0442400ZY	0	+	0	0	4657	0.0000000
zheyou73v0_A09	51571660	51575243	BnaA09T0442500ZY	0	+	0	0	3583	0.0000000
zheyou73v0_A09	51571660	51574385	BnaA09T0442500ZY.1	0	+	0	0	2725	0.0000000
zheyou73v0_A09	51576091	51577066	BnaA09T0442600ZY	0	-	0	0	975	0.0000000
zheyou73v0_A09	51582065	51585809	BnaA09T0442700ZY	0	+	0	0	3744	0.0000000
zheyou73v0_A09	51591878	51592467	BnaA09T0442800ZY	0	-	0	0	589	0.0000000
zheyou73v0_A09	51594782	51595264	BnaA09T0442900ZY	0	-	0	0	482	0.0000000
zheyou73v0_A09	51603861	51604254	BnaA09T0443000ZY	0	+	0	0	393	0.0000000
zheyou73v0_A09	51604531	51607279	BnaA09T0443100ZY	0	-	0	0	2748	0.0000000
zheyou73v0_A09	51631771	51632925	BnaA09T0443200ZY	0	-	0	0	1154	0.0000000
zheyou73v0_A09	51633443	51636346	BnaA09T0443300ZY	0	-	0	0	2903	0.0000000
zheyou73v0_A09	51636996	51638387	BnaA09T0443400ZY	0	-	0	0	1391	0.0000000
zheyou73v0_A09	51640089	51641921	BnaA09T0443500ZY	0	-	0	0	1832	0.0000000
zheyou73v0_A09	51640089	51641921	BnaA09T0443500ZY.1	0	-	0	0	1832	0.0000000
zheyou73v0_A09	51643970	51646268	BnaA09T0443600ZY	0	+	0	0	2298	0.0000000
zheyou73v0_A09	51646536	51647197	BnaA09T0443700ZY	0	-	0	0	661	0.0000000
zheyou73v0_A09	51651849	51656033	BnaA09T0443800ZY	0	+	0	0	4184	0.0000000
zheyou73v0_A09	51658149	51659587	BnaA09T0443900ZY	0	+	0	0	1438	0.0000000
zheyou73v0_A09	51659847	51661697	BnaA09T0444000ZY	0	-	0	0	1850	0.0000000
zheyou73v0_A09	51665831	51666332	BnaA09T0444100ZY	0	-	0	0	501	0.0000000
zheyou73v0_A09	51669816	51671325	BnaA09T0444200ZY	0	+	0	0	1509	0.0000000
zheyou73v0_A09	51671756	51674210	BnaA09T0444300ZY	0	-	0	0	2454	0.0000000
zheyou73v0_A09	51678327	51680002	BnaA09T0444400ZY	0	-	0	0	1675	0.0000000
zheyou73v0_A09	51682748	51683220	BnaA09T0444500ZY	0	+	0	0	472	0.0000000
zheyou73v0_A09	51684501	51686363	BnaA09T0444600ZY	0	-	0	0	1862	0.0000000
zheyou73v0_A09	51684501	51686363	BnaA09T0444600ZY.1	0	-	0	0	1862	0.0000000
zheyou73v0_A09	51684501	51686363	BnaA09T0444600ZY.2	0	-	0	0	1862	0.0000000
zheyou73v0_A09	51684501	51686363	BnaA09T0444600ZY.3	0	-	0	0	1862	0.0000000
zheyou73v0_A09	51694890	51706373	BnaA09T0444700ZY	0	-	0	0	11483	0.0000000
zheyou73v0_A09	51708460	51731616	BnaA09T0444800ZY	0	+	0	0	23156	0.0000000
zheyou73v0_A09	51740164	51741346	BnaA09T0444900ZY	0	+	0	0	1182	0.0000000
zheyou73v0_A09	51741365	51744374	BnaA09T0445000ZY	0	-	0	0	3009	0.0000000
zheyou73v0_A09	51762409	51763692	BnaA09T0445100ZY	0	+	0	0	1283	0.0000000
zheyou73v0_A09	51764116	51765089	BnaA09T0445200ZY	0	-	0	0	973	0.0000000
zheyou73v0_A09	51768157	51771400	BnaA09T0445300ZY	0	-	0	0	3243	0.0000000
zheyou73v0_A09	51768157	51771400	BnaA09T0445300ZY.1	0	-	0	0	3243	0.0000000
zheyou73v0_A09	51768157	51771145	BnaA09T0445300ZY.2	0	-	0	0	2988	0.0000000
zheyou73v0_A09	51771804	51785355	BnaA09T0445400ZY	0	+	0	0	13551	0.0000000
zheyou73v0_A09	51786622	51787508	BnaA09T0445500ZY	0	-	0	0	886	0.0000000
zheyou73v0_A09	51787817	51799167	BnaA09T0445600ZY	0	-	0	0	11350	0.0000000
zheyou73v0_A09	51804658	51807401	BnaA09T0445700ZY	0	+	0	0	2743	0.0000000
zheyou73v0_A09	51807482	51809204	BnaA09T0445800ZY	0	+	0	0	1722	0.0000000
zheyou73v0_A09	51809654	51810294	BnaA09T0445900ZY	0	+	0	0	640	0.0000000
zheyou73v0_A09	51811520	51813229	BnaA09T0446000ZY	0	+	0	0	1709	0.0000000
zheyou73v0_A09	51815753	51817832	BnaA09T0446100ZY	0	-	0	0	2079	0.0000000
zheyou73v0_A09	51818705	51824272	BnaA09T0446200ZY	0	-	0	0	5567	0.0000000
zheyou73v0_A09	51825032	51825603	BnaA09T0446300ZY	0	-	0	0	571	0.0000000
zheyou73v0_A09	51827983	51829105	BnaA09T0446400ZY	0	+	0	0	1122	0.0000000
zheyou73v0_A09	51829480	51830544	BnaA09T0446500ZY	0	-	0	0	1064	0.0000000
zheyou73v0_A09	51831067	51833037	BnaA09T0446600ZY	0	+	0	0	1970	0.0000000
zheyou73v0_A09	51831067	51833037	BnaA09T0446600ZY.1	0	+	0	0	1970	0.0000000
zheyou73v0_A09	51833275	51837422	BnaA09T0446700ZY	0	-	0	0	4147	0.0000000
zheyou73v0_A09	51848275	51850289	BnaA09T0446800ZY	0	-	0	0	2014	0.0000000
zheyou73v0_A09	51855266	51857981	BnaA09T0446900ZY	0	-	0	0	2715	0.0000000
zheyou73v0_A09	51858243	51860457	BnaA09T0447000ZY	0	+	0	0	2214	0.0000000
zheyou73v0_A09	51861215	51865211	BnaA09T0447100ZY	0	-	0	0	3996	0.0000000
zheyou73v0_A09	51887193	51887616	BnaA09T0447200ZY	0	+	0	0	423	0.0000000
zheyou73v0_A09	51892931	51896143	BnaA09T0447300ZY	0	+	0	0	3212	0.0000000
zheyou73v0_A09	51894809	51897283	BnaA09T0447400ZY	0	-	0	0	2474	0.0000000
zheyou73v0_A09	51899811	51901509	BnaA09T0447500ZY	0	+	0	0	1698	0.0000000
zheyou73v0_A09	51901830	51902598	BnaA09T0447600ZY	0	-	0	0	768	0.0000000
zheyou73v0_A09	51903272	51905445	BnaA09T0447700ZY	0	-	0	0	2173	0.0000000
zheyou73v0_A09	51905891	51908706	BnaA09T0447800ZY	0	-	0	0	2815	0.0000000
zheyou73v0_A09	51926205	51927680	BnaA09T0447900ZY	0	+	0	0	1475	0.0000000
zheyou73v0_A09	51933766	51935062	BnaA09T0448000ZY	0	-	0	0	1296	0.0000000
zheyou73v0_A09	51945909	51947876	BnaA09T0448100ZY	0	+	0	0	1967	0.0000000
zheyou73v0_A09	51945909	51947876	BnaA09T0448100ZY.1	0	+	0	0	1967	0.0000000
zheyou73v0_A09	51958452	51960387	BnaA09T0448200ZY	0	-	0	0	1935	0.0000000
zheyou73v0_A09	51958452	51960387	BnaA09T0448200ZY.1	0	-	0	0	1935	0.0000000
zheyou73v0_A09	51961470	51963753	BnaA09T0448300ZY	0	+	0	0	2283	0.0000000
zheyou73v0_A09	51978515	51979143	BnaA09T0448400ZY	0	+	0	0	628	0.0000000
zheyou73v0_A09	52004238	52005243	BnaA09T0448500ZY	0	+	0	0	1005	0.0000000
zheyou73v0_A09	52005545	52005782	BnaA09T0448600ZY	0	-	0	0	237	0.0000000
zheyou73v0_A09	52006631	52008626	BnaA09T0448700ZY	0	+	0	0	1995	0.0000000
zheyou73v0_A09	52008552	52011979	BnaA09T0448800ZY	0	-	0	0	3427	0.0000000
zheyou73v0_A09	52016281	52018705	BnaA09T0448900ZY	0	+	0	0	2424	0.0000000
zheyou73v0_A09	52018976	52020101	BnaA09T0449000ZY	0	-	0	0	1125	0.0000000
zheyou73v0_A09	52020797	52023562	BnaA09T0449100ZY	0	-	0	0	2765	0.0000000
zheyou73v0_A09	52023817	52025728	BnaA09T0449200ZY	0	-	0	0	1911	0.0000000
zheyou73v0_A09	52026370	52029240	BnaA09T0449300ZY	0	-	0	0	2870	0.0000000
zheyou73v0_A09	52034585	52037651	BnaA09T0449400ZY	0	-	0	0	3066	0.0000000
zheyou73v0_A09	52040826	52043618	BnaA09T0449500ZY	0	+	0	0	2792	0.0000000
zheyou73v0_A09	52044679	52047296	BnaA09T0449600ZY	0	-	0	0	2617	0.0000000
zheyou73v0_A09	52056339	52057319	BnaA09T0449700ZY	0	+	0	0	980	0.0000000
zheyou73v0_A09	52058905	52059926	BnaA09T0449800ZY	0	-	0	0	1021	0.0000000
zheyou73v0_A09	52061942	52064626	BnaA09T0449900ZY	0	+	0	0	2684	0.0000000
zheyou73v0_A09	52065341	52072454	BnaA09T0450000ZY	0	+	0	0	7113	0.0000000
zheyou73v0_A09	52065341	52072454	BnaA09T0450000ZY.1	0	+	0	0	7113	0.0000000
zheyou73v0_A09	52073352	52073658	BnaA09T0450100ZY	0	+	0	0	306	0.0000000
zheyou73v0_A09	52073910	52076774	BnaA09T0450200ZY	0	-	0	0	2864	0.0000000
zheyou73v0_A09	52073910	52076774	BnaA09T0450200ZY.1	0	-	0	0	2864	0.0000000
zheyou73v0_A09	52079783	52082590	BnaA09T0450300ZY	0	-	0	0	2807	0.0000000
zheyou73v0_A09	52094814	52106443	BnaA09T0450400ZY	0	+	0	0	11629	0.0000000
zheyou73v0_A09	52094814	52103321	BnaA09T0450400ZY.1	0	+	0	0	8507	0.0000000
zheyou73v0_A09	52107531	52108769	BnaA09T0450500ZY	0	-	0	0	1238	0.0000000
zheyou73v0_A09	52111138	52113278	BnaA09T0450600ZY	0	-	0	0	2140	0.0000000
zheyou73v0_A09	52115129	52116831	BnaA09T0450700ZY	0	-	0	0	1702	0.0000000
zheyou73v0_A09	52120530	52124178	BnaA09T0450800ZY	0	+	0	0	3648	0.0000000
zheyou73v0_A09	52125295	52127516	BnaA09T0450900ZY	0	-	0	0	2221	0.0000000
zheyou73v0_A09	52125295	52127516	BnaA09T0450900ZY.1	0	-	0	0	2221	0.0000000
zheyou73v0_A09	52131147	52133782	BnaA09T0451000ZY	0	-	0	0	2635	0.0000000
zheyou73v0_A09	52136552	52138431	BnaA09T0451100ZY	0	-	0	0	1879	0.0000000
zheyou73v0_A09	52138969	52142058	BnaA09T0451200ZY	0	+	0	0	3089	0.0000000
zheyou73v0_A09	52142579	52146027	BnaA09T0451300ZY	0	-	0	0	3448	0.0000000
zheyou73v0_A09	52147252	52150206	BnaA09T0451400ZY	0	+	0	0	2954	0.0000000
zheyou73v0_A09	52150530	52152191	BnaA09T0451500ZY	0	-	0	0	1661	0.0000000
zheyou73v0_A09	52153800	52157636	BnaA09T0451600ZY	0	+	0	0	3836	0.0000000
zheyou73v0_A09	52159836	52162294	BnaA09T0451700ZY	0	-	0	0	2458	0.0000000
zheyou73v0_A09	52162867	52164685	BnaA09T0451800ZY	0	+	0	0	1818	0.0000000
zheyou73v0_A09	52165784	52166828	BnaA09T0451900ZY	0	-	0	0	1044	0.0000000
zheyou73v0_A09	52170146	52170377	BnaA09T0452000ZY	0	+	0	0	231	0.0000000
zheyou73v0_A09	52172773	52175971	BnaA09T0452100ZY	0	+	0	0	3198	0.0000000
zheyou73v0_A09	52183892	52184269	BnaA09T0452200ZY	0	+	0	0	377	0.0000000
zheyou73v0_A09	52196162	52197523	BnaA09T0452300ZY	0	-	0	0	1361	0.0000000
zheyou73v0_A09	52201829	52203986	BnaA09T0452400ZY	0	+	0	0	2157	0.0000000
zheyou73v0_A09	52204498	52206194	BnaA09T0452500ZY	0	+	0	0	1696	0.0000000
zheyou73v0_A09	52209406	52209703	BnaA09T0452600ZY	0	-	0	0	297	0.0000000
zheyou73v0_A09	52233386	52234673	BnaA09T0452700ZY	0	+	0	0	1287	0.0000000
zheyou73v0_A09	52234887	52235180	BnaA09T0452800ZY	0	+	0	0	293	0.0000000
zheyou73v0_A09	52235491	52237579	BnaA09T0452900ZY	0	-	0	0	2088	0.0000000
zheyou73v0_A09	52241984	52243954	BnaA09T0453000ZY	0	-	0	0	1970	0.0000000
zheyou73v0_A09	52245501	52247403	BnaA09T0453100ZY	0	-	0	0	1902	0.0000000
zheyou73v0_A09	52245501	52247403	BnaA09T0453100ZY.1	0	-	0	0	1902	0.0000000
zheyou73v0_A09	52245501	52247403	BnaA09T0453100ZY.2	0	-	0	0	1902	0.0000000
zheyou73v0_A09	52245501	52247403	BnaA09T0453100ZY.3	0	-	0	0	1902	0.0000000
zheyou73v0_A09	52248172	52251897	BnaA09T0453200ZY	0	-	0	0	3725	0.0000000
zheyou73v0_A09	52252695	52256218	BnaA09T0453300ZY	0	-	0	0	3523	0.0000000
zheyou73v0_A09	52264093	52271878	BnaA09T0453400ZY	0	+	0	0	7785	0.0000000
zheyou73v0_A09	52272079	52273464	BnaA09T0453500ZY	0	+	0	0	1385	0.0000000
zheyou73v0_A09	52279137	52282346	BnaA09T0453600ZY	0	-	0	0	3209	0.0000000
zheyou73v0_A09	52279137	52282346	BnaA09T0453600ZY.1	0	-	0	0	3209	0.0000000
zheyou73v0_A09	52285641	52286478	BnaA09T0453700ZY	0	+	0	0	837	0.0000000
zheyou73v0_A09	52288244	52289724	BnaA09T0453800ZY	0	+	0	0	1480	0.0000000
zheyou73v0_A09	52289995	52294179	BnaA09T0453900ZY	0	-	0	0	4184	0.0000000
zheyou73v0_A09	52302205	52304687	BnaA09T0454000ZY	0	-	0	0	2482	0.0000000
zheyou73v0_A09	52305822	52307862	BnaA09T0454100ZY	0	-	0	0	2040	0.0000000
zheyou73v0_A09	52316635	52321139	BnaA09T0454200ZY	0	+	0	0	4504	0.0000000
zheyou73v0_A09	52328383	52330109	BnaA09T0454300ZY	0	+	0	0	1726	0.0000000
zheyou73v0_A09	52340631	52343091	BnaA09T0454400ZY	0	+	0	0	2460	0.0000000
zheyou73v0_A09	52346879	52348061	BnaA09T0454500ZY	0	+	0	0	1182	0.0000000
zheyou73v0_A09	52350346	52350604	BnaA09T0454600ZY	0	-	0	0	258	0.0000000
zheyou73v0_A09	52355345	52356634	BnaA09T0454700ZY	0	+	0	0	1289	0.0000000
zheyou73v0_A09	52357925	52361379	BnaA09T0454800ZY	0	-	0	0	3454	0.0000000
zheyou73v0_A09	52369151	52369469	BnaA09T0454900ZY	0	+	0	0	318	0.0000000
zheyou73v0_A09	52379070	52381380	BnaA09T0455000ZY	0	+	0	0	2310	0.0000000
zheyou73v0_A09	52387716	52390722	BnaA09T0455100ZY	0	+	0	0	3006	0.0000000
zheyou73v0_A09	52390743	52395785	BnaA09T0455200ZY	0	-	0	0	5042	0.0000000
zheyou73v0_A09	52397499	52403293	BnaA09T0455300ZY	0	+	0	0	5794	0.0000000
zheyou73v0_A09	52403777	52405075	BnaA09T0455400ZY	0	-	0	0	1298	0.0000000
zheyou73v0_A09	52403777	52405075	BnaA09T0455400ZY.1	0	-	0	0	1298	0.0000000
zheyou73v0_A09	52403777	52405075	BnaA09T0455400ZY.2	0	-	0	0	1298	0.0000000
zheyou73v0_A09	52403777	52405075	BnaA09T0455400ZY.3	0	-	0	0	1298	0.0000000
zheyou73v0_A09	52406660	52408324	BnaA09T0455500ZY	0	-	0	0	1664	0.0000000
zheyou73v0_A09	52406660	52408324	BnaA09T0455500ZY.1	0	-	0	0	1664	0.0000000
zheyou73v0_A09	52406660	52408324	BnaA09T0455500ZY.2	0	-	0	0	1664	0.0000000
zheyou73v0_A09	52409125	52409957	BnaA09T0455600ZY	0	-	0	0	832	0.0000000
zheyou73v0_A09	52428816	52431478	BnaA09T0455700ZY	0	+	0	0	2662	0.0000000
zheyou73v0_A09	52442388	52446336	BnaA09T0455800ZY	0	+	0	0	3948	0.0000000
zheyou73v0_A09	52447098	52448937	BnaA09T0455900ZY	0	-	0	0	1839	0.0000000
zheyou73v0_A09	52454358	52455958	BnaA09T0456000ZY	0	+	0	0	1600	0.0000000
zheyou73v0_A09	52462225	52464473	BnaA09T0456100ZY	0	-	0	0	2248	0.0000000
zheyou73v0_A09	52465982	52469006	BnaA09T0456200ZY	0	-	0	0	3024	0.0000000
zheyou73v0_A09	52469470	52471316	BnaA09T0456300ZY	0	-	0	0	1846	0.0000000
zheyou73v0_A09	52469470	52471316	BnaA09T0456300ZY.1	0	-	0	0	1846	0.0000000
zheyou73v0_A09	52471507	52474391	BnaA09T0456400ZY	0	+	0	0	2884	0.0000000
zheyou73v0_A09	52478645	52481977	BnaA09T0456500ZY	0	-	0	0	3332	0.0000000
zheyou73v0_A09	52501176	52503237	BnaA09T0456600ZY	0	+	0	0	2061	0.0000000
zheyou73v0_A09	52503257	52505553	BnaA09T0456700ZY	0	+	0	0	2296	0.0000000
zheyou73v0_A09	52505911	52510680	BnaA09T0456800ZY	0	-	0	0	4769	0.0000000
zheyou73v0_A09	52514877	52515999	BnaA09T0456900ZY	0	+	0	0	1122	0.0000000
zheyou73v0_A09	52515902	52518138	BnaA09T0457000ZY	0	-	0	0	2236	0.0000000
zheyou73v0_A09	52518333	52520326	BnaA09T0457100ZY	0	-	0	0	1993	0.0000000
zheyou73v0_A09	52532391	52534926	BnaA09T0457200ZY	0	+	0	0	2535	0.0000000
zheyou73v0_A09	52532391	52534926	BnaA09T0457200ZY.1	0	+	0	0	2535	0.0000000
zheyou73v0_A09	52537576	52538437	BnaA09T0457300ZY	0	+	0	0	861	0.0000000
zheyou73v0_A09	52538515	52543487	BnaA09T0457400ZY	0	-	0	0	4972	0.0000000
zheyou73v0_A09	52547971	52550444	BnaA09T0457500ZY	0	-	0	0	2473	0.0000000
zheyou73v0_A09	52555339	52557228	BnaA09T0457600ZY	0	-	0	0	1889	0.0000000
zheyou73v0_A09	52560300	52564122	BnaA09T0457700ZY	0	-	0	0	3822	0.0000000
zheyou73v0_A09	52565017	52566892	BnaA09T0457800ZY	0	-	0	0	1875	0.0000000
zheyou73v0_A09	52577232	52579274	BnaA09T0457900ZY	0	+	0	0	2042	0.0000000
zheyou73v0_A09	52581816	52583112	BnaA09T0458000ZY	0	-	0	0	1296	0.0000000
zheyou73v0_A09	52596467	52598167	BnaA09T0458100ZY	0	+	0	0	1700	0.0000000
zheyou73v0_A09	52600509	52601382	BnaA09T0458200ZY	0	+	0	0	873	0.0000000
zheyou73v0_A09	52602819	52603062	BnaA09T0458300ZY	0	-	0	0	243	0.0000000
zheyou73v0_A09	52603284	52606289	BnaA09T0458400ZY	0	+	0	0	3005	0.0000000
zheyou73v0_A09	52618185	52619902	BnaA09T0458500ZY	0	+	0	0	1717	0.0000000
zheyou73v0_A09	52620341	52622274	BnaA09T0458600ZY	0	-	0	0	1933	0.0000000
zheyou73v0_A09	52620341	52622274	BnaA09T0458600ZY.1	0	-	0	0	1933	0.0000000
zheyou73v0_A09	52622480	52637069	BnaA09T0458700ZY	0	-	0	0	14589	0.0000000
zheyou73v0_A09	52639750	52641324	BnaA09T0458800ZY	0	+	0	0	1574	0.0000000
zheyou73v0_A09	52647800	52648969	BnaA09T0458900ZY	0	+	0	0	1169	0.0000000
zheyou73v0_A09	52650410	52651320	BnaA09T0459000ZY	0	+	0	0	910	0.0000000
zheyou73v0_A09	52651546	52654583	BnaA09T0459100ZY	0	-	0	0	3037	0.0000000
zheyou73v0_A09	52658666	52660399	BnaA09T0459200ZY	0	+	0	0	1733	0.0000000
zheyou73v0_A09	52660952	52677477	BnaA09T0459300ZY	0	-	0	0	16525	0.0000000
zheyou73v0_A09	52678390	52680474	BnaA09T0459400ZY	0	+	0	0	2084	0.0000000
zheyou73v0_A09	52692453	52693339	BnaA09T0459500ZY	0	-	0	0	886	0.0000000
zheyou73v0_A09	52695353	52697661	BnaA09T0459600ZY	0	+	0	0	2308	0.0000000
zheyou73v0_A09	52695353	52697661	BnaA09T0459600ZY.1	0	+	0	0	2308	0.0000000
zheyou73v0_A09	52701135	52702294	BnaA09T0459700ZY	0	-	0	0	1159	0.0000000
zheyou73v0_A09	52704226	52706123	BnaA09T0459800ZY	0	+	0	0	1897	0.0000000
zheyou73v0_A09	52704226	52706156	BnaA09T0459800ZY.1	0	+	0	0	1930	0.0000000
zheyou73v0_A09	52704226	52706123	BnaA09T0459800ZY.2	0	+	0	0	1897	0.0000000
zheyou73v0_A09	52709393	52714243	BnaA09T0459900ZY	0	-	0	0	4850	0.0000000
zheyou73v0_A09	52715240	52716223	BnaA09T0460000ZY	0	+	0	0	983	0.0000000
zheyou73v0_A09	52725494	52726528	BnaA09T0460100ZY	0	+	0	0	1034	0.0000000
zheyou73v0_A09	52732693	52733762	BnaA09T0460200ZY	0	+	0	0	1069	0.0000000
zheyou73v0_A09	52734634	52735984	BnaA09T0460300ZY	0	-	0	0	1350	0.0000000
zheyou73v0_A09	52739402	52742096	BnaA09T0460400ZY	0	+	0	0	2694	0.0000000
zheyou73v0_A09	52753725	52758501	BnaA09T0460500ZY	0	+	0	0	4776	0.0000000
zheyou73v0_A09	52761390	52761960	BnaA09T0460600ZY	0	+	0	0	570	0.0000000
zheyou73v0_A09	52765035	52766446	BnaA09T0460700ZY	0	+	0	0	1411	0.0000000
zheyou73v0_A09	52766618	52769105	BnaA09T0460800ZY	0	-	0	0	2487	0.0000000
zheyou73v0_A09	52770777	52772115	BnaA09T0460900ZY	0	-	0	0	1338	0.0000000
zheyou73v0_A09	52774193	52775384	BnaA09T0461000ZY	0	-	0	0	1191	0.0000000
zheyou73v0_A09	52787112	52790269	BnaA09T0461100ZY	0	+	0	0	3157	0.0000000
zheyou73v0_A09	52791187	52793085	BnaA09T0461200ZY	0	+	0	0	1898	0.0000000
zheyou73v0_A09	52791187	52793085	BnaA09T0461200ZY.1	0	+	0	0	1898	0.0000000
zheyou73v0_A09	52793702	52797937	BnaA09T0461300ZY	0	-	0	0	4235	0.0000000
zheyou73v0_A09	52810116	52811982	BnaA09T0461400ZY	0	+	0	0	1866	0.0000000
zheyou73v0_A09	52810116	52811982	BnaA09T0461400ZY.1	0	+	0	0	1866	0.0000000
zheyou73v0_A09	52812595	52815504	BnaA09T0461500ZY	0	+	0	0	2909	0.0000000
zheyou73v0_A09	52812595	52815504	BnaA09T0461500ZY.1	0	+	0	0	2909	0.0000000
zheyou73v0_A09	52812595	52815504	BnaA09T0461500ZY.2	0	+	0	0	2909	0.0000000
zheyou73v0_A09	52816454	52818210	BnaA09T0461600ZY	0	+	0	0	1756	0.0000000
zheyou73v0_A09	52824606	52826340	BnaA09T0461700ZY	0	+	0	0	1734	0.0000000
zheyou73v0_A09	52826796	52829667	BnaA09T0461800ZY	0	-	0	0	2871	0.0000000
zheyou73v0_A09	52830255	52834253	BnaA09T0461900ZY	0	+	0	0	3998	0.0000000
zheyou73v0_A09	52836152	52838265	BnaA09T0462000ZY	0	+	0	0	2113	0.0000000
zheyou73v0_A09	52847871	52849706	BnaA09T0462100ZY	0	+	0	0	1835	0.0000000
zheyou73v0_A09	52849938	52851552	BnaA09T0462200ZY	0	-	0	0	1614	0.0000000
zheyou73v0_A09	52854738	52877292	BnaA09T0462300ZY	0	+	0	0	22554	0.0000000
zheyou73v0_A09	52886843	52889017	BnaA09T0462400ZY	0	+	0	0	2174	0.0000000
zheyou73v0_A09	52889930	52891360	BnaA09T0462500ZY	0	+	0	0	1430	0.0000000
zheyou73v0_A09	52891932	52893875	BnaA09T0462600ZY	0	+	0	0	1943	0.0000000
zheyou73v0_A09	52894257	52895388	BnaA09T0462700ZY	0	+	0	0	1131	0.0000000
zheyou73v0_A09	52896749	52897297	BnaA09T0462800ZY	0	+	0	0	548	0.0000000
zheyou73v0_A09	52898086	52900238	BnaA09T0462900ZY	0	+	0	0	2152	0.0000000
zheyou73v0_A09	52898086	52900238	BnaA09T0462900ZY.1	0	+	0	0	2152	0.0000000
zheyou73v0_A09	52904221	52905013	BnaA09T0463000ZY	0	+	0	0	792	0.0000000
zheyou73v0_A09	52905776	52907367	BnaA09T0463100ZY	0	+	0	0	1591	0.0000000
zheyou73v0_A09	52905776	52908957	BnaA09T0463100ZY.1	0	+	0	0	3181	0.0000000
zheyou73v0_A09	52905776	52907367	BnaA09T0463100ZY.2	0	+	0	0	1591	0.0000000
zheyou73v0_A09	52905776	52907892	BnaA09T0463100ZY.3	0	+	0	0	2116	0.0000000
zheyou73v0_A09	52907535	52908813	BnaA09T0463200ZY	0	-	0	0	1278	0.0000000
zheyou73v0_A09	52934752	52937088	BnaA09T0463300ZY	0	+	0	0	2336	0.0000000
zheyou73v0_A09	52934752	52937088	BnaA09T0463300ZY.1	0	+	0	0	2336	0.0000000
zheyou73v0_A09	52938861	52939860	BnaA09T0463400ZY	0	+	0	0	999	0.0000000
zheyou73v0_A09	52941685	52946988	BnaA09T0463500ZY	0	-	0	0	5303	0.0000000
zheyou73v0_A09	52952641	52955567	BnaA09T0463600ZY	0	+	0	0	2926	0.0000000
zheyou73v0_A09	52957186	52959863	BnaA09T0463700ZY	0	-	0	0	2677	0.0000000
zheyou73v0_A09	52967018	52968644	BnaA09T0463800ZY	0	-	0	0	1626	0.0000000
zheyou73v0_A09	52972161	52974814	BnaA09T0463900ZY	0	-	0	0	2653	0.0000000
zheyou73v0_A09	53000434	53002746	BnaA09T0464000ZY	0	+	0	0	2312	0.0000000
zheyou73v0_A09	53006173	53009790	BnaA09T0464100ZY	0	+	0	0	3617	0.0000000
zheyou73v0_A09	53010330	53012581	BnaA09T0464200ZY	0	-	0	0	2251	0.0000000
zheyou73v0_A09	53013285	53014669	BnaA09T0464300ZY	0	+	0	0	1384	0.0000000
zheyou73v0_A09	53018016	53018214	BnaA09T0464400ZY	0	-	0	0	198	0.0000000
zheyou73v0_A09	53018857	53025355	BnaA09T0464500ZY	0	-	0	0	6498	0.0000000
zheyou73v0_A09	53018857	53025355	BnaA09T0464500ZY.1	0	-	0	0	6498	0.0000000
zheyou73v0_A09	53018857	53025355	BnaA09T0464500ZY.2	0	-	0	0	6498	0.0000000
zheyou73v0_A09	53018984	53019986	BnaA09T0464600ZY	0	+	0	0	1002	0.0000000
zheyou73v0_A09	53025900	53028762	BnaA09T0464700ZY	0	-	0	0	2862	0.0000000
zheyou73v0_A09	53034169	53038928	BnaA09T0464800ZY	0	-	0	0	4759	0.0000000
zheyou73v0_A09	53047292	53050471	BnaA09T0464900ZY	0	-	0	0	3179	0.0000000
zheyou73v0_A09	53047292	53050471	BnaA09T0464900ZY.1	0	-	0	0	3179	0.0000000
zheyou73v0_A09	53049204	53050471	BnaA09T0464900ZY.2	0	-	0	0	1267	0.0000000
zheyou73v0_A09	53054860	53058956	BnaA09T0465000ZY	0	-	0	0	4096	0.0000000
zheyou73v0_A09	53054860	53057433	BnaA09T0465000ZY.1	0	-	0	0	2573	0.0000000
zheyou73v0_A09	53062448	53063400	BnaA09T0465100ZY	0	+	0	0	952	0.0000000
zheyou73v0_A09	53071048	53072787	BnaA09T0465200ZY	0	-	0	0	1739	0.0000000
zheyou73v0_A09	53071048	53072787	BnaA09T0465200ZY.1	0	-	0	0	1739	0.0000000
zheyou73v0_A09	53079623	53080577	BnaA09T0465300ZY	0	-	0	0	954	0.0000000
zheyou73v0_A09	53081731	53084561	BnaA09T0465400ZY	0	+	0	0	2830	0.0000000
zheyou73v0_A09	53085199	53087011	BnaA09T0465500ZY	0	+	0	0	1812	0.0000000
zheyou73v0_A09	53088242	53091181	BnaA09T0465600ZY	0	+	0	0	2939	0.0000000
zheyou73v0_A09	53091461	53098567	BnaA09T0465700ZY	0	-	0	0	7106	0.0000000
zheyou73v0_A09	53108023	53109819	BnaA09T0465800ZY	0	+	0	0	1796	0.0000000
zheyou73v0_A09	53110318	53111116	BnaA09T0465900ZY	0	+	0	0	798	0.0000000
zheyou73v0_A09	53111324	53113730	BnaA09T0466000ZY	0	-	0	0	2406	0.0000000
zheyou73v0_A09	53115043	53120428	BnaA09T0466100ZY	0	+	0	0	5385	0.0000000
zheyou73v0_A09	53120528	53122231	BnaA09T0466200ZY	0	-	0	0	1703	0.0000000
zheyou73v0_A09	53141459	53142903	BnaA09T0466300ZY	0	+	0	0	1444	0.0000000
zheyou73v0_A09	53141459	53142903	BnaA09T0466300ZY.1	0	+	0	0	1444	0.0000000
zheyou73v0_A09	53143262	53146106	BnaA09T0466400ZY	0	-	0	0	2844	0.0000000
zheyou73v0_A09	53146713	53147626	BnaA09T0466500ZY	0	-	0	0	913	0.0000000
zheyou73v0_A09	53147888	53148621	BnaA09T0466600ZY	0	-	0	0	733	0.0000000
zheyou73v0_A09	53156345	53157936	BnaA09T0466700ZY	0	+	0	0	1591	0.0000000
zheyou73v0_A09	53158274	53158889	BnaA09T0466800ZY	0	-	0	0	615	0.0000000
zheyou73v0_A09	53165554	53166819	BnaA09T0466900ZY	0	+	0	0	1265	0.0000000
zheyou73v0_A09	53167235	53168223	BnaA09T0467000ZY	0	+	0	0	988	0.0000000
zheyou73v0_A09	53177597	53178399	BnaA09T0467100ZY	0	-	0	0	802	0.0000000
zheyou73v0_A09	53186035	53188668	BnaA09T0467200ZY	0	+	0	0	2633	0.0000000
zheyou73v0_A09	53188907	53192670	BnaA09T0467300ZY	0	-	0	0	3763	0.0000000
zheyou73v0_A09	53194471	53196237	BnaA09T0467400ZY	0	+	0	0	1766	0.0000000
zheyou73v0_A09	53196520	53199308	BnaA09T0467500ZY	0	-	0	0	2788	0.0000000
zheyou73v0_A09	53201915	53203163	BnaA09T0467600ZY	0	-	0	0	1248	0.0000000
zheyou73v0_A09	53205445	53206648	BnaA09T0467700ZY	0	+	0	0	1203	0.0000000
zheyou73v0_A09	53208213	53212097	BnaA09T0467800ZY	0	-	0	0	3884	0.0000000
zheyou73v0_A09	53214266	53215133	BnaA09T0467900ZY	0	+	0	0	867	0.0000000
zheyou73v0_A09	53216669	53218072	BnaA09T0468000ZY	0	-	0	0	1403	0.0000000
zheyou73v0_A09	53230461	53232961	BnaA09T0468100ZY	0	-	0	0	2500	0.0000000
zheyou73v0_A09	53240246	53240969	BnaA09T0468200ZY	0	-	0	0	723	0.0000000
zheyou73v0_A09	53241424	53243127	BnaA09T0468300ZY	0	-	0	0	1703	0.0000000
zheyou73v0_A09	53244150	53249738	BnaA09T0468400ZY	0	+	0	0	5588	0.0000000
zheyou73v0_A09	53250161	53252574	BnaA09T0468500ZY	0	-	0	0	2413	0.0000000
zheyou73v0_A09	53255777	53256926	BnaA09T0468600ZY	0	+	0	0	1149	0.0000000
zheyou73v0_A09	53257576	53259026	BnaA09T0468700ZY	0	-	0	0	1450	0.0000000
zheyou73v0_A09	53259716	53262134	BnaA09T0468800ZY	0	-	0	0	2418	0.0000000
zheyou73v0_A09	53262411	53264792	BnaA09T0468900ZY	0	+	0	0	2381	0.0000000
zheyou73v0_A09	53265862	53267952	BnaA09T0469000ZY	0	+	0	0	2090	0.0000000
zheyou73v0_A09	53265923	53267952	BnaA09T0469000ZY.1	0	+	0	0	2029	0.0000000
zheyou73v0_A09	53268519	53270208	BnaA09T0469100ZY	0	+	0	0	1689	0.0000000
zheyou73v0_A09	53273944	53278411	BnaA09T0469200ZY	0	+	0	0	4467	0.0000000
zheyou73v0_A09	53281351	53284686	BnaA09T0469300ZY	0	+	0	0	3335	0.0000000
zheyou73v0_A09	53287399	53287785	BnaA09T0469400ZY	0	-	0	0	386	0.0000000
zheyou73v0_A09	53291985	53293737	BnaA09T0469500ZY	0	-	0	0	1752	0.0000000
zheyou73v0_A09	53299317	53301762	BnaA09T0469600ZY	0	+	0	0	2445	0.0000000
zheyou73v0_A09	53303065	53306072	BnaA09T0469700ZY	0	+	0	0	3007	0.0000000
zheyou73v0_A09	53306647	53306914	BnaA09T0469800ZY	0	+	0	0	267	0.0000000
zheyou73v0_A09	53308420	53312438	BnaA09T0469900ZY	0	-	0	0	4018	0.0000000
zheyou73v0_A09	53313484	53315734	BnaA09T0470000ZY	0	-	0	0	2250	0.0000000
zheyou73v0_A09	53319316	53319642	BnaA09T0470100ZY	0	-	0	0	326	0.0000000
zheyou73v0_A09	53319660	53333327	BnaA09T0470200ZY	0	-	0	0	13667	0.0000000
zheyou73v0_A09	53334307	53335148	BnaA09T0470300ZY	0	-	0	0	841	0.0000000
zheyou73v0_A09	53341566	53343337	BnaA09T0470400ZY	0	+	0	0	1771	0.0000000
zheyou73v0_A09	53346762	53348846	BnaA09T0470500ZY	0	+	0	0	2084	0.0000000
zheyou73v0_A09	53348879	53350559	BnaA09T0470600ZY	0	-	0	0	1680	0.0000000
zheyou73v0_A09	53353995	53354286	BnaA09T0470700ZY	0	+	0	0	291	0.0000000
zheyou73v0_A09	53354350	53355113	BnaA09T0470800ZY	0	+	0	0	763	0.0000000
zheyou73v0_A09	53356100	53358679	BnaA09T0470900ZY	0	-	0	0	2579	0.0000000
zheyou73v0_A09	53359579	53361132	BnaA09T0471000ZY	0	-	0	0	1553	0.0000000
zheyou73v0_A09	53361688	53363290	BnaA09T0471100ZY	0	-	0	0	1602	0.0000000
zheyou73v0_A09	53361688	53363290	BnaA09T0471100ZY.1	0	-	0	0	1602	0.0000000
zheyou73v0_A09	53363479	53365219	BnaA09T0471200ZY	0	+	0	0	1740	0.0000000
zheyou73v0_A09	53365518	53367402	BnaA09T0471300ZY	0	-	0	0	1884	0.0000000
zheyou73v0_A09	53369870	53374117	BnaA09T0471400ZY	0	+	0	0	4247	0.0000000
zheyou73v0_A09	53374256	53375439	BnaA09T0471500ZY	0	+	0	0	1183	0.0000000
zheyou73v0_A09	53375737	53376974	BnaA09T0471600ZY	0	-	0	0	1237	0.0000000
zheyou73v0_A09	53377214	53379994	BnaA09T0471700ZY	0	+	0	0	2780	0.0000000
zheyou73v0_A09	53379535	53382145	BnaA09T0471800ZY	0	-	0	0	2610	0.0000000
zheyou73v0_A09	53379535	53382211	BnaA09T0471800ZY.1	0	-	0	0	2676	0.0000000
zheyou73v0_A09	53382475	53385733	BnaA09T0471900ZY	0	+	0	0	3258	0.0000000
zheyou73v0_A09	53407533	53408538	BnaA09T0472000ZY	0	+	0	0	1005	0.0000000
zheyou73v0_A09	53412679	53413586	BnaA09T0472100ZY	0	-	0	0	907	0.0000000
zheyou73v0_A09	53419417	53422135	BnaA09T0472200ZY	0	+	0	0	2718	0.0000000
zheyou73v0_A09	53422373	53422964	BnaA09T0472300ZY	0	-	0	0	591	0.0000000
zheyou73v0_A09	53423574	53430887	BnaA09T0472400ZY	0	+	0	0	7313	0.0000000
zheyou73v0_A09	53432068	53437436	BnaA09T0472500ZY	0	+	0	0	5368	0.0000000
zheyou73v0_A09	53432068	53437043	BnaA09T0472500ZY.1	0	+	0	0	4975	0.0000000
zheyou73v0_A09	53437985	53438852	BnaA09T0472600ZY	0	-	0	0	867	0.0000000
zheyou73v0_A09	53440000	53441686	BnaA09T0472700ZY	0	-	0	0	1686	0.0000000
zheyou73v0_A09	53442041	53442503	BnaA09T0472800ZY	0	-	0	0	462	0.0000000
zheyou73v0_A09	53442685	53443254	BnaA09T0472900ZY	0	-	0	0	569	0.0000000
zheyou73v0_A09	53445955	53449235	BnaA09T0473000ZY	0	+	0	0	3280	0.0000000
zheyou73v0_A09	53461793	53462724	BnaA09T0473100ZY	0	-	0	0	931	0.0000000
zheyou73v0_A09	53471848	53472827	BnaA09T0473200ZY	0	-	0	0	979	0.0000000
zheyou73v0_A09	53494520	53496049	BnaA09T0473300ZY	0	-	0	0	1529	0.0000000
zheyou73v0_A09	53511971	53516090	BnaA09T0473400ZY	0	-	0	0	4119	0.0000000
zheyou73v0_A09	53517104	53519026	BnaA09T0473500ZY	0	+	0	0	1922	0.0000000
zheyou73v0_A09	53519481	53521964	BnaA09T0473600ZY	0	-	0	0	2483	0.0000000
zheyou73v0_A09	53526767	53529130	BnaA09T0473700ZY	0	-	0	0	2363	0.0000000
zheyou73v0_A09	53536057	53537442	BnaA09T0473800ZY	0	+	0	0	1385	0.0000000
zheyou73v0_A09	53537992	53547817	BnaA09T0473900ZY	0	-	0	0	9825	0.0000000
zheyou73v0_A09	53561155	53566826	BnaA09T0474000ZY	0	-	0	0	5671	0.0000000
zheyou73v0_A09	53569241	53570874	BnaA09T0474100ZY	0	+	0	0	1633	0.0000000
zheyou73v0_A09	53572474	53574370	BnaA09T0474200ZY	0	+	0	0	1896	0.0000000
zheyou73v0_A09	53574434	53577693	BnaA09T0474300ZY	0	+	0	0	3259	0.0000000
zheyou73v0_A09	53577892	53579240	BnaA09T0474400ZY	0	+	0	0	1348	0.0000000
zheyou73v0_A09	53579978	53580826	BnaA09T0474500ZY	0	+	0	0	848	0.0000000
zheyou73v0_A09	53596367	53598108	BnaA09T0474600ZY	0	+	0	0	1741	0.0000000
zheyou73v0_A09	53603872	53605007	BnaA09T0474700ZY	0	-	0	0	1135	0.0000000
zheyou73v0_A09	53608079	53608241	BnaA09T0474800ZY	0	-	0	0	162	0.0000000
zheyou73v0_A09	53619820	53621971	BnaA09T0474900ZY	0	+	0	0	2151	0.0000000
zheyou73v0_A09	53624099	53624674	BnaA09T0475000ZY	0	+	0	0	575	0.0000000
zheyou73v0_A09	53626730	53630316	BnaA09T0475100ZY	0	-	0	0	3586	0.0000000
zheyou73v0_A09	53627193	53630316	BnaA09T0475100ZY.1	0	-	0	0	3123	0.0000000
zheyou73v0_A09	53634821	53637470	BnaA09T0475200ZY	0	-	0	0	2649	0.0000000
zheyou73v0_A09	53637723	53639681	BnaA09T0475300ZY	0	+	0	0	1958	0.0000000
zheyou73v0_A09	53646336	53647843	BnaA09T0475400ZY	0	-	0	0	1507	0.0000000
zheyou73v0_A09	53650633	53653601	BnaA09T0475500ZY	0	+	0	0	2968	0.0000000
zheyou73v0_A09	53650633	53653601	BnaA09T0475500ZY.1	0	+	0	0	2968	0.0000000
zheyou73v0_A09	53650633	53653601	BnaA09T0475500ZY.2	0	+	0	0	2968	0.0000000
zheyou73v0_A09	53653860	53656606	BnaA09T0475600ZY	0	+	0	0	2746	0.0000000
zheyou73v0_A09	53669907	53671604	BnaA09T0475700ZY	0	+	0	0	1697	0.0000000
zheyou73v0_A09	53669907	53671604	BnaA09T0475700ZY.1	0	+	0	0	1697	0.0000000
zheyou73v0_A09	53671668	53674053	BnaA09T0475800ZY	0	-	0	0	2385	0.0000000
zheyou73v0_A09	53678279	53685616	BnaA09T0475900ZY	0	+	0	0	7337	0.0000000
zheyou73v0_A09	53686423	53691524	BnaA09T0476000ZY	0	-	0	0	5101	0.0000000
zheyou73v0_A09	53701029	53707163	BnaA09T0476100ZY	0	-	0	0	6134	0.0000000
zheyou73v0_A09	53701157	53702240	BnaA09T0476200ZY	0	+	0	0	1083	0.0000000
zheyou73v0_A09	53707463	53708758	BnaA09T0476300ZY	0	+	0	0	1295	0.0000000
zheyou73v0_A09	53711973	53714111	BnaA09T0476400ZY	0	+	0	0	2138	0.0000000
zheyou73v0_A09	53715914	53718406	BnaA09T0476500ZY	0	+	0	0	2492	0.0000000
zheyou73v0_A09	53715914	53718406	BnaA09T0476500ZY.1	0	+	0	0	2492	0.0000000
zheyou73v0_A09	53721050	53722565	BnaA09T0476600ZY	0	+	0	0	1515	0.0000000
zheyou73v0_A09	53729204	53735927	BnaA09T0476700ZY	0	-	0	0	6723	0.0000000
zheyou73v0_A09	53729204	53735927	BnaA09T0476700ZY.1	0	-	0	0	6723	0.0000000
zheyou73v0_A09	53729204	53735683	BnaA09T0476700ZY.2	0	-	0	0	6479	0.0000000
zheyou73v0_A09	53745945	53746688	BnaA09T0476800ZY	0	+	0	0	743	0.0000000
zheyou73v0_A09	53757943	53758560	BnaA09T0476900ZY	0	-	0	0	617	0.0000000
zheyou73v0_A09	53760564	53761114	BnaA09T0477000ZY	0	+	0	0	550	0.0000000
zheyou73v0_A09	53761426	53767950	BnaA09T0477100ZY	0	-	0	0	6524	0.0000000
zheyou73v0_A09	53761426	53767903	BnaA09T0477100ZY.1	0	-	0	0	6477	0.0000000
zheyou73v0_A09	53768793	53769719	BnaA09T0477200ZY	0	-	0	0	926	0.0000000
zheyou73v0_A09	53770726	53771283	BnaA09T0477300ZY	0	+	0	0	557	0.0000000
zheyou73v0_A09	53772133	53774724	BnaA09T0477400ZY	0	-	0	0	2591	0.0000000
zheyou73v0_A09	53777691	53782487	BnaA09T0477500ZY	0	-	0	0	4796	0.0000000
zheyou73v0_A09	53795456	53797525	BnaA09T0477600ZY	0	-	0	0	2069	0.0000000
zheyou73v0_A09	53810338	53812752	BnaA09T0477700ZY	0	-	0	0	2414	0.0000000
zheyou73v0_A09	53813631	53814316	BnaA09T0477800ZY	0	-	0	0	685	0.0000000
zheyou73v0_A09	53815095	53817347	BnaA09T0477900ZY	0	+	0	0	2252	0.0000000
zheyou73v0_A09	53826644	53827947	BnaA09T0478000ZY	0	-	0	0	1303	0.0000000
zheyou73v0_A09	53828991	53830866	BnaA09T0478100ZY	0	-	0	0	1875	0.0000000
zheyou73v0_A09	53834274	53835615	BnaA09T0478200ZY	0	-	0	0	1341	0.0000000
zheyou73v0_A09	53835974	53843126	BnaA09T0478300ZY	0	+	0	0	7152	0.0000000
zheyou73v0_A09	53845225	53846038	BnaA09T0478400ZY	0	+	0	0	813	0.0000000
zheyou73v0_A09	53846751	53848839	BnaA09T0478500ZY	0	-	0	0	2088	0.0000000
zheyou73v0_A09	53849652	53853786	BnaA09T0478600ZY	0	-	0	0	4134	0.0000000
zheyou73v0_A09	53861496	53864514	BnaA09T0478700ZY	0	+	0	0	3018	0.0000000
zheyou73v0_A09	53865610	53872877	BnaA09T0478800ZY	0	+	0	0	7267	0.0000000
zheyou73v0_A09	53886225	53888615	BnaA09T0478900ZY	0	+	0	0	2390	0.0000000
zheyou73v0_A09	53896755	53899137	BnaA09T0479000ZY	0	+	0	0	2382	0.0000000
zheyou73v0_A09	53899578	53899984	BnaA09T0479100ZY	0	+	0	0	406	0.0000000
zheyou73v0_A09	53906325	53907500	BnaA09T0479200ZY	0	+	0	0	1175	0.0000000
zheyou73v0_A09	53928697	53929247	BnaA09T0479300ZY	0	+	0	0	550	0.0000000
zheyou73v0_A09	53936917	53940508	BnaA09T0479400ZY	0	-	0	0	3591	0.0000000
zheyou73v0_A09	53937521	53940508	BnaA09T0479400ZY.1	0	-	0	0	2987	0.0000000
zheyou73v0_A09	53948695	53950711	BnaA09T0479500ZY	0	+	0	0	2016	0.0000000
zheyou73v0_A09	53959529	53962147	BnaA09T0479600ZY	0	+	0	0	2618	0.0000000
zheyou73v0_A09	53963320	53964943	BnaA09T0479700ZY	0	+	0	0	1623	0.0000000
zheyou73v0_A09	53965346	53966861	BnaA09T0479800ZY	0	-	0	0	1515	0.0000000
zheyou73v0_A09	53968640	53969030	BnaA09T0479900ZY	0	+	0	0	390	0.0000000
zheyou73v0_A09	53974514	53978492	BnaA09T0480000ZY	0	+	0	0	3978	0.0000000
zheyou73v0_A09	53982605	53982851	BnaA09T0480100ZY	0	+	0	0	246	0.0000000
zheyou73v0_A09	53984183	53990332	BnaA09T0480200ZY	0	+	0	0	6149	0.0000000
zheyou73v0_A09	53993400	53994197	BnaA09T0480300ZY	0	+	0	0	797	0.0000000
zheyou73v0_A09	54001400	54002983	BnaA09T0480400ZY	0	+	0	0	1583	0.0000000
zheyou73v0_A09	54003149	54005658	BnaA09T0480500ZY	0	-	0	0	2509	0.0000000
zheyou73v0_A09	54007082	54008099	BnaA09T0480600ZY	0	-	0	0	1017	0.0000000
zheyou73v0_A09	54016016	54016562	BnaA09T0480700ZY	0	+	0	0	546	0.0000000
zheyou73v0_A09	54017569	54018867	BnaA09T0480800ZY	0	+	0	0	1298	0.0000000
zheyou73v0_A09	54019679	54021870	BnaA09T0480900ZY	0	+	0	0	2191	0.0000000
zheyou73v0_A09	54019679	54021870	BnaA09T0480900ZY.1	0	+	0	0	2191	0.0000000
zheyou73v0_A09	54024052	54027020	BnaA09T0481000ZY	0	+	0	0	2968	0.0000000
zheyou73v0_A09	54027690	54029697	BnaA09T0481100ZY	0	-	0	0	2007	0.0000000
zheyou73v0_A09	54027690	54029697	BnaA09T0481100ZY.1	0	-	0	0	2007	0.0000000
zheyou73v0_A09	54030735	54032605	BnaA09T0481200ZY	0	-	0	0	1870	0.0000000
zheyou73v0_A09	54038124	54038922	BnaA09T0481300ZY	0	-	0	0	798	0.0000000
zheyou73v0_A09	54048512	54048924	BnaA09T0481400ZY	0	-	0	0	412	0.0000000
zheyou73v0_A09	54053017	54055060	BnaA09T0481500ZY	0	-	0	0	2043	0.0000000
zheyou73v0_A09	54060448	54062026	BnaA09T0481600ZY	0	+	0	0	1578	0.0000000
zheyou73v0_A09	54062036	54064563	BnaA09T0481700ZY	0	-	0	0	2527	0.0000000
zheyou73v0_A09	54065496	54065979	BnaA09T0481800ZY	0	-	0	0	483	0.0000000
zheyou73v0_A09	54067143	54069088	BnaA09T0481900ZY	0	+	0	0	1945	0.0000000
zheyou73v0_A09	54073093	54073893	BnaA09T0482000ZY	0	-	0	0	800	0.0000000
zheyou73v0_A09	54088465	54089868	BnaA09T0482100ZY	0	+	0	0	1403	0.0000000
zheyou73v0_A09	54096576	54099754	BnaA09T0482200ZY	0	-	0	0	3178	0.0000000
zheyou73v0_A09	54100891	54102098	BnaA09T0482300ZY	0	+	0	0	1207	0.0000000
zheyou73v0_A09	54102646	54103572	BnaA09T0482400ZY	0	-	0	0	926	0.0000000
zheyou73v0_A09	54104128	54106758	BnaA09T0482500ZY	0	-	0	0	2630	0.0000000
zheyou73v0_A09	54107955	54109340	BnaA09T0482600ZY	0	-	0	0	1385	0.0000000
zheyou73v0_A09	54113234	54114095	BnaA09T0482700ZY	0	+	0	0	861	0.0000000
zheyou73v0_A09	54116060	54118925	BnaA09T0482800ZY	0	-	0	0	2865	0.0000000
zheyou73v0_A09	54119243	54120548	BnaA09T0482900ZY	0	-	0	0	1305	0.0000000
zheyou73v0_A09	54119243	54120548	BnaA09T0482900ZY.1	0	-	0	0	1305	0.0000000
zheyou73v0_A09	54119243	54120548	BnaA09T0482900ZY.2	0	-	0	0	1305	0.0000000
zheyou73v0_A09	54121941	54126676	BnaA09T0483000ZY	0	+	0	0	4735	0.0000000
zheyou73v0_A09	54127236	54128712	BnaA09T0483100ZY	0	-	0	0	1476	0.0000000
zheyou73v0_A09	54133439	54136081	BnaA09T0483200ZY	0	-	0	0	2642	0.0000000
zheyou73v0_A09	54136169	54139359	BnaA09T0483300ZY	0	+	0	0	3190	0.0000000
zheyou73v0_A09	54139979	54141654	BnaA09T0483400ZY	0	-	0	0	1675	0.0000000
zheyou73v0_A09	54142125	54144894	BnaA09T0483500ZY	0	+	0	0	2769	0.0000000
zheyou73v0_A09	54147067	54149870	BnaA09T0483600ZY	0	+	0	0	2803	0.0000000
zheyou73v0_A09	54149906	54153155	BnaA09T0483700ZY	0	-	0	0	3249	0.0000000
zheyou73v0_A09	54153856	54155903	BnaA09T0483800ZY	0	-	0	0	2047	0.0000000
zheyou73v0_A09	54157798	54160829	BnaA09T0483900ZY	0	+	0	0	3031	0.0000000
zheyou73v0_A09	54171514	54172699	BnaA09T0484000ZY	0	-	0	0	1185	0.0000000
zheyou73v0_A09	54173341	54175249	BnaA09T0484100ZY	0	-	0	0	1908	0.0000000
zheyou73v0_A09	54173341	54175249	BnaA09T0484100ZY.1	0	-	0	0	1908	0.0000000
zheyou73v0_A09	54176166	54182312	BnaA09T0484200ZY	0	-	0	0	6146	0.0000000
zheyou73v0_A09	54176166	54182312	BnaA09T0484200ZY.1	0	-	0	0	6146	0.0000000
zheyou73v0_A09	54183240	54184605	BnaA09T0484300ZY	0	+	0	0	1365	0.0000000
zheyou73v0_A09	54184744	54186945	BnaA09T0484400ZY	0	-	0	0	2201	0.0000000
zheyou73v0_A09	54184744	54187210	BnaA09T0484400ZY.1	0	-	0	0	2466	0.0000000
zheyou73v0_A09	54184744	54186588	BnaA09T0484400ZY.2	0	-	0	0	1844	0.0000000
zheyou73v0_A09	54187995	54188976	BnaA09T0484500ZY	0	+	0	0	981	0.0000000
zheyou73v0_A09	54189274	54191142	BnaA09T0484600ZY	0	+	0	0	1868	0.0000000
zheyou73v0_A09	54195843	54196813	BnaA09T0484700ZY	0	+	0	0	970	0.0000000
zheyou73v0_A09	54200384	54201796	BnaA09T0484800ZY	0	+	0	0	1412	0.0000000
zheyou73v0_A09	54202080	54203117	BnaA09T0484900ZY	0	-	0	0	1037	0.0000000
zheyou73v0_A09	54202080	54203139	BnaA09T0484900ZY.1	0	-	0	0	1059	0.0000000
zheyou73v0_A09	54208412	54209790	BnaA09T0485000ZY	0	-	0	0	1378	0.0000000
zheyou73v0_A09	54211713	54214921	BnaA09T0485100ZY	0	-	0	0	3208	0.0000000
zheyou73v0_A09	54217670	54220866	BnaA09T0485200ZY	0	-	0	0	3196	0.0000000
zheyou73v0_A09	54217670	54220866	BnaA09T0485200ZY.1	0	-	0	0	3196	0.0000000
zheyou73v0_A09	54222236	54228211	BnaA09T0485300ZY	0	+	0	0	5975	0.0000000
zheyou73v0_A09	54233144	54236452	BnaA09T0485400ZY	0	+	0	0	3308	0.0000000
zheyou73v0_A09	54235971	54240821	BnaA09T0485500ZY	0	-	0	0	4850	0.0000000
zheyou73v0_A09	54247833	54249256	BnaA09T0485600ZY	0	+	0	0	1423	0.0000000
zheyou73v0_A09	54253487	54254058	BnaA09T0485700ZY	0	-	0	0	571	0.0000000
zheyou73v0_A09	54264170	54266232	BnaA09T0485800ZY	0	-	0	0	2062	0.0000000
zheyou73v0_A09	54270288	54270930	BnaA09T0485900ZY	0	+	0	0	642	0.0000000
zheyou73v0_A09	54272293	54274528	BnaA09T0486000ZY	0	-	0	0	2235	0.0000000
zheyou73v0_A09	54286512	54289745	BnaA09T0486100ZY	0	-	0	0	3233	0.0000000
zheyou73v0_A09	54292768	54294784	BnaA09T0486200ZY	0	-	0	0	2016	0.0000000
zheyou73v0_A09	54303377	54304433	BnaA09T0486300ZY	0	-	0	0	1056	0.0000000
zheyou73v0_A09	54304564	54305161	BnaA09T0486400ZY	0	-	0	0	597	0.0000000
zheyou73v0_A09	54307281	54310739	BnaA09T0486500ZY	0	+	0	0	3458	0.0000000
zheyou73v0_A09	54313282	54316090	BnaA09T0486600ZY	0	+	0	0	2808	0.0000000
zheyou73v0_A09	54316226	54322608	BnaA09T0486700ZY	0	-	0	0	6382	0.0000000
zheyou73v0_A09	54325410	54334293	BnaA09T0486800ZY	0	+	0	0	8883	0.0000000
zheyou73v0_A09	54337941	54338274	BnaA09T0486900ZY	0	+	0	0	333	0.0000000
zheyou73v0_A09	54338329	54341497	BnaA09T0487000ZY	0	+	0	0	3168	0.0000000
zheyou73v0_A09	54347364	54348701	BnaA09T0487100ZY	0	+	0	0	1337	0.0000000
zheyou73v0_A09	54348963	54351622	BnaA09T0487200ZY	0	-	0	0	2659	0.0000000
zheyou73v0_A09	54355952	54358984	BnaA09T0487300ZY	0	+	0	0	3032	0.0000000
zheyou73v0_A09	54358980	54360565	BnaA09T0487400ZY	0	-	0	0	1585	0.0000000
zheyou73v0_A09	54361638	54365158	BnaA09T0487500ZY	0	+	0	0	3520	0.0000000
zheyou73v0_A09	54361638	54365158	BnaA09T0487500ZY.1	0	+	0	0	3520	0.0000000
zheyou73v0_A09	54372357	54375985	BnaA09T0487600ZY	0	+	0	0	3628	0.0000000
zheyou73v0_A09	54376116	54379927	BnaA09T0487700ZY	0	-	0	0	3811	0.0000000
zheyou73v0_A09	54382881	54384011	BnaA09T0487800ZY	0	-	0	0	1130	0.0000000
zheyou73v0_A09	54385960	54393515	BnaA09T0487900ZY	0	+	0	0	7555	0.0000000
zheyou73v0_A09	54394756	54398194	BnaA09T0488000ZY	0	-	0	0	3438	0.0000000
zheyou73v0_A09	54399000	54401778	BnaA09T0488100ZY	0	-	0	0	2778	0.0000000
zheyou73v0_A09	54404597	54405159	BnaA09T0488200ZY	0	+	0	0	562	0.0000000
zheyou73v0_A09	54412380	54414541	BnaA09T0488300ZY	0	-	0	0	2161	0.0000000
zheyou73v0_A09	54412380	54414541	BnaA09T0488300ZY.1	0	-	0	0	2161	0.0000000
zheyou73v0_A09	54416035	54417423	BnaA09T0488400ZY	0	+	0	0	1388	0.0000000
zheyou73v0_A09	54427591	54427982	BnaA09T0488500ZY	0	+	0	0	391	0.0000000
zheyou73v0_A09	54428006	54429569	BnaA09T0488600ZY	0	-	0	0	1563	0.0000000
zheyou73v0_A09	54432232	54438576	BnaA09T0488700ZY	0	+	0	0	6344	0.0000000
zheyou73v0_A09	54442423	54443714	BnaA09T0488800ZY	0	+	0	0	1291	0.0000000
zheyou73v0_A09	54444091	54445599	BnaA09T0488900ZY	0	+	0	0	1508	0.0000000
zheyou73v0_A09	54445537	54450826	BnaA09T0489000ZY	0	-	0	0	5289	0.0000000
zheyou73v0_A09	54445537	54450826	BnaA09T0489000ZY.1	0	-	0	0	5289	0.0000000
zheyou73v0_A09	54451159	54454434	BnaA09T0489100ZY	0	+	0	0	3275	0.0000000
zheyou73v0_A09	54454758	54458605	BnaA09T0489200ZY	0	-	0	0	3847	0.0000000
zheyou73v0_A09	54454758	54457562	BnaA09T0489200ZY.1	0	-	0	0	2804	0.0000000
zheyou73v0_A09	54467474	54469184	BnaA09T0489300ZY	0	+	0	0	1710	0.0000000
zheyou73v0_A09	54472296	54472756	BnaA09T0489400ZY	0	-	0	0	460	0.0000000
zheyou73v0_A09	54473136	54473526	BnaA09T0489500ZY	0	-	0	0	390	0.0000000
zheyou73v0_A09	54481336	54482880	BnaA09T0489600ZY	0	+	0	0	1544	0.0000000
zheyou73v0_A09	54486785	54490499	BnaA09T0489700ZY	0	-	0	0	3714	0.0000000
zheyou73v0_A09	54490609	54491447	BnaA09T0489800ZY	0	-	0	0	838	0.0000000
zheyou73v0_A09	54492741	54494407	BnaA09T0489900ZY	0	+	0	0	1666	0.0000000
zheyou73v0_A09	54495264	54496077	BnaA09T0490000ZY	0	+	0	0	813	0.0000000
zheyou73v0_A09	54519786	54523622	BnaA09T0490100ZY	0	-	0	0	3836	0.0000000
zheyou73v0_A09	54525827	54528686	BnaA09T0490200ZY	0	+	0	0	2859	0.0000000
zheyou73v0_A09	54531073	54532968	BnaA09T0490300ZY	0	+	0	0	1895	0.0000000
zheyou73v0_A09	54535860	54538902	BnaA09T0490400ZY	0	+	0	0	3042	0.0000000
zheyou73v0_A09	54536267	54538902	BnaA09T0490400ZY.1	0	+	0	0	2635	0.0000000
zheyou73v0_A09	54540488	54541900	BnaA09T0490500ZY	0	-	0	0	1412	0.0000000
zheyou73v0_A09	54547796	54548006	BnaA09T0490600ZY	0	+	0	0	210	0.0000000
zheyou73v0_A09	54548112	54554792	BnaA09T0490700ZY	0	-	0	0	6680	0.0000000
zheyou73v0_A09	54558680	54561315	BnaA09T0490800ZY	0	+	0	0	2635	0.0000000
zheyou73v0_A09	54563021	54565159	BnaA09T0490900ZY	0	+	0	0	2138	0.0000000
zheyou73v0_A09	54565346	54566427	BnaA09T0491000ZY	0	-	0	0	1081	0.0000000
zheyou73v0_A09	54568080	54571779	BnaA09T0491100ZY	0	-	0	0	3699	0.0000000
zheyou73v0_A09	54568080	54571779	BnaA09T0491100ZY.1	0	-	0	0	3699	0.0000000
zheyou73v0_A09	54572508	54574888	BnaA09T0491200ZY	0	-	0	0	2380	0.0000000
zheyou73v0_A09	54577168	54578833	BnaA09T0491300ZY	0	-	0	0	1665	0.0000000
zheyou73v0_A09	54581694	54584154	BnaA09T0491400ZY	0	-	0	0	2460	0.0000000
zheyou73v0_A09	54589353	54590100	BnaA09T0491500ZY	0	+	0	0	747	0.0000000
zheyou73v0_A09	54609931	54612179	BnaA09T0491600ZY	0	+	0	0	2248	0.0000000
zheyou73v0_A09	54618460	54618781	BnaA09T0491700ZY	0	+	0	0	321	0.0000000
zheyou73v0_A09	54620944	54624345	BnaA09T0491800ZY	0	-	0	0	3401	0.0000000
zheyou73v0_A09	54620944	54624345	BnaA09T0491800ZY.1	0	-	0	0	3401	0.0000000
zheyou73v0_A09	54626037	54628652	BnaA09T0491900ZY	0	+	0	0	2615	0.0000000
zheyou73v0_A09	54631899	54635969	BnaA09T0492000ZY	0	-	0	0	4070	0.0000000
zheyou73v0_A09	54632164	54633427	BnaA09T0492100ZY	0	+	0	0	1263	0.0000000
zheyou73v0_A09	54650274	54652314	BnaA09T0492200ZY	0	+	0	0	2040	0.0000000
zheyou73v0_A09	54653284	54656311	BnaA09T0492300ZY	0	+	0	0	3027	0.0000000
zheyou73v0_A09	54656475	54657459	BnaA09T0492400ZY	0	-	0	0	984	0.0000000
zheyou73v0_A09	54657607	54660623	BnaA09T0492500ZY	0	-	0	0	3016	0.0000000
zheyou73v0_A09	54685257	54686907	BnaA09T0492600ZY	0	+	0	0	1650	0.0000000
zheyou73v0_A09	54693043	54694199	BnaA09T0492700ZY	0	+	0	0	1156	0.0000000
zheyou73v0_A09	54696047	54696512	BnaA09T0492800ZY	0	+	0	0	465	0.0000000
zheyou73v0_A09	54698855	54702009	BnaA09T0492900ZY	0	+	0	0	3154	0.0000000
zheyou73v0_A09	54708049	54711145	BnaA09T0493000ZY	0	+	0	0	3096	0.0000000
zheyou73v0_A09	54708049	54711145	BnaA09T0493000ZY.1	0	+	0	0	3096	0.0000000
zheyou73v0_A09	54714883	54717414	BnaA09T0493100ZY	0	+	0	0	2531	0.0000000
zheyou73v0_A09	54720042	54723857	BnaA09T0493200ZY	0	+	0	0	3815	0.0000000
zheyou73v0_A09	54729154	54733910	BnaA09T0493300ZY	0	+	0	0	4756	0.0000000
zheyou73v0_A09	54729154	54733910	BnaA09T0493300ZY.1	0	+	0	0	4756	0.0000000
zheyou73v0_A09	54729154	54733910	BnaA09T0493300ZY.2	0	+	0	0	4756	0.0000000
zheyou73v0_A09	54734553	54735354	BnaA09T0493400ZY	0	-	0	0	801	0.0000000
zheyou73v0_A09	54736158	54737867	BnaA09T0493500ZY	0	-	0	0	1709	0.0000000
zheyou73v0_A09	54736158	54737867	BnaA09T0493500ZY.1	0	-	0	0	1709	0.0000000
zheyou73v0_A09	54738271	54741949	BnaA09T0493600ZY	0	-	0	0	3678	0.0000000
zheyou73v0_A09	54738271	54741781	BnaA09T0493600ZY.1	0	-	0	0	3510	0.0000000
zheyou73v0_A09	54743749	54744568	BnaA09T0493700ZY	0	+	0	0	819	0.0000000
zheyou73v0_A09	54746268	54747207	BnaA09T0493800ZY	0	-	0	0	939	0.0000000
zheyou73v0_A09	54749329	54749924	BnaA09T0493900ZY	0	-	0	0	595	0.0000000
zheyou73v0_A09	54757725	54758611	BnaA09T0494000ZY	0	+	0	0	886	0.0000000
zheyou73v0_A09	54759460	54760564	BnaA09T0494100ZY	0	-	0	0	1104	0.0000000
zheyou73v0_A09	54761265	54762430	BnaA09T0494200ZY	0	+	0	0	1165	0.0000000
zheyou73v0_A09	54762776	54764410	BnaA09T0494300ZY	0	-	0	0	1634	0.0000000
zheyou73v0_A09	54762776	54764410	BnaA09T0494300ZY.1	0	-	0	0	1634	0.0000000
zheyou73v0_A09	54766332	54768167	BnaA09T0494400ZY	0	+	0	0	1835	0.0000000
zheyou73v0_A09	54768671	54769524	BnaA09T0494500ZY	0	-	0	0	853	0.0000000
zheyou73v0_A09	54772410	54775236	BnaA09T0494600ZY	0	-	0	0	2826	0.0000000
zheyou73v0_A09	54776531	54778366	BnaA09T0494700ZY	0	-	0	0	1835	0.0000000
zheyou73v0_A09	54780993	54785599	BnaA09T0494800ZY	0	+	0	0	4606	0.0000000
zheyou73v0_A09	54786349	54787185	BnaA09T0494900ZY.1	0	+	0	0	836	0.0000000
zheyou73v0_A09	54786355	54787185	BnaA09T0494900ZY	0	+	0	0	830	0.0000000
zheyou73v0_A09	54787708	54788657	BnaA09T0495000ZY	0	+	0	0	949	0.0000000
zheyou73v0_A09	54787708	54788657	BnaA09T0495000ZY.1	0	+	0	0	949	0.0000000
zheyou73v0_A09	54789779	54790082	BnaA09T0495100ZY	0	+	0	0	303	0.0000000
zheyou73v0_A09	54792021	54793222	BnaA09T0495200ZY	0	+	0	0	1201	0.0000000
zheyou73v0_A09	54794764	54798365	BnaA09T0495300ZY	0	-	0	0	3601	0.0000000
zheyou73v0_A09	54801123	54802888	BnaA09T0495400ZY	0	-	0	0	1765	0.0000000
zheyou73v0_A09	54809102	54810792	BnaA09T0495500ZY	0	-	0	0	1690	0.0000000
zheyou73v0_A09	54823254	54826802	BnaA09T0495600ZY	0	+	0	0	3548	0.0000000
zheyou73v0_A09	54828156	54830240	BnaA09T0495700ZY	0	+	0	0	2084	0.0000000
zheyou73v0_A09	54830586	54831497	BnaA09T0495800ZY	0	-	0	0	911	0.0000000
zheyou73v0_A09	54835562	54840538	BnaA09T0495900ZY	0	+	0	0	4976	0.0000000
zheyou73v0_A09	54841114	54841861	BnaA09T0496000ZY	0	-	0	0	747	0.0000000
zheyou73v0_A09	54845068	54845940	BnaA09T0496100ZY	0	+	0	0	872	0.0000000
zheyou73v0_A09	54849404	54851679	BnaA09T0496200ZY	0	+	0	0	2275	0.0000000
zheyou73v0_A09	54849404	54851679	BnaA09T0496200ZY.1	0	+	0	0	2275	0.0000000
zheyou73v0_A09	54853794	54854839	BnaA09T0496300ZY	0	-	0	0	1045	0.0000000
zheyou73v0_A09	54870253	54871096	BnaA09T0496400ZY	0	+	0	0	843	0.0000000
zheyou73v0_A09	54882386	54883511	BnaA09T0496500ZY	0	+	0	0	1125	0.0000000
zheyou73v0_A09	54891143	54892222	BnaA09T0496600ZY	0	+	0	0	1079	0.0000000
zheyou73v0_A09	54896959	54898360	BnaA09T0496700ZY.1	0	+	0	0	1401	0.0000000
zheyou73v0_A09	54897066	54898360	BnaA09T0496700ZY	0	+	0	0	1294	0.0000000
zheyou73v0_A09	54899085	54901450	BnaA09T0496800ZY	0	+	0	0	2365	0.0000000
zheyou73v0_A09	54901916	54903462	BnaA09T0496900ZY	0	+	0	0	1546	0.0000000
zheyou73v0_A09	54905940	54907292	BnaA09T0497000ZY	0	+	0	0	1352	0.0000000
zheyou73v0_A09	54908645	54910577	BnaA09T0497100ZY	0	+	0	0	1932	0.0000000
zheyou73v0_A09	54911928	54913162	BnaA09T0497200ZY	0	-	0	0	1234	0.0000000
zheyou73v0_A09	54916615	54918421	BnaA09T0497300ZY	0	+	0	0	1806	0.0000000
zheyou73v0_A09	54925740	54926662	BnaA09T0497400ZY	0	+	0	0	922	0.0000000
zheyou73v0_A09	54930687	54934388	BnaA09T0497500ZY	0	+	0	0	3701	0.0000000
zheyou73v0_A09	54935940	54938257	BnaA09T0497600ZY	0	+	0	0	2317	0.0000000
zheyou73v0_A09	54938424	54938658	BnaA09T0497700ZY	0	-	0	0	234	0.0000000
zheyou73v0_A09	54940403	54943305	BnaA09T0497800ZY	0	+	0	0	2902	0.0000000
zheyou73v0_A09	54943741	54944912	BnaA09T0497900ZY	0	-	0	0	1171	0.0000000
zheyou73v0_A09	54943741	54944912	BnaA09T0497900ZY.1	0	-	0	0	1171	0.0000000
zheyou73v0_A09	54950786	54951876	BnaA09T0498000ZY	0	+	0	0	1090	0.0000000
zheyou73v0_A09	54951900	54954529	BnaA09T0498100ZY	0	+	0	0	2629	0.0000000
zheyou73v0_A09	54955044	54955497	BnaA09T0498200ZY	0	+	0	0	453	0.0000000
zheyou73v0_A09	54955771	54960136	BnaA09T0498300ZY	0	+	0	0	4365	0.0000000
zheyou73v0_A09	54962005	54964107	BnaA09T0498400ZY	0	+	0	0	2102	0.0000000
zheyou73v0_A09	54969776	54970866	BnaA09T0498500ZY	0	+	0	0	1090	0.0000000
zheyou73v0_A09	54970890	54973515	BnaA09T0498600ZY	0	+	0	0	2625	0.0000000
zheyou73v0_A09	54978747	54980946	BnaA09T0498700ZY	0	-	0	0	2199	0.0000000
zheyou73v0_A09	54978747	54980946	BnaA09T0498700ZY.1	0	-	0	0	2199	0.0000000
zheyou73v0_A09	54981723	54982855	BnaA09T0498800ZY	0	+	0	0	1132	0.0000000
zheyou73v0_A09	54983048	54984240	BnaA09T0498900ZY	0	-	0	0	1192	0.0000000
zheyou73v0_A09	54984498	54986159	BnaA09T0499000ZY	0	+	0	0	1661	0.0000000
zheyou73v0_A09	54986905	54989092	BnaA09T0499100ZY	0	+	0	0	2187	0.0000000
zheyou73v0_A09	54990125	54991351	BnaA09T0499200ZY	0	+	0	0	1226	0.0000000
zheyou73v0_A09	54993267	54994843	BnaA09T0499300ZY	0	-	0	0	1576	0.0000000
zheyou73v0_A09	54996397	55008857	BnaA09T0499400ZY	0	-	0	0	12460	0.0000000
zheyou73v0_A09	55009564	55011737	BnaA09T0499500ZY	0	-	0	0	2173	0.0000000
zheyou73v0_A09	55013845	55014607	BnaA09T0499600ZY	0	-	0	0	762	0.0000000
zheyou73v0_A09	55015076	55018390	BnaA09T0499700ZY	0	+	0	0	3314	0.0000000
zheyou73v0_A09	55019513	55021383	BnaA09T0499800ZY	0	-	0	0	1870	0.0000000
zheyou73v0_A09	55022048	55023547	BnaA09T0499900ZY	0	+	0	0	1499	0.0000000
zheyou73v0_A09	55025214	55027794	BnaA09T0500000ZY	0	+	0	0	2580	0.0000000
zheyou73v0_A09	55028966	55031442	BnaA09T0500100ZY	0	+	0	0	2476	0.0000000
zheyou73v0_A09	55031472	55034000	BnaA09T0500200ZY	0	-	0	0	2528	0.0000000
zheyou73v0_A09	55038303	55038725	BnaA09T0500300ZY	0	-	0	0	422	0.0000000
zheyou73v0_A09	55042199	55042619	BnaA09T0500400ZY	0	-	0	0	420	0.0000000
zheyou73v0_A09	55045307	55047308	BnaA09T0500500ZY	0	+	0	0	2001	0.0000000
zheyou73v0_A09	55045307	55047308	BnaA09T0500500ZY.1	0	+	0	0	2001	0.0000000
zheyou73v0_A09	55045307	55047308	BnaA09T0500500ZY.2	0	+	0	0	2001	0.0000000
zheyou73v0_A09	55060230	55060794	BnaA09T0500600ZY	0	-	0	0	564	0.0000000
zheyou73v0_A09	55071296	55072479	BnaA09T0500700ZY	0	-	0	0	1183	0.0000000
zheyou73v0_A09	55076279	55078498	BnaA09T0500800ZY	0	+	0	0	2219	0.0000000
zheyou73v0_A09	55078231	55079123	BnaA09T0500900ZY	0	-	0	0	892	0.0000000
zheyou73v0_A09	55079851	55082855	BnaA09T0501000ZY	0	+	0	0	3004	0.0000000
zheyou73v0_A09	55079851	55082855	BnaA09T0501000ZY.1	0	+	0	0	3004	0.0000000
zheyou73v0_A09	55084341	55085625	BnaA09T0501100ZY	0	+	0	0	1284	0.0000000
zheyou73v0_A09	55085742	55087020	BnaA09T0501200ZY	0	-	0	0	1278	0.0000000
zheyou73v0_A09	55088710	55090642	BnaA09T0501300ZY	0	+	0	0	1932	0.0000000
zheyou73v0_A09	55094767	55096476	BnaA09T0501400ZY	0	+	0	0	1709	0.0000000
zheyou73v0_A09	55099136	55101869	BnaA09T0501500ZY	0	+	0	0	2733	0.0000000
zheyou73v0_A09	55103545	55106790	BnaA09T0501600ZY	0	+	0	0	3245	0.0000000
zheyou73v0_A09	55107891	55108814	BnaA09T0501700ZY	0	+	0	0	923	0.0000000
zheyou73v0_A09	55110868	55112979	BnaA09T0501800ZY	0	-	0	0	2111	0.0000000
zheyou73v0_A09	55115596	55118879	BnaA09T0501900ZY	0	+	0	0	3283	0.0000000
zheyou73v0_A09	55117472	55118930	BnaA09T0502000ZY	0	-	0	0	1458	0.0000000
zheyou73v0_A09	55119569	55120171	BnaA09T0502100ZY	0	+	0	0	602	0.0000000
zheyou73v0_A09	55120645	55123468	BnaA09T0502200ZY	0	-	0	0	2823	0.0000000
zheyou73v0_A09	55132816	55134735	BnaA09T0502300ZY	0	+	0	0	1919	0.0000000
zheyou73v0_A09	55135477	55137169	BnaA09T0502400ZY	0	+	0	0	1692	0.0000000
zheyou73v0_A09	55137169	55140115	BnaA09T0502500ZY	0	-	0	0	2946	0.0000000
zheyou73v0_A09	55144500	55146163	BnaA09T0502600ZY	0	+	0	0	1663	0.0000000
zheyou73v0_A09	55151439	55154454	BnaA09T0502700ZY	0	+	0	0	3015	0.0000000
zheyou73v0_A09	55151439	55154454	BnaA09T0502700ZY.1	0	+	0	0	3015	0.0000000
zheyou73v0_A09	55156798	55158548	BnaA09T0502800ZY	0	+	0	0	1750	0.0000000
zheyou73v0_A09	55162734	55163302	BnaA09T0502900ZY	0	+	0	0	568	0.0000000
zheyou73v0_A09	55166844	55167754	BnaA09T0503000ZY	0	-	0	0	910	0.0000000
zheyou73v0_A09	55172741	55173869	BnaA09T0503100ZY	0	-	0	0	1128	0.0000000
zheyou73v0_A09	55176607	55182427	BnaA09T0503200ZY	0	+	0	0	5820	0.0000000
zheyou73v0_A09	55184043	55186342	BnaA09T0503300ZY	0	+	0	0	2299	0.0000000
zheyou73v0_A09	55192601	55193949	BnaA09T0503400ZY	0	-	0	0	1348	0.0000000
zheyou73v0_A09	55197024	55201042	BnaA09T0503500ZY	0	+	0	0	4018	0.0000000
zheyou73v0_A09	55202052	55204168	BnaA09T0503600ZY	0	-	0	0	2116	0.0000000
zheyou73v0_A09	55210243	55211627	BnaA09T0503700ZY	0	-	0	0	1384	0.0000000
zheyou73v0_A09	55213598	55214258	BnaA09T0503800ZY	0	+	0	0	660	0.0000000
zheyou73v0_A09	55218023	55221891	BnaA09T0503900ZY	0	-	0	0	3868	0.0000000
zheyou73v0_A09	55223109	55224932	BnaA09T0504000ZY	0	+	0	0	1823	0.0000000
zheyou73v0_A09	55229111	55231386	BnaA09T0504100ZY	0	+	0	0	2275	0.0000000
zheyou73v0_A09	55237794	55240371	BnaA09T0504200ZY	0	+	0	0	2577	0.0000000
zheyou73v0_A09	55245835	55247252	BnaA09T0504300ZY	0	-	0	0	1417	0.0000000
zheyou73v0_A09	55255010	55256143	BnaA09T0504400ZY	0	+	0	0	1133	0.0000000
zheyou73v0_A09	55256761	55259344	BnaA09T0504500ZY	0	-	0	0	2583	0.0000000
zheyou73v0_A09	55259808	55262521	BnaA09T0504600ZY	0	-	0	0	2713	0.0000000
zheyou73v0_A09	55262972	55263404	BnaA09T0504700ZY	0	+	0	0	432	0.0000000
zheyou73v0_A09	55266800	55269387	BnaA09T0504800ZY	0	+	0	0	2587	0.0000000
zheyou73v0_A09	55269533	55272448	BnaA09T0504900ZY	0	+	0	0	2915	0.0000000
zheyou73v0_A09	55272720	55274202	BnaA09T0505000ZY	0	+	0	0	1482	0.0000000
zheyou73v0_A09	55275383	55281100	BnaA09T0505100ZY	0	+	0	0	5717	0.0000000
zheyou73v0_A09	55289797	55292322	BnaA09T0505200ZY	0	-	0	0	2525	0.0000000
zheyou73v0_A09	55293064	55294405	BnaA09T0505300ZY	0	-	0	0	1341	0.0000000
zheyou73v0_A09	55295471	55298182	BnaA09T0505400ZY	0	-	0	0	2711	0.0000000
zheyou73v0_A09	55299548	55300598	BnaA09T0505500ZY	0	+	0	0	1050	0.0000000
zheyou73v0_A09	55320904	55323527	BnaA09T0505600ZY	0	+	0	0	2623	0.0000000
zheyou73v0_A09	55323816	55324629	BnaA09T0505700ZY	0	+	0	0	813	0.0000000
zheyou73v0_A09	55324723	55328846	BnaA09T0505800ZY	0	+	0	0	4123	0.0000000
zheyou73v0_A09	55327172	55328983	BnaA09T0505800ZY.1	0	+	0	0	1811	0.0000000
zheyou73v0_A09	55333953	55337799	BnaA09T0505900ZY	0	-	0	0	3846	0.0000000
zheyou73v0_A09	55341979	55343621	BnaA09T0506000ZY	0	+	0	0	1642	0.0000000
zheyou73v0_A09	55344442	55344775	BnaA09T0506100ZY	0	+	0	0	333	0.0000000
zheyou73v0_A09	55347802	55349919	BnaA09T0506200ZY	0	-	0	0	2117	0.0000000
zheyou73v0_A09	55363963	55365057	BnaA09T0506300ZY	0	-	0	0	1094	0.0000000
zheyou73v0_A09	55388727	55389035	BnaA09T0506400ZY	0	+	0	0	308	0.0000000
zheyou73v0_A09	55389341	55390496	BnaA09T0506500ZY	0	+	0	0	1155	0.0000000
zheyou73v0_A09	55392868	55393756	BnaA09T0506600ZY	0	+	0	0	888	0.0000000
zheyou73v0_A09	55404985	55405606	BnaA09T0506700ZY	0	-	0	0	621	0.0000000
zheyou73v0_A09	55408241	55408724	BnaA09T0506800ZY	0	+	0	0	483	0.0000000
zheyou73v0_A09	55410667	55411675	BnaA09T0506900ZY	0	+	0	0	1008	0.0000000
zheyou73v0_A09	55412820	55414433	BnaA09T0507000ZY	0	+	0	0	1613	0.0000000
zheyou73v0_A09	55414662	55418497	BnaA09T0507100ZY	0	-	0	0	3835	0.0000000
zheyou73v0_A09	55414662	55418497	BnaA09T0507100ZY.1	0	-	0	0	3835	0.0000000
zheyou73v0_A09	55426297	55427407	BnaA09T0507200ZY	0	+	0	0	1110	0.0000000
zheyou73v0_A09	55430138	55430851	BnaA09T0507300ZY	0	-	0	0	713	0.0000000
zheyou73v0_A09	55434215	55436215	BnaA09T0507400ZY	0	-	0	0	2000	0.0000000
zheyou73v0_A09	55442666	55447112	BnaA09T0507500ZY	0	+	0	0	4446	0.0000000
zheyou73v0_A09	55447386	55448230	BnaA09T0507600ZY	0	-	0	0	844	0.0000000
zheyou73v0_A09	55449403	55450055	BnaA09T0507700ZY	0	+	0	0	652	0.0000000
zheyou73v0_A09	55450737	55451640	BnaA09T0507800ZY	0	+	0	0	903	0.0000000
zheyou73v0_A09	55453440	55454724	BnaA09T0507900ZY	0	+	0	0	1284	0.0000000
zheyou73v0_A09	55454872	55456183	BnaA09T0508000ZY	0	-	0	0	1311	0.0000000
zheyou73v0_A09	55457881	55460320	BnaA09T0508100ZY	0	+	0	0	2439	0.0000000
zheyou73v0_A09	55460633	55461630	BnaA09T0508200ZY	0	-	0	0	997	0.0000000
zheyou73v0_A09	55462673	55464623	BnaA09T0508300ZY	0	+	0	0	1950	0.0000000
zheyou73v0_A09	55462673	55464623	BnaA09T0508300ZY.1	0	+	0	0	1950	0.0000000
zheyou73v0_A09	55462673	55464623	BnaA09T0508300ZY.2	0	+	0	0	1950	0.0000000
zheyou73v0_A09	55462673	55464623	BnaA09T0508300ZY.3	0	+	0	0	1950	0.0000000
zheyou73v0_A09	55462673	55464623	BnaA09T0508300ZY.4	0	+	0	0	1950	0.0000000
zheyou73v0_A09	55465942	55466287	BnaA09T0508400ZY	0	+	0	0	345	0.0000000
zheyou73v0_A09	55469492	55471692	BnaA09T0508500ZY	0	+	0	0	2200	0.0000000
zheyou73v0_A09	55472106	55473423	BnaA09T0508600ZY	0	-	0	0	1317	0.0000000
zheyou73v0_A09	55478965	55479588	BnaA09T0508700ZY	0	+	0	0	623	0.0000000
zheyou73v0_A09	55480701	55483125	BnaA09T0508800ZY	0	-	0	0	2424	0.0000000
zheyou73v0_A09	55484559	55486982	BnaA09T0508900ZY	0	-	0	0	2423	0.0000000
zheyou73v0_A09	55494272	55495611	BnaA09T0509000ZY	0	+	0	0	1339	0.0000000
zheyou73v0_A09	55496409	55498596	BnaA09T0509100ZY	0	-	0	0	2187	0.0000000
zheyou73v0_A09	55500645	55501539	BnaA09T0509200ZY	0	-	0	0	894	0.0000000
zheyou73v0_A09	55502558	55503800	BnaA09T0509300ZY	0	+	0	0	1242	0.0000000
zheyou73v0_A09	55504497	55506876	BnaA09T0509400ZY	0	-	0	0	2379	0.0000000
zheyou73v0_A09	55509081	55511271	BnaA09T0509500ZY	0	-	0	0	2190	0.0000000
zheyou73v0_A09	55513321	55516537	BnaA09T0509600ZY	0	+	0	0	3216	0.0000000
zheyou73v0_A09	55516615	55519779	BnaA09T0509700ZY	0	-	0	0	3164	0.0000000
zheyou73v0_A09	55520147	55520712	BnaA09T0509800ZY	0	-	0	0	565	0.0000000
zheyou73v0_A09	55521382	55523587	BnaA09T0509900ZY	0	-	0	0	2205	0.0000000
zheyou73v0_A09	55525986	55527079	BnaA09T0510000ZY	0	-	0	0	1093	0.0000000
zheyou73v0_A09	55528383	55535509	BnaA09T0510100ZY	0	-	0	0	7126	0.0000000
zheyou73v0_A09	55528383	55533407	BnaA09T0510100ZY.1	0	-	0	0	5024	0.0000000
zheyou73v0_A09	55536694	55538590	BnaA09T0510200ZY	0	-	0	0	1896	0.0000000
zheyou73v0_A09	55539574	55539992	BnaA09T0510300ZY	0	+	0	0	418	0.0000000
zheyou73v0_A09	55540383	55540776	BnaA09T0510400ZY	0	+	0	0	393	0.0000000
zheyou73v0_A09	55541105	55541531	BnaA09T0510500ZY	0	-	0	0	426	0.0000000
zheyou73v0_A09	55542990	55544199	BnaA09T0510600ZY	0	+	0	0	1209	0.0000000
zheyou73v0_A09	55544611	55545133	BnaA09T0510700ZY	0	+	0	0	522	0.0000000
zheyou73v0_A09	55545637	55547520	BnaA09T0510800ZY	0	-	0	0	1883	0.0000000
zheyou73v0_A09	55553599	55554721	BnaA09T0510900ZY	0	+	0	0	1122	0.0000000
zheyou73v0_A09	55561054	55563157	BnaA09T0511000ZY	0	+	0	0	2103	0.0000000
zheyou73v0_A09	55568218	55569029	BnaA09T0511100ZY	0	+	0	0	811	0.0000000
zheyou73v0_A09	55569209	55571321	BnaA09T0511200ZY	0	-	0	0	2112	0.0000000
zheyou73v0_A09	55571890	55574515	BnaA09T0511300ZY	0	-	0	0	2625	0.0000000
zheyou73v0_A09	55574815	55576570	BnaA09T0511400ZY	0	+	0	0	1755	0.0000000
zheyou73v0_A09	55578528	55580176	BnaA09T0511500ZY	0	-	0	0	1648	0.0000000
zheyou73v0_A09	55580719	55581361	BnaA09T0511600ZY	0	-	0	0	642	0.0000000
zheyou73v0_A09	55583072	55583225	BnaA09T0511700ZY	0	-	0	0	153	0.0000000
zheyou73v0_A09	55588041	55589178	BnaA09T0511800ZY	0	-	0	0	1137	0.0000000
zheyou73v0_A09	55592641	55593625	BnaA09T0511900ZY	0	+	0	0	984	0.0000000
zheyou73v0_A09	55597950	55599297	BnaA09T0512000ZY	0	+	0	0	1347	0.0000000
zheyou73v0_A09	55601409	55603066	BnaA09T0512100ZY	0	-	0	0	1657	0.0000000
zheyou73v0_A09	55617396	55618687	BnaA09T0512200ZY	0	-	0	0	1291	0.0000000
zheyou73v0_A09	55622370	55627763	BnaA09T0512300ZY	0	-	0	0	5393	0.0000000
zheyou73v0_A09	55622370	55627763	BnaA09T0512300ZY.1	0	-	0	0	5393	0.0000000
zheyou73v0_A09	55631756	55633277	BnaA09T0512400ZY	0	+	0	0	1521	0.0000000
zheyou73v0_A09	55633339	55635092	BnaA09T0512500ZY	0	-	0	0	1753	0.0000000
zheyou73v0_A09	55646079	55647995	BnaA09T0512600ZY	0	-	0	0	1916	0.0000000
zheyou73v0_A09	55646361	55647995	BnaA09T0512600ZY.1	0	-	0	0	1634	0.0000000
zheyou73v0_A09	55648564	55649573	BnaA09T0512700ZY	0	-	0	0	1009	0.0000000
zheyou73v0_A09	55649907	55651607	BnaA09T0512800ZY	0	-	0	0	1700	0.0000000
zheyou73v0_A09	55652187	55652758	BnaA09T0512900ZY	0	+	0	0	571	0.0000000
zheyou73v0_A09	55654342	55655156	BnaA09T0513000ZY	0	+	0	0	814	0.0000000
zheyou73v0_A09	55657873	55660766	BnaA09T0513100ZY	0	+	0	0	2893	0.0000000
zheyou73v0_A09	55661220	55672262	BnaA09T0513200ZY	0	-	0	0	11042	0.0000000
zheyou73v0_A09	55684008	55689452	BnaA09T0513300ZY	0	-	0	0	5444	0.0000000
zheyou73v0_A09	55692188	55693426	BnaA09T0513400ZY	0	+	0	0	1238	0.0000000
zheyou73v0_A09	55695115	55696841	BnaA09T0513500ZY	0	-	0	0	1726	0.0000000
zheyou73v0_A09	55697529	55701684	BnaA09T0513600ZY	0	-	0	0	4155	0.0000000
zheyou73v0_A09	55702082	55703309	BnaA09T0513700ZY	0	+	0	0	1227	0.0000000
zheyou73v0_A09	55702953	55703262	BnaA09T0513800ZY	0	-	0	0	309	0.0000000
zheyou73v0_A09	55704260	55705895	BnaA09T0513900ZY	0	-	0	0	1635	0.0000000
zheyou73v0_A09	55708808	55709445	BnaA09T0514000ZY	0	+	0	0	637	0.0000000
zheyou73v0_A09	55711681	55712257	BnaA09T0514100ZY	0	+	0	0	576	0.0000000
zheyou73v0_A09	55714066	55716510	BnaA09T0514200ZY	0	+	0	0	2444	0.0000000
zheyou73v0_A09	55716703	55719395	BnaA09T0514300ZY	0	-	0	0	2692	0.0000000
zheyou73v0_A09	55743226	55745159	BnaA09T0514400ZY	0	+	0	0	1933	0.0000000
zheyou73v0_A09	55748513	55750164	BnaA09T0514500ZY	0	+	0	0	1651	0.0000000
zheyou73v0_A09	55752368	55754774	BnaA09T0514600ZY	0	-	0	0	2406	0.0000000
zheyou73v0_A09	55752368	55754774	BnaA09T0514600ZY.1	0	-	0	0	2406	0.0000000
zheyou73v0_A09	55760405	55762826	BnaA09T0514700ZY	0	+	0	0	2421	0.0000000
zheyou73v0_A09	55765108	55766375	BnaA09T0514800ZY	0	-	0	0	1267	0.0000000
zheyou73v0_A09	55778619	55781290	BnaA09T0514900ZY	0	-	0	0	2671	0.0000000
zheyou73v0_A09	55781651	55782390	BnaA09T0515000ZY	0	-	0	0	739	0.0000000
zheyou73v0_A09	55783014	55785222	BnaA09T0515100ZY	0	+	0	0	2208	0.0000000
zheyou73v0_A09	55786024	55786583	BnaA09T0515200ZY	0	-	0	0	559	0.0000000
zheyou73v0_A09	55788079	55789564	BnaA09T0515300ZY	0	+	0	0	1485	0.0000000
zheyou73v0_A09	55789324	55791223	BnaA09T0515400ZY	0	-	0	0	1899	0.0000000
zheyou73v0_A09	55789405	55791223	BnaA09T0515400ZY.1	0	-	0	0	1818	0.0000000
zheyou73v0_A09	55789405	55791223	BnaA09T0515400ZY.2	0	-	0	0	1818	0.0000000
zheyou73v0_A09	55791425	55792274	BnaA09T0515500ZY	0	+	0	0	849	0.0000000
zheyou73v0_A09	55793354	55794921	BnaA09T0515600ZY	0	+	0	0	1567	0.0000000
zheyou73v0_A09	55804318	55806220	BnaA09T0515700ZY	0	-	0	0	1902	0.0000000
zheyou73v0_A09	55811612	55812560	BnaA09T0515800ZY	0	-	0	0	948	0.0000000
zheyou73v0_A09	55816483	55817662	BnaA09T0515900ZY	0	+	0	0	1179	0.0000000
zheyou73v0_A09	55823341	55826357	BnaA09T0516000ZY	0	-	0	0	3016	0.0000000
zheyou73v0_A09	55835830	55840066	BnaA09T0516100ZY	0	-	0	0	4236	0.0000000
zheyou73v0_A09	55850390	55850939	BnaA09T0516200ZY	0	-	0	0	549	0.0000000
zheyou73v0_A09	55851113	55852454	BnaA09T0516300ZY	0	+	0	0	1341	0.0000000
zheyou73v0_A09	55853792	55855768	BnaA09T0516400ZY	0	+	0	0	1976	0.0000000
zheyou73v0_A09	55857726	55860087	BnaA09T0516500ZY	0	+	0	0	2361	0.0000000
zheyou73v0_A09	55864878	55866050	BnaA09T0516600ZY	0	+	0	0	1172	0.0000000
zheyou73v0_A09	55866419	55872377	BnaA09T0516700ZY	0	-	0	0	5958	0.0000000
zheyou73v0_A09	55880977	55886935	BnaA09T0516800ZY	0	-	0	0	5958	0.0000000
zheyou73v0_A09	55888016	55891705	BnaA09T0516900ZY	0	-	0	0	3689	0.0000000
zheyou73v0_A09	55894211	55897427	BnaA09T0517000ZY	0	+	0	0	3216	0.0000000
zheyou73v0_A09	55896890	55897262	BnaA09T0517100ZY	0	-	0	0	372	0.0000000
zheyou73v0_A09	55898218	55899832	BnaA09T0517200ZY	0	-	0	0	1614	0.0000000
zheyou73v0_A09	55900776	55904129	BnaA09T0517300ZY	0	-	0	0	3353	0.0000000
zheyou73v0_A09	55904519	55906681	BnaA09T0517400ZY	0	-	0	0	2162	0.0000000
zheyou73v0_A09	55910576	55911825	BnaA09T0517500ZY	0	+	0	0	1249	0.0000000
zheyou73v0_A09	55916343	55927430	BnaA09T0517600ZY	0	+	0	0	11087	0.0000000
zheyou73v0_A09	55933834	55939774	BnaA09T0517700ZY	0	+	0	0	5940	0.0000000
zheyou73v0_A09	55945278	55946120	BnaA09T0517800ZY	0	+	0	0	842	0.0000000
zheyou73v0_A09	55949556	55952681	BnaA09T0517900ZY	0	-	0	0	3125	0.0000000
zheyou73v0_A09	55949556	55952829	BnaA09T0517900ZY.1	0	-	0	0	3273	0.0000000
zheyou73v0_A09	55958473	55961858	BnaA09T0518000ZY	0	+	0	0	3385	0.0000000
zheyou73v0_A09	55958473	55961858	BnaA09T0518000ZY.1	0	+	0	0	3385	0.0000000
zheyou73v0_A09	55962039	55966127	BnaA09T0518100ZY	0	-	0	0	4088	0.0000000
zheyou73v0_A09	55967366	55969886	BnaA09T0518200ZY	0	+	0	0	2520	0.0000000
zheyou73v0_A09	55971054	55972943	BnaA09T0518300ZY	0	+	0	0	1889	0.0000000
zheyou73v0_A09	55973403	55976667	BnaA09T0518400ZY	0	+	0	0	3264	0.0000000
zheyou73v0_A09	55977864	55979286	BnaA09T0518500ZY	0	+	0	0	1422	0.0000000
zheyou73v0_A09	55980442	55982502	BnaA09T0518600ZY	0	-	0	0	2060	0.0000000
zheyou73v0_A09	55986209	55987017	BnaA09T0518700ZY	0	+	0	0	808	0.0000000
zheyou73v0_A09	55989838	55990981	BnaA09T0518800ZY	0	-	0	0	1143	0.0000000
zheyou73v0_A09	55993902	55996549	BnaA09T0518900ZY	0	+	0	0	2647	0.0000000
zheyou73v0_A09	55996887	55999488	BnaA09T0519000ZY	0	-	0	0	2601	0.0000000
zheyou73v0_A09	56002038	56005907	BnaA09T0519100ZY	0	-	0	0	3869	0.0000000
zheyou73v0_A09	56007259	56008145	BnaA09T0519200ZY	0	-	0	0	886	0.0000000
zheyou73v0_A09	56015102	56018178	BnaA09T0519300ZY	0	+	0	0	3076	0.0000000
zheyou73v0_A09	56019136	56021916	BnaA09T0519400ZY	0	-	0	0	2780	0.0000000
zheyou73v0_A09	56023007	56025248	BnaA09T0519500ZY	0	+	0	0	2241	0.0000000
zheyou73v0_A09	56031239	56032619	BnaA09T0519600ZY	0	+	0	0	1380	0.0000000
zheyou73v0_A09	56033324	56034788	BnaA09T0519700ZY	0	+	0	0	1464	0.0000000
zheyou73v0_A09	56036020	56037406	BnaA09T0519800ZY	0	+	0	0	1386	0.0000000
zheyou73v0_A09	56037971	56042216	BnaA09T0519900ZY	0	-	0	0	4245	0.0000000
zheyou73v0_A09	56045285	56047256	BnaA09T0520000ZY	0	-	0	0	1971	0.0000000
zheyou73v0_A09	56047574	56049895	BnaA09T0520100ZY	0	-	0	0	2321	0.0000000
zheyou73v0_A09	56050293	56052104	BnaA09T0520200ZY	0	+	0	0	1811	0.0000000
zheyou73v0_A09	56053452	56054025	BnaA09T0520300ZY	0	+	0	0	573	0.0000000
zheyou73v0_A09	56055546	56057325	BnaA09T0520400ZY	0	-	0	0	1779	0.0000000
zheyou73v0_A09	56061714	56067199	BnaA09T0520500ZY	0	+	0	0	5485	0.0000000
zheyou73v0_A09	56068242	56069907	BnaA09T0520600ZY	0	-	0	0	1665	0.0000000
zheyou73v0_A09	56076257	56078952	BnaA09T0520700ZY	0	-	0	0	2695	0.0000000
zheyou73v0_A09	56080016	56081495	BnaA09T0520800ZY	0	-	0	0	1479	0.0000000
zheyou73v0_A09	56086256	56090513	BnaA09T0520900ZY	0	+	0	0	4257	0.0000000
zheyou73v0_A09	56092459	56094691	BnaA09T0521000ZY.1	0	+	0	0	2232	0.0000000
zheyou73v0_A09	56092470	56094554	BnaA09T0521000ZY	0	+	0	0	2084	0.0000000
zheyou73v0_A09	56096787	56098642	BnaA09T0521100ZY	0	-	0	0	1855	0.0000000
zheyou73v0_A09	56102949	56104910	BnaA09T0521200ZY	0	-	0	0	1961	0.0000000
zheyou73v0_A09	56114038	56120508	BnaA09T0521300ZY	0	+	0	0	6470	0.0000000
zheyou73v0_A09	56114038	56120508	BnaA09T0521300ZY.1	0	+	0	0	6470	0.0000000
zheyou73v0_A09	56124209	56126027	BnaA09T0521400ZY	0	+	0	0	1818	0.0000000
zheyou73v0_A09	56127122	56129558	BnaA09T0521500ZY	0	+	0	0	2436	0.0000000
zheyou73v0_A09	56130991	56133729	BnaA09T0521600ZY	0	+	0	0	2738	0.0000000
zheyou73v0_A09	56134444	56136004	BnaA09T0521700ZY	0	+	0	0	1560	0.0000000
zheyou73v0_A09	56136168	56138774	BnaA09T0521800ZY	0	-	0	0	2606	0.0000000
zheyou73v0_A09	56139151	56139433	BnaA09T0521900ZY	0	+	0	0	282	0.0000000
zheyou73v0_A09	56146470	56147416	BnaA09T0522000ZY	0	-	0	0	946	0.0000000
zheyou73v0_A09	56151725	56155270	BnaA09T0522100ZY	0	-	0	0	3545	0.0000000
zheyou73v0_A09	56177365	56177606	BnaA09T0522200ZY	0	-	0	0	241	0.0000000
zheyou73v0_A09	56180487	56181543	BnaA09T0522300ZY	0	+	0	0	1056	0.0000000
zheyou73v0_A09	56188071	56189490	BnaA09T0522400ZY	0	+	0	0	1419	0.0000000
zheyou73v0_A09	56190209	56193374	BnaA09T0522500ZY	0	-	0	0	3165	0.0000000
zheyou73v0_A09	56194835	56203410	BnaA09T0522600ZY	0	-	0	0	8575	0.0000000
zheyou73v0_A09	56206661	56210306	BnaA09T0522700ZY	0	+	0	0	3645	0.0000000
zheyou73v0_A09	56213393	56214916	BnaA09T0522800ZY	0	+	0	0	1523	0.0000000
zheyou73v0_A09	56220584	56222565	BnaA09T0522900ZY	0	-	0	0	1981	0.0000000
zheyou73v0_A09	56223128	56223415	BnaA09T0523000ZY	0	+	0	0	287	0.0000000
zheyou73v0_A09	56237984	56239159	BnaA09T0523100ZY	0	-	0	0	1175	0.0000000
zheyou73v0_A09	56246845	56249244	BnaA09T0523200ZY	0	+	0	0	2399	0.0000000
zheyou73v0_A09	56246845	56249531	BnaA09T0523200ZY.1	0	+	0	0	2686	0.0000000
zheyou73v0_A09	56250410	56251329	BnaA09T0523300ZY	0	-	0	0	919	0.0000000
zheyou73v0_A09	56264718	56270529	BnaA09T0523400ZY	0	+	0	0	5811	0.0000000
zheyou73v0_A09	56271355	56272416	BnaA09T0523500ZY	0	+	0	0	1061	0.0000000
zheyou73v0_A09	56273551	56275717	BnaA09T0523600ZY	0	-	0	0	2166	0.0000000
zheyou73v0_A09	56278919	56285058	BnaA09T0523700ZY	0	-	0	0	6139	0.0000000
zheyou73v0_A09	56293242	56304135	BnaA09T0523800ZY	0	-	0	0	10893	0.0000000
zheyou73v0_A09	56308099	56309257	BnaA09T0523900ZY	0	+	0	0	1158	0.0000000
zheyou73v0_A09	56309821	56312637	BnaA09T0524000ZY	0	-	0	0	2816	0.0000000
zheyou73v0_A09	56309821	56312637	BnaA09T0524000ZY.1	0	-	0	0	2816	0.0000000
zheyou73v0_A09	56336079	56336563	BnaA09T0524100ZY	0	-	0	0	484	0.0000000
zheyou73v0_A09	56338076	56340115	BnaA09T0524200ZY	0	+	0	0	2039	0.0000000
zheyou73v0_A09	56338076	56340115	BnaA09T0524200ZY.1	0	+	0	0	2039	0.0000000
zheyou73v0_A09	56341992	56343252	BnaA09T0524300ZY	0	+	0	0	1260	0.0000000
zheyou73v0_A09	56346744	56352435	BnaA09T0524400ZY	0	-	0	0	5691	0.0000000
zheyou73v0_A09	56357388	56358546	BnaA09T0524500ZY	0	+	0	0	1158	0.0000000
zheyou73v0_A09	56358684	56358843	BnaA09T0524600ZY	0	-	0	0	159	0.0000000
zheyou73v0_A09	56367994	56368478	BnaA09T0524700ZY	0	-	0	0	484	0.0000000
zheyou73v0_A09	56370683	56372484	BnaA09T0524800ZY	0	+	0	0	1801	0.0000000
zheyou73v0_A09	56374507	56375917	BnaA09T0524900ZY	0	+	0	0	1410	0.0000000
zheyou73v0_A09	56377313	56380326	BnaA09T0525000ZY	0	+	0	0	3013	0.0000000
zheyou73v0_A09	56381177	56382697	BnaA09T0525100ZY	0	-	0	0	1520	0.0000000
zheyou73v0_A09	56385165	56385786	BnaA09T0525200ZY	0	-	0	0	621	0.0000000
zheyou73v0_A09	56389145	56398822	BnaA09T0525300ZY	0	+	0	0	9677	0.0000000
zheyou73v0_A09	56399590	56403840	BnaA09T0525400ZY	0	+	0	0	4250	0.0000000
zheyou73v0_A09	56404728	56408050	BnaA09T0525500ZY	0	+	0	0	3322	0.0000000
zheyou73v0_A09	56412142	56415407	BnaA09T0525600ZY	0	+	0	0	3265	0.0000000
zheyou73v0_A09	56416044	56419594	BnaA09T0525700ZY	0	-	0	0	3550	0.0000000
zheyou73v0_A09	56421186	56425502	BnaA09T0525800ZY	0	-	0	0	4316	0.0000000
zheyou73v0_A09	56429919	56430795	BnaA09T0525900ZY	0	+	0	0	876	0.0000000
zheyou73v0_A09	56432108	56433581	BnaA09T0526000ZY	0	+	0	0	1473	0.0000000
zheyou73v0_A09	56434567	56435889	BnaA09T0526100ZY	0	-	0	0	1322	0.0000000
zheyou73v0_A09	56438033	56439930	BnaA09T0526200ZY	0	-	0	0	1897	0.0000000
zheyou73v0_A09	56445552	56451230	BnaA09T0526300ZY	0	+	0	0	5678	0.0000000
zheyou73v0_A09	56452996	56454004	BnaA09T0526400ZY	0	+	0	0	1008	0.0000000
zheyou73v0_A09	56458063	56458618	BnaA09T0526500ZY	0	-	0	0	555	0.0000000
zheyou73v0_A09	56459177	56459807	BnaA09T0526600ZY	0	-	0	0	630	0.0000000
zheyou73v0_A09	56461887	56462730	BnaA09T0526700ZY	0	+	0	0	843	0.0000000
zheyou73v0_A09	56463227	56463970	BnaA09T0526800ZY	0	-	0	0	743	0.0000000
zheyou73v0_A09	56474387	56474888	BnaA09T0526900ZY	0	+	0	0	501	0.0000000
zheyou73v0_A09	56475371	56478591	BnaA09T0527000ZY	0	-	0	0	3220	0.0000000
zheyou73v0_A09	56486494	56490091	BnaA09T0527100ZY	0	+	0	0	3597	0.0000000
zheyou73v0_A09	56490324	56498440	BnaA09T0527200ZY	0	-	0	0	8116	0.0000000
zheyou73v0_A09	56499370	56503992	BnaA09T0527300ZY	0	+	0	0	4622	0.0000000
zheyou73v0_A09	56504942	56506345	BnaA09T0527400ZY	0	+	0	0	1403	0.0000000
zheyou73v0_A09	56508378	56511874	BnaA09T0527500ZY	0	+	0	0	3496	0.0000000
zheyou73v0_A09	56518007	56525304	BnaA09T0527600ZY	0	+	0	0	7297	0.0000000
zheyou73v0_A09	56566459	56566810	BnaA09T0527700ZY	0	+	0	0	351	0.0000000
zheyou73v0_A09	56567714	56569792	BnaA09T0527800ZY	0	-	0	0	2078	0.0000000
zheyou73v0_A09	56576501	56577599	BnaA09T0527900ZY	0	-	0	0	1098	0.0000000
zheyou73v0_A09	56582168	56582999	BnaA09T0528000ZY	0	-	0	0	831	0.0000000
zheyou73v0_A09	56583729	56585012	BnaA09T0528100ZY	0	-	0	0	1283	0.0000000
zheyou73v0_A09	56592109	56593773	BnaA09T0528200ZY	0	-	0	0	1664	0.0000000
zheyou73v0_A09	56592109	56593773	BnaA09T0528200ZY.1	0	-	0	0	1664	0.0000000
zheyou73v0_A09	56597425	56600125	BnaA09T0528300ZY	0	+	0	0	2700	0.0000000
zheyou73v0_A09	56600627	56602816	BnaA09T0528400ZY	0	-	0	0	2189	0.0000000
zheyou73v0_A09	56610318	56613296	BnaA09T0528500ZY	0	+	0	0	2978	0.0000000
zheyou73v0_A09	56614934	56618118	BnaA09T0528600ZY	0	+	0	0	3184	0.0000000
zheyou73v0_A09	56619173	56620536	BnaA09T0528700ZY	0	+	0	0	1363	0.0000000
zheyou73v0_A09	56622445	56625500	BnaA09T0528800ZY	0	-	0	0	3055	0.0000000
zheyou73v0_A09	56630738	56635618	BnaA09T0528900ZY	0	+	0	0	4880	0.0000000
zheyou73v0_A09	56637968	56640422	BnaA09T0529000ZY	0	-	0	0	2454	0.0000000
zheyou73v0_A09	56647048	56648375	BnaA09T0529100ZY	0	-	0	0	1327	0.0000000
zheyou73v0_A09	56651771	56654439	BnaA09T0529200ZY	0	+	0	0	2668	0.0000000
zheyou73v0_A09	56656279	56657110	BnaA09T0529300ZY	0	+	0	0	831	0.0000000
zheyou73v0_A09	56660236	56660464	BnaA09T0529400ZY	0	+	0	0	228	0.0000000
zheyou73v0_A09	56661246	56662447	BnaA09T0529500ZY	0	-	0	0	1201	0.0000000
zheyou73v0_A09	56663747	56665174	BnaA09T0529600ZY	0	+	0	0	1427	0.0000000
zheyou73v0_A09	56665900	56671478	BnaA09T0529700ZY	0	-	0	0	5578	0.0000000
zheyou73v0_A09	56672786	56674211	BnaA09T0529800ZY	0	-	0	0	1425	0.0000000
zheyou73v0_A09	56677271	56678490	BnaA09T0529900ZY	0	+	0	0	1219	0.0000000
zheyou73v0_A09	56679082	56682721	BnaA09T0530000ZY	0	+	0	0	3639	0.0000000
zheyou73v0_A09	56682354	56684696	BnaA09T0530100ZY	0	-	0	0	2342	0.0000000
zheyou73v0_A09	56688453	56690346	BnaA09T0530200ZY	0	-	0	0	1893	0.0000000
zheyou73v0_A09	56694434	56696069	BnaA09T0530300ZY	0	-	0	0	1635	0.0000000
zheyou73v0_A09	56694434	56696072	BnaA09T0530300ZY.1	0	-	0	0	1638	0.0000000
zheyou73v0_A09	56699303	56700777	BnaA09T0530400ZY	0	+	0	0	1474	0.0000000
zheyou73v0_A09	56702646	56703762	BnaA09T0530500ZY	0	+	0	0	1116	0.0000000
zheyou73v0_A09	56706576	56707031	BnaA09T0530600ZY	0	-	0	0	455	0.0000000
zheyou73v0_A09	56709067	56709884	BnaA09T0530700ZY	0	+	0	0	817	0.0000000
zheyou73v0_A09	56730172	56735571	BnaA09T0530800ZY	0	+	0	0	5399	0.0000000
zheyou73v0_A09	56730290	56735571	BnaA09T0530800ZY.1	0	+	0	0	5281	0.0000000
zheyou73v0_A09	56730290	56735571	BnaA09T0530800ZY.2	0	+	0	0	5281	0.0000000
zheyou73v0_A09	56747512	56749288	BnaA09T0530900ZY	0	+	0	0	1776	0.0000000
zheyou73v0_A09	56749586	56751646	BnaA09T0531000ZY	0	-	0	0	2060	0.0000000
zheyou73v0_A09	56751807	56753065	BnaA09T0531100ZY	0	+	0	0	1258	0.0000000
zheyou73v0_A09	56759062	56759670	BnaA09T0531200ZY	0	-	0	0	608	0.0000000
zheyou73v0_A09	56768347	56769647	BnaA09T0531300ZY	0	-	0	0	1300	0.0000000
zheyou73v0_A09	56775983	56778092	BnaA09T0531400ZY	0	+	0	0	2109	0.0000000
zheyou73v0_A09	56778791	56780566	BnaA09T0531500ZY	0	-	0	0	1775	0.0000000
zheyou73v0_A09	56786016	56786373	BnaA09T0531600ZY	0	+	0	0	357	0.0000000
zheyou73v0_A09	56787924	56788645	BnaA09T0531700ZY	0	+	0	0	721	0.0000000
zheyou73v0_A09	56790858	56794945	BnaA09T0531800ZY	0	+	0	0	4087	0.0000000
zheyou73v0_A09	56797562	56800474	BnaA09T0531900ZY	0	+	0	0	2912	0.0000000
zheyou73v0_A09	56797923	56800474	BnaA09T0531900ZY.1	0	+	0	0	2551	0.0000000
zheyou73v0_A09	56808773	56809025	BnaA09T0532000ZY	0	-	0	0	252	0.0000000
zheyou73v0_A09	56816600	56817991	BnaA09T0532100ZY	0	+	0	0	1391	0.0000000
zheyou73v0_A09	56816600	56818009	BnaA09T0532100ZY.1	0	+	0	0	1409	0.0000000
zheyou73v0_A09	56816600	56818009	BnaA09T0532100ZY.2	0	+	0	0	1409	0.0000000
zheyou73v0_A09	56821240	56824194	BnaA09T0532200ZY	0	-	0	0	2954	0.0000000
zheyou73v0_A09	56829161	56831126	BnaA09T0532300ZY	0	+	0	0	1965	0.0000000
zheyou73v0_A09	56831324	56834956	BnaA09T0532400ZY	0	-	0	0	3632	0.0000000
zheyou73v0_A09	56836703	56840185	BnaA09T0532500ZY	0	-	0	0	3482	0.0000000
zheyou73v0_A09	56841697	56845822	BnaA09T0532600ZY	0	-	0	0	4125	0.0000000
zheyou73v0_A09	56847636	56848014	BnaA09T0532700ZY	0	-	0	0	378	0.0000000
zheyou73v0_A09	56850298	56851299	BnaA09T0532800ZY	0	-	0	0	1001	0.0000000
zheyou73v0_A09	56856071	56857519	BnaA09T0532900ZY	0	+	0	0	1448	0.0000000
zheyou73v0_A09	56858901	56860257	BnaA09T0533000ZY	0	+	0	0	1356	0.0000000
zheyou73v0_A09	56860642	56863678	BnaA09T0533100ZY	0	-	0	0	3036	0.0000000
zheyou73v0_A09	56863881	56866381	BnaA09T0533200ZY	0	-	0	0	2500	0.0000000
zheyou73v0_A09	56867193	56868327	BnaA09T0533300ZY	0	-	0	0	1134	0.0000000
zheyou73v0_A09	56869265	56870937	BnaA09T0533400ZY	0	-	0	0	1672	0.0000000
zheyou73v0_A09	56890176	56892581	BnaA09T0533500ZY	0	+	0	0	2405	0.0000000
zheyou73v0_A09	56898347	56904259	BnaA09T0533600ZY	0	+	0	0	5912	0.0000000
zheyou73v0_A09	56905037	56906454	BnaA09T0533700ZY	0	-	0	0	1417	0.0000000
zheyou73v0_A09	56924504	56924753	BnaA09T0533800ZY	0	-	0	0	249	0.0000000
zheyou73v0_A09	56927248	56928295	BnaA09T0533900ZY	0	+	0	0	1047	0.0000000
zheyou73v0_A09	56931786	56934506	BnaA09T0534000ZY	0	-	0	0	2720	0.0000000
zheyou73v0_A09	56935970	56936968	BnaA09T0534100ZY	0	+	0	0	998	0.0000000
zheyou73v0_A09	56937713	56940484	BnaA09T0534200ZY	0	+	0	0	2771	0.0000000
zheyou73v0_A09	56941971	56944485	BnaA09T0534300ZY	0	-	0	0	2514	0.0000000
zheyou73v0_A09	56947214	56952141	BnaA09T0534400ZY	0	-	0	0	4927	0.0000000
zheyou73v0_A09	56984316	56984987	BnaA09T0534500ZY	0	-	0	0	671	0.0000000
zheyou73v0_A09	56984316	56996614	BnaA09T0534600ZY	0	+	0	0	12298	0.0000000
zheyou73v0_A09	57000412	57002866	BnaA09T0534700ZY	0	-	0	0	2454	0.0000000
zheyou73v0_A09	57004291	57005289	BnaA09T0534800ZY	0	+	0	0	998	0.0000000
zheyou73v0_A09	57006048	57008564	BnaA09T0534900ZY	0	+	0	0	2516	0.0000000
zheyou73v0_A09	57010289	57012800	BnaA09T0535000ZY	0	-	0	0	2511	0.0000000
zheyou73v0_A09	57015529	57020455	BnaA09T0535100ZY	0	-	0	0	4926	0.0000000
zheyou73v0_A09	57023551	57029597	BnaA09T0535200ZY	0	+	0	0	6046	0.0000000
zheyou73v0_A09	57033317	57034475	BnaA09T0535300ZY.1	0	+	0	0	1158	0.0000000
zheyou73v0_A09	57033378	57034475	BnaA09T0535300ZY	0	+	0	0	1097	0.0000000
zheyou73v0_A09	57039231	57041341	BnaA09T0535400ZY	0	+	0	0	2110	0.0000000
zheyou73v0_A09	57045820	57046349	BnaA09T0535500ZY	0	+	0	0	529	0.0000000
zheyou73v0_A09	57048830	57057025	BnaA09T0535600ZY	0	-	0	0	8195	0.0000000
zheyou73v0_A09	57058832	57061458	BnaA09T0535700ZY	0	+	0	0	2626	0.0000000
zheyou73v0_A09	57062718	57063843	BnaA09T0535800ZY	0	-	0	0	1125	0.0000000
zheyou73v0_A09	57070693	57072184	BnaA09T0535900ZY	0	+	0	0	1491	0.0000000
zheyou73v0_A09	57072574	57074626	BnaA09T0536000ZY	0	-	0	0	2052	0.0000000
zheyou73v0_A09	57101568	57106059	BnaA09T0536100ZY	0	+	0	0	4491	0.0000000
zheyou73v0_A09	57111754	57113228	BnaA09T0536200ZY	0	+	0	0	1474	0.0000000
zheyou73v0_A09	57116824	57118613	BnaA09T0536300ZY	0	-	0	0	1789	0.0000000
zheyou73v0_A09	57135892	57137260	BnaA09T0536400ZY	0	-	0	0	1368	0.0000000
zheyou73v0_A09	57138651	57143836	BnaA09T0536500ZY	0	-	0	0	5185	0.0000000
zheyou73v0_A09	57138651	57143836	BnaA09T0536500ZY.1	0	-	0	0	5185	0.0000000
zheyou73v0_A09	57138651	57143836	BnaA09T0536500ZY.2	0	-	0	0	5185	0.0000000
zheyou73v0_A09	57138651	57143836	BnaA09T0536500ZY.3	0	-	0	0	5185	0.0000000
zheyou73v0_A09	57150065	57151616	BnaA09T0536600ZY	0	-	0	0	1551	0.0000000
zheyou73v0_A09	57160043	57163574	BnaA09T0536700ZY	0	-	0	0	3531	0.0000000
zheyou73v0_A09	57160043	57163574	BnaA09T0536700ZY.1	0	-	0	0	3531	0.0000000
zheyou73v0_A09	57160043	57163574	BnaA09T0536700ZY.2	0	-	0	0	3531	0.0000000
zheyou73v0_A09	57163635	57164611	BnaA09T0536800ZY	0	-	0	0	976	0.0000000
zheyou73v0_A09	57167162	57171484	BnaA09T0536900ZY	0	-	0	0	4322	0.0000000
zheyou73v0_A09	57187623	57194122	BnaA09T0537000ZY	0	+	0	0	6499	0.0000000
zheyou73v0_A09	57194464	57199325	BnaA09T0537100ZY	0	-	0	0	4861	0.0000000
zheyou73v0_A09	57200396	57203428	BnaA09T0537200ZY	0	-	0	0	3032	0.0000000
zheyou73v0_A09	57201422	57203428	BnaA09T0537200ZY.1	0	-	0	0	2006	0.0000000
zheyou73v0_A09	57204954	57206562	BnaA09T0537300ZY	0	+	0	0	1608	0.0000000
zheyou73v0_A09	57204954	57206562	BnaA09T0537300ZY.1	0	+	0	0	1608	0.0000000
zheyou73v0_A09	57204954	57206846	BnaA09T0537300ZY.2	0	+	0	0	1892	0.0000000
zheyou73v0_A09	57215677	57219797	BnaA09T0537400ZY	0	-	0	0	4120	0.0000000
zheyou73v0_A09	57222814	57227233	BnaA09T0537500ZY	0	+	0	0	4419	0.0000000
zheyou73v0_A09	57227575	57228128	BnaA09T0537600ZY	0	-	0	0	553	0.0000000
zheyou73v0_A09	57228204	57228562	BnaA09T0537700ZY	0	-	0	0	358	0.0000000
zheyou73v0_A09	57230034	57231254	BnaA09T0537800ZY	0	+	0	0	1220	0.0000000
zheyou73v0_A09	57236830	57239935	BnaA09T0537900ZY	0	+	0	0	3105	0.0000000
zheyou73v0_A09	57242894	57243493	BnaA09T0538000ZY	0	+	0	0	599	0.0000000
zheyou73v0_A09	57247298	57248417	BnaA09T0538100ZY	0	+	0	0	1119	0.0000000
zheyou73v0_A09	57253068	57254690	BnaA09T0538200ZY	0	+	0	0	1622	0.0000000
zheyou73v0_A09	57261543	57264455	BnaA09T0538300ZY	0	-	0	0	2912	0.0000000
zheyou73v0_A09	57265317	57268193	BnaA09T0538400ZY	0	-	0	0	2876	0.0000000
zheyou73v0_A09	57270880	57271538	BnaA09T0538500ZY	0	+	0	0	658	0.0000000
zheyou73v0_A09	57278280	57280390	BnaA09T0538600ZY	0	-	0	0	2110	0.0000000
zheyou73v0_A09	57283485	57285150	BnaA09T0538700ZY	0	+	0	0	1665	0.0000000
zheyou73v0_A09	57303356	57303931	BnaA09T0538800ZY	0	-	0	0	575	0.0000000
zheyou73v0_A09	57304700	57306270	BnaA09T0538900ZY	0	-	0	0	1570	0.0000000
zheyou73v0_A09	57304700	57306270	BnaA09T0538900ZY.1	0	-	0	0	1570	0.0000000
zheyou73v0_A09	57312153	57316043	BnaA09T0539000ZY	0	+	0	0	3890	0.0000000
zheyou73v0_A09	57318591	57319506	BnaA09T0539100ZY	0	-	0	0	915	0.0000000
zheyou73v0_A09	57322182	57322899	BnaA09T0539200ZY	0	-	0	0	717	0.0000000
zheyou73v0_A09	57326260	57326547	BnaA09T0539300ZY	0	+	0	0	287	0.0000000
zheyou73v0_A09	57330462	57330813	BnaA09T0539400ZY	0	-	0	0	351	0.0000000
zheyou73v0_A09	57333256	57333469	BnaA09T0539500ZY	0	+	0	0	213	0.0000000
zheyou73v0_A09	57337425	57339107	BnaA09T0539600ZY	0	+	0	0	1682	0.0000000
zheyou73v0_A09	57339190	57343735	BnaA09T0539700ZY	0	-	0	0	4545	0.0000000
zheyou73v0_A09	57344898	57346450	BnaA09T0539800ZY	0	-	0	0	1552	0.0000000
zheyou73v0_A09	57346742	57348307	BnaA09T0539900ZY	0	-	0	0	1565	0.0000000
zheyou73v0_A09	57351587	57353986	BnaA09T0540000ZY	0	+	0	0	2399	0.0000000
zheyou73v0_A09	57351587	57353986	BnaA09T0540000ZY.1	0	+	0	0	2399	0.0000000
zheyou73v0_A09	57359496	57361811	BnaA09T0540100ZY	0	+	0	0	2315	0.0000000
zheyou73v0_A09	57361805	57362927	BnaA09T0540200ZY	0	-	0	0	1122	0.0000000
zheyou73v0_A09	57364391	57365484	BnaA09T0540300ZY	0	-	0	0	1093	0.0000000
zheyou73v0_A09	57367509	57368227	BnaA09T0540400ZY	0	+	0	0	718	0.0000000
zheyou73v0_A09	57381202	57384438	BnaA09T0540500ZY	0	+	0	0	3236	0.0000000
zheyou73v0_A09	57384914	57392160	BnaA09T0540600ZY	0	-	0	0	7246	0.0000000
zheyou73v0_A09	57402008	57402678	BnaA09T0540700ZY	0	-	0	0	670	0.0000000
zheyou73v0_A09	57411408	57413355	BnaA09T0540800ZY	0	-	0	0	1947	0.0000000
zheyou73v0_A09	57416419	57417779	BnaA09T0540900ZY	0	+	0	0	1360	0.0000000
zheyou73v0_A09	57416419	57418402	BnaA09T0540900ZY.1	0	+	0	0	1983	0.0000000
zheyou73v0_A09	57416419	57418402	BnaA09T0540900ZY.2	0	+	0	0	1983	0.0000000
zheyou73v0_A09	57418458	57420256	BnaA09T0541000ZY	0	-	0	0	1798	0.0000000
zheyou73v0_A09	57418458	57420256	BnaA09T0541000ZY.1	0	-	0	0	1798	0.0000000
zheyou73v0_A09	57420574	57423161	BnaA09T0541100ZY	0	-	0	0	2587	0.0000000
zheyou73v0_A09	57424984	57426234	BnaA09T0541200ZY	0	+	0	0	1250	0.0000000
zheyou73v0_A09	57429116	57430175	BnaA09T0541300ZY	0	+	0	0	1059	0.0000000
zheyou73v0_A09	57431274	57433240	BnaA09T0541400ZY	0	+	0	0	1966	0.0000000
zheyou73v0_A09	57436906	57442256	BnaA09T0541500ZY	0	+	0	0	5350	0.0000000
zheyou73v0_A09	57446052	57446966	BnaA09T0541600ZY	0	-	0	0	914	0.0000000
zheyou73v0_A09	57450398	57454437	BnaA09T0541700ZY	0	-	0	0	4039	0.0000000
zheyou73v0_A09	57455881	57457145	BnaA09T0541800ZY	0	+	0	0	1264	0.0000000
zheyou73v0_A09	57467216	57475577	BnaA09T0541900ZY	0	+	0	0	8361	0.0000000
zheyou73v0_A09	57476801	57478276	BnaA09T0542000ZY	0	+	0	0	1475	0.0000000
zheyou73v0_A09	57476801	57478276	BnaA09T0542000ZY.1	0	+	0	0	1475	0.0000000
zheyou73v0_A09	57476801	57478276	BnaA09T0542000ZY.2	0	+	0	0	1475	0.0000000
zheyou73v0_A09	57478285	57478968	BnaA09T0542100ZY	0	-	0	0	683	0.0000000
zheyou73v0_A09	57481941	57484299	BnaA09T0542200ZY	0	+	0	0	2358	0.0000000
zheyou73v0_A09	57485486	57486163	BnaA09T0542300ZY	0	-	0	0	677	0.0000000
zheyou73v0_A09	57486397	57488949	BnaA09T0542400ZY	0	+	0	0	2552	0.0000000
zheyou73v0_A09	57493195	57493694	BnaA09T0542500ZY	0	+	0	0	499	0.0000000
zheyou73v0_A09	57494030	57496114	BnaA09T0542600ZY	0	-	0	0	2084	0.0000000
zheyou73v0_A09	57503412	57506612	BnaA09T0542700ZY	0	-	0	0	3200	0.0000000
zheyou73v0_A09	57506960	57510221	BnaA09T0542800ZY	0	+	0	0	3261	0.0000000
zheyou73v0_A09	57510279	57513441	BnaA09T0542900ZY	0	-	0	0	3162	0.0000000
zheyou73v0_A09	57514505	57515681	BnaA09T0543000ZY	0	-	0	0	1176	0.0000000
zheyou73v0_A09	57516755	57517904	BnaA09T0543100ZY	0	-	0	0	1149	0.0000000
zheyou73v0_A09	57519322	57520227	BnaA09T0543200ZY	0	+	0	0	905	0.0000000
zheyou73v0_A09	57527464	57528636	BnaA09T0543300ZY	0	+	0	0	1172	0.0000000
zheyou73v0_A09	57534590	57536240	BnaA09T0543400ZY	0	-	0	0	1650	0.0000000
zheyou73v0_A09	57539440	57540542	BnaA09T0543500ZY	0	-	0	0	1102	0.0000000
zheyou73v0_A09	57540581	57545318	BnaA09T0543600ZY	0	-	0	0	4737	0.0000000
zheyou73v0_A09	57551696	57553863	BnaA09T0543700ZY	0	+	0	0	2167	0.0000000
zheyou73v0_A09	57554419	57557206	BnaA09T0543800ZY	0	-	0	0	2787	0.0000000
zheyou73v0_A09	57561564	57562628	BnaA09T0543900ZY	0	+	0	0	1064	0.0000000
zheyou73v0_A09	57563105	57563282	BnaA09T0544000ZY	0	+	0	0	177	0.0000000
zheyou73v0_A09	57563961	57565020	BnaA09T0544100ZY	0	-	0	0	1059	0.0000000
zheyou73v0_A09	57568566	57569007	BnaA09T0544200ZY	0	+	0	0	441	0.0000000
zheyou73v0_A09	57568841	57570440	BnaA09T0544300ZY	0	-	0	0	1599	0.0000000
zheyou73v0_A09	57570441	57574068	BnaA09T0544400ZY	0	-	0	0	3627	0.0000000
zheyou73v0_A09	57570441	57574068	BnaA09T0544400ZY.1	0	-	0	0	3627	0.0000000
zheyou73v0_A09	57570441	57574068	BnaA09T0544400ZY.2	0	-	0	0	3627	0.0000000
zheyou73v0_A09	57578089	57579909	BnaA09T0544500ZY	0	+	0	0	1820	0.0000000
zheyou73v0_A09	57581937	57582711	BnaA09T0544600ZY	0	+	0	0	774	0.0000000
zheyou73v0_A09	57586828	57589472	BnaA09T0544700ZY	0	+	0	0	2644	0.0000000
zheyou73v0_A09	57586828	57589472	BnaA09T0544700ZY.1	0	+	0	0	2644	0.0000000
zheyou73v0_A09	57589938	57590814	BnaA09T0544800ZY	0	+	0	0	876	0.0000000
zheyou73v0_A09	57591692	57595127	BnaA09T0544900ZY	0	-	0	0	3435	0.0000000
zheyou73v0_A09	57596500	57601829	BnaA09T0545000ZY	0	+	0	0	5329	0.0000000
zheyou73v0_A09	57602370	57608075	BnaA09T0545100ZY	0	+	0	0	5705	0.0000000
zheyou73v0_A09	57608696	57615229	BnaA09T0545200ZY	0	-	0	0	6533	0.0000000
zheyou73v0_A09	57617042	57622265	BnaA09T0545300ZY	0	-	0	0	5223	0.0000000
zheyou73v0_A09	57625005	57626715	BnaA09T0545400ZY	0	-	0	0	1710	0.0000000
zheyou73v0_A09	57628533	57632257	BnaA09T0545500ZY	0	-	0	0	3724	0.0000000
zheyou73v0_A09	57634357	57636523	BnaA09T0545600ZY	0	-	0	0	2166	0.0000000
zheyou73v0_A09	57634357	57636523	BnaA09T0545600ZY.1	0	-	0	0	2166	0.0000000
zheyou73v0_A09	57634357	57636523	BnaA09T0545600ZY.2	0	-	0	0	2166	0.0000000
zheyou73v0_A09	57637111	57644098	BnaA09T0545700ZY	0	-	0	0	6987	0.0000000
zheyou73v0_A09	57645695	57648246	BnaA09T0545800ZY	0	+	0	0	2551	0.0000000
zheyou73v0_A09	57648569	57651707	BnaA09T0545900ZY	0	-	0	0	3138	0.0000000
zheyou73v0_A09	57653656	57655979	BnaA09T0546000ZY	0	+	0	0	2323	0.0000000
zheyou73v0_A09	57656542	57657684	BnaA09T0546100ZY	0	-	0	0	1142	0.0000000
zheyou73v0_A09	57661318	57662554	BnaA09T0546200ZY	0	+	0	0	1236	0.0000000
zheyou73v0_A09	57662930	57666969	BnaA09T0546300ZY	0	+	0	0	4039	0.0000000
zheyou73v0_A09	57668110	57668412	BnaA09T0546400ZY	0	-	0	0	302	0.0000000
zheyou73v0_A09	57668949	57671401	BnaA09T0546500ZY	0	-	0	0	2452	0.0000000
zheyou73v0_A09	57671632	57673474	BnaA09T0546600ZY	0	+	0	0	1842	0.0000000
zheyou73v0_A09	57682240	57682759	BnaA09T0546700ZY	0	+	0	0	519	0.0000000
zheyou73v0_A09	57685802	57686580	BnaA09T0546800ZY	0	+	0	0	778	0.0000000
zheyou73v0_A09	57689847	57691482	BnaA09T0546900ZY	0	+	0	0	1635	0.0000000
zheyou73v0_A09	57692136	57693822	BnaA09T0547000ZY	0	+	0	0	1686	0.0000000
zheyou73v0_A09	57704670	57705413	BnaA09T0547100ZY	0	-	0	0	743	0.0000000
zheyou73v0_A09	57713826	57715604	BnaA09T0547200ZY	0	-	0	0	1778	0.0000000
zheyou73v0_A09	57713826	57715604	BnaA09T0547200ZY.1	0	-	0	0	1778	0.0000000
zheyou73v0_A09	57717689	57717971	BnaA09T0547300ZY	0	+	0	0	282	0.0000000
zheyou73v0_A09	57718971	57719370	BnaA09T0547400ZY	0	+	0	0	399	0.0000000
zheyou73v0_A09	57723122	57725383	BnaA09T0547500ZY	0	+	0	0	2261	0.0000000
zheyou73v0_A09	57725626	57727852	BnaA09T0547600ZY	0	-	0	0	2226	0.0000000
zheyou73v0_A09	57727946	57730523	BnaA09T0547700ZY	0	-	0	0	2577	0.0000000
zheyou73v0_A09	57727946	57730523	BnaA09T0547700ZY.1	0	-	0	0	2577	0.0000000
zheyou73v0_A09	57731394	57733938	BnaA09T0547800ZY	0	+	0	0	2544	0.0000000
zheyou73v0_A09	57731394	57733938	BnaA09T0547800ZY.1	0	+	0	0	2544	0.0000000
zheyou73v0_A09	57731394	57733938	BnaA09T0547800ZY.2	0	+	0	0	2544	0.0000000
zheyou73v0_A09	57736219	57737037	BnaA09T0547900ZY	0	+	0	0	818	0.0000000
zheyou73v0_A09	57737976	57738805	BnaA09T0548000ZY	0	+	0	0	829	0.0000000
zheyou73v0_A09	57743208	57745008	BnaA09T0548100ZY	0	+	0	0	1800	0.0000000
zheyou73v0_A09	57747207	57747896	BnaA09T0548200ZY	0	+	0	0	689	0.0000000
zheyou73v0_A09	57748301	57751535	BnaA09T0548300ZY	0	-	0	0	3234	0.0000000
zheyou73v0_A09	57757264	57757621	BnaA09T0548400ZY	0	+	0	0	357	0.0000000
zheyou73v0_A09	57760104	57762369	BnaA09T0548500ZY	0	-	0	0	2265	0.0000000
zheyou73v0_A09	57764154	57765577	BnaA09T0548600ZY	0	-	0	0	1423	0.0000000
zheyou73v0_A09	57766290	57768677	BnaA09T0548700ZY	0	-	0	0	2387	0.0000000
zheyou73v0_A09	57770733	57772896	BnaA09T0548800ZY	0	-	0	0	2163	0.0000000
zheyou73v0_A09	57777205	57778172	BnaA09T0548900ZY	0	+	0	0	967	0.0000000
zheyou73v0_A09	57780043	57780370	BnaA09T0549000ZY	0	+	0	0	327	0.0000000
zheyou73v0_A09	57783384	57784051	BnaA09T0549100ZY	0	+	0	0	667	0.0000000
zheyou73v0_A09	57793211	57796156	BnaA09T0549200ZY	0	+	0	0	2945	0.0000000
zheyou73v0_A09	57796477	57797685	BnaA09T0549300ZY	0	-	0	0	1208	0.0000000
zheyou73v0_A09	57799047	57800057	BnaA09T0549400ZY	0	-	0	0	1010	0.0000000
zheyou73v0_A09	57802648	57803073	BnaA09T0549500ZY	0	+	0	0	425	0.0000000
zheyou73v0_A09	57808646	57809456	BnaA09T0549600ZY	0	+	0	0	810	0.0000000
zheyou73v0_A09	57809460	57811140	BnaA09T0549700ZY	0	-	0	0	1680	0.0000000
zheyou73v0_A09	57813196	57813601	BnaA09T0549800ZY	0	+	0	0	405	0.0000000
zheyou73v0_A09	57813925	57815724	BnaA09T0549900ZY	0	+	0	0	1799	0.0000000
zheyou73v0_A09	57816584	57817451	BnaA09T0550000ZY	0	-	0	0	867	0.0000000
zheyou73v0_A09	57817760	57819137	BnaA09T0550100ZY	0	+	0	0	1377	0.0000000
zheyou73v0_A09	57822561	57824571	BnaA09T0550200ZY	0	-	0	0	2010	0.0000000
zheyou73v0_A09	57828252	57829571	BnaA09T0550300ZY	0	+	0	0	1319	0.0000000
zheyou73v0_A09	57830085	57832777	BnaA09T0550400ZY	0	-	0	0	2692	0.0000000
zheyou73v0_A09	57834850	57836440	BnaA09T0550500ZY	0	+	0	0	1590	0.0000000
zheyou73v0_A09	57837563	57837987	BnaA09T0550600ZY	0	-	0	0	424	0.0000000
zheyou73v0_A09	57839985	57841797	BnaA09T0550700ZY	0	+	0	0	1812	0.0000000
zheyou73v0_A09	57839985	57841797	BnaA09T0550700ZY.1	0	+	0	0	1812	0.0000000
zheyou73v0_A09	57843756	57845688	BnaA09T0550800ZY	0	+	0	0	1932	0.0000000
zheyou73v0_A09	57846751	57847257	BnaA09T0550900ZY	0	-	0	0	506	0.0000000
zheyou73v0_A09	57848300	57850498	BnaA09T0551000ZY	0	-	0	0	2198	0.0000000
zheyou73v0_A09	57848300	57850498	BnaA09T0551000ZY.1	0	-	0	0	2198	0.0000000
zheyou73v0_A09	57857064	57857684	BnaA09T0551100ZY	0	+	0	0	620	0.0000000
zheyou73v0_A09	57862766	57865228	BnaA09T0551200ZY	0	+	0	0	2462	0.0000000
zheyou73v0_A09	57864212	57865823	BnaA09T0551300ZY	0	-	0	0	1611	0.0000000
zheyou73v0_A09	57866296	57867071	BnaA09T0551400ZY	0	-	0	0	775	0.0000000
zheyou73v0_A09	57867311	57867761	BnaA09T0551500ZY	0	+	0	0	450	0.0000000
zheyou73v0_A09	57868489	57871189	BnaA09T0551600ZY	0	+	0	0	2700	0.0000000
zheyou73v0_A09	57874622	57875084	BnaA09T0551700ZY	0	+	0	0	462	0.0000000
zheyou73v0_A09	57877990	57878933	BnaA09T0551800ZY	0	+	0	0	943	0.0000000
zheyou73v0_A09	57879749	57880314	BnaA09T0551900ZY	0	-	0	0	565	0.0000000
zheyou73v0_A09	57880920	57888114	BnaA09T0552000ZY	0	-	0	0	7194	0.0000000
zheyou73v0_A09	57894085	57897553	BnaA09T0552100ZY	0	+	0	0	3468	0.0000000
zheyou73v0_A09	57897990	57900522	BnaA09T0552200ZY	0	+	0	0	2532	0.0000000
zheyou73v0_A09	57902848	57907456	BnaA09T0552300ZY	0	+	0	0	4608	0.0000000
zheyou73v0_A09	57907840	57908992	BnaA09T0552400ZY	0	-	0	0	1152	0.0000000
zheyou73v0_A09	57911133	57915032	BnaA09T0552500ZY	0	-	0	0	3899	0.0000000
zheyou73v0_A09	57926049	57928230	BnaA09T0552600ZY	0	+	0	0	2181	0.0000000
zheyou73v0_A09	57930942	57936912	BnaA09T0552700ZY	0	-	0	0	5970	0.0000000
zheyou73v0_A09	57938640	57939810	BnaA09T0552800ZY	0	-	0	0	1170	0.0000000
zheyou73v0_A09	57941971	57942685	BnaA09T0552900ZY	0	-	0	0	714	0.0000000
zheyou73v0_A09	57944456	57950513	BnaA09T0553000ZY	0	+	0	0	6057	0.0000000
zheyou73v0_A09	57950804	57954075	BnaA09T0553100ZY	0	-	0	0	3271	0.0000000
zheyou73v0_A09	57950804	57954075	BnaA09T0553100ZY.1	0	-	0	0	3271	0.0000000
zheyou73v0_A09	57950804	57954075	BnaA09T0553100ZY.2	0	-	0	0	3271	0.0000000
zheyou73v0_A09	57971006	57972272	BnaA09T0553200ZY	0	+	0	0	1266	0.0000000
zheyou73v0_A09	57984665	57986199	BnaA09T0553300ZY	0	+	0	0	1534	0.0000000
zheyou73v0_A09	57993628	57995265	BnaA09T0553400ZY	0	+	0	0	1637	0.0000000
zheyou73v0_A09	57996732	57997347	BnaA09T0553500ZY	0	+	0	0	615	0.0000000
zheyou73v0_A09	57997747	57998695	BnaA09T0553600ZY	0	-	0	0	948	0.0000000
zheyou73v0_A09	57999217	57999586	BnaA09T0553700ZY	0	+	0	0	369	0.0000000
zheyou73v0_A09	57999758	58000649	BnaA09T0553800ZY	0	-	0	0	891	0.0000000
zheyou73v0_A09	58001059	58001942	BnaA09T0553900ZY	0	-	0	0	883	0.0000000
zheyou73v0_A09	58005380	58012803	BnaA09T0554000ZY	0	+	0	0	7423	0.0000000
zheyou73v0_A09	58014916	58016237	BnaA09T0554100ZY	0	+	0	0	1321	0.0000000
zheyou73v0_A09	58017184	58019910	BnaA09T0554200ZY	0	+	0	0	2726	0.0000000
zheyou73v0_A09	58023878	58031139	BnaA09T0554300ZY	0	+	0	0	7261	0.0000000
zheyou73v0_A09	58031302	58033661	BnaA09T0554400ZY	0	-	0	0	2359	0.0000000
zheyou73v0_A09	58034157	58035581	BnaA09T0554500ZY	0	-	0	0	1424	0.0000000
zheyou73v0_A09	58036126	58039172	BnaA09T0554600ZY	0	-	0	0	3046	0.0000000
zheyou73v0_A09	58040005	58042133	BnaA09T0554700ZY	0	-	0	0	2128	0.0000000
zheyou73v0_A09	58042474	58044749	BnaA09T0554800ZY	0	-	0	0	2275	0.0000000
zheyou73v0_A09	58046696	58049831	BnaA09T0554900ZY	0	+	0	0	3135	0.0000000
zheyou73v0_A09	58049885	58051767	BnaA09T0555000ZY	0	-	0	0	1882	0.0000000
zheyou73v0_A09	58064464	58066262	BnaA09T0555100ZY	0	-	0	0	1798	0.0000000
zheyou73v0_A09	58064464	58066310	BnaA09T0555100ZY.1	0	-	0	0	1846	0.0000000
zheyou73v0_A09	58068029	58069692	BnaA09T0555200ZY	0	+	0	0	1663	0.0000000
zheyou73v0_A09	58070431	58074508	BnaA09T0555300ZY	0	+	0	0	4077	0.0000000
zheyou73v0_A09	58075413	58081946	BnaA09T0555400ZY	0	+	0	0	6533	0.0000000
zheyou73v0_A09	58083102	58083708	BnaA09T0555500ZY	0	-	0	0	606	0.0000000
zheyou73v0_A09	58091120	58092746	BnaA09T0555600ZY	0	-	0	0	1626	0.0000000
zheyou73v0_A09	58096168	58099133	BnaA09T0555700ZY	0	+	0	0	2965	0.0000000
zheyou73v0_A09	58096168	58099133	BnaA09T0555700ZY.1	0	+	0	0	2965	0.0000000
zheyou73v0_A09	58096168	58099133	BnaA09T0555700ZY.2	0	+	0	0	2965	0.0000000
zheyou73v0_A09	58096168	58099133	BnaA09T0555700ZY.3	0	+	0	0	2965	0.0000000
zheyou73v0_A09	58096168	58099133	BnaA09T0555700ZY.4	0	+	0	0	2965	0.0000000
zheyou73v0_A09	58096168	58099133	BnaA09T0555700ZY.5	0	+	0	0	2965	0.0000000
zheyou73v0_A09	58101778	58102828	BnaA09T0555800ZY	0	-	0	0	1050	0.0000000
zheyou73v0_A09	58117450	58120082	BnaA09T0555900ZY	0	+	0	0	2632	0.0000000
zheyou73v0_A09	58121842	58124134	BnaA09T0556000ZY	0	-	0	0	2292	0.0000000
zheyou73v0_A09	58129112	58130230	BnaA09T0556100ZY	0	+	0	0	1118	0.0000000
zheyou73v0_A09	58131044	58136469	BnaA09T0556200ZY	0	-	0	0	5425	0.0000000
zheyou73v0_A09	58140305	58141527	BnaA09T0556300ZY	0	+	0	0	1222	0.0000000
zheyou73v0_A09	58141607	58142183	BnaA09T0556400ZY	0	+	0	0	576	0.0000000
zheyou73v0_A09	58144752	58146771	BnaA09T0556500ZY	0	-	0	0	2019	0.0000000
zheyou73v0_A09	58151664	58152577	BnaA09T0556600ZY.2	0	-	0	0	913	0.0000000
zheyou73v0_A09	58151664	58152577	BnaA09T0556600ZY.3	0	-	0	0	913	0.0000000
zheyou73v0_A09	58151724	58152577	BnaA09T0556600ZY	0	-	0	0	853	0.0000000
zheyou73v0_A09	58151724	58152577	BnaA09T0556600ZY.1	0	-	0	0	853	0.0000000
zheyou73v0_A09	58153787	58154874	BnaA09T0556700ZY	0	-	0	0	1087	0.0000000
zheyou73v0_A09	58155366	58158947	BnaA09T0556800ZY	0	-	0	0	3581	0.0000000
zheyou73v0_A09	58159853	58164992	BnaA09T0556900ZY	0	-	0	0	5139	0.0000000
zheyou73v0_A09	58165541	58167478	BnaA09T0557000ZY	0	-	0	0	1937	0.0000000
zheyou73v0_A09	58169721	58170194	BnaA09T0557100ZY	0	-	0	0	473	0.0000000
zheyou73v0_A09	58174374	58175495	BnaA09T0557200ZY	0	+	0	0	1121	0.0000000
zheyou73v0_A09	58176173	58177786	BnaA09T0557300ZY	0	+	0	0	1613	0.0000000
zheyou73v0_A09	58178460	58179105	BnaA09T0557400ZY	0	+	0	0	645	0.0000000
zheyou73v0_A09	58179840	58185005	BnaA09T0557500ZY	0	-	0	0	5165	0.0000000
zheyou73v0_A09	58186924	58192942	BnaA09T0557600ZY	0	+	0	0	6018	0.0000000
zheyou73v0_A09	58186924	58192970	BnaA09T0557600ZY.1	0	+	0	0	6046	0.0000000
zheyou73v0_A09	58194880	58197748	BnaA09T0557700ZY	0	+	0	0	2868	0.0000000
zheyou73v0_A09	58194880	58197748	BnaA09T0557700ZY.1	0	+	0	0	2868	0.0000000
zheyou73v0_A09	58197531	58199952	BnaA09T0557800ZY	0	-	0	0	2421	0.0000000
zheyou73v0_A09	58204948	58207445	BnaA09T0557900ZY	0	-	0	0	2497	0.0000000
zheyou73v0_A09	58210190	58210954	BnaA09T0558000ZY	0	+	0	0	764	0.0000000
zheyou73v0_A09	58217411	58217857	BnaA09T0558100ZY	0	+	0	0	446	0.0000000
zheyou73v0_A09	58220704	58221937	BnaA09T0558200ZY	0	-	0	0	1233	0.0000000
zheyou73v0_A09	58227762	58229172	BnaA09T0558300ZY	0	-	0	0	1410	0.0000000
zheyou73v0_A09	58232107	58233950	BnaA09T0558400ZY	0	+	0	0	1843	0.0000000
zheyou73v0_A09	58232107	58233413	BnaA09T0558400ZY.1	0	+	0	0	1306	0.0000000
zheyou73v0_A09	58237556	58239857	BnaA09T0558500ZY	0	-	0	0	2301	0.0000000
zheyou73v0_A09	58240271	58241870	BnaA09T0558600ZY	0	+	0	0	1599	0.0000000
zheyou73v0_A09	58242861	58244187	BnaA09T0558700ZY	0	+	0	0	1326	0.0000000
zheyou73v0_A09	58245888	58248458	BnaA09T0558800ZY	0	+	0	0	2570	0.0000000
zheyou73v0_A09	58249702	58253031	BnaA09T0558900ZY	0	-	0	0	3329	0.0000000
zheyou73v0_A09	58264791	58270276	BnaA09T0559000ZY	0	-	0	0	5485	0.0000000
zheyou73v0_A09	58264791	58270276	BnaA09T0559000ZY.1	0	-	0	0	5485	0.0000000
zheyou73v0_A09	58270501	58271996	BnaA09T0559100ZY	0	+	0	0	1495	0.0000000
zheyou73v0_A09	58277858	58281319	BnaA09T0559200ZY	0	-	0	0	3461	0.0000000
zheyou73v0_A09	58282182	58285656	BnaA09T0559300ZY	0	-	0	0	3474	0.0000000
zheyou73v0_A09	58292832	58293078	BnaA09T0559400ZY	0	-	0	0	246	0.0000000
zheyou73v0_A09	58299418	58300886	BnaA09T0559500ZY	0	-	0	0	1468	0.0000000
zheyou73v0_A09	58306215	58307441	BnaA09T0559600ZY	0	+	0	0	1226	0.0000000
zheyou73v0_A09	58307597	58308068	BnaA09T0559700ZY	0	-	0	0	471	0.0000000
zheyou73v0_A09	58308704	58309667	BnaA09T0559800ZY	0	-	0	0	963	0.0000000
zheyou73v0_A09	58310205	58313464	BnaA09T0559900ZY	0	-	0	0	3259	0.0000000
zheyou73v0_A09	58315232	58318926	BnaA09T0560000ZY	0	+	0	0	3694	0.0000000
zheyou73v0_A09	58319292	58322389	BnaA09T0560100ZY	0	-	0	0	3097	0.0000000
zheyou73v0_A09	58328948	58340617	BnaA09T0560200ZY	0	-	0	0	11669	0.0000000
zheyou73v0_A09	58342428	58346326	BnaA09T0560300ZY	0	+	0	0	3898	0.0000000
zheyou73v0_A09	58346725	58348177	BnaA09T0560400ZY	0	-	0	0	1452	0.0000000
zheyou73v0_A09	58349471	58349807	BnaA09T0560500ZY	0	-	0	0	336	0.0000000
zheyou73v0_A09	58352176	58353260	BnaA09T0560600ZY	0	-	0	0	1084	0.0000000
zheyou73v0_A09	58356083	58356851	BnaA09T0560700ZY	0	-	0	0	768	0.0000000
zheyou73v0_A09	58361295	58362296	BnaA09T0560800ZY	0	-	0	0	1001	0.0000000
zheyou73v0_A09	58373336	58377615	BnaA09T0560900ZY	0	-	0	0	4279	0.0000000
zheyou73v0_A09	58381415	58381996	BnaA09T0561000ZY	0	-	0	0	581	0.0000000
zheyou73v0_A09	58389093	58390000	BnaA09T0561100ZY	0	+	0	0	907	0.0000000
zheyou73v0_A09	58392331	58393658	BnaA09T0561200ZY	0	-	0	0	1327	0.0000000
zheyou73v0_A09	58393817	58396757	BnaA09T0561300ZY	0	+	0	0	2940	0.0000000
zheyou73v0_A09	58398459	58400185	BnaA09T0561400ZY	0	+	0	0	1726	0.0000000
zheyou73v0_A09	58401182	58402912	BnaA09T0561500ZY	0	-	0	0	1730	0.0000000
zheyou73v0_A09	58403800	58408834	BnaA09T0561600ZY	0	+	0	0	5034	0.0000000
zheyou73v0_A09	58409236	58411290	BnaA09T0561700ZY	0	+	0	0	2054	0.0000000
zheyou73v0_A09	58411735	58413626	BnaA09T0561800ZY	0	-	0	0	1891	0.0000000
zheyou73v0_A09	58414834	58416208	BnaA09T0561900ZY	0	-	0	0	1374	0.0000000
zheyou73v0_A09	58417484	58425405	BnaA09T0562000ZY	0	+	0	0	7921	0.0000000
zheyou73v0_A09	58426874	58428345	BnaA09T0562100ZY	0	-	0	0	1471	0.0000000
zheyou73v0_A09	58431343	58433224	BnaA09T0562200ZY	0	+	0	0	1881	0.0000000
zheyou73v0_A09	58433882	58437218	BnaA09T0562300ZY	0	+	0	0	3336	0.0000000
zheyou73v0_A09	58437498	58438650	BnaA09T0562400ZY	0	-	0	0	1152	0.0000000
zheyou73v0_A09	58441676	58443752	BnaA09T0562500ZY	0	+	0	0	2076	0.0000000
zheyou73v0_A09	58444679	58448024	BnaA09T0562600ZY	0	+	0	0	3345	0.0000000
zheyou73v0_A09	58450175	58451820	BnaA09T0562700ZY	0	+	0	0	1645	0.0000000
zheyou73v0_A09	58453558	58454104	BnaA09T0562800ZY	0	-	0	0	546	0.0000000
zheyou73v0_A09	58457899	58463235	BnaA09T0562900ZY	0	-	0	0	5336	0.0000000
zheyou73v0_A09	58482708	58484123	BnaA09T0563000ZY	0	+	0	0	1415	0.0000000
zheyou73v0_A09	58484429	58486368	BnaA09T0563100ZY	0	-	0	0	1939	0.0000000
zheyou73v0_A09	58491353	58500674	BnaA09T0563200ZY	0	-	0	0	9321	0.0000000
zheyou73v0_A09	58511615	58511984	BnaA09T0563300ZY	0	+	0	0	369	0.0000000
zheyou73v0_A09	58516844	58517786	BnaA09T0563400ZY	0	+	0	0	942	0.0000000
zheyou73v0_A09	58518547	58520177	BnaA09T0563500ZY	0	+	0	0	1630	0.0000000
zheyou73v0_A09	58520775	58525957	BnaA09T0563600ZY	0	-	0	0	5182	0.0000000
zheyou73v0_A09	58532209	58533327	BnaA09T0563700ZY	0	-	0	0	1118	0.0000000
zheyou73v0_A09	58537189	58539817	BnaA09T0563800ZY	0	+	0	0	2628	0.0000000
zheyou73v0_A09	58540291	58545049	BnaA09T0563900ZY	0	-	0	0	4758	0.0000000
zheyou73v0_A09	58561342	58562924	BnaA09T0564000ZY	0	+	0	0	1582	0.0000000
zheyou73v0_A09	58564196	58566990	BnaA09T0564100ZY	0	+	0	0	2794	0.0000000
zheyou73v0_A09	58567242	58571419	BnaA09T0564200ZY	0	-	0	0	4177	0.0000000
zheyou73v0_A09	58579850	58585197	BnaA09T0564300ZY	0	-	0	0	5347	0.0000000
zheyou73v0_A09	58591272	58596101	BnaA09T0564400ZY	0	-	0	0	4829	0.0000000
zheyou73v0_A09	58613612	58614233	BnaA09T0564500ZY	0	+	0	0	621	0.0000000
zheyou73v0_A09	58614877	58618153	BnaA09T0564600ZY	0	-	0	0	3276	0.0000000
zheyou73v0_A09	58619190	58619598	BnaA09T0564700ZY	0	-	0	0	408	0.0000000
zheyou73v0_A09	58621424	58623269	BnaA09T0564800ZY	0	+	0	0	1845	0.0000000
zheyou73v0_A09	58626920	58630215	BnaA09T0564900ZY	0	-	0	0	3295	0.0000000
zheyou73v0_A09	58631958	58632911	BnaA09T0565000ZY	0	-	0	0	953	0.0000000
zheyou73v0_A09	58641345	58642260	BnaA09T0565100ZY	0	-	0	0	915	0.0000000
zheyou73v0_A09	58643733	58644514	BnaA09T0565200ZY	0	-	0	0	781	0.0000000
zheyou73v0_A09	58647446	58650123	BnaA09T0565300ZY	0	+	0	0	2677	0.0000000
zheyou73v0_A09	58654141	58654926	BnaA09T0565400ZY	0	-	0	0	785	0.0000000
zheyou73v0_A09	58655663	58656253	BnaA09T0565500ZY	0	+	0	0	590	0.0000000
zheyou73v0_A09	58656946	58657359	BnaA09T0565600ZY	0	-	0	0	413	0.0000000
zheyou73v0_A09	58664958	58668513	BnaA09T0565700ZY	0	-	0	0	3555	0.0000000
zheyou73v0_A09	58664958	58668513	BnaA09T0565700ZY.1	0	-	0	0	3555	0.0000000
zheyou73v0_A09	58664958	58668513	BnaA09T0565700ZY.2	0	-	0	0	3555	0.0000000
zheyou73v0_A09	58664958	58668513	BnaA09T0565700ZY.3	0	-	0	0	3555	0.0000000
zheyou73v0_A09	58665199	58666463	BnaA09T0565800ZY	0	+	0	0	1264	0.0000000
zheyou73v0_A09	58675252	58677169	BnaA09T0565900ZY	0	-	0	0	1917	0.0000000
zheyou73v0_A09	58679223	58680033	BnaA09T0566000ZY	0	+	0	0	810	0.0000000
zheyou73v0_A09	58680918	58681900	BnaA09T0566100ZY	0	+	0	0	982	0.0000000
zheyou73v0_A09	58681977	58684634	BnaA09T0566200ZY	0	-	0	0	2657	0.0000000
zheyou73v0_A09	58691307	58694590	BnaA09T0566300ZY	0	+	0	0	3283	0.0000000
zheyou73v0_A09	58695430	58697371	BnaA09T0566400ZY	0	-	0	0	1941	0.0000000
zheyou73v0_A09	58701530	58703598	BnaA09T0566500ZY	0	-	0	0	2068	0.0000000
zheyou73v0_A09	58712112	58715211	BnaA09T0566600ZY	0	-	0	0	3099	0.0000000
zheyou73v0_A09	58717707	58719385	BnaA09T0566700ZY	0	+	0	0	1678	0.0000000
zheyou73v0_A09	58719480	58720108	BnaA09T0566800ZY	0	+	0	0	628	0.0000000
zheyou73v0_A09	58720402	58722262	BnaA09T0566900ZY	0	+	0	0	1860	0.0000000
zheyou73v0_A09	58723102	58724153	BnaA09T0567000ZY	0	+	0	0	1051	0.0000000
zheyou73v0_A09	58724269	58725382	BnaA09T0567100ZY	0	+	0	0	1113	0.0000000
zheyou73v0_A09	58724269	58725382	BnaA09T0567100ZY.1	0	+	0	0	1113	0.0000000
zheyou73v0_A09	58742018	58743040	BnaA09T0567200ZY	0	-	0	0	1022	0.0000000
zheyou73v0_A09	58748050	58749302	BnaA09T0567300ZY	0	-	0	0	1252	0.0000000
zheyou73v0_A09	58749683	58759035	BnaA09T0567400ZY	0	+	0	0	9352	0.0000000
zheyou73v0_A09	58759240	58763302	BnaA09T0567500ZY	0	-	0	0	4062	0.0000000
zheyou73v0_A09	58763978	58774115	BnaA09T0567600ZY	0	-	0	0	10137	0.0000000
zheyou73v0_A09	58775384	58777084	BnaA09T0567700ZY	0	-	0	0	1700	0.0000000
zheyou73v0_A09	58781175	58782787	BnaA09T0567800ZY	0	+	0	0	1612	0.0000000
zheyou73v0_A09	58784965	58788014	BnaA09T0567900ZY	0	+	0	0	3049	0.0000000
zheyou73v0_A09	58784965	58788014	BnaA09T0567900ZY.1	0	+	0	0	3049	0.0000000
zheyou73v0_A09	58788191	58789305	BnaA09T0568000ZY	0	-	0	0	1114	0.0000000
zheyou73v0_A09	58789463	58792256	BnaA09T0568100ZY	0	+	0	0	2793	0.0000000
zheyou73v0_A09	58789463	58792256	BnaA09T0568100ZY.1	0	+	0	0	2793	0.0000000
zheyou73v0_A09	58795936	58797212	BnaA09T0568200ZY	0	+	0	0	1276	0.0000000
zheyou73v0_A09	58804541	58804982	BnaA09T0568300ZY	0	+	0	0	441	0.0000000
zheyou73v0_A09	58808050	58809176	BnaA09T0568400ZY	0	-	0	0	1126	0.0000000
zheyou73v0_A09	58820723	58821974	BnaA09T0568500ZY	0	+	0	0	1251	0.0000000
zheyou73v0_A09	58828792	58830102	BnaA09T0568600ZY	0	-	0	0	1310	0.0000000
zheyou73v0_A09	58833195	58843391	BnaA09T0568700ZY	0	+	0	0	10196	0.0000000
zheyou73v0_A09	58843834	58846494	BnaA09T0568800ZY	0	-	0	0	2660	0.0000000
zheyou73v0_A09	58848766	58851665	BnaA09T0568900ZY	0	+	0	0	2899	0.0000000
zheyou73v0_A09	58852239	58855129	BnaA09T0569000ZY	0	+	0	0	2890	0.0000000
zheyou73v0_A09	58855547	58860351	BnaA09T0569100ZY	0	-	0	0	4804	0.0000000
zheyou73v0_A09	58862917	58864649	BnaA09T0569200ZY	0	+	0	0	1732	0.0000000
zheyou73v0_A09	58862917	58864649	BnaA09T0569200ZY.1	0	+	0	0	1732	0.0000000
zheyou73v0_A09	58865436	58867060	BnaA09T0569300ZY	0	-	0	0	1624	0.0000000
zheyou73v0_A09	58867538	58869595	BnaA09T0569400ZY	0	-	0	0	2057	0.0000000
zheyou73v0_A09	58869753	58870757	BnaA09T0569500ZY	0	+	0	0	1004	0.0000000
zheyou73v0_A09	58870802	58873058	BnaA09T0569600ZY	0	-	0	0	2256	0.0000000
zheyou73v0_A09	58874699	58875918	BnaA09T0569700ZY	0	-	0	0	1219	0.0000000
zheyou73v0_A09	58876607	58882227	BnaA09T0569800ZY	0	-	0	0	5620	0.0000000
zheyou73v0_A09	58882540	58884425	BnaA09T0569900ZY	0	-	0	0	1885	0.0000000
zheyou73v0_A09	58885298	58888580	BnaA09T0570000ZY	0	-	0	0	3282	0.0000000
zheyou73v0_A09	58885298	58888580	BnaA09T0570000ZY.1	0	-	0	0	3282	0.0000000
zheyou73v0_A09	58885302	58885729	BnaA09T0570100ZY	0	+	0	0	427	0.0000000
zheyou73v0_A09	58890492	58892066	BnaA09T0570200ZY	0	+	0	0	1574	0.0000000
zheyou73v0_A09	58892413	58900194	BnaA09T0570300ZY	0	-	0	0	7781	0.0000000
zheyou73v0_A09	58901491	58902354	BnaA09T0570400ZY	0	-	0	0	863	0.0000000
zheyou73v0_A09	58903639	58907029	BnaA09T0570500ZY	0	-	0	0	3390	0.0000000
zheyou73v0_A09	58903639	58906803	BnaA09T0570500ZY.1	0	-	0	0	3164	0.0000000
zheyou73v0_A09	58907309	58908872	BnaA09T0570600ZY	0	+	0	0	1563	0.0000000
zheyou73v0_A09	58909348	58912278	BnaA09T0570700ZY	0	-	0	0	2930	0.0000000
zheyou73v0_A09	58913858	58914542	BnaA09T0570800ZY	0	+	0	0	684	0.0000000
zheyou73v0_A09	58915712	58917215	BnaA09T0570900ZY	0	+	0	0	1503	0.0000000
zheyou73v0_A09	58917532	58919055	BnaA09T0571000ZY	0	+	0	0	1523	0.0000000
zheyou73v0_A09	58918913	58920598	BnaA09T0571100ZY	0	-	0	0	1685	0.0000000
zheyou73v0_A09	58923462	58924708	BnaA09T0571200ZY	0	+	0	0	1246	0.0000000
zheyou73v0_A09	58938696	58942280	BnaA09T0571300ZY	0	+	0	0	3584	0.0000000
zheyou73v0_A09	58950045	58955956	BnaA09T0571400ZY	0	+	0	0	5911	0.0000000
zheyou73v0_A09	58956716	58961844	BnaA09T0571500ZY	0	-	0	0	5128	0.0000000
zheyou73v0_A09	58967509	58968946	BnaA09T0571600ZY	0	-	0	0	1437	0.0000000
zheyou73v0_A09	58978044	58980948	BnaA09T0571700ZY	0	-	0	0	2904	0.0000000
zheyou73v0_A09	58982977	58984678	BnaA09T0571800ZY	0	-	0	0	1701	0.0000000
zheyou73v0_A09	59011914	59013519	BnaA09T0571900ZY	0	+	0	0	1605	0.0000000
zheyou73v0_A09	59020706	59022900	BnaA09T0572000ZY	0	+	0	0	2194	0.0000000
zheyou73v0_A09	59023732	59024166	BnaA09T0572100ZY	0	+	0	0	434	0.0000000
zheyou73v0_A09	59024714	59026449	BnaA09T0572200ZY	0	-	0	0	1735	0.0000000
zheyou73v0_A09	59027616	59029249	BnaA09T0572300ZY	0	-	0	0	1633	0.0000000
zheyou73v0_A09	59027616	59029249	BnaA09T0572300ZY.1	0	-	0	0	1633	0.0000000
zheyou73v0_A09	59027616	59029089	BnaA09T0572300ZY.2	0	-	0	0	1473	0.0000000
zheyou73v0_A09	59038489	59039628	BnaA09T0572400ZY	0	+	0	0	1139	0.0000000
zheyou73v0_A09	59041040	59041547	BnaA09T0572500ZY	0	-	0	0	507	0.0000000
zheyou73v0_A09	59042988	59043437	BnaA09T0572600ZY	0	+	0	0	449	0.0000000
zheyou73v0_A09	59043818	59044735	BnaA09T0572700ZY	0	-	0	0	917	0.0000000
zheyou73v0_A09	59047616	59047847	BnaA09T0572800ZY	0	+	0	0	231	0.0000000
zheyou73v0_A09	59049028	59050284	BnaA09T0572900ZY	0	-	0	0	1256	0.0000000
zheyou73v0_A09	59054166	59055572	BnaA09T0573000ZY	0	-	0	0	1406	0.0000000
zheyou73v0_A09	59059206	59060424	BnaA09T0573100ZY	0	-	0	0	1218	0.0000000
zheyou73v0_A09	59062334	59063199	BnaA09T0573200ZY	0	+	0	0	865	0.0000000
zheyou73v0_A09	59063704	59064990	BnaA09T0573300ZY	0	+	0	0	1286	0.0000000
zheyou73v0_A09	59065471	59067292	BnaA09T0573400ZY	0	+	0	0	1821	0.0000000
zheyou73v0_A09	59069710	59070290	BnaA09T0573500ZY	0	-	0	0	580	0.0000000
zheyou73v0_A09	59072991	59074514	BnaA09T0573600ZY	0	+	0	0	1523	0.0000000
zheyou73v0_A09	59074368	59074926	BnaA09T0573700ZY	0	-	0	0	558	0.0000000
zheyou73v0_A09	59075276	59080270	BnaA09T0573800ZY	0	-	0	0	4994	0.0000000
zheyou73v0_A09	59088576	59090431	BnaA09T0573900ZY	0	-	0	0	1855	0.0000000
zheyou73v0_A09	59093424	59097320	BnaA09T0574000ZY	0	+	0	0	3896	0.0000000
zheyou73v0_A09	59097823	59098600	BnaA09T0574100ZY	0	-	0	0	777	0.0000000
zheyou73v0_A09	59099468	59102260	BnaA09T0574200ZY	0	-	0	0	2792	0.0000000
zheyou73v0_A09	59099468	59101887	BnaA09T0574200ZY.1	0	-	0	0	2419	0.0000000
zheyou73v0_A09	59099468	59101887	BnaA09T0574200ZY.2	0	-	0	0	2419	0.0000000
zheyou73v0_A09	59114745	59120340	BnaA09T0574300ZY	0	-	0	0	5595	0.0000000
zheyou73v0_A09	59125836	59128126	BnaA09T0574400ZY	0	-	0	0	2290	0.0000000
zheyou73v0_A09	59129131	59131916	BnaA09T0574500ZY	0	+	0	0	2785	0.0000000
zheyou73v0_A09	59136430	59139846	BnaA09T0574600ZY.1	0	-	0	0	3416	0.0000000
zheyou73v0_A09	59136452	59137595	BnaA09T0574700ZY	0	+	0	0	1143	0.0000000
zheyou73v0_A09	59137806	59139846	BnaA09T0574600ZY	0	-	0	0	2040	0.0000000
zheyou73v0_A09	59141420	59143480	BnaA09T0574800ZY	0	+	0	0	2060	0.0000000
zheyou73v0_A09	59144365	59145715	BnaA09T0574900ZY	0	-	0	0	1350	0.0000000
zheyou73v0_A09	59146322	59147456	BnaA09T0575000ZY	0	+	0	0	1134	0.0000000
zheyou73v0_A09	59149031	59151597	BnaA09T0575100ZY	0	+	0	0	2566	0.0000000
zheyou73v0_A09	59152787	59154100	BnaA09T0575200ZY	0	-	0	0	1313	0.0000000
zheyou73v0_A09	59155510	59157654	BnaA09T0575300ZY	0	+	0	0	2144	0.0000000
zheyou73v0_A09	59165601	59168724	BnaA09T0575400ZY	0	+	0	0	3123	0.0000000
zheyou73v0_A09	59171362	59172258	BnaA09T0575500ZY	0	+	0	0	896	0.0000000
zheyou73v0_A09	59176954	59177116	BnaA09T0575600ZY	0	-	0	0	162	0.0000000
zheyou73v0_A09	59178582	59179841	BnaA09T0575700ZY	0	-	0	0	1259	0.0000000
zheyou73v0_A09	59182431	59188210	BnaA09T0575800ZY	0	+	0	0	5779	0.0000000
zheyou73v0_A09	59191457	59194948	BnaA09T0575900ZY	0	+	0	0	3491	0.0000000
zheyou73v0_A09	59195703	59199269	BnaA09T0576000ZY	0	+	0	0	3566	0.0000000
zheyou73v0_A09	59199884	59201294	BnaA09T0576100ZY	0	+	0	0	1410	0.0000000
zheyou73v0_A09	59202340	59203889	BnaA09T0576200ZY	0	+	0	0	1549	0.0000000
zheyou73v0_A09	59204719	59208118	BnaA09T0576300ZY	0	-	0	0	3399	0.0000000
zheyou73v0_A09	59212640	59213334	BnaA09T0576400ZY	0	+	0	0	694	0.0000000
zheyou73v0_A09	59214702	59217346	BnaA09T0576500ZY	0	+	0	0	2644	0.0000000
zheyou73v0_A09	59218054	59219110	BnaA09T0576600ZY	0	-	0	0	1056	0.0000000
zheyou73v0_A09	59225264	59227206	BnaA09T0576700ZY	0	+	0	0	1942	0.0000000
zheyou73v0_A09	59230436	59232869	BnaA09T0576800ZY	0	+	0	0	2433	0.0000000
zheyou73v0_A09	59230436	59232869	BnaA09T0576800ZY.1	0	+	0	0	2433	0.0000000
zheyou73v0_A09	59240474	59244064	BnaA09T0576900ZY	0	+	0	0	3590	0.0000000
zheyou73v0_A09	59240474	59244064	BnaA09T0576900ZY.1	0	+	0	0	3590	0.0000000
zheyou73v0_A09	59246462	59246927	BnaA09T0577000ZY	0	-	0	0	465	0.0000000
zheyou73v0_A09	59247640	59247937	BnaA09T0577100ZY	0	+	0	0	297	0.0000000
zheyou73v0_A09	59248735	59249487	BnaA09T0577200ZY	0	-	0	0	752	0.0000000
zheyou73v0_A09	59250675	59252214	BnaA09T0577300ZY	0	-	0	0	1539	0.0000000
zheyou73v0_A09	59269956	59270465	BnaA09T0577400ZY	0	-	0	0	509	0.0000000
zheyou73v0_A09	59274233	59276343	BnaA09T0577500ZY	0	-	0	0	2110	0.0000000
zheyou73v0_A09	59276438	59277730	BnaA09T0577600ZY	0	-	0	0	1292	0.0000000
zheyou73v0_A09	59283948	59289774	BnaA09T0577700ZY	0	+	0	0	5826	0.0000000
zheyou73v0_A09	59290739	59293756	BnaA09T0577800ZY	0	+	0	0	3017	0.0000000
zheyou73v0_A09	59300399	59302796	BnaA09T0577900ZY	0	+	0	0	2397	0.0000000
zheyou73v0_A09	59311029	59312306	BnaA09T0578000ZY	0	-	0	0	1277	0.0000000
zheyou73v0_A09	59323328	59325384	BnaA09T0578100ZY	0	-	0	0	2056	0.0000000
zheyou73v0_A09	59327289	59329032	BnaA09T0578200ZY	0	+	0	0	1743	0.0000000
zheyou73v0_A09	59332761	59333427	BnaA09T0578300ZY	0	+	0	0	666	0.0000000
zheyou73v0_A09	59334472	59336481	BnaA09T0578400ZY	0	+	0	0	2009	0.0000000
zheyou73v0_A09	59336407	59338065	BnaA09T0578500ZY	0	-	0	0	1658	0.0000000
zheyou73v0_A09	59338704	59345514	BnaA09T0578600ZY	0	-	0	0	6810	0.0000000
zheyou73v0_A09	59347849	59348873	BnaA09T0578700ZY	0	-	0	0	1024	0.0000000
zheyou73v0_A09	59359064	59360997	BnaA09T0578800ZY	0	+	0	0	1933	0.0000000
zheyou73v0_A09	59364354	59366154	BnaA09T0578900ZY	0	-	0	0	1800	0.0000000
zheyou73v0_A09	59367412	59369424	BnaA09T0579000ZY	0	+	0	0	2012	0.0000000
zheyou73v0_A09	59369971	59371361	BnaA09T0579100ZY	0	+	0	0	1390	0.0000000
zheyou73v0_A09	59371491	59373815	BnaA09T0579200ZY	0	-	0	0	2324	0.0000000
zheyou73v0_A09	59380112	59382069	BnaA09T0579300ZY	0	+	0	0	1957	0.0000000
zheyou73v0_A09	59391570	59392848	BnaA09T0579400ZY	0	+	0	0	1278	0.0000000
zheyou73v0_A09	59392895	59393267	BnaA09T0579500ZY	0	+	0	0	372	0.0000000
zheyou73v0_A09	59394457	59395625	BnaA09T0579600ZY	0	-	0	0	1168	0.0000000
zheyou73v0_A09	59397095	59398727	BnaA09T0579700ZY	0	-	0	0	1632	0.0000000
zheyou73v0_A09	59401280	59401848	BnaA09T0579800ZY	0	+	0	0	568	0.0000000
zheyou73v0_A09	59406057	59407582	BnaA09T0579900ZY	0	-	0	0	1525	0.0000000
zheyou73v0_A09	59409375	59410854	BnaA09T0580000ZY	0	-	0	0	1479	0.0000000
zheyou73v0_A09	59412006	59413042	BnaA09T0580100ZY	0	+	0	0	1036	0.0000000
zheyou73v0_A09	59414734	59415759	BnaA09T0580200ZY	0	+	0	0	1025	0.0000000
zheyou73v0_A09	59416805	59417775	BnaA09T0580300ZY	0	+	0	0	970	0.0000000
zheyou73v0_A09	59417886	59418820	BnaA09T0580400ZY	0	-	0	0	934	0.0000000
zheyou73v0_A09	59419249	59419816	BnaA09T0580500ZY	0	+	0	0	567	0.0000000
zheyou73v0_A09	59420069	59421647	BnaA09T0580600ZY	0	-	0	0	1578	0.0000000
zheyou73v0_A09	59422159	59423327	BnaA09T0580700ZY	0	-	0	0	1168	0.0000000
zheyou73v0_A09	59425169	59425767	BnaA09T0580800ZY	0	-	0	0	598	0.0000000
zheyou73v0_A09	59427996	59430497	BnaA09T0580900ZY	0	+	0	0	2501	0.0000000
zheyou73v0_A09	59431243	59432151	BnaA09T0581000ZY	0	+	0	0	908	0.0000000
zheyou73v0_A09	59432304	59433255	BnaA09T0581100ZY	0	-	0	0	951	0.0000000
zheyou73v0_A09	59434076	59435807	BnaA09T0581200ZY	0	+	0	0	1731	0.0000000
zheyou73v0_A09	59439108	59440175	BnaA09T0581300ZY	0	+	0	0	1067	0.0000000
zheyou73v0_A09	59441155	59442198	BnaA09T0581400ZY	0	+	0	0	1043	0.0000000
zheyou73v0_A09	59442527	59444063	BnaA09T0581500ZY	0	-	0	0	1536	0.0000000
zheyou73v0_A09	59444589	59446189	BnaA09T0581600ZY	0	-	0	0	1600	0.0000000
zheyou73v0_A09	59447826	59449527	BnaA09T0581700ZY	0	-	0	0	1701	0.0000000
zheyou73v0_A09	59457911	59458370	BnaA09T0581800ZY	0	+	0	0	459	0.0000000
zheyou73v0_A09	59467188	59467597	BnaA09T0581900ZY	0	-	0	0	409	0.0000000
zheyou73v0_A09	59487877	59489926	BnaA09T0582000ZY	0	+	0	0	2049	0.0000000
zheyou73v0_A09	59490170	59491070	BnaA09T0582100ZY	0	+	0	0	900	0.0000000
zheyou73v0_A09	59491328	59493798	BnaA09T0582200ZY	0	-	0	0	2470	0.0000000
zheyou73v0_A09	59498287	59501212	BnaA09T0582300ZY	0	+	0	0	2925	0.0000000
zheyou73v0_A09	59501623	59503703	BnaA09T0582400ZY	0	-	0	0	2080	0.0000000
zheyou73v0_A09	59514123	59516697	BnaA09T0582500ZY	0	+	0	0	2574	0.0000000
zheyou73v0_A09	59517132	59518041	BnaA09T0582600ZY	0	+	0	0	909	0.0000000
zheyou73v0_A09	59520674	59523517	BnaA09T0582700ZY	0	+	0	0	2843	0.0000000
zheyou73v0_A09	59523638	59525037	BnaA09T0582800ZY	0	-	0	0	1399	0.0000000
zheyou73v0_A09	59525657	59527975	BnaA09T0582900ZY	0	-	0	0	2318	0.0000000
zheyou73v0_A09	59528017	59529166	BnaA09T0583000ZY	0	+	0	0	1149	0.0000000
zheyou73v0_A09	59531790	59532810	BnaA09T0583100ZY	0	+	0	0	1020	0.0000000
zheyou73v0_A09	59538135	59540898	BnaA09T0583200ZY	0	-	0	0	2763	0.0000000
zheyou73v0_A09	59550363	59559789	BnaA09T0583300ZY	0	+	0	0	9426	0.0000000
zheyou73v0_A09	59564604	59565781	BnaA09T0583400ZY	0	-	0	0	1177	0.0000000
zheyou73v0_A09	59573984	59578710	BnaA09T0583500ZY	0	+	0	0	4726	0.0000000
zheyou73v0_A09	59577294	59578288	BnaA09T0583600ZY	0	-	0	0	994	0.0000000
zheyou73v0_A09	59583878	59584254	BnaA09T0583700ZY	0	+	0	0	376	0.0000000
zheyou73v0_A09	59596328	59597986	BnaA09T0583800ZY	0	+	0	0	1658	0.0000000
zheyou73v0_A09	59620397	59622093	BnaA09T0583900ZY	0	+	0	0	1696	0.0000000
zheyou73v0_A09	59620397	59622093	BnaA09T0583900ZY.1	0	+	0	0	1696	0.0000000
zheyou73v0_A09	59634297	59637956	BnaA09T0584000ZY	0	-	0	0	3659	0.0000000
zheyou73v0_A09	59646622	59647369	BnaA09T0584100ZY	0	+	0	0	747	0.0000000
zheyou73v0_A09	59649207	59650262	BnaA09T0584200ZY	0	-	0	0	1055	0.0000000
zheyou73v0_A09	59651397	59653137	BnaA09T0584300ZY	0	+	0	0	1740	0.0000000
zheyou73v0_A09	59654405	59657484	BnaA09T0584400ZY	0	+	0	0	3079	0.0000000
zheyou73v0_A09	59657812	59659561	BnaA09T0584500ZY	0	+	0	0	1749	0.0000000
zheyou73v0_A09	59662964	59664811	BnaA09T0584600ZY	0	+	0	0	1847	0.0000000
zheyou73v0_A09	59666630	59668011	BnaA09T0584700ZY	0	+	0	0	1381	0.0000000
zheyou73v0_A09	59669911	59672259	BnaA09T0584800ZY	0	+	0	0	2348	0.0000000
zheyou73v0_A09	59673737	59675844	BnaA09T0584900ZY	0	+	0	0	2107	0.0000000
zheyou73v0_A09	59684241	59686131	BnaA09T0585000ZY	0	+	0	0	1890	0.0000000
zheyou73v0_A09	59684241	59686131	BnaA09T0585000ZY.1	0	+	0	0	1890	0.0000000
zheyou73v0_A09	59684241	59686131	BnaA09T0585000ZY.2	0	+	0	0	1890	0.0000000
zheyou73v0_A09	59712339	59712813	BnaA09T0585100ZY	0	+	0	0	474	0.0000000
zheyou73v0_A09	59721200	59724049	BnaA09T0585200ZY	0	-	0	0	2849	0.0000000
zheyou73v0_A09	59735365	59735940	BnaA09T0585300ZY	0	+	0	0	575	0.0000000
zheyou73v0_A09	59737791	59738193	BnaA09T0585400ZY	0	+	0	0	402	0.0000000
zheyou73v0_A09	59738606	59739478	BnaA09T0585500ZY	0	+	0	0	872	0.0000000
zheyou73v0_A09	59741331	59743297	BnaA09T0585600ZY	0	-	0	0	1966	0.0000000
zheyou73v0_A09	59746428	59747825	BnaA09T0585700ZY	0	-	0	0	1397	0.0000000
zheyou73v0_A09	59767042	59767441	BnaA09T0585800ZY	0	-	0	0	399	0.0000000
zheyou73v0_A09	59767867	59771396	BnaA09T0585900ZY	0	-	0	0	3529	0.0000000
zheyou73v0_A09	59774604	59781810	BnaA09T0586000ZY	0	+	0	0	7206	0.0000000
zheyou73v0_A09	59782838	59786830	BnaA09T0586100ZY	0	-	0	0	3992	0.0000000
zheyou73v0_A09	59787714	59788260	BnaA09T0586200ZY	0	-	0	0	546	0.0000000
zheyou73v0_A09	59794057	59795537	BnaA09T0586300ZY	0	-	0	0	1480	0.0000000
zheyou73v0_A09	59799155	59806716	BnaA09T0586400ZY	0	+	0	0	7561	0.0000000
zheyou73v0_A09	59806915	59808294	BnaA09T0586500ZY	0	-	0	0	1379	0.0000000
zheyou73v0_A09	59814544	59815485	BnaA09T0586600ZY	0	+	0	0	941	0.0000000
zheyou73v0_A09	59815562	59816014	BnaA09T0586700ZY	0	-	0	0	452	0.0000000
zheyou73v0_A09	59817032	59820637	BnaA09T0586800ZY	0	+	0	0	3605	0.0000000
zheyou73v0_A09	59835250	59838848	BnaA09T0586900ZY	0	+	0	0	3598	0.0000000
zheyou73v0_A09	59857189	59858688	BnaA09T0587000ZY	0	-	0	0	1499	0.0000000
zheyou73v0_A09	59859934	59862792	BnaA09T0587100ZY	0	+	0	0	2858	0.0000000
zheyou73v0_A09	59867036	59869659	BnaA09T0587200ZY	0	+	0	0	2623	0.0000000
zheyou73v0_A09	59871363	59872248	BnaA09T0587300ZY	0	-	0	0	885	0.0000000
zheyou73v0_A09	59876150	59878301	BnaA09T0587400ZY	0	-	0	0	2151	0.0000000
zheyou73v0_A09	59881418	59884534	BnaA09T0587500ZY	0	-	0	0	3116	0.0000000
zheyou73v0_A09	59885718	59892067	BnaA09T0587600ZY	0	+	0	0	6349	0.0000000
zheyou73v0_A09	59892495	59894046	BnaA09T0587700ZY	0	+	0	0	1551	0.0000000
zheyou73v0_A09	59894341	59896497	BnaA09T0587800ZY	0	+	0	0	2156	0.0000000
zheyou73v0_A09	59896553	59897222	BnaA09T0587900ZY	0	-	0	0	669	0.0000000
zheyou73v0_A09	59898701	59900277	BnaA09T0588000ZY	0	+	0	0	1576	0.0000000
zheyou73v0_A09	59901114	59901364	BnaA09T0588100ZY	0	-	0	0	250	0.0000000
zheyou73v0_A09	59902240	59905010	BnaA09T0588200ZY	0	-	0	0	2770	0.0000000
zheyou73v0_A09	59905262	59905856	BnaA09T0588300ZY	0	+	0	0	594	0.0000000
zheyou73v0_A09	59909510	59911559	BnaA09T0588400ZY	0	+	0	0	2049	0.0000000
zheyou73v0_A09	59916579	59916789	BnaA09T0588500ZY	0	+	0	0	210	0.0000000
zheyou73v0_A09	59917848	59920100	BnaA09T0588600ZY	0	-	0	0	2252	0.0000000
zheyou73v0_A09	59920509	59922882	BnaA09T0588700ZY	0	-	0	0	2373	0.0000000
zheyou73v0_A09	59923981	59926057	BnaA09T0588800ZY	0	-	0	0	2076	0.0000000
zheyou73v0_A09	59934636	59936602	BnaA09T0588900ZY	0	+	0	0	1966	0.0000000
zheyou73v0_A09	59942966	59945303	BnaA09T0589000ZY	0	+	0	0	2337	0.0000000
zheyou73v0_A09	59948701	59949405	BnaA09T0589100ZY	0	-	0	0	704	0.0000000
zheyou73v0_A09	59951796	59952743	BnaA09T0589200ZY	0	-	0	0	947	0.0000000
zheyou73v0_A09	59953768	59954262	BnaA09T0589300ZY	0	-	0	0	494	0.0000000
zheyou73v0_A09	59955081	59958419	BnaA09T0589400ZY	0	-	0	0	3338	0.0000000
zheyou73v0_A09	59960663	59962446	BnaA09T0589500ZY	0	-	0	0	1783	0.0000000
zheyou73v0_A09	59972644	59973262	BnaA09T0589600ZY	0	+	0	0	618	0.0000000
zheyou73v0_A09	59974124	59976494	BnaA09T0589700ZY	0	-	0	0	2370	0.0000000
zheyou73v0_A09	59978523	59979712	BnaA09T0589800ZY	0	-	0	0	1189	0.0000000
zheyou73v0_A09	59981386	59982712	BnaA09T0589900ZY	0	-	0	0	1326	0.0000000
zheyou73v0_A09	59985694	59987956	BnaA09T0590000ZY	0	-	0	0	2262	0.0000000
zheyou73v0_A09	59988078	59994505	BnaA09T0590100ZY	0	-	0	0	6427	0.0000000
zheyou73v0_A09	59996100	59997506	BnaA09T0590200ZY	0	+	0	0	1406	0.0000000
zheyou73v0_A09	59997604	59999263	BnaA09T0590300ZY	0	+	0	0	1659	0.0000000
zheyou73v0_A09	59997604	59999263	BnaA09T0590300ZY.1	0	+	0	0	1659	0.0000000
zheyou73v0_A09	60001308	60002924	BnaA09T0590400ZY	0	-	0	0	1616	0.0000000
zheyou73v0_A09	60006891	60008295	BnaA09T0590500ZY	0	+	0	0	1404	0.0000000
zheyou73v0_A09	60008672	60008950	BnaA09T0590600ZY	0	+	0	0	278	0.0000000
zheyou73v0_A09	60011137	60015134	BnaA09T0590700ZY	0	-	0	0	3997	0.0000000
zheyou73v0_A09	60016619	60017818	BnaA09T0590800ZY	0	-	0	0	1199	0.0000000
zheyou73v0_A09	60018682	60019769	BnaA09T0590900ZY	0	-	0	0	1087	0.0000000
zheyou73v0_A09	60024336	60027087	BnaA09T0591000ZY	0	+	0	0	2751	0.0000000
zheyou73v0_A09	60036516	60041858	BnaA09T0591100ZY	0	-	0	0	5342	0.0000000
zheyou73v0_A09	60043113	60044149	BnaA09T0591200ZY	0	-	0	0	1036	0.0000000
zheyou73v0_A09	60046504	60047301	BnaA09T0591300ZY	0	+	0	0	797	0.0000000
zheyou73v0_A09	60054959	60055679	BnaA09T0591400ZY	0	+	0	0	720	0.0000000
zheyou73v0_A09	60059943	60061221	BnaA09T0591500ZY	0	+	0	0	1278	0.0000000
zheyou73v0_A09	60061856	60063759	BnaA09T0591600ZY	0	-	0	0	1903	0.0000000
zheyou73v0_A09	60073299	60076128	BnaA09T0591700ZY	0	+	0	0	2829	0.0000000
zheyou73v0_A09	60076553	60078235	BnaA09T0591800ZY	0	-	0	0	1682	0.0000000
zheyou73v0_A09	60078521	60079599	BnaA09T0591900ZY	0	-	0	0	1078	0.0000000
zheyou73v0_A09	60085929	60089792	BnaA09T0592000ZY	0	-	0	0	3863	0.0000000
zheyou73v0_A09	60085929	60089214	BnaA09T0592000ZY.1	0	-	0	0	3285	0.0000000
zheyou73v0_A09	60093778	60097224	BnaA09T0592100ZY	0	-	0	0	3446	0.0000000
zheyou73v0_A09	60093933	60097224	BnaA09T0592100ZY.1	0	-	0	0	3291	0.0000000
zheyou73v0_A09	60109675	60111924	BnaA09T0592200ZY	0	-	0	0	2249	0.0000000
zheyou73v0_A09	60109675	60111924	BnaA09T0592200ZY.1	0	-	0	0	2249	0.0000000
zheyou73v0_A09	60129733	60132987	BnaA09T0592300ZY	0	+	0	0	3254	0.0000000
zheyou73v0_A09	60132994	60134995	BnaA09T0592400ZY	0	-	0	0	2001	0.0000000
zheyou73v0_A09	60137128	60138713	BnaA09T0592500ZY	0	+	0	0	1585	0.0000000
zheyou73v0_A09	60140451	60144560	BnaA09T0592600ZY	0	-	0	0	4109	0.0000000
zheyou73v0_A09	60156035	60156637	BnaA09T0592700ZY	0	-	0	0	602	0.0000000
zheyou73v0_A09	60166069	60167901	BnaA09T0592800ZY	0	+	0	0	1832	0.0000000
zheyou73v0_A09	60168677	60169016	BnaA09T0592900ZY	0	+	0	0	339	0.0000000
zheyou73v0_A09	60169616	60179647	BnaA09T0593000ZY	0	-	0	0	10031	0.0000000
zheyou73v0_A09	60197895	60198747	BnaA09T0593100ZY	0	+	0	0	852	0.0000000
zheyou73v0_A09	60204024	60205759	BnaA09T0593200ZY	0	-	0	0	1735	0.0000000
zheyou73v0_A09	60207569	60212590	BnaA09T0593300ZY	0	+	0	0	5021	0.0000000
zheyou73v0_A09	60214542	60215257	BnaA09T0593400ZY	0	+	0	0	715	0.0000000
zheyou73v0_A09	60216995	60217630	BnaA09T0593500ZY	0	+	0	0	635	0.0000000
zheyou73v0_A09	60220918	60221188	BnaA09T0593600ZY	0	-	0	0	270	0.0000000
zheyou73v0_A09	60238671	60239091	BnaA09T0593700ZY	0	+	0	0	420	0.0000000
zheyou73v0_A09	60240663	60241543	BnaA09T0593800ZY	0	+	0	0	880	0.0000000
zheyou73v0_A09	60243595	60244933	BnaA09T0593900ZY	0	+	0	0	1338	0.0000000
zheyou73v0_A09	60247539	60252379	BnaA09T0594000ZY	0	+	0	0	4840	0.0000000
zheyou73v0_A09	60249167	60252379	BnaA09T0594000ZY.1	0	+	0	0	3212	0.0000000
zheyou73v0_A09	60252760	60255043	BnaA09T0594100ZY	0	-	0	0	2283	0.0000000
zheyou73v0_A09	60256715	60258587	BnaA09T0594200ZY	0	-	0	0	1872	0.0000000
zheyou73v0_A09	60259067	60260451	BnaA09T0594300ZY	0	-	0	0	1384	0.0000000
zheyou73v0_A09	60260987	60263069	BnaA09T0594400ZY	0	+	0	0	2082	0.0000000
zheyou73v0_A09	60263284	60265978	BnaA09T0594500ZY	0	-	0	0	2694	0.0000000
zheyou73v0_A09	60266489	60269189	BnaA09T0594600ZY	0	-	0	0	2700	0.0000000
zheyou73v0_A09	60269313	60270277	BnaA09T0594700ZY	0	-	0	0	964	0.0000000
zheyou73v0_A09	60272359	60279156	BnaA09T0594800ZY	0	+	0	0	6797	0.0000000
zheyou73v0_A09	60279551	60281168	BnaA09T0594900ZY	0	-	0	0	1617	0.0000000
zheyou73v0_A09	60282258	60282708	BnaA09T0595000ZY	0	-	0	0	450	0.0000000
zheyou73v0_A09	60285196	60285858	BnaA09T0595100ZY	0	-	0	0	662	0.0000000
zheyou73v0_A09	60286136	60287941	BnaA09T0595200ZY	0	-	0	0	1805	0.0000000
zheyou73v0_A09	60286136	60287941	BnaA09T0595200ZY.1	0	-	0	0	1805	0.0000000
zheyou73v0_A09	60296785	60299910	BnaA09T0595300ZY	0	+	0	0	3125	0.0000000
zheyou73v0_A09	60308691	60309036	BnaA09T0595400ZY	0	-	0	0	345	0.0000000
zheyou73v0_A09	60310069	60313624	BnaA09T0595500ZY	0	-	0	0	3555	0.0000000
zheyou73v0_A09	60310069	60313624	BnaA09T0595500ZY.1	0	-	0	0	3555	0.0000000
zheyou73v0_A09	60310069	60313624	BnaA09T0595500ZY.2	0	-	0	0	3555	0.0000000
zheyou73v0_A09	60316469	60318298	BnaA09T0595600ZY	0	-	0	0	1829	0.0000000
zheyou73v0_A09	60319395	60322118	BnaA09T0595700ZY.1	0	-	0	0	2723	0.0000000
zheyou73v0_A09	60319406	60322118	BnaA09T0595700ZY	0	-	0	0	2712	0.0000000
zheyou73v0_A09	60322779	60325582	BnaA09T0595800ZY	0	-	0	0	2803	0.0000000
zheyou73v0_A09	60328548	60329980	BnaA09T0595900ZY	0	-	0	0	1432	0.0000000
zheyou73v0_A09	60330979	60331595	BnaA09T0596000ZY	0	-	0	0	616	0.0000000
zheyou73v0_A09	60335930	60336807	BnaA09T0596100ZY	0	-	0	0	877	0.0000000
zheyou73v0_A09	60338160	60339045	BnaA09T0596200ZY	0	-	0	0	885	0.0000000
zheyou73v0_A09	60342883	60345412	BnaA09T0596300ZY	0	+	0	0	2529	0.0000000
zheyou73v0_A09	60378093	60381558	BnaA09T0596400ZY	0	+	0	0	3465	0.0000000
zheyou73v0_A09	60378093	60381558	BnaA09T0596400ZY.1	0	+	0	0	3465	0.0000000
zheyou73v0_A09	60389237	60392776	BnaA09T0596500ZY	0	-	0	0	3539	0.0000000
zheyou73v0_A09	60396817	60398103	BnaA09T0596600ZY	0	-	0	0	1286	0.0000000
zheyou73v0_A09	60398730	60401818	BnaA09T0596700ZY	0	+	0	0	3088	0.0000000
zheyou73v0_A09	60398730	60401818	BnaA09T0596700ZY.1	0	+	0	0	3088	0.0000000
zheyou73v0_A09	60402591	60412279	BnaA09T0596800ZY	0	-	0	0	9688	0.0000000
zheyou73v0_A09	60423839	60427453	BnaA09T0596900ZY	0	+	0	0	3614	0.0000000
zheyou73v0_A09	60427482	60427707	BnaA09T0597000ZY	0	+	0	0	225	0.0000000
zheyou73v0_A09	60432374	60434607	BnaA09T0597100ZY	0	+	0	0	2233	0.0000000
zheyou73v0_A09	60435006	60436917	BnaA09T0597200ZY	0	+	0	0	1911	0.0000000
zheyou73v0_A09	60445705	60448314	BnaA09T0597300ZY	0	+	0	0	2609	0.0000000
zheyou73v0_A09	60448660	60450986	BnaA09T0597400ZY	0	-	0	0	2326	0.0000000
zheyou73v0_A09	60454960	60458813	BnaA09T0597500ZY	0	-	0	0	3853	0.0000000
zheyou73v0_A09	60463636	60472341	BnaA09T0597600ZY	0	-	0	0	8705	0.0000000
zheyou73v0_A09	60473297	60474329	BnaA09T0597700ZY	0	-	0	0	1032	0.0000000
zheyou73v0_A09	60475077	60476490	BnaA09T0597800ZY	0	-	0	0	1413	0.0000000
zheyou73v0_A09	60479797	60482982	BnaA09T0597900ZY	0	-	0	0	3185	0.0000000
zheyou73v0_A09	60479797	60482982	BnaA09T0597900ZY.1	0	-	0	0	3185	0.0000000
zheyou73v0_A09	60479797	60482982	BnaA09T0597900ZY.2	0	-	0	0	3185	0.0000000
zheyou73v0_A09	60484050	60487093	BnaA09T0598000ZY	0	+	0	0	3043	0.0000000
zheyou73v0_A09	60488001	60490417	BnaA09T0598100ZY	0	-	0	0	2416	0.0000000
zheyou73v0_A09	60490732	60491802	BnaA09T0598200ZY.1	0	-	0	0	1070	0.0000000
zheyou73v0_A09	60490976	60492044	BnaA09T0598200ZY	0	-	0	0	1068	0.0000000
zheyou73v0_A09	60496073	60499058	BnaA09T0598300ZY	0	-	0	0	2985	0.0000000
zheyou73v0_A09	60504606	60511911	BnaA09T0598400ZY	0	-	0	0	7305	0.0000000
zheyou73v0_A09	60512336	60514826	BnaA09T0598500ZY	0	-	0	0	2490	0.0000000
zheyou73v0_A09	60512336	60514826	BnaA09T0598500ZY.1	0	-	0	0	2490	0.0000000
zheyou73v0_A09	60515444	60519130	BnaA09T0598600ZY	0	+	0	0	3686	0.0000000
zheyou73v0_A09	60522558	60523784	BnaA09T0598700ZY	0	-	0	0	1226	0.0000000
zheyou73v0_A09	60524916	60528955	BnaA09T0598800ZY	0	-	0	0	4039	0.0000000
zheyou73v0_A09	60524916	60528843	BnaA09T0598800ZY.1	0	-	0	0	3927	0.0000000
zheyou73v0_A09	60524916	60528955	BnaA09T0598800ZY.2	0	-	0	0	4039	0.0000000
zheyou73v0_A09	60529599	60531431	BnaA09T0598900ZY	0	+	0	0	1832	0.0000000
zheyou73v0_A09	60538133	60540198	BnaA09T0599000ZY	0	+	0	0	2065	0.0000000
zheyou73v0_A09	60541318	60545906	BnaA09T0599100ZY	0	+	0	0	4588	0.0000000
zheyou73v0_A09	60545958	60548707	BnaA09T0599200ZY	0	-	0	0	2749	0.0000000
zheyou73v0_A09	60549655	60550551	BnaA09T0599300ZY	0	+	0	0	896	0.0000000
zheyou73v0_A09	60555782	60557331	BnaA09T0599400ZY	0	+	0	0	1549	0.0000000
zheyou73v0_A09	60561138	60562791	BnaA09T0599500ZY	0	+	0	0	1653	0.0000000
zheyou73v0_A09	60563819	60566276	BnaA09T0599600ZY	0	+	0	0	2457	0.0000000
zheyou73v0_A09	60567809	60568034	BnaA09T0599700ZY	0	-	0	0	225	0.0000000
zheyou73v0_A09	60568063	60568439	BnaA09T0599800ZY	0	-	0	0	376	0.0000000
zheyou73v0_A09	60568506	60571677	BnaA09T0599900ZY	0	-	0	0	3171	0.0000000
zheyou73v0_A09	60581153	60583753	BnaA09T0600000ZY	0	+	0	0	2600	0.0000000
zheyou73v0_A09	60584142	60585775	BnaA09T0600100ZY	0	-	0	0	1633	0.0000000
zheyou73v0_A09	60586556	60587707	BnaA09T0600200ZY	0	+	0	0	1151	0.0000000
zheyou73v0_A09	60590517	60591483	BnaA09T0600300ZY	0	+	0	0	966	0.0000000
zheyou73v0_A09	60595868	60596899	BnaA09T0600400ZY	0	+	0	0	1031	0.0000000
zheyou73v0_A09	60621760	60622885	BnaA09T0600500ZY	0	+	0	0	1125	0.0000000
zheyou73v0_A09	60623930	60624919	BnaA09T0600600ZY	0	-	0	0	989	0.0000000
zheyou73v0_A09	60629568	60630259	BnaA09T0600700ZY	0	-	0	0	691	0.0000000
zheyou73v0_A09	60636948	60638277	BnaA09T0600800ZY	0	+	0	0	1329	0.0000000
zheyou73v0_A09	60644348	60645287	BnaA09T0600900ZY	0	+	0	0	939	0.0000000
zheyou73v0_A09	60646717	60648481	BnaA09T0601000ZY	0	+	0	0	1764	0.0000000
zheyou73v0_A09	60648599	60656211	BnaA09T0601100ZY	0	-	0	0	7612	0.0000000
zheyou73v0_A09	60648599	60656211	BnaA09T0601100ZY.1	0	-	0	0	7612	0.0000000
zheyou73v0_A09	60663604	60666199	BnaA09T0601200ZY	0	+	0	0	2595	0.0000000
zheyou73v0_A09	60666364	60667476	BnaA09T0601300ZY	0	-	0	0	1112	0.0000000
zheyou73v0_A09	60670331	60671554	BnaA09T0601400ZY	0	+	0	0	1223	0.0000000
zheyou73v0_A09	60674407	60680894	BnaA09T0601500ZY	0	-	0	0	6487	0.0000000
zheyou73v0_A09	60683996	60686744	BnaA09T0601600ZY	0	-	0	0	2748	0.0000000
zheyou73v0_A09	60687171	60693861	BnaA09T0601700ZY	0	-	0	0	6690	0.0000000
zheyou73v0_A09	60695565	60699154	BnaA09T0601800ZY	0	+	0	0	3589	0.0000000
zheyou73v0_A09	60701828	60702642	BnaA09T0601900ZY	0	-	0	0	814	0.0000000
zheyou73v0_A09	60705274	60705775	BnaA09T0602000ZY	0	+	0	0	501	0.0000000
zheyou73v0_A09	60707006	60717617	BnaA09T0602100ZY	0	-	0	0	10611	0.0000000
zheyou73v0_A09	60723079	60725347	BnaA09T0602200ZY	0	+	0	0	2268	0.0000000
zheyou73v0_A09	60725231	60732845	BnaA09T0602300ZY	0	-	0	0	7614	0.0000000
zheyou73v0_A09	60733711	60733960	BnaA09T0602400ZY	0	-	0	0	249	0.0000000
zheyou73v0_A09	60735382	60735587	BnaA09T0602500ZY	0	-	0	0	205	0.0000000
zheyou73v0_A09	60735679	60736752	BnaA09T0602600ZY	0	-	0	0	1073	0.0000000
zheyou73v0_A09	60738265	60741010	BnaA09T0602700ZY	0	-	0	0	2745	0.0000000
zheyou73v0_A09	60742631	60745492	BnaA09T0602800ZY	0	-	0	0	2861	0.0000000
zheyou73v0_A09	60747256	60751321	BnaA09T0602900ZY	0	+	0	0	4065	0.0000000
zheyou73v0_A09	60752349	60755450	BnaA09T0603000ZY	0	-	0	0	3101	0.0000000
zheyou73v0_A09	60764187	60767447	BnaA09T0603100ZY	0	-	0	0	3260	0.0000000
zheyou73v0_A09	60764187	60767447	BnaA09T0603100ZY.1	0	-	0	0	3260	0.0000000
zheyou73v0_A09	60770113	60771070	BnaA09T0603200ZY	0	+	0	0	957	0.0000000
zheyou73v0_A09	60777048	60778429	BnaA09T0603300ZY	0	+	0	0	1381	0.0000000
zheyou73v0_A09	60779609	60785408	BnaA09T0603400ZY	0	+	0	0	5799	0.0000000
zheyou73v0_A09	60785262	60787970	BnaA09T0603500ZY	0	-	0	0	2708	0.0000000
zheyou73v0_A09	60785262	60787970	BnaA09T0603500ZY.1	0	-	0	0	2708	0.0000000
zheyou73v0_A09	60795635	60798374	BnaA09T0603600ZY	0	+	0	0	2739	0.0000000
zheyou73v0_A09	60802981	60804614	BnaA09T0603700ZY	0	+	0	0	1633	0.0000000
zheyou73v0_A09	60805882	60806695	BnaA09T0603800ZY	0	+	0	0	813	0.0000000
zheyou73v0_A09	60807408	60809373	BnaA09T0603900ZY	0	+	0	0	1965	0.0000000
zheyou73v0_A09	60810465	60811562	BnaA09T0604000ZY	0	+	0	0	1097	0.0000000
zheyou73v0_A09	60812896	60814775	BnaA09T0604100ZY	0	-	0	0	1879	0.0000000
zheyou73v0_A09	60815893	60816895	BnaA09T0604200ZY	0	+	0	0	1002	0.0000000
zheyou73v0_A09	60824706	60825764	BnaA09T0604300ZY	0	+	0	0	1058	0.0000000
zheyou73v0_A09	60826592	60828956	BnaA09T0604400ZY	0	-	0	0	2364	0.0000000
zheyou73v0_A09	60829673	60833367	BnaA09T0604500ZY	0	+	0	0	3694	0.0000000
zheyou73v0_A09	60833587	60838828	BnaA09T0604600ZY	0	-	0	0	5241	0.0000000
zheyou73v0_A09	60840070	60845127	BnaA09T0604700ZY	0	+	0	0	5057	0.0000000
zheyou73v0_A09	60840070	60844880	BnaA09T0604700ZY.1	0	+	0	0	4810	0.0000000
zheyou73v0_A09	60840070	60844661	BnaA09T0604700ZY.2	0	+	0	0	4591	0.0000000
zheyou73v0_A09	60845403	60846518	BnaA09T0604800ZY	0	-	0	0	1115	0.0000000
zheyou73v0_A09	60848940	60852239	BnaA09T0604900ZY	0	-	0	0	3299	0.0000000
zheyou73v0_A09	60858301	60860704	BnaA09T0605000ZY	0	-	0	0	2403	0.0000000
zheyou73v0_A09	60865359	60866055	BnaA09T0605100ZY	0	+	0	0	696	0.0000000
zheyou73v0_A09	60867840	60870124	BnaA09T0605200ZY	0	-	0	0	2284	0.0000000
zheyou73v0_A09	60870809	60871490	BnaA09T0605300ZY	0	+	0	0	681	0.0000000
zheyou73v0_A09	60873013	60876935	BnaA09T0605400ZY	0	+	0	0	3922	0.0000000
zheyou73v0_A09	60877252	60877914	BnaA09T0605500ZY	0	-	0	0	662	0.0000000
zheyou73v0_A09	60878487	60880202	BnaA09T0605600ZY	0	-	0	0	1715	0.0000000
zheyou73v0_A09	60878487	60880202	BnaA09T0605600ZY.1	0	-	0	0	1715	0.0000000
zheyou73v0_A09	60881928	60882858	BnaA09T0605700ZY	0	-	0	0	930	0.0000000
zheyou73v0_A09	60883834	60885970	BnaA09T0605800ZY	0	+	0	0	2136	0.0000000
zheyou73v0_A09	60889125	60890844	BnaA09T0605900ZY	0	+	0	0	1719	0.0000000
zheyou73v0_A09	60891405	60904745	BnaA09T0606000ZY	0	+	0	0	13340	0.0000000
zheyou73v0_A09	60907893	60909166	BnaA09T0606100ZY	0	-	0	0	1273	0.0000000
zheyou73v0_A09	60911167	60916151	BnaA09T0606200ZY	0	-	0	0	4984	0.0000000
zheyou73v0_A09	60917213	60918000	BnaA09T0606300ZY	0	+	0	0	787	0.0000000
zheyou73v0_A09	60920004	60921270	BnaA09T0606400ZY	0	-	0	0	1266	0.0000000
zheyou73v0_A09	60923550	60924452	BnaA09T0606500ZY	0	-	0	0	902	0.0000000
zheyou73v0_A09	60926739	60930921	BnaA09T0606600ZY	0	+	0	0	4182	0.0000000
zheyou73v0_A09	60931526	60934303	BnaA09T0606700ZY	0	-	0	0	2777	0.0000000
zheyou73v0_A09	60934802	60937678	BnaA09T0606800ZY	0	-	0	0	2876	0.0000000
zheyou73v0_A09	60934802	60937678	BnaA09T0606800ZY.1	0	-	0	0	2876	0.0000000
zheyou73v0_A09	60938216	60939360	BnaA09T0606900ZY	0	-	0	0	1144	0.0000000
zheyou73v0_A09	60939774	60942509	BnaA09T0607000ZY	0	-	0	0	2735	0.0000000
zheyou73v0_A09	60943892	60947228	BnaA09T0607100ZY	0	-	0	0	3336	0.0000000
zheyou73v0_A09	60951094	60954300	BnaA09T0607200ZY	0	-	0	0	3206	0.0000000
zheyou73v0_A09	60951094	60954300	BnaA09T0607200ZY.1	0	-	0	0	3206	0.0000000
zheyou73v0_A09	60958003	60963214	BnaA09T0607300ZY	0	-	0	0	5211	0.0000000
zheyou73v0_A09	60963349	60963848	BnaA09T0607400ZY	0	-	0	0	499	0.0000000
zheyou73v0_A09	60964167	60968328	BnaA09T0607500ZY	0	-	0	0	4161	0.0000000
zheyou73v0_A09	60964167	60968328	BnaA09T0607500ZY.1	0	-	0	0	4161	0.0000000
zheyou73v0_A09	60970482	60972466	BnaA09T0607600ZY	0	-	0	0	1984	0.0000000
zheyou73v0_A09	60970482	60972466	BnaA09T0607600ZY.1	0	-	0	0	1984	0.0000000
zheyou73v0_A09	60973102	60981862	BnaA09T0607700ZY	0	+	0	0	8760	0.0000000
zheyou73v0_A09	60982185	60983975	BnaA09T0607800ZY	0	-	0	0	1790	0.0000000
zheyou73v0_A09	60985335	60987892	BnaA09T0607900ZY	0	+	0	0	2557	0.0000000
zheyou73v0_A09	60988064	60990672	BnaA09T0608000ZY	0	-	0	0	2608	0.0000000
zheyou73v0_A09	60991632	60999135	BnaA09T0608100ZY	0	-	0	0	7503	0.0000000
zheyou73v0_A09	60991632	60998518	BnaA09T0608100ZY.1	0	-	0	0	6886	0.0000000
zheyou73v0_A09	61001523	61003286	BnaA09T0608200ZY	0	+	0	0	1763	0.0000000
zheyou73v0_A09	61001523	61003286	BnaA09T0608200ZY.1	0	+	0	0	1763	0.0000000
zheyou73v0_A09	61011372	61012581	BnaA09T0608300ZY	0	+	0	0	1209	0.0000000
zheyou73v0_A09	61014897	61017702	BnaA09T0608400ZY	0	+	0	0	2805	0.0000000
zheyou73v0_A09	61018799	61019383	BnaA09T0608500ZY	0	+	0	0	584	0.0000000
zheyou73v0_A09	61026661	61028817	BnaA09T0608600ZY	0	+	0	0	2156	0.0000000
zheyou73v0_A09	61029446	61032613	BnaA09T0608700ZY	0	-	0	0	3167	0.0000000
zheyou73v0_A09	61033966	61035454	BnaA09T0608800ZY	0	+	0	0	1488	0.0000000
zheyou73v0_A09	61033966	61035454	BnaA09T0608800ZY.1	0	+	0	0	1488	0.0000000
zheyou73v0_A09	61035427	61036473	BnaA09T0608900ZY	0	-	0	0	1046	0.0000000
zheyou73v0_A09	61040078	61042857	BnaA09T0609000ZY	0	+	0	0	2779	0.0000000
zheyou73v0_A09	61043663	61044971	BnaA09T0609100ZY	0	-	0	0	1308	0.0000000
zheyou73v0_A09	61049161	61052942	BnaA09T0609200ZY	0	-	0	0	3781	0.0000000
zheyou73v0_A09	61049161	61053068	BnaA09T0609200ZY.1	0	-	0	0	3907	0.0000000
zheyou73v0_A09	61054256	61056528	BnaA09T0609300ZY	0	-	0	0	2272	0.0000000
zheyou73v0_A09	61057266	61058852	BnaA09T0609400ZY	0	+	0	0	1586	0.0000000
zheyou73v0_A09	61060886	61067140	BnaA09T0609500ZY	0	-	0	0	6254	0.0000000
zheyou73v0_A09	61069469	61070086	BnaA09T0609600ZY	0	-	0	0	617	0.0000000
zheyou73v0_A09	61072308	61073138	BnaA09T0609700ZY	0	+	0	0	830	0.0000000
zheyou73v0_A09	61073253	61075558	BnaA09T0609800ZY	0	-	0	0	2305	0.0000000
zheyou73v0_A09	61078056	61079732	BnaA09T0609900ZY	0	-	0	0	1676	0.0000000
zheyou73v0_A09	61083924	61089754	BnaA09T0610000ZY	0	+	0	0	5830	0.0000000
zheyou73v0_A09	61091374	61093394	BnaA09T0610100ZY	0	+	0	0	2020	0.0000000
zheyou73v0_A09	61094552	61095825	BnaA09T0610200ZY	0	+	0	0	1273	0.0000000
zheyou73v0_A09	61097549	61098954	BnaA09T0610300ZY	0	+	0	0	1405	0.0000000
zheyou73v0_A09	61100088	61101500	BnaA09T0610400ZY	0	+	0	0	1412	0.0000000
zheyou73v0_A09	61102131	61105034	BnaA09T0610500ZY	0	+	0	0	2903	0.0000000
zheyou73v0_A09	61106259	61109284	BnaA09T0610600ZY	0	+	0	0	3025	0.0000000
zheyou73v0_A09	61112465	61113282	BnaA09T0610700ZY	0	+	0	0	817	0.0000000
zheyou73v0_A09	61113893	61120647	BnaA09T0610800ZY	0	+	0	0	6754	0.0000000
zheyou73v0_A09	61121493	61124827	BnaA09T0610900ZY	0	+	0	0	3334	0.0000000
zheyou73v0_A09	61128620	61131091	BnaA09T0611000ZY	0	-	0	0	2471	0.0000000
zheyou73v0_A09	61135502	61139481	BnaA09T0611100ZY	0	+	0	0	3979	0.0000000
zheyou73v0_A09	61146712	61148695	BnaA09T0611200ZY	0	+	0	0	1983	0.0000000
zheyou73v0_A09	61151884	61153744	BnaA09T0611300ZY	0	+	0	0	1860	0.0000000
zheyou73v0_A09	61156191	61164083	BnaA09T0611400ZY	0	+	0	0	7892	0.0000000
zheyou73v0_A09	61166193	61167081	BnaA09T0611500ZY	0	+	0	0	888	0.0000000
zheyou73v0_A09	61167572	61172332	BnaA09T0611600ZY	0	-	0	0	4760	0.0000000
zheyou73v0_A09	61173918	61175224	BnaA09T0611700ZY	0	+	0	0	1306	0.0000000
zheyou73v0_A09	61173918	61175224	BnaA09T0611700ZY.1	0	+	0	0	1306	0.0000000
zheyou73v0_A09	61175499	61176371	BnaA09T0611800ZY	0	-	0	0	872	0.0000000
zheyou73v0_A09	61178840	61179871	BnaA09T0611900ZY	0	-	0	0	1031	0.0000000
zheyou73v0_A09	61183166	61190232	BnaA09T0612000ZY	0	-	0	0	7066	0.0000000
zheyou73v0_A09	61191785	61193057	BnaA09T0612100ZY	0	-	0	0	1272	0.0000000
zheyou73v0_A09	61195866	61198286	BnaA09T0612200ZY	0	-	0	0	2420	0.0000000
zheyou73v0_A09	61199779	61201889	BnaA09T0612300ZY	0	+	0	0	2110	0.0000000
zheyou73v0_A09	61203495	61205968	BnaA09T0612400ZY	0	+	0	0	2473	0.0000000
zheyou73v0_A09	61206449	61207200	BnaA09T0612500ZY	0	-	0	0	751	0.0000000
zheyou73v0_A09	61207626	61208171	BnaA09T0612600ZY	0	+	0	0	545	0.0000000
zheyou73v0_A09	61208454	61212737	BnaA09T0612700ZY	0	-	0	0	4283	0.0000000
zheyou73v0_A09	61214705	61215223	BnaA09T0612800ZY	0	+	0	0	518	0.0000000
zheyou73v0_A09	61215559	61219029	BnaA09T0612900ZY	0	-	0	0	3470	0.0000000
zheyou73v0_A09	61222653	61223863	BnaA09T0613000ZY	0	-	0	0	1210	0.0000000
zheyou73v0_A09	61224583	61225165	BnaA09T0613100ZY	0	+	0	0	582	0.0000000
zheyou73v0_A09	61225576	61226687	BnaA09T0613200ZY	0	+	0	0	1111	0.0000000
zheyou73v0_A09	61235816	61237312	BnaA09T0613300ZY	0	+	0	0	1496	0.0000000
zheyou73v0_A09	61239048	61241409	BnaA09T0613400ZY	0	+	0	0	2361	0.0000000
zheyou73v0_A09	61243504	61246036	BnaA09T0613500ZY	0	+	0	0	2532	0.0000000
zheyou73v0_A09	61249251	61251511	BnaA09T0613600ZY	0	+	0	0	2260	0.0000000
zheyou73v0_A09	61258367	61259993	BnaA09T0613700ZY	0	-	0	0	1626	0.0000000
zheyou73v0_A09	61268808	61270809	BnaA09T0613800ZY	0	+	0	0	2001	0.0000000
zheyou73v0_A09	61272466	61274709	BnaA09T0613900ZY	0	+	0	0	2243	0.0000000
zheyou73v0_A09	61274916	61279045	BnaA09T0614000ZY	0	-	0	0	4129	0.0000000
zheyou73v0_A09	61290855	61291303	BnaA09T0614100ZY	0	+	0	0	448	0.0000000
zheyou73v0_A09	61293687	61296299	BnaA09T0614200ZY	0	+	0	0	2612	0.0000000
zheyou73v0_A09	61296343	61296946	BnaA09T0614300ZY	0	-	0	0	603	0.0000000
zheyou73v0_A09	61298389	61305083	BnaA09T0614400ZY	0	+	0	0	6694	0.0000000
zheyou73v0_A09	61305160	61306898	BnaA09T0614500ZY	0	+	0	0	1738	0.0000000
zheyou73v0_A09	61309843	61311062	BnaA09T0614600ZY	0	-	0	0	1219	0.0000000
zheyou73v0_A09	61312117	61313053	BnaA09T0614700ZY	0	-	0	0	936	0.0000000
zheyou73v0_A09	61316301	61316814	BnaA09T0614800ZY	0	-	0	0	513	0.0000000
zheyou73v0_A09	61322556	61323241	BnaA09T0614900ZY	0	-	0	0	685	0.0000000
zheyou73v0_A09	61323246	61328280	BnaA09T0615000ZY	0	-	0	0	5034	0.0000000
zheyou73v0_A09	61328578	61329960	BnaA09T0615100ZY	0	-	0	0	1382	0.0000000
zheyou73v0_A09	61330443	61331481	BnaA09T0615200ZY	0	+	0	0	1038	0.0000000
zheyou73v0_A09	61332448	61333465	BnaA09T0615300ZY	0	+	0	0	1017	0.0000000
zheyou73v0_A09	61334527	61336299	BnaA09T0615400ZY	0	+	0	0	1772	0.0000000
zheyou73v0_A09	61336684	61339474	BnaA09T0615500ZY	0	-	0	0	2790	0.0000000
zheyou73v0_A09	61346567	61346929	BnaA09T0615600ZY	0	-	0	0	362	0.0000000
zheyou73v0_A09	61359936	61360919	BnaA09T0615700ZY	0	-	0	0	983	0.0000000
zheyou73v0_A09	61364966	61365890	BnaA09T0615800ZY	0	-	0	0	924	0.0000000
zheyou73v0_A09	61368113	61369855	BnaA09T0615900ZY	0	-	0	0	1742	0.0000000
zheyou73v0_A09	61371069	61373191	BnaA09T0616000ZY	0	+	0	0	2122	0.0000000
zheyou73v0_A09	61372979	61374888	BnaA09T0616100ZY	0	-	0	0	1909	0.0000000
zheyou73v0_A09	61378276	61383179	BnaA09T0616200ZY	0	+	0	0	4903	0.0000000
zheyou73v0_A09	61384063	61385584	BnaA09T0616300ZY	0	+	0	0	1521	0.0000000
zheyou73v0_A09	61385585	61387188	BnaA09T0616400ZY	0	+	0	0	1603	0.0000000
zheyou73v0_A09	61388392	61393739	BnaA09T0616500ZY	0	+	0	0	5347	0.0000000
zheyou73v0_A09	61397538	61398484	BnaA09T0616600ZY	0	+	0	0	946	0.0000000
zheyou73v0_A09	61400187	61402015	BnaA09T0616700ZY	0	-	0	0	1828	0.0000000
zheyou73v0_A09	61402409	61404173	BnaA09T0616800ZY	0	-	0	0	1764	0.0000000
zheyou73v0_A09	61411095	61411857	BnaA09T0616900ZY	0	+	0	0	762	0.0000000
zheyou73v0_A09	61413454	61419664	BnaA09T0617000ZY	0	-	0	0	6210	0.0000000
zheyou73v0_A09	61421201	61421678	BnaA09T0617100ZY	0	-	0	0	477	0.0000000
zheyou73v0_A09	61422260	61422960	BnaA09T0617200ZY	0	-	0	0	700	0.0000000
zheyou73v0_A09	61426558	61427551	BnaA09T0617300ZY	0	+	0	0	993	0.0000000
zheyou73v0_A09	61428112	61428751	BnaA09T0617400ZY	0	-	0	0	639	0.0000000
zheyou73v0_A09	61428414	61430864	BnaA09T0617500ZY	0	-	0	0	2450	0.0000000
zheyou73v0_A09	61428966	61430864	BnaA09T0617500ZY.1	0	-	0	0	1898	0.0000000
zheyou73v0_A09	61431272	61433304	BnaA09T0617600ZY	0	+	0	0	2032	0.0000000
zheyou73v0_A09	61433597	61436612	BnaA09T0617700ZY	0	+	0	0	3015	0.0000000
zheyou73v0_A09	61433798	61436387	BnaA09T0617700ZY.1	0	+	0	0	2589	0.0000000
zheyou73v0_A09	61441087	61443411	BnaA09T0617800ZY	0	-	0	0	2324	0.0000000
zheyou73v0_A09	61444877	61447089	BnaA09T0617900ZY	0	-	0	0	2212	0.0000000
zheyou73v0_A09	61450334	61453431	BnaA09T0618000ZY	0	+	0	0	3097	0.0000000
zheyou73v0_A09	61453706	61454857	BnaA09T0618100ZY	0	-	0	0	1151	0.0000000
zheyou73v0_A09	61455314	61458351	BnaA09T0618200ZY	0	-	0	0	3037	0.0000000
zheyou73v0_A09	61459288	61462226	BnaA09T0618300ZY	0	-	0	0	2938	0.0000000
zheyou73v0_A09	61466048	61471401	BnaA09T0618400ZY	0	+	0	0	5353	0.0000000
zheyou73v0_A09	61472269	61474358	BnaA09T0618500ZY	0	+	0	0	2089	0.0000000
zheyou73v0_A09	61472269	61474358	BnaA09T0618500ZY.1	0	+	0	0	2089	0.0000000
zheyou73v0_A09	61474571	61476179	BnaA09T0618600ZY	0	-	0	0	1608	0.0000000
zheyou73v0_A09	61488226	61494690	BnaA09T0618700ZY	0	+	0	0	6464	0.0000000
zheyou73v0_A09	61496973	61498568	BnaA09T0618800ZY	0	+	0	0	1595	0.0000000
zheyou73v0_A09	61499709	61500427	BnaA09T0618900ZY	0	+	0	0	718	0.0000000
zheyou73v0_A09	61502253	61512308	BnaA09T0619000ZY	0	-	0	0	10055	0.0000000
zheyou73v0_A09	61502253	61512308	BnaA09T0619000ZY.1	0	-	0	0	10055	0.0000000
zheyou73v0_A09	61513719	61519798	BnaA09T0619100ZY	0	-	0	0	6079	0.0000000
zheyou73v0_A09	61520369	61521269	BnaA09T0619200ZY	0	+	0	0	900	0.0000000
zheyou73v0_A09	61526806	61527640	BnaA09T0619300ZY	0	-	0	0	834	0.0000000
zheyou73v0_A09	61528228	61529884	BnaA09T0619400ZY	0	+	0	0	1656	0.0000000
zheyou73v0_A09	61530483	61531472	BnaA09T0619500ZY	0	-	0	0	989	0.0000000
zheyou73v0_A09	61532437	61532875	BnaA09T0619600ZY	0	+	0	0	438	0.0000000
zheyou73v0_A09	61534158	61534590	BnaA09T0619700ZY	0	+	0	0	432	0.0000000
zheyou73v0_A09	61540071	61540820	BnaA09T0619800ZY	0	+	0	0	749	0.0000000
zheyou73v0_A09	61541318	61542071	BnaA09T0619900ZY	0	-	0	0	753	0.0000000
zheyou73v0_A09	61542365	61546487	BnaA09T0620000ZY	0	+	0	0	4122	0.0000000
zheyou73v0_A09	61546871	61549813	BnaA09T0620100ZY	0	-	0	0	2942	0.0000000
zheyou73v0_A09	61547407	61549813	BnaA09T0620100ZY.1	0	-	0	0	2406	0.0000000
zheyou73v0_A09	61553932	61556424	BnaA09T0620200ZY	0	-	0	0	2492	0.0000000
zheyou73v0_A09	61558662	61559506	BnaA09T0620300ZY	0	-	0	0	844	0.0000000
zheyou73v0_A09	61568297	61570246	BnaA09T0620400ZY	0	+	0	0	1949	0.0000000
zheyou73v0_A09	61571404	61571727	BnaA09T0620500ZY	0	+	0	0	323	0.0000000
zheyou73v0_A09	61573570	61575970	BnaA09T0620600ZY	0	+	0	0	2400	0.0000000
zheyou73v0_A09	61575697	61590446	BnaA09T0620700ZY	0	-	0	0	14749	0.0000000
zheyou73v0_A09	61591462	61595448	BnaA09T0620800ZY	0	-	0	0	3986	0.0000000
zheyou73v0_A09	61591462	61595448	BnaA09T0620800ZY.1	0	-	0	0	3986	0.0000000
zheyou73v0_A09	61613330	61614699	BnaA09T0620900ZY	0	+	0	0	1369	0.0000000
zheyou73v0_A09	61614845	61615821	BnaA09T0621000ZY	0	-	0	0	976	0.0000000
zheyou73v0_A09	61620058	61625129	BnaA09T0621100ZY	0	+	0	0	5071	0.0000000
zheyou73v0_A09	61626261	61627963	BnaA09T0621200ZY	0	+	0	0	1702	0.0000000
zheyou73v0_A09	61628981	61630664	BnaA09T0621300ZY	0	+	0	0	1683	0.0000000
zheyou73v0_A09	61630701	61634940	BnaA09T0621400ZY	0	+	0	0	4239	0.0000000
zheyou73v0_A09	61635509	61637324	BnaA09T0621500ZY	0	+	0	0	1815	0.0000000
zheyou73v0_A09	61637598	61642967	BnaA09T0621600ZY	0	-	0	0	5369	0.0000000
zheyou73v0_A09	61643256	61645852	BnaA09T0621700ZY	0	-	0	0	2596	0.0000000
zheyou73v0_A09	61643256	61645852	BnaA09T0621700ZY.1	0	-	0	0	2596	0.0000000
zheyou73v0_A09	61643856	61645852	BnaA09T0621700ZY.2	0	-	0	0	1996	0.0000000
zheyou73v0_A09	61648134	61649489	BnaA09T0621800ZY	0	+	0	0	1355	0.0000000
zheyou73v0_A09	61648134	61648975	BnaA09T0621800ZY.1	0	+	0	0	841	0.0000000
zheyou73v0_A09	61650115	61653186	BnaA09T0621900ZY	0	+	0	0	3071	0.0000000
zheyou73v0_A09	61653375	61659873	BnaA09T0622000ZY	0	-	0	0	6498	0.0000000
zheyou73v0_A09	61660428	61661716	BnaA09T0622100ZY	0	-	0	0	1288	0.0000000
zheyou73v0_A09	61665730	61666725	BnaA09T0622200ZY	0	-	0	0	995	0.0000000
zheyou73v0_A09	61667160	61668271	BnaA09T0622300ZY	0	+	0	0	1111	0.0000000
zheyou73v0_A09	61668988	61677860	BnaA09T0622400ZY	0	-	0	0	8872	0.0000000
zheyou73v0_A09	61678698	61679406	BnaA09T0622500ZY	0	+	0	0	708	0.0000000
zheyou73v0_A09	61680452	61682546	BnaA09T0622600ZY	0	-	0	0	2094	0.0000000
zheyou73v0_A09	61680452	61682236	BnaA09T0622600ZY.1	0	-	0	0	1784	0.0000000
zheyou73v0_A09	61683106	61684015	BnaA09T0622700ZY	0	+	0	0	909	0.0000000
zheyou73v0_A09	61684450	61686730	BnaA09T0622800ZY	0	-	0	0	2280	0.0000000
zheyou73v0_A09	61692101	61696540	BnaA09T0622900ZY	0	+	0	0	4439	0.0000000
zheyou73v0_A09	61696459	61697831	BnaA09T0623000ZY	0	-	0	0	1372	0.0000000
zheyou73v0_A09	61696459	61697831	BnaA09T0623000ZY.1	0	-	0	0	1372	0.0000000
zheyou73v0_A09	61702096	61702780	BnaA09T0623100ZY	0	+	0	0	684	0.0000000
zheyou73v0_A09	61712273	61715369	BnaA09T0623200ZY	0	+	0	0	3096	0.0000000
zheyou73v0_A09	61717145	61719698	BnaA09T0623300ZY	0	-	0	0	2553	0.0000000
zheyou73v0_A09	61720079	61723247	BnaA09T0623400ZY	0	+	0	0	3168	0.0000000
zheyou73v0_A09	61723726	61725884	BnaA09T0623500ZY	0	-	0	0	2158	0.0000000
zheyou73v0_A09	61728867	61733311	BnaA09T0623600ZY	0	+	0	0	4444	0.0000000
zheyou73v0_A09	61733886	61735335	BnaA09T0623700ZY	0	+	0	0	1449	0.0000000
zheyou73v0_A09	61799794	61802066	BnaA09T0623800ZY	0	+	0	0	2272	0.0000000
zheyou73v0_A09	61803476	61828860	BnaA09T0623900ZY	0	+	0	0	25384	0.0000000
zheyou73v0_A09	61803476	61828860	BnaA09T0623900ZY.1	0	+	0	0	25384	0.0000000
zheyou73v0_A09	61828008	61831039	BnaA09T0624000ZY	0	-	0	0	3031	0.0000000
zheyou73v0_A09	61832947	61834221	BnaA09T0624100ZY	0	+	0	0	1274	0.0000000
zheyou73v0_A09	61834942	61838327	BnaA09T0624200ZY	0	+	0	0	3385	0.0000000
zheyou73v0_A09	61839108	61840227	BnaA09T0624300ZY	0	+	0	0	1119	0.0000000
zheyou73v0_A09	61843509	61844003	BnaA09T0624400ZY	0	+	0	0	494	0.0000000
zheyou73v0_A09	61857177	61859955	BnaA09T0624500ZY	0	+	0	0	2778	0.0000000
zheyou73v0_A09	61873014	61874847	BnaA09T0624600ZY	0	+	0	0	1833	0.0000000
zheyou73v0_A09	61875630	61878667	BnaA09T0624700ZY	0	+	0	0	3037	0.0000000
zheyou73v0_A09	61879531	61880217	BnaA09T0624800ZY	0	+	0	0	686	0.0000000
zheyou73v0_A09	61888017	61899139	BnaA09T0624900ZY	0	+	0	0	11122	0.0000000
zheyou73v0_A09	61901348	61902671	BnaA09T0625000ZY	0	-	0	0	1323	0.0000000
zheyou73v0_A09	61903409	61904243	BnaA09T0625100ZY	0	+	0	0	834	0.0000000
zheyou73v0_A09	61906502	61907331	BnaA09T0625200ZY	0	+	0	0	829	0.0000000
zheyou73v0_A09	61909123	61910842	BnaA09T0625300ZY	0	-	0	0	1719	0.0000000
zheyou73v0_A09	61918568	61920805	BnaA09T0625400ZY	0	+	0	0	2237	0.0000000
zheyou73v0_A09	61918568	61920805	BnaA09T0625400ZY.1	0	+	0	0	2237	0.0000000
zheyou73v0_A09	61920911	61925535	BnaA09T0625500ZY	0	-	0	0	4624	0.0000000
zheyou73v0_A09	61926597	61929077	BnaA09T0625600ZY	0	-	0	0	2480	0.0000000
zheyou73v0_A09	61932907	61934187	BnaA09T0625700ZY	0	+	0	0	1280	0.0000000
zheyou73v0_A09	61943070	61947001	BnaA09T0625800ZY	0	+	0	0	3931	0.0000000
zheyou73v0_A09	61947799	61949169	BnaA09T0625900ZY	0	-	0	0	1370	0.0000000
zheyou73v0_A09	61950159	61950858	BnaA09T0626000ZY	0	-	0	0	699	0.0000000
zheyou73v0_A09	61953145	61954702	BnaA09T0626100ZY	0	-	0	0	1557	0.0000000
zheyou73v0_A09	61953145	61954702	BnaA09T0626100ZY.1	0	-	0	0	1557	0.0000000
zheyou73v0_A09	61958675	61959243	BnaA09T0626200ZY	0	-	0	0	568	0.0000000
zheyou73v0_A09	61965504	61968414	BnaA09T0626300ZY	0	-	0	0	2910	0.0000000
zheyou73v0_A09	61967184	61968414	BnaA09T0626300ZY.1	0	-	0	0	1230	0.0000000
zheyou73v0_A09	61972103	61972514	BnaA09T0626400ZY	0	-	0	0	411	0.0000000
zheyou73v0_A09	61979206	61981831	BnaA09T0626500ZY	0	+	0	0	2625	0.0000000
zheyou73v0_A09	61983750	61985396	BnaA09T0626600ZY	0	-	0	0	1646	0.0000000
zheyou73v0_A09	61985572	61989519	BnaA09T0626700ZY	0	+	0	0	3947	0.0000000
zheyou73v0_A09	61991469	61996921	BnaA09T0626800ZY	0	+	0	0	5452	0.0000000
zheyou73v0_A09	61991469	61996921	BnaA09T0626800ZY.1	0	+	0	0	5452	0.0000000
zheyou73v0_A09	61997511	61998689	BnaA09T0626900ZY	0	+	0	0	1178	0.0000000
zheyou73v0_A09	62006109	62008354	BnaA09T0627000ZY	0	-	0	0	2245	0.0000000
zheyou73v0_A09	62006109	62008354	BnaA09T0627000ZY.1	0	-	0	0	2245	0.0000000
zheyou73v0_A09	62018064	62018798	BnaA09T0627100ZY	0	+	0	0	734	0.0000000
zheyou73v0_A09	62019218	62023901	BnaA09T0627200ZY	0	-	0	0	4683	0.0000000
zheyou73v0_A09	62024992	62025226	BnaA09T0627300ZY	0	+	0	0	234	0.0000000
zheyou73v0_A09	62025720	62026152	BnaA09T0627400ZY	0	-	0	0	432	0.0000000
zheyou73v0_A09	62026157	62027105	BnaA09T0627500ZY	0	-	0	0	948	0.0000000
zheyou73v0_A09	62034291	62036567	BnaA09T0627600ZY	0	-	0	0	2276	0.0000000
zheyou73v0_A09	62052325	62056084	BnaA09T0627700ZY	0	+	0	0	3759	0.0000000
zheyou73v0_A09	62056723	62058376	BnaA09T0627800ZY	0	-	0	0	1653	0.0000000
zheyou73v0_A09	62059099	62061091	BnaA09T0627900ZY	0	+	0	0	1992	0.0000000
zheyou73v0_A09	62063077	62064827	BnaA09T0628000ZY	0	+	0	0	1750	0.0000000
zheyou73v0_A09	62064365	62070178	BnaA09T0628100ZY	0	-	0	0	5813	0.0000000
zheyou73v0_A09	62070620	62075021	BnaA09T0628200ZY	0	+	0	0	4401	0.0000000
zheyou73v0_A09	62077319	62078186	BnaA09T0628300ZY	0	+	0	0	867	0.0000000
zheyou73v0_A09	62079034	62079865	BnaA09T0628400ZY	0	+	0	0	831	0.0000000
zheyou73v0_A09	62080574	62083137	BnaA09T0628500ZY	0	+	0	0	2563	0.0000000
zheyou73v0_A09	62083915	62086564	BnaA09T0628600ZY	0	-	0	0	2649	0.0000000
zheyou73v0_A09	62088045	62091380	BnaA09T0628700ZY	0	-	0	0	3335	0.0000000
zheyou73v0_A09	62106845	62108574	BnaA09T0628800ZY	0	-	0	0	1729	0.0000000
zheyou73v0_A09	62109566	62111118	BnaA09T0628900ZY	0	+	0	0	1552	0.0000000
zheyou73v0_A09	62114103	62114568	BnaA09T0629000ZY	0	+	0	0	465	0.0000000
zheyou73v0_A09	62115829	62116123	BnaA09T0629100ZY	0	-	0	0	294	0.0000000
zheyou73v0_A09	62122503	62124642	BnaA09T0629200ZY	0	+	0	0	2139	0.0000000
zheyou73v0_A09	62128699	62132133	BnaA09T0629300ZY	0	+	0	0	3434	0.0000000
zheyou73v0_A09	62134779	62143082	BnaA09T0629400ZY	0	-	0	0	8303	0.0000000
zheyou73v0_A09	62134779	62143082	BnaA09T0629400ZY.1	0	-	0	0	8303	0.0000000
zheyou73v0_A09	62145968	62146727	BnaA09T0629500ZY	0	+	0	0	759	0.0000000
zheyou73v0_A09	62146871	62149257	BnaA09T0629600ZY	0	-	0	0	2386	0.0000000
zheyou73v0_A09	62149493	62151709	BnaA09T0629700ZY	0	+	0	0	2216	0.0000000
zheyou73v0_A09	62152330	62152663	BnaA09T0629800ZY	0	+	0	0	333	0.0000000
zheyou73v0_A09	62153041	62153983	BnaA09T0629900ZY	0	+	0	0	942	0.0000000
zheyou73v0_A09	62155248	62156973	BnaA09T0630000ZY	0	+	0	0	1725	0.0000000
zheyou73v0_A09	62158177	62160035	BnaA09T0630100ZY	0	+	0	0	1858	0.0000000
zheyou73v0_A09	62161404	62162215	BnaA09T0630200ZY	0	+	0	0	811	0.0000000
zheyou73v0_A09	62162321	62165620	BnaA09T0630300ZY	0	-	0	0	3299	0.0000000
zheyou73v0_A09	62166755	62169156	BnaA09T0630400ZY	0	+	0	0	2401	0.0000000
zheyou73v0_A09	62170690	62172142	BnaA09T0630500ZY	0	+	0	0	1452	0.0000000
zheyou73v0_A09	62172582	62173176	BnaA09T0630600ZY	0	+	0	0	594	0.0000000
zheyou73v0_A09	62174918	62181431	BnaA09T0630700ZY	0	-	0	0	6513	0.0000000
zheyou73v0_A09	62183761	62188892	BnaA09T0630800ZY	0	+	0	0	5131	0.0000000
zheyou73v0_A09	62193466	62207657	BnaA09T0630900ZY	0	+	0	0	14191	0.0000000
zheyou73v0_A09	62207948	62209563	BnaA09T0631000ZY	0	+	0	0	1615	0.0000000
zheyou73v0_A09	62209887	62212386	BnaA09T0631100ZY	0	-	0	0	2499	0.0000000
zheyou73v0_A09	62220965	62224358	BnaA09T0631200ZY	0	-	0	0	3393	0.0000000
zheyou73v0_A09	62225656	62229613	BnaA09T0631300ZY	0	+	0	0	3957	0.0000000
zheyou73v0_A09	62229963	62234434	BnaA09T0631400ZY	0	+	0	0	4471	0.0000000
zheyou73v0_A09	62234920	62237965	BnaA09T0631500ZY	0	-	0	0	3045	0.0000000
zheyou73v0_A09	62238538	62241233	BnaA09T0631600ZY	0	-	0	0	2695	0.0000000
zheyou73v0_A09	62242629	62244116	BnaA09T0631700ZY	0	+	0	0	1487	0.0000000
zheyou73v0_A09	62246261	62252422	BnaA09T0631800ZY	0	+	0	0	6161	0.0000000
zheyou73v0_A09	62252500	62255139	BnaA09T0631900ZY	0	-	0	0	2639	0.0000000
zheyou73v0_A09	62255429	62257223	BnaA09T0632000ZY	0	-	0	0	1794	0.0000000
zheyou73v0_A09	62260074	62260806	BnaA09T0632100ZY	0	-	0	0	732	0.0000000
zheyou73v0_A09	62269817	62271144	BnaA09T0632200ZY	0	+	0	0	1327	0.0000000
zheyou73v0_A09	62271671	62273375	BnaA09T0632300ZY	0	-	0	0	1704	0.0000000
zheyou73v0_A09	62273621	62275984	BnaA09T0632400ZY	0	+	0	0	2363	0.0000000
zheyou73v0_A09	62276229	62277356	BnaA09T0632500ZY	0	-	0	0	1127	0.0000000
zheyou73v0_A09	62280259	62280799	BnaA09T0632600ZY	0	+	0	0	540	0.0000000
zheyou73v0_A09	62284354	62287196	BnaA09T0632700ZY	0	+	0	0	2842	0.0000000
zheyou73v0_A09	62289380	62293610	BnaA09T0632800ZY	0	-	0	0	4230	0.0000000
zheyou73v0_A09	62301773	62308179	BnaA09T0632900ZY	0	-	0	0	6406	0.0000000
zheyou73v0_A09	62311353	62312854	BnaA09T0633000ZY	0	+	0	0	1501	0.0000000
zheyou73v0_A09	62311353	62312854	BnaA09T0633000ZY.1	0	+	0	0	1501	0.0000000
zheyou73v0_A09	62325856	62326508	BnaA09T0633100ZY	0	+	0	0	652	0.0000000
zheyou73v0_A09	62326834	62327850	BnaA09T0633200ZY	0	+	0	0	1016	0.0000000
zheyou73v0_A09	62327519	62329597	BnaA09T0633300ZY	0	-	0	0	2078	0.0000000
zheyou73v0_A09	62330092	62330512	BnaA09T0633400ZY	0	+	0	0	420	0.0000000
zheyou73v0_A09	62333774	62336044	BnaA09T0633500ZY	0	+	0	0	2270	0.0000000
zheyou73v0_A09	62336297	62336771	BnaA09T0633600ZY	0	-	0	0	474	0.0000000
zheyou73v0_A09	62343504	62345852	BnaA09T0633700ZY	0	+	0	0	2348	0.0000000
zheyou73v0_A09	62343504	62345852	BnaA09T0633700ZY.1	0	+	0	0	2348	0.0000000
zheyou73v0_A09	62348062	62349006	BnaA09T0633800ZY	0	-	0	0	944	0.0000000
zheyou73v0_A09	62351284	62351497	BnaA09T0633900ZY	0	+	0	0	213	0.0000000
zheyou73v0_A09	62351639	62351895	BnaA09T0634000ZY	0	-	0	0	256	0.0000000
zheyou73v0_A09	62353935	62355143	BnaA09T0634100ZY.1	0	+	0	0	1208	0.0000000
zheyou73v0_A09	62354128	62356071	BnaA09T0634100ZY	0	+	0	0	1943	0.0000000
zheyou73v0_A09	62356261	62357230	BnaA09T0634200ZY	0	+	0	0	969	0.0000000
zheyou73v0_A09	62358495	62359662	BnaA09T0634300ZY	0	+	0	0	1167	0.0000000
zheyou73v0_A09	62361067	62362869	BnaA09T0634400ZY	0	+	0	0	1802	0.0000000
zheyou73v0_A09	62361158	62362869	BnaA09T0634400ZY.1	0	+	0	0	1711	0.0000000
zheyou73v0_A09	62363074	62370322	BnaA09T0634500ZY	0	+	0	0	7248	0.0000000
zheyou73v0_A09	62370852	62372848	BnaA09T0634600ZY	0	+	0	0	1996	0.0000000
zheyou73v0_A09	62374085	62375225	BnaA09T0634700ZY	0	+	0	0	1140	0.0000000
zheyou73v0_A09	62382175	62383449	BnaA09T0634800ZY	0	-	0	0	1274	0.0000000
zheyou73v0_A09	62387236	62391002	BnaA09T0634900ZY	0	-	0	0	3766	0.0000000
zheyou73v0_A09	62394704	62398505	BnaA09T0635000ZY	0	-	0	0	3801	0.0000000
zheyou73v0_A09	62394704	62398505	BnaA09T0635000ZY.1	0	-	0	0	3801	0.0000000
zheyou73v0_A09	62394704	62398505	BnaA09T0635000ZY.2	0	-	0	0	3801	0.0000000
zheyou73v0_A09	62402792	62404620	BnaA09T0635100ZY	0	-	0	0	1828	0.0000000
zheyou73v0_A09	62405078	62406220	BnaA09T0635200ZY	0	-	0	0	1142	0.0000000
zheyou73v0_A09	62407126	62408964	BnaA09T0635300ZY	0	-	0	0	1838	0.0000000
zheyou73v0_A09	62415414	62419111	BnaA09T0635400ZY	0	-	0	0	3697	0.0000000
zheyou73v0_A09	62415414	62418351	BnaA09T0635400ZY.1	0	-	0	0	2937	0.0000000
zheyou73v0_A09	62415414	62419111	BnaA09T0635400ZY.2	0	-	0	0	3697	0.0000000
zheyou73v0_A09	62415414	62418308	BnaA09T0635400ZY.3	0	-	0	0	2894	0.0000000
zheyou73v0_A09	62415414	62418308	BnaA09T0635400ZY.4	0	-	0	0	2894	0.0000000
zheyou73v0_A09	62421605	62421944	BnaA09T0635500ZY	0	+	0	0	339	0.0000000
zheyou73v0_A09	62422449	62423654	BnaA09T0635600ZY	0	+	0	0	1205	0.0000000
zheyou73v0_A09	62431934	62433812	BnaA09T0635700ZY	0	-	0	0	1878	0.0000000
zheyou73v0_A09	62440436	62443491	BnaA09T0635800ZY	0	+	0	0	3055	0.0000000
zheyou73v0_A09	62443689	62447411	BnaA09T0635900ZY	0	+	0	0	3722	0.0000000
zheyou73v0_A09	62443689	62447411	BnaA09T0635900ZY.1	0	+	0	0	3722	0.0000000
zheyou73v0_A09	62447512	62448777	BnaA09T0636000ZY	0	+	0	0	1265	0.0000000
zheyou73v0_A09	62448932	62450199	BnaA09T0636100ZY	0	+	0	0	1267	0.0000000
zheyou73v0_A09	62450767	62452743	BnaA09T0636200ZY	0	+	0	0	1976	0.0000000
zheyou73v0_A09	62454261	62455110	BnaA09T0636300ZY	0	-	0	0	849	0.0000000
zheyou73v0_A09	62458517	62460019	BnaA09T0636400ZY	0	+	0	0	1502	0.0000000
zheyou73v0_A09	62460193	62461602	BnaA09T0636500ZY	0	+	0	0	1409	0.0000000
zheyou73v0_A09	62461751	62462642	BnaA09T0636600ZY	0	+	0	0	891	0.0000000
zheyou73v0_A09	62465102	62466922	BnaA09T0636700ZY	0	+	0	0	1820	0.0000000
zheyou73v0_A09	62471396	62472110	BnaA09T0636800ZY	0	+	0	0	714	0.0000000
zheyou73v0_A09	62472732	62474871	BnaA09T0636900ZY	0	-	0	0	2139	0.0000000
zheyou73v0_A09	62485714	62488271	BnaA09T0637000ZY	0	-	0	0	2557	0.0000000
zheyou73v0_A09	62515075	62516049	BnaA09T0637100ZY	0	+	0	0	974	0.0000000
zheyou73v0_A09	62517922	62519504	BnaA09T0637200ZY	0	+	0	0	1582	0.0000000
zheyou73v0_A09	62520551	62521525	BnaA09T0637300ZY	0	+	0	0	974	0.0000000
zheyou73v0_A09	62523403	62525816	BnaA09T0637400ZY	0	+	0	0	2413	0.0000000
zheyou73v0_A09	62527940	62532174	BnaA09T0637500ZY	0	+	0	0	4234	0.0000000
zheyou73v0_A09	62534712	62538084	BnaA09T0637600ZY	0	+	0	0	3372	0.0000000
zheyou73v0_A09	62540786	62543242	BnaA09T0637700ZY	0	+	0	0	2456	0.0000000
zheyou73v0_A09	62547401	62548778	BnaA09T0637800ZY	0	-	0	0	1377	0.0000000
zheyou73v0_A09	62554011	62555898	BnaA09T0637900ZY	0	+	0	0	1887	0.0000000
zheyou73v0_A09	62556572	62559816	BnaA09T0638000ZY	0	-	0	0	3244	0.0000000
zheyou73v0_A09	62565371	62567074	BnaA09T0638100ZY	0	+	0	0	1703	0.0000000
zheyou73v0_A09	62567522	62568547	BnaA09T0638200ZY	0	+	0	0	1025	0.0000000
zheyou73v0_A09	62568627	62576279	BnaA09T0638300ZY	0	+	0	0	7652	0.0000000
zheyou73v0_A09	62578523	62579831	BnaA09T0638400ZY	0	+	0	0	1308	0.0000000
zheyou73v0_A09	62580166	62580491	BnaA09T0638500ZY	0	+	0	0	325	0.0000000
zheyou73v0_A09	62580507	62586202	BnaA09T0638600ZY	0	+	0	0	5695	0.0000000
zheyou73v0_A09	62590887	62594692	BnaA09T0638700ZY	0	-	0	0	3805	0.0000000
zheyou73v0_A09	62594978	62597506	BnaA09T0638800ZY	0	-	0	0	2528	0.0000000
zheyou73v0_A09	62597844	62599924	BnaA09T0638900ZY	0	-	0	0	2080	0.0000000
zheyou73v0_A09	62600116	62603263	BnaA09T0639000ZY	0	+	0	0	3147	0.0000000
zheyou73v0_A09	62603697	62606042	BnaA09T0639100ZY	0	-	0	0	2345	0.0000000
zheyou73v0_A09	62606239	62607836	BnaA09T0639200ZY	0	+	0	0	1597	0.0000000
zheyou73v0_A09	62606239	62607836	BnaA09T0639200ZY.1	0	+	0	0	1597	0.0000000
zheyou73v0_A09	62608114	62612592	BnaA09T0639300ZY	0	+	0	0	4478	0.0000000
zheyou73v0_A09	62612844	62619480	BnaA09T0639400ZY	0	-	0	0	6636	0.0000000
zheyou73v0_A09	62621350	62625526	BnaA09T0639500ZY	0	+	0	0	4176	0.0000000
zheyou73v0_A09	62621350	62625526	BnaA09T0639500ZY.1	0	+	0	0	4176	0.0000000
zheyou73v0_A09	62626700	62627610	BnaA09T0639600ZY	0	-	0	0	910	0.0000000
zheyou73v0_A09	62630137	62631953	BnaA09T0639700ZY	0	+	0	0	1816	0.0000000
zheyou73v0_A09	62630137	62631953	BnaA09T0639700ZY.1	0	+	0	0	1816	0.0000000
zheyou73v0_A09	62634002	62634514	BnaA09T0639800ZY	0	-	0	0	512	0.0000000
zheyou73v0_A09	62637453	62650680	BnaA09T0639900ZY	0	+	0	0	13227	0.0000000
zheyou73v0_A09	62637453	62650445	BnaA09T0639900ZY.1	0	+	0	0	12992	0.0000000
zheyou73v0_A09	62652480	62655215	BnaA09T0640000ZY	0	-	0	0	2735	0.0000000
zheyou73v0_A09	62652480	62655215	BnaA09T0640000ZY.1	0	-	0	0	2735	0.0000000
zheyou73v0_A09	62652527	62653007	BnaA09T0640100ZY	0	+	0	0	480	0.0000000
zheyou73v0_A09	62653507	62655215	BnaA09T0640000ZY.2	0	-	0	0	1708	0.0000000
zheyou73v0_A09	62655469	62658292	BnaA09T0640200ZY	0	+	0	0	2823	0.0000000
zheyou73v0_A09	62659478	62662662	BnaA09T0640300ZY	0	-	0	0	3184	0.0000000
zheyou73v0_A09	62662768	62666800	BnaA09T0640400ZY	0	+	0	0	4032	0.0000000
zheyou73v0_A09	62673444	62677534	BnaA09T0640500ZY	0	+	0	0	4090	0.0000000
zheyou73v0_A09	62710119	62712775	BnaA09T0640600ZY	0	+	0	0	2656	0.0000000
zheyou73v0_A09	62714491	62716754	BnaA09T0640700ZY	0	+	0	0	2263	0.0000000
zheyou73v0_A09	62717277	62728620	BnaA09T0640800ZY	0	-	0	0	11343	0.0000000
zheyou73v0_A09	62740179	62743211	BnaA09T0640900ZY	0	+	0	0	3032	0.0000000
zheyou73v0_A09	62745071	62747339	BnaA09T0641000ZY	0	+	0	0	2268	0.0000000
zheyou73v0_A09	62747606	62751444	BnaA09T0641100ZY	0	-	0	0	3838	0.0000000
zheyou73v0_A09	62755849	62756306	BnaA09T0641200ZY	0	+	0	0	457	0.0000000
zheyou73v0_A09	62758686	62761117	BnaA09T0641300ZY	0	+	0	0	2431	0.0000000
zheyou73v0_A09	62761298	62761936	BnaA09T0641400ZY	0	-	0	0	638	0.0000000
zheyou73v0_A09	62763253	62765869	BnaA09T0641500ZY	0	+	0	0	2616	0.0000000
zheyou73v0_A09	62774717	62777046	BnaA09T0641600ZY	0	+	0	0	2329	0.0000000
zheyou73v0_A09	62778979	62782784	BnaA09T0641700ZY	0	-	0	0	3805	0.0000000
zheyou73v0_A09	62783131	62785309	BnaA09T0641800ZY	0	-	0	0	2178	0.0000000
zheyou73v0_A09	62787287	62792577	BnaA09T0641900ZY	0	-	0	0	5290	0.0000000
zheyou73v0_A09	62793270	62797718	BnaA09T0642000ZY	0	-	0	0	4448	0.0000000
zheyou73v0_A09	62797980	62799379	BnaA09T0642100ZY	0	-	0	0	1399	0.0000000
zheyou73v0_A09	62799868	62801185	BnaA09T0642200ZY	0	+	0	0	1317	0.0000000
zheyou73v0_A09	62801885	62802745	BnaA09T0642300ZY	0	+	0	0	860	0.0000000
zheyou73v0_A09	62803751	62805835	BnaA09T0642400ZY	0	+	0	0	2084	0.0000000
zheyou73v0_A09	62806116	62808979	BnaA09T0642500ZY	0	-	0	0	2863	0.0000000
zheyou73v0_A09	62816605	62817240	BnaA09T0642600ZY	0	-	0	0	635	0.0000000
zheyou73v0_A09	62822624	62822921	BnaA09T0642700ZY	0	+	0	0	297	0.0000000
zheyou73v0_A09	62828222	62829862	BnaA09T0642800ZY	0	-	0	0	1640	0.0000000
zheyou73v0_A09	62832013	62833768	BnaA09T0642900ZY	0	-	0	0	1755	0.0000000
zheyou73v0_A09	62836050	62838029	BnaA09T0643000ZY	0	+	0	0	1979	0.0000000
zheyou73v0_A09	62838383	62839648	BnaA09T0643100ZY	0	-	0	0	1265	0.0000000
zheyou73v0_A09	62838383	62839648	BnaA09T0643100ZY.1	0	-	0	0	1265	0.0000000
zheyou73v0_A09	62844853	62848447	BnaA09T0643200ZY	0	+	0	0	3594	0.0000000
zheyou73v0_A09	62849344	62850886	BnaA09T0643300ZY	0	+	0	0	1542	0.0000000
zheyou73v0_A09	62852583	62852970	BnaA09T0643400ZY	0	+	0	0	387	0.0000000
zheyou73v0_A09	62862663	62863640	BnaA09T0643500ZY	0	+	0	0	977	0.0000000
zheyou73v0_A09	62864551	62870049	BnaA09T0643600ZY	0	+	0	0	5498	0.0000000
zheyou73v0_A09	62878530	62879480	BnaA09T0643700ZY	0	+	0	0	950	0.0000000
zheyou73v0_A09	62880561	62882444	BnaA09T0643800ZY	0	-	0	0	1883	0.0000000
zheyou73v0_A09	62880561	62882444	BnaA09T0643800ZY.1	0	-	0	0	1883	0.0000000
zheyou73v0_A09	62882854	62884889	BnaA09T0643900ZY	0	-	0	0	2035	0.0000000
zheyou73v0_A09	62885004	62886198	BnaA09T0644000ZY	0	-	0	0	1194	0.0000000
zheyou73v0_A09	62889213	62889974	BnaA09T0644100ZY	0	+	0	0	761	0.0000000
zheyou73v0_A09	62895042	62896083	BnaA09T0644200ZY	0	-	0	0	1041	0.0000000
zheyou73v0_A09	62896888	62897338	BnaA09T0644300ZY	0	-	0	0	450	0.0000000
zheyou73v0_A09	62898025	62898726	BnaA09T0644400ZY	0	-	0	0	701	0.0000000
zheyou73v0_A09	62901222	62902218	BnaA09T0644500ZY	0	+	0	0	996	0.0000000
zheyou73v0_A09	62902754	62903146	BnaA09T0644600ZY	0	-	0	0	392	0.0000000
zheyou73v0_A09	62903281	62905520	BnaA09T0644700ZY	0	-	0	0	2239	0.0000000
zheyou73v0_A09	62906139	62911030	BnaA09T0644800ZY	0	+	0	0	4891	0.0000000
zheyou73v0_A09	62911560	62914396	BnaA09T0644900ZY	0	+	0	0	2836	0.0000000
zheyou73v0_A09	62911763	62914396	BnaA09T0644900ZY.1	0	+	0	0	2633	0.0000000
zheyou73v0_A09	62912015	62914614	BnaA09T0644900ZY.2	0	+	0	0	2599	0.0000000
zheyou73v0_A09	62917068	62919269	BnaA09T0645000ZY	0	-	0	0	2201	0.0000000
zheyou73v0_A09	62923239	62924722	BnaA09T0645100ZY	0	-	0	0	1483	0.0000000
zheyou73v0_A09	62925838	62926489	BnaA09T0645200ZY	0	-	0	0	651	0.0000000
zheyou73v0_A09	62927597	62930559	BnaA09T0645300ZY	0	+	0	0	2962	0.0000000
zheyou73v0_A09	62930836	62932022	BnaA09T0645400ZY	0	-	0	0	1186	0.0000000
zheyou73v0_A09	62932489	62935503	BnaA09T0645500ZY	0	-	0	0	3014	0.0000000
zheyou73v0_A09	62937410	62937982	BnaA09T0645600ZY	0	+	0	0	572	0.0000000
zheyou73v0_A09	62937676	62940585	BnaA09T0645700ZY	0	-	0	0	2909	0.0000000
zheyou73v0_A09	62944792	62951155	BnaA09T0645800ZY	0	+	0	0	6363	0.0000000
zheyou73v0_A09	62951304	62953837	BnaA09T0645900ZY	0	+	0	0	2533	0.0000000
zheyou73v0_A09	62953473	62955110	BnaA09T0646000ZY	0	-	0	0	1637	0.0000000
zheyou73v0_A09	62961311	62961827	BnaA09T0646100ZY	0	-	0	0	516	0.0000000
zheyou73v0_A09	62963304	62963641	BnaA09T0646200ZY	0	+	0	0	337	0.0000000
zheyou73v0_A09	62968301	62974798	BnaA09T0646300ZY	0	+	0	0	6497	0.0000000
zheyou73v0_A09	62975304	62977065	BnaA09T0646400ZY	0	+	0	0	1761	0.0000000
zheyou73v0_A09	62977457	62978856	BnaA09T0646500ZY	0	+	0	0	1399	0.0000000
zheyou73v0_A09	62978861	62979565	BnaA09T0646600ZY	0	-	0	0	704	0.0000000
zheyou73v0_A09	62980032	62980556	BnaA09T0646700ZY	0	+	0	0	524	0.0000000
zheyou73v0_A09	62981175	62982318	BnaA09T0646800ZY	0	-	0	0	1143	0.0000000
zheyou73v0_A09	62982560	62992597	BnaA09T0646900ZY	0	-	0	0	10037	0.0000000
zheyou73v0_A09	62982560	62992597	BnaA09T0646900ZY.1	0	-	0	0	10037	0.0000000
zheyou73v0_A09	62996778	62997882	BnaA09T0647000ZY	0	-	0	0	1104	0.0000000
zheyou73v0_A09	62998374	62998923	BnaA09T0647100ZY	0	-	0	0	549	0.0000000
zheyou73v0_A09	63008314	63009418	BnaA09T0647200ZY	0	-	0	0	1104	0.0000000
zheyou73v0_A09	63010189	63010663	BnaA09T0647300ZY	0	+	0	0	474	0.0000000
zheyou73v0_A09	63013233	63013868	BnaA09T0647400ZY	0	-	0	0	635	0.0000000
zheyou73v0_A09	63016428	63017279	BnaA09T0647500ZY	0	-	0	0	851	0.0000000
zheyou73v0_A09	63017859	63019048	BnaA09T0647600ZY	0	+	0	0	1189	0.0000000
zheyou73v0_A09	63019525	63021283	BnaA09T0647700ZY	0	-	0	0	1758	0.0000000
zheyou73v0_A09	63022361	63024436	BnaA09T0647800ZY	0	+	0	0	2075	0.0000000
zheyou73v0_A09	63024905	63025672	BnaA09T0647900ZY	0	-	0	0	767	0.0000000
zheyou73v0_A09	63025878	63027882	BnaA09T0648000ZY	0	+	0	0	2004	0.0000000
zheyou73v0_A09	63025878	63027882	BnaA09T0648000ZY.1	0	+	0	0	2004	0.0000000
zheyou73v0_A09	63030921	63031515	BnaA09T0648100ZY	0	+	0	0	594	0.0000000
zheyou73v0_A09	63031949	63035132	BnaA09T0648200ZY	0	-	0	0	3183	0.0000000
zheyou73v0_A09	63032487	63035031	BnaA09T0648200ZY.1	0	-	0	0	2544	0.0000000
zheyou73v0_A09	63036277	63040666	BnaA09T0648300ZY	0	-	0	0	4389	0.0000000
zheyou73v0_A09	63048189	63049905	BnaA09T0648400ZY	0	-	0	0	1716	0.0000000
zheyou73v0_A09	63055631	63056472	BnaA09T0648500ZY	0	-	0	0	841	0.0000000
zheyou73v0_A09	63072320	63074340	BnaA09T0648600ZY	0	+	0	0	2020	0.0000000
zheyou73v0_A09	63075507	63075836	BnaA09T0648700ZY	0	+	0	0	329	0.0000000
zheyou73v0_A09	63077735	63079881	BnaA09T0648800ZY	0	+	0	0	2146	0.0000000
zheyou73v0_A09	63083927	63084367	BnaA09T0648900ZY	0	+	0	0	440	0.0000000
zheyou73v0_A09	63088834	63092250	BnaA09T0649000ZY	0	-	0	0	3416	0.0000000
zheyou73v0_A09	63088834	63092250	BnaA09T0649000ZY.1	0	-	0	0	3416	0.0000000
zheyou73v0_A09	63096496	63097662	BnaA09T0649100ZY	0	+	0	0	1166	0.0000000
zheyou73v0_A09	63097709	63099160	BnaA09T0649200ZY	0	-	0	0	1451	0.0000000
zheyou73v0_A09	63101187	63102481	BnaA09T0649300ZY	0	+	0	0	1294	0.0000000
zheyou73v0_A09	63110249	63110705	BnaA09T0649400ZY	0	-	0	0	456	0.0000000
zheyou73v0_A09	63112276	63117987	BnaA09T0649500ZY	0	+	0	0	5711	0.0000000
zheyou73v0_A09	63119231	63120931	BnaA09T0649600ZY	0	+	0	0	1700	0.0000000
zheyou73v0_A09	63121770	63123462	BnaA09T0649700ZY	0	+	0	0	1692	0.0000000
zheyou73v0_A09	63125159	63130093	BnaA09T0649800ZY	0	+	0	0	4934	0.0000000
zheyou73v0_A09	63130352	63135187	BnaA09T0649900ZY	0	-	0	0	4835	0.0000000
zheyou73v0_A09	63137510	63139792	BnaA09T0650000ZY	0	-	0	0	2282	0.0000000
zheyou73v0_A09	63142527	63143371	BnaA09T0650100ZY	0	+	0	0	844	0.0000000
zheyou73v0_A09	63144427	63148143	BnaA09T0650200ZY	0	+	0	0	3716	0.0000000
zheyou73v0_A09	63144427	63148143	BnaA09T0650200ZY.1	0	+	0	0	3716	0.0000000
zheyou73v0_A09	63147819	63154583	BnaA09T0650300ZY	0	-	0	0	6764	0.0000000
zheyou73v0_A09	63155212	63156495	BnaA09T0650400ZY	0	-	0	0	1283	0.0000000
zheyou73v0_A09	63157633	63163806	BnaA09T0650500ZY	0	-	0	0	6173	0.0000000
zheyou73v0_A09	63164161	63164685	BnaA09T0650600ZY	0	+	0	0	524	0.0000000
zheyou73v0_A09	63172638	63173481	BnaA09T0650700ZY	0	-	0	0	843	0.0000000
zheyou73v0_A09	63173695	63174875	BnaA09T0650800ZY	0	+	0	0	1180	0.0000000
zheyou73v0_A09	63175610	63181056	BnaA09T0650900ZY	0	-	0	0	5446	0.0000000
zheyou73v0_A09	63182284	63182977	BnaA09T0651000ZY	0	+	0	0	693	0.0000000
zheyou73v0_A09	63184034	63185942	BnaA09T0651100ZY	0	-	0	0	1908	0.0000000
zheyou73v0_A09	63187588	63188491	BnaA09T0651200ZY	0	+	0	0	903	0.0000000
zheyou73v0_A09	63189636	63191946	BnaA09T0651300ZY	0	-	0	0	2310	0.0000000
zheyou73v0_A09	63189636	63191985	BnaA09T0651300ZY.1	0	-	0	0	2349	0.0000000
zheyou73v0_A09	63194524	63205551	BnaA09T0651400ZY	0	+	0	0	11027	0.0000000
zheyou73v0_A09	63205724	63206245	BnaA09T0651500ZY	0	+	0	0	521	0.0000000
zheyou73v0_A09	63206691	63207911	BnaA09T0651600ZY	0	-	0	0	1220	0.0000000
zheyou73v0_A09	63208991	63209471	BnaA09T0651700ZY	0	+	0	0	480	0.0000000
zheyou73v0_A09	63213328	63214012	BnaA09T0651800ZY	0	+	0	0	684	0.0000000
zheyou73v0_A09	63221912	63224966	BnaA09T0651900ZY	0	+	0	0	3054	0.0000000
zheyou73v0_A09	63225380	63225707	BnaA09T0652000ZY	0	-	0	0	327	0.0000000
zheyou73v0_A09	63227712	63230069	BnaA09T0652100ZY	0	-	0	0	2357	0.0000000
zheyou73v0_A09	63231057	63234101	BnaA09T0652200ZY	0	+	0	0	3044	0.0000000
zheyou73v0_A09	63231057	63234101	BnaA09T0652200ZY.1	0	+	0	0	3044	0.0000000
zheyou73v0_A09	63234546	63236684	BnaA09T0652300ZY	0	-	0	0	2138	0.0000000
zheyou73v0_A09	63239223	63245864	BnaA09T0652400ZY	0	+	0	0	6641	0.0000000
zheyou73v0_A09	63246592	63248044	BnaA09T0652500ZY	0	+	0	0	1452	0.0000000
zheyou73v0_A09	63259364	63264818	BnaA09T0652600ZY	0	+	0	0	5454	0.0000000
zheyou73v0_A09	63265057	63266764	BnaA09T0652700ZY	0	-	0	0	1707	0.0000000
zheyou73v0_A09	63286937	63292821	BnaA09T0652800ZY	0	+	0	0	5884	0.0000000
zheyou73v0_A09	63286937	63320143	BnaA09T0652800ZY.1	0	+	0	0	33206	0.0000000
zheyou73v0_A09	63293367	63293939	BnaA09T0652900ZY	0	-	0	0	572	0.0000000
zheyou73v0_A09	63298739	63300065	BnaA09T0653000ZY	0	+	0	0	1326	0.0000000
zheyou73v0_A09	63308289	63311709	BnaA09T0653100ZY	0	+	0	0	3420	0.0000000
zheyou73v0_A09	63312651	63314126	BnaA09T0653200ZY	0	-	0	0	1475	0.0000000
zheyou73v0_A09	63318272	63342640	BnaA09T0653300ZY	0	+	0	0	24368	0.0000000
zheyou73v0_A09	63342755	63343745	BnaA09T0653400ZY	0	-	0	0	990	0.0000000
zheyou73v0_A09	63356408	63356621	BnaA09T0653500ZY	0	-	0	0	213	0.0000000
zheyou73v0_A09	63361817	63362681	BnaA09T0653600ZY	0	+	0	0	864	0.0000000
zheyou73v0_A09	63361817	63362681	BnaA09T0653600ZY.1	0	+	0	0	864	0.0000000
zheyou73v0_A09	63362832	63365865	BnaA09T0653700ZY	0	-	0	0	3033	0.0000000
zheyou73v0_A09	63374296	63375541	BnaA09T0653800ZY	0	+	0	0	1245	0.0000000
zheyou73v0_A09	63376242	63382362	BnaA09T0653900ZY	0	+	0	0	6120	0.0000000
zheyou73v0_A09	63383427	63384809	BnaA09T0654000ZY	0	+	0	0	1382	0.0000000
zheyou73v0_A09	63387435	63387696	BnaA09T0654100ZY	0	+	0	0	261	0.0000000
zheyou73v0_A09	63395775	63399407	BnaA09T0654200ZY	0	+	0	0	3632	0.0000000
zheyou73v0_A09	63416489	63418866	BnaA09T0654300ZY	0	+	0	0	2377	0.0000000
zheyou73v0_A09	63428553	63429616	BnaA09T0654400ZY	0	+	0	0	1063	0.0000000
zheyou73v0_A09	63437748	63439607	BnaA09T0654500ZY	0	+	0	0	1859	0.0000000
zheyou73v0_A09	63441332	63444022	BnaA09T0654600ZY	0	+	0	0	2690	0.0000000
zheyou73v0_A09	63445458	63449772	BnaA09T0654700ZY	0	+	0	0	4314	0.0000000
zheyou73v0_A09	63453783	63457375	BnaA09T0654800ZY	0	+	0	0	3592	0.0000000
zheyou73v0_A09	63459867	63461162	BnaA09T0654900ZY	0	-	0	0	1295	0.0000000
zheyou73v0_A09	63461903	63462725	BnaA09T0655000ZY	0	+	0	0	822	0.0000000
zheyou73v0_A09	63464964	63465904	BnaA09T0655100ZY	0	+	0	0	940	0.0000000
zheyou73v0_A09	63468540	63470296	BnaA09T0655200ZY	0	-	0	0	1756	0.0000000
zheyou73v0_A09	63478318	63480473	BnaA09T0655300ZY	0	+	0	0	2155	0.0000000
zheyou73v0_A09	63478318	63480473	BnaA09T0655300ZY.1	0	+	0	0	2155	0.0000000
zheyou73v0_A09	63480574	63484750	BnaA09T0655400ZY	0	-	0	0	4176	0.0000000
zheyou73v0_A09	63486367	63488878	BnaA09T0655500ZY	0	-	0	0	2511	0.0000000
zheyou73v0_A09	63489658	63490511	BnaA09T0655600ZY	0	+	0	0	853	0.0000000
zheyou73v0_A09	63493333	63494621	BnaA09T0655700ZY	0	+	0	0	1288	0.0000000
zheyou73v0_A09	63497739	63501758	BnaA09T0655800ZY	0	+	0	0	4019	0.0000000
zheyou73v0_A09	63502520	63523927	BnaA09T0655900ZY	0	-	0	0	21407	0.0000000
zheyou73v0_A09	63528944	63529352	BnaA09T0656000ZY	0	-	0	0	408	0.0000000
zheyou73v0_A09	63541181	63542273	BnaA09T0656100ZY	0	+	0	0	1092	0.0000000
zheyou73v0_A09	63543503	63546998	BnaA09T0656200ZY	0	-	0	0	3495	0.0000000
zheyou73v0_A09	63548946	63550586	BnaA09T0656300ZY	0	+	0	0	1640	0.0000000
zheyou73v0_A09	63551231	63553477	BnaA09T0656400ZY	0	-	0	0	2246	0.0000000
zheyou73v0_A09	63554924	63556929	BnaA09T0656500ZY	0	+	0	0	2005	0.0000000
zheyou73v0_A09	63560295	63561032	BnaA09T0656600ZY	0	+	0	0	737	0.0000000
zheyou73v0_A09	63563388	63563550	BnaA09T0656700ZY	0	+	0	0	162	0.0000000
zheyou73v0_A09	63566718	63571965	BnaA09T0656800ZY	0	+	0	0	5247	0.0000000
zheyou73v0_A09	63566718	63571965	BnaA09T0656800ZY.1	0	+	0	0	5247	0.0000000
zheyou73v0_A09	63572576	63573736	BnaA09T0656900ZY	0	+	0	0	1160	0.0000000
zheyou73v0_A09	63575602	63577836	BnaA09T0657000ZY	0	-	0	0	2234	0.0000000
zheyou73v0_A09	63575602	63577836	BnaA09T0657000ZY.1	0	-	0	0	2234	0.0000000
zheyou73v0_A09	63585726	63587199	BnaA09T0657100ZY	0	+	0	0	1473	0.0000000
zheyou73v0_A09	63587051	63591897	BnaA09T0657200ZY	0	-	0	0	4846	0.0000000
zheyou73v0_A09	63593530	63593743	BnaA09T0657300ZY	0	+	0	0	213	0.0000000
zheyou73v0_A09	63595536	63597345	BnaA09T0657400ZY	0	-	0	0	1809	0.0000000
zheyou73v0_A09	63598114	63599587	BnaA09T0657500ZY	0	-	0	0	1473	0.0000000
zheyou73v0_A09	63606520	63608806	BnaA09T0657600ZY	0	-	0	0	2286	0.0000000
zheyou73v0_A09	63609379	63613422	BnaA09T0657700ZY	0	-	0	0	4043	0.0000000
zheyou73v0_A09	63633792	63637598	BnaA09T0657800ZY	0	+	0	0	3806	0.0000000
zheyou73v0_A09	63637989	63639908	BnaA09T0657900ZY	0	-	0	0	1919	0.0000000
zheyou73v0_A09	63640681	63643231	BnaA09T0658000ZY	0	+	0	0	2550	0.0000000
zheyou73v0_A09	63644730	63646228	BnaA09T0658100ZY	0	+	0	0	1498	0.0000000
zheyou73v0_A09	63646291	63651627	BnaA09T0658200ZY	0	-	0	0	5336	0.0000000
zheyou73v0_A09	63652056	63656437	BnaA09T0658300ZY	0	+	0	0	4381	0.0000000
zheyou73v0_A09	63658798	63659664	BnaA09T0658400ZY	0	+	0	0	866	0.0000000
zheyou73v0_A09	63660525	63661340	BnaA09T0658500ZY	0	+	0	0	815	0.0000000
zheyou73v0_A09	63661996	63664653	BnaA09T0658600ZY	0	+	0	0	2657	0.0000000
zheyou73v0_A09	63665286	63668589	BnaA09T0658700ZY	0	-	0	0	3303	0.0000000
zheyou73v0_A09	63670032	63673083	BnaA09T0658800ZY	0	-	0	0	3051	0.0000000
zheyou73v0_A09	63682327	63683788	BnaA09T0658900ZY	0	-	0	0	1461	0.0000000
zheyou73v0_A09	63687852	63689588	BnaA09T0659000ZY	0	-	0	0	1736	0.0000000
zheyou73v0_A09	63690441	63692768	BnaA09T0659100ZY	0	+	0	0	2327	0.0000000
zheyou73v0_A09	63695512	63696054	BnaA09T0659200ZY	0	+	0	0	542	0.0000000
zheyou73v0_A09	63717885	63720924	BnaA09T0659300ZY	0	+	0	0	3039	0.0000000
zheyou73v0_A09	63729731	63733226	BnaA09T0659400ZY	0	+	0	0	3495	0.0000000
zheyou73v0_A09	63734206	63735936	BnaA09T0659500ZY	0	+	0	0	1730	0.0000000
zheyou73v0_A09	63737396	63745750	BnaA09T0659600ZY	0	-	0	0	8354	0.0000000
zheyou73v0_A09	63748511	63749284	BnaA09T0659700ZY	0	+	0	0	773	0.0000000
zheyou73v0_A09	63749502	63751838	BnaA09T0659800ZY	0	-	0	0	2336	0.0000000
zheyou73v0_A09	63752001	63753124	BnaA09T0659900ZY	0	+	0	0	1123	0.0000000
zheyou73v0_A09	63753471	63753942	BnaA09T0660000ZY	0	+	0	0	471	0.0000000
zheyou73v0_A09	63755129	63755462	BnaA09T0660100ZY	0	+	0	0	333	0.0000000
zheyou73v0_A09	63755834	63756534	BnaA09T0660200ZY	0	+	0	0	700	0.0000000
zheyou73v0_A09	63761137	63762823	BnaA09T0660300ZY	0	+	0	0	1686	0.0000000
zheyou73v0_A09	63763664	63765431	BnaA09T0660400ZY	0	+	0	0	1767	0.0000000
zheyou73v0_A09	63766922	63768338	BnaA09T0660500ZY	0	+	0	0	1416	0.0000000
zheyou73v0_A09	63768463	63772613	BnaA09T0660600ZY	0	+	0	0	4150	0.0000000
zheyou73v0_A09	63773806	63775702	BnaA09T0660700ZY	0	-	0	0	1896	0.0000000
zheyou73v0_A09	63782294	63785504	BnaA09T0660800ZY	0	+	0	0	3210	0.0000000
zheyou73v0_A09	63785546	63786146	BnaA09T0660900ZY	0	+	0	0	600	0.0000000
zheyou73v0_A09	63786910	63787608	BnaA09T0661000ZY	0	+	0	0	698	0.0000000
zheyou73v0_A09	63793064	63794909	BnaA09T0661100ZY	0	+	0	0	1845	0.0000000
zheyou73v0_A09	63796716	63797619	BnaA09T0661200ZY	0	+	0	0	903	0.0000000
zheyou73v0_A09	63797675	63797897	BnaA09T0661300ZY	0	+	0	0	222	0.0000000
zheyou73v0_A09	63798270	63801432	BnaA09T0661400ZY	0	-	0	0	3162	0.0000000
zheyou73v0_A09	63802494	63804956	BnaA09T0661500ZY	0	+	0	0	2462	0.0000000
zheyou73v0_A09	63807927	63809231	BnaA09T0661600ZY	0	+	0	0	1304	0.0000000
zheyou73v0_A09	63813380	63819767	BnaA09T0661700ZY	0	-	0	0	6387	0.0000000
zheyou73v0_A09	63821918	63827699	BnaA09T0661800ZY	0	+	0	0	5781	0.0000000
zheyou73v0_A09	63830861	63845125	BnaA09T0661900ZY	0	+	0	0	14264	0.0000000
zheyou73v0_A09	63845411	63846991	BnaA09T0662000ZY	0	+	0	0	1580	0.0000000
zheyou73v0_A09	63847316	63848116	BnaA09T0662100ZY	0	-	0	0	800	0.0000000
zheyou73v0_A09	63848220	63849686	BnaA09T0662200ZY	0	-	0	0	1466	0.0000000
zheyou73v0_A09	63856833	63857976	BnaA09T0662300ZY	0	-	0	0	1143	0.0000000
zheyou73v0_A09	63869268	63871081	BnaA09T0662400ZY	0	+	0	0	1813	0.0000000
zheyou73v0_A09	63876024	63876815	BnaA09T0662500ZY	0	-	0	0	791	0.0000000
zheyou73v0_A09	63881103	63882249	BnaA09T0662600ZY	0	-	0	0	1146	0.0000000
zheyou73v0_A09	63888216	63888525	BnaA09T0662700ZY	0	+	0	0	309	0.0000000
zheyou73v0_A09	63895660	63898969	BnaA09T0662800ZY	0	-	0	0	3309	0.0000000
zheyou73v0_A09	63900500	63904518	BnaA09T0662900ZY	0	+	0	0	4018	0.0000000
zheyou73v0_A09	63904787	63909399	BnaA09T0663000ZY	0	+	0	0	4612	0.0000000
zheyou73v0_A09	63909708	63912834	BnaA09T0663100ZY	0	-	0	0	3126	0.0000000
zheyou73v0_A09	63913361	63916073	BnaA09T0663200ZY	0	-	0	0	2712	0.0000000
zheyou73v0_A09	63920729	63922227	BnaA09T0663300ZY	0	+	0	0	1498	0.0000000
zheyou73v0_A09	63924190	63925814	BnaA09T0663400ZY	0	-	0	0	1624	0.0000000
zheyou73v0_A09	63932367	63932883	BnaA09T0663500ZY	0	-	0	0	516	0.0000000
zheyou73v0_A09	63935549	63938349	BnaA09T0663600ZY	0	+	0	0	2800	0.0000000
zheyou73v0_A09	63943828	63945819	BnaA09T0663700ZY	0	+	0	0	1991	0.0000000
zheyou73v0_A09	63947165	63948480	BnaA09T0663800ZY	0	+	0	0	1315	0.0000000
zheyou73v0_A09	63947165	63948480	BnaA09T0663800ZY.1	0	+	0	0	1315	0.0000000
zheyou73v0_A09	63949158	63950690	BnaA09T0663900ZY	0	-	0	0	1532	0.0000000
zheyou73v0_A09	63950855	63953270	BnaA09T0664000ZY	0	+	0	0	2415	0.0000000
zheyou73v0_A09	63950855	63953270	BnaA09T0664000ZY.1	0	+	0	0	2415	0.0000000
zheyou73v0_A09	63953542	63954631	BnaA09T0664100ZY	0	-	0	0	1089	0.0000000
zheyou73v0_A09	63958644	63959187	BnaA09T0664200ZY	0	+	0	0	543	0.0000000
zheyou73v0_A09	63961347	63963606	BnaA09T0664300ZY	0	+	0	0	2259	0.0000000
zheyou73v0_A09	63965184	63969417	BnaA09T0664400ZY	0	-	0	0	4233	0.0000000
zheyou73v0_A09	63983648	63984548	BnaA09T0664500ZY	0	+	0	0	900	0.0000000
zheyou73v0_A09	63985268	63986225	BnaA09T0664600ZY	0	-	0	0	957	0.0000000
zheyou73v0_A09	63985774	63986225	BnaA09T0664600ZY.1	0	-	0	0	451	0.0000000
zheyou73v0_A09	63996146	63999139	BnaA09T0664700ZY	0	+	0	0	2993	0.0000000
zheyou73v0_A09	63996146	63999139	BnaA09T0664700ZY.1	0	+	0	0	2993	0.0000000
zheyou73v0_A09	64020889	64021526	BnaA09T0664800ZY	0	+	0	0	637	0.0000000
zheyou73v0_A09	64023502	64024503	BnaA09T0664900ZY	0	+	0	0	1001	0.0000000
zheyou73v0_A09	64024172	64026241	BnaA09T0665000ZY	0	-	0	0	2069	0.0000000
zheyou73v0_A09	64026697	64027132	BnaA09T0665100ZY	0	+	0	0	435	0.0000000
zheyou73v0_A09	64029452	64030060	BnaA09T0665200ZY	0	+	0	0	608	0.0000000
zheyou73v0_A09	64030608	64031445	BnaA09T0665300ZY	0	-	0	0	837	0.0000000
zheyou73v0_A09	64033667	64034060	BnaA09T0665400ZY	0	+	0	0	393	0.0000000
zheyou73v0_A09	64039626	64040952	BnaA09T0665500ZY	0	+	0	0	1326	0.0000000
zheyou73v0_A09	64039626	64041707	BnaA09T0665500ZY.1	0	+	0	0	2081	0.0000000
zheyou73v0_A09	64044429	64046252	BnaA09T0665600ZY	0	+	0	0	1823	0.0000000
zheyou73v0_A09	64047566	64048224	BnaA09T0665700ZY	0	-	0	0	658	0.0000000
zheyou73v0_A09	64049081	64057466	BnaA09T0665800ZY	0	+	0	0	8385	0.0000000
zheyou73v0_A09	64057666	64059258	BnaA09T0665900ZY	0	+	0	0	1592	0.0000000
zheyou73v0_A09	64061198	64062307	BnaA09T0666000ZY	0	+	0	0	1109	0.0000000
zheyou73v0_A09	64069105	64070126	BnaA09T0666100ZY	0	+	0	0	1021	0.0000000
zheyou73v0_A09	64070923	64072691	BnaA09T0666200ZY	0	-	0	0	1768	0.0000000
zheyou73v0_A09	64073524	64076211	BnaA09T0666300ZY	0	-	0	0	2687	0.0000000
zheyou73v0_A09	64078514	64081178	BnaA09T0666400ZY	0	-	0	0	2664	0.0000000
zheyou73v0_A09	64086350	64090331	BnaA09T0666500ZY	0	-	0	0	3981	0.0000000
zheyou73v0_A09	64086350	64090331	BnaA09T0666500ZY.1	0	-	0	0	3981	0.0000000
zheyou73v0_A09	64086350	64090331	BnaA09T0666500ZY.2	0	-	0	0	3981	0.0000000
zheyou73v0_A09	64096608	64098287	BnaA09T0666600ZY	0	-	0	0	1679	0.0000000
zheyou73v0_A09	64098730	64099903	BnaA09T0666700ZY	0	-	0	0	1173	0.0000000
zheyou73v0_A09	64100815	64102642	BnaA09T0666800ZY	0	-	0	0	1827	0.0000000
zheyou73v0_A09	64102744	64104450	BnaA09T0666900ZY	0	+	0	0	1706	0.0000000
zheyou73v0_A09	64108211	64112181	BnaA09T0667000ZY	0	+	0	0	3970	0.0000000
zheyou73v0_A09	64113718	64117381	BnaA09T0667100ZY	0	-	0	0	3663	0.0000000
zheyou73v0_A09	64113718	64116676	BnaA09T0667100ZY.1	0	-	0	0	2958	0.0000000
zheyou73v0_A09	64113718	64117381	BnaA09T0667100ZY.2	0	-	0	0	3663	0.0000000
zheyou73v0_A09	64113718	64116633	BnaA09T0667100ZY.3	0	-	0	0	2915	0.0000000
zheyou73v0_A09	64113718	64116633	BnaA09T0667100ZY.4	0	-	0	0	2915	0.0000000
zheyou73v0_A09	64119910	64120373	BnaA09T0667200ZY	0	-	0	0	463	0.0000000
zheyou73v0_A09	64120605	64121826	BnaA09T0667300ZY	0	+	0	0	1221	0.0000000
zheyou73v0_A09	64134628	64136592	BnaA09T0667400ZY	0	-	0	0	1964	0.0000000
zheyou73v0_A09	64142878	64146588	BnaA09T0667500ZY	0	+	0	0	3710	0.0000000
zheyou73v0_A09	64146962	64150888	BnaA09T0667600ZY	0	+	0	0	3926	0.0000000
zheyou73v0_A09	64146962	64150888	BnaA09T0667600ZY.1	0	+	0	0	3926	0.0000000
zheyou73v0_A09	64151006	64152314	BnaA09T0667700ZY	0	+	0	0	1308	0.0000000
zheyou73v0_A09	64152516	64153904	BnaA09T0667800ZY	0	+	0	0	1388	0.0000000
zheyou73v0_A09	64154497	64156437	BnaA09T0667900ZY	0	+	0	0	1940	0.0000000
zheyou73v0_A09	64154497	64156437	BnaA09T0667900ZY.1	0	+	0	0	1940	0.0000000
zheyou73v0_A09	64154497	64156437	BnaA09T0667900ZY.2	0	+	0	0	1940	0.0000000
zheyou73v0_A09	64158851	64159409	BnaA09T0668000ZY	0	-	0	0	558	0.0000000
zheyou73v0_A09	64162979	64164471	BnaA09T0668100ZY	0	+	0	0	1492	0.0000000
zheyou73v0_A09	64164615	64166100	BnaA09T0668200ZY	0	+	0	0	1485	0.0000000
zheyou73v0_A09	64166249	64167139	BnaA09T0668300ZY	0	+	0	0	890	0.0000000
zheyou73v0_A09	64168777	64170085	BnaA09T0668400ZY	0	+	0	0	1308	0.0000000
zheyou73v0_A09	64173363	64174060	BnaA09T0668500ZY	0	+	0	0	697	0.0000000
zheyou73v0_A09	64174685	64176150	BnaA09T0668600ZY	0	-	0	0	1465	0.0000000
zheyou73v0_A09	64176428	64176845	BnaA09T0668700ZY	0	-	0	0	417	0.0000000
zheyou73v0_A09	64188712	64191207	BnaA09T0668800ZY	0	-	0	0	2495	0.0000000
zheyou73v0_A09	64201562	64202545	BnaA09T0668900ZY	0	+	0	0	983	0.0000000
zheyou73v0_A09	64204447	64206498	BnaA09T0669000ZY	0	+	0	0	2051	0.0000000
zheyou73v0_A09	64208777	64218224	BnaA09T0669100ZY	0	+	0	0	9447	0.0000000
zheyou73v0_A09	64219880	64223222	BnaA09T0669200ZY	0	+	0	0	3342	0.0000000
zheyou73v0_A09	64219880	64223222	BnaA09T0669200ZY.1	0	+	0	0	3342	0.0000000
zheyou73v0_A09	64225488	64227922	BnaA09T0669300ZY	0	+	0	0	2434	0.0000000
zheyou73v0_A09	64228136	64230874	BnaA09T0669400ZY	0	-	0	0	2738	0.0000000
zheyou73v0_A09	64235469	64236668	BnaA09T0669500ZY	0	-	0	0	1199	0.0000000
zheyou73v0_A09	64239681	64241910	BnaA09T0669600ZY	0	-	0	0	2229	0.0000000
zheyou73v0_A09	64242756	64244631	BnaA09T0669700ZY	0	+	0	0	1875	0.0000000
zheyou73v0_A09	64242756	64243807	BnaA09T0669700ZY.1	0	+	0	0	1051	0.0000000
zheyou73v0_A09	64246057	64249454	BnaA09T0669800ZY	0	-	0	0	3397	0.0000000
zheyou73v0_A09	64246057	64249454	BnaA09T0669800ZY.1	0	-	0	0	3397	0.0000000
zheyou73v0_A09	64252837	64253011	BnaA09T0669900ZY	0	+	0	0	174	0.0000000
zheyou73v0_A09	64260600	64262286	BnaA09T0670000ZY	0	+	0	0	1686	0.0000000
zheyou73v0_A09	64262713	64263745	BnaA09T0670100ZY	0	+	0	0	1032	0.0000000
zheyou73v0_A09	64265027	64277025	BnaA09T0670200ZY.1	0	+	0	0	11998	0.0000000
zheyou73v0_A09	64273430	64277025	BnaA09T0670200ZY	0	+	0	0	3595	0.0000000
zheyou73v0_A09	64277390	64278938	BnaA09T0670300ZY	0	+	0	0	1548	0.0000000
zheyou73v0_A09	64277390	64278938	BnaA09T0670300ZY.1	0	+	0	0	1548	0.0000000
zheyou73v0_A09	64277390	64278938	BnaA09T0670300ZY.2	0	+	0	0	1548	0.0000000
zheyou73v0_A09	64279711	64281035	BnaA09T0670400ZY	0	+	0	0	1324	0.0000000
zheyou73v0_A09	64281145	64281717	BnaA09T0670500ZY	0	+	0	0	572	0.0000000
zheyou73v0_A09	64281733	64287262	BnaA09T0670600ZY	0	+	0	0	5529	0.0000000
zheyou73v0_A09	64307348	64314689	BnaA09T0670700ZY	0	-	0	0	7341	0.0000000
zheyou73v0_A09	64314960	64317511	BnaA09T0670800ZY	0	-	0	0	2551	0.0000000
zheyou73v0_A09	64314960	64317511	BnaA09T0670800ZY.1	0	-	0	0	2551	0.0000000
zheyou73v0_A09	64317893	64318585	BnaA09T0670900ZY	0	-	0	0	692	0.0000000
zheyou73v0_A09	64318735	64320772	BnaA09T0671000ZY	0	-	0	0	2037	0.0000000
zheyou73v0_A09	64320997	64324243	BnaA09T0671100ZY	0	+	0	0	3246	0.0000000
zheyou73v0_A09	64324434	64327297	BnaA09T0671200ZY	0	-	0	0	2863	0.0000000
zheyou73v0_A09	64327458	64328968	BnaA09T0671300ZY	0	+	0	0	1510	0.0000000
zheyou73v0_A09	64329403	64333569	BnaA09T0671400ZY	0	+	0	0	4166	0.0000000
zheyou73v0_A09	64333349	64340657	BnaA09T0671500ZY	0	-	0	0	7308	0.0000000
zheyou73v0_A09	64341378	64341605	BnaA09T0671600ZY	0	+	0	0	227	0.0000000
zheyou73v0_A09	64342345	64346785	BnaA09T0671700ZY	0	+	0	0	4440	0.0000000
zheyou73v0_A09	64342345	64346785	BnaA09T0671700ZY.1	0	+	0	0	4440	0.0000000
zheyou73v0_A09	64349588	64350502	BnaA09T0671800ZY	0	-	0	0	914	0.0000000
zheyou73v0_A09	64354626	64356471	BnaA09T0671900ZY	0	+	0	0	1845	0.0000000
zheyou73v0_A09	64362990	64363500	BnaA09T0672000ZY	0	-	0	0	510	0.0000000
zheyou73v0_A09	64376996	64390080	BnaA09T0672100ZY	0	+	0	0	13084	0.0000000
zheyou73v0_A09	64376996	64389883	BnaA09T0672100ZY.1	0	+	0	0	12887	0.0000000
zheyou73v0_A09	64396159	64396991	BnaA09T0672200ZY	0	-	0	0	832	0.0000000
zheyou73v0_A09	64397600	64398245	BnaA09T0672300ZY	0	-	0	0	645	0.0000000
zheyou73v0_A09	64399595	64400222	BnaA09T0672400ZY	0	-	0	0	627	0.0000000
zheyou73v0_A09	64400837	64402919	BnaA09T0672500ZY	0	+	0	0	2082	0.0000000
zheyou73v0_A09	64409335	64409956	BnaA09T0672600ZY	0	-	0	0	621	0.0000000
zheyou73v0_A09	64410857	64413678	BnaA09T0672700ZY	0	-	0	0	2821	0.0000000
zheyou73v0_A09	64410857	64413678	BnaA09T0672700ZY.1	0	-	0	0	2821	0.0000000
zheyou73v0_A09	64410904	64411405	BnaA09T0672800ZY	0	+	0	0	501	0.0000000
zheyou73v0_A09	64411883	64413678	BnaA09T0672700ZY.2	0	-	0	0	1795	0.0000000
zheyou73v0_A09	64413989	64417273	BnaA09T0672900ZY	0	+	0	0	3284	0.0000000
zheyou73v0_A09	64417419	64419145	BnaA09T0673000ZY	0	-	0	0	1726	0.0000000
zheyou73v0_A09	64419502	64420668	BnaA09T0673100ZY	0	-	0	0	1166	0.0000000
zheyou73v0_A09	64420836	64424450	BnaA09T0673200ZY	0	+	0	0	3614	0.0000000
zheyou73v0_A09	64425804	64426442	BnaA09T0673300ZY	0	-	0	0	638	0.0000000
zheyou73v0_A09	64426477	64427209	BnaA09T0673400ZY	0	-	0	0	732	0.0000000
zheyou73v0_A09	64427947	64428755	BnaA09T0673500ZY	0	-	0	0	808	0.0000000
zheyou73v0_A09	64428964	64432577	BnaA09T0673600ZY	0	+	0	0	3613	0.0000000
zheyou73v0_A09	64433725	64434238	BnaA09T0673700ZY	0	+	0	0	513	0.0000000
zheyou73v0_A09	64437156	64440507	BnaA09T0673800ZY	0	+	0	0	3351	0.0000000
zheyou73v0_A09	64446017	64446536	BnaA09T0673900ZY	0	-	0	0	519	0.0000000
zheyou73v0_A10	8940	9597	BnaA10T0000100ZY	0	-	88	533	657	0.8112633
zheyou73v0_A10	11132	12587	BnaA10T0000200ZY	0	-	297	1083	1455	0.7443299
zheyou73v0_A10	14191	15166	BnaA10T0000300ZY	0	-	130	459	975	0.4707692
zheyou73v0_A10	17489	19870	BnaA10T0000400ZY	0	+	127	1038	2381	0.4359513
zheyou73v0_A10	20143	22864	BnaA10T0000500ZY	0	-	416	2234	2721	0.8210217
zheyou73v0_A10	24358	30713	BnaA10T0000600ZY	0	+	647	3863	6355	0.6078678
zheyou73v0_A10	31903	35381	BnaA10T0000700ZY	0	+	366	2408	3478	0.6923519
zheyou73v0_A10	35703	37917	BnaA10T0000800ZY	0	-	71	1397	2214	0.6309847
zheyou73v0_A10	43004	45028	BnaA10T0000900ZY	0	-	510	1474	2024	0.7282609
zheyou73v0_A10	46245	47309	BnaA10T0001000ZY	0	+	340	1064	1064	1.0000000
zheyou73v0_A10	48307	49190	BnaA10T0001100ZY	0	-	130	862	883	0.9762174
zheyou73v0_A10	53351	55994	BnaA10T0001200ZY	0	+	665	2480	2643	0.9383277
zheyou73v0_A10	54118	57115	BnaA10T0001300ZY	0	-	548	2508	2997	0.8368368
zheyou73v0_A10	54118	57115	BnaA10T0001300ZY.1	0	-	548	2508	2997	0.8368368
zheyou73v0_A10	58334	70340	BnaA10T0001400ZY	0	-	1186	6327	12006	0.5269865
zheyou73v0_A10	65745	70340	BnaA10T0001400ZY.1	0	-	988	3891	4595	0.8467900
zheyou73v0_A10	73774	74230	BnaA10T0001500ZY	0	-	23	197	456	0.4320175
zheyou73v0_A10	74581	79745	BnaA10T0001600ZY	0	+	779	4394	5164	0.8508908
zheyou73v0_A10	80189	83131	BnaA10T0001700ZY	0	+	740	2926	2942	0.9945615
zheyou73v0_A10	83226	84921	BnaA10T0001800ZY	0	+	809	1625	1695	0.9587021
zheyou73v0_A10	85090	87427	BnaA10T0001900ZY	0	-	168	1718	2337	0.7351305
zheyou73v0_A10	93232	98516	BnaA10T0002000ZY	0	-	862	4736	5284	0.8962907
zheyou73v0_A10	105115	107669	BnaA10T0002100ZY	0	+	525	2402	2554	0.9404855
zheyou73v0_A10	112678	118562	BnaA10T0002200ZY	0	+	35	731	5884	0.1242352
zheyou73v0_A10	126520	128071	BnaA10T0002300ZY	0	+	263	1243	1551	0.8014184
zheyou73v0_A10	128828	133252	BnaA10T0002400ZY	0	+	404	1935	4424	0.4373870
zheyou73v0_A10	128828	133252	BnaA10T0002400ZY.1	0	+	404	1935	4424	0.4373870
zheyou73v0_A10	133803	138707	BnaA10T0002500ZY	0	+	504	3587	4904	0.7314437
zheyou73v0_A10	139141	142545	BnaA10T0002600ZY	0	-	1340	3017	3404	0.8863102
zheyou73v0_A10	153721	154790	BnaA10T0002700ZY	0	-	416	1069	1069	1.0000000
zheyou73v0_A10	162803	164598	BnaA10T0002800ZY	0	+	333	1754	1795	0.9771588
zheyou73v0_A10	173764	174911	BnaA10T0002900ZY	0	-	426	1147	1147	1.0000000
zheyou73v0_A10	175482	183538	BnaA10T0003000ZY	0	-	847	3055	8056	0.3792205
zheyou73v0_A10	186279	187151	BnaA10T0003100ZY	0	-	455	872	872	1.0000000
zheyou73v0_A10	186279	187151	BnaA10T0003100ZY.1	0	-	455	872	872	1.0000000
zheyou73v0_A10	187886	193037	BnaA10T0003200ZY	0	-	1088	4048	5151	0.7858668
zheyou73v0_A10	187886	191470	BnaA10T0003200ZY.1	0	-	785	2752	3584	0.7678571
zheyou73v0_A10	193872	196553	BnaA10T0003300ZY	0	-	164	1960	2681	0.7310705
zheyou73v0_A10	193872	196553	BnaA10T0003300ZY.1	0	-	164	1960	2681	0.7310705
zheyou73v0_A10	202908	203449	BnaA10T0003400ZY	0	-	62	510	541	0.9426987
zheyou73v0_A10	204598	206046	BnaA10T0003500ZY	0	-	315	1295	1448	0.8943370
zheyou73v0_A10	204598	206046	BnaA10T0003500ZY.1	0	-	315	1295	1448	0.8943370
zheyou73v0_A10	211735	212857	BnaA10T0003600ZY	0	-	107	829	1122	0.7388592
zheyou73v0_A10	217106	217580	BnaA10T0003700ZY	0	+	58	271	474	0.5717300
zheyou73v0_A10	222301	222907	BnaA10T0003800ZY	0	-	0	0	606	0.0000000
zheyou73v0_A10	222991	223682	BnaA10T0003900ZY	0	-	0	0	691	0.0000000
zheyou73v0_A10	230357	230762	BnaA10T0004000ZY	0	+	67	269	405	0.6641975
zheyou73v0_A10	233325	239949	BnaA10T0004100ZY	0	-	761	1779	6624	0.2685688
zheyou73v0_A10	244503	248034	BnaA10T0004200ZY	0	-	350	1722	3531	0.4876806
zheyou73v0_A10	248256	252463	BnaA10T0004300ZY	0	-	521	2745	4207	0.6524839
zheyou73v0_A10	248256	252374	BnaA10T0004300ZY.1	0	-	501	2656	4118	0.6449733
zheyou73v0_A10	252831	255046	BnaA10T0004400ZY	0	-	504	1922	2215	0.8677201
zheyou73v0_A10	255245	258008	BnaA10T0004500ZY	0	+	891	2553	2763	0.9239957
zheyou73v0_A10	259927	263960	BnaA10T0004600ZY	0	+	829	3562	4033	0.8832135
zheyou73v0_A10	265966	268698	BnaA10T0004700ZY	0	+	252	1291	2732	0.4725476
zheyou73v0_A10	269240	275698	BnaA10T0004800ZY	0	-	893	4319	6458	0.6687829
zheyou73v0_A10	277063	278287	BnaA10T0004900ZY	0	+	555	1224	1224	1.0000000
zheyou73v0_A10	278311	278940	BnaA10T0005000ZY	0	-	377	629	629	1.0000000
zheyou73v0_A10	279215	279648	BnaA10T0005100ZY	0	-	137	433	433	1.0000000
zheyou73v0_A10	287031	289875	BnaA10T0005200ZY	0	-	647	2489	2844	0.8751758
zheyou73v0_A10	291843	296336	BnaA10T0005300ZY	0	+	1237	3961	4493	0.8815936
zheyou73v0_A10	297232	299340	BnaA10T0005400ZY	0	+	225	1509	2108	0.7158444
zheyou73v0_A10	299661	300881	BnaA10T0005500ZY	0	-	357	1150	1220	0.9426230
zheyou73v0_A10	302488	304279	BnaA10T0005600ZY	0	+	226	1493	1791	0.8336125
zheyou73v0_A10	305402	306798	BnaA10T0005700ZY	0	+	514	1395	1396	0.9992837
zheyou73v0_A10	307198	308605	BnaA10T0005800ZY	0	+	731	1407	1407	1.0000000
zheyou73v0_A10	308994	309755	BnaA10T0005900ZY	0	+	268	706	761	0.9277267
zheyou73v0_A10	309823	312071	BnaA10T0006000ZY	0	-	636	2237	2248	0.9951068
zheyou73v0_A10	312817	318399	BnaA10T0006100ZY	0	-	1760	5263	5582	0.9428520
zheyou73v0_A10	312817	318399	BnaA10T0006100ZY.1	0	-	1760	5263	5582	0.9428520
zheyou73v0_A10	319124	321664	BnaA10T0006200ZY	0	-	789	2173	2540	0.8555118
zheyou73v0_A10	334322	336128	BnaA10T0006300ZY	0	+	417	1754	1806	0.9712071
zheyou73v0_A10	338867	340440	BnaA10T0006400ZY	0	-	0	0	1573	0.0000000
zheyou73v0_A10	343705	347203	BnaA10T0006500ZY	0	-	1599	3208	3498	0.9170955
zheyou73v0_A10	343705	347098	BnaA10T0006500ZY.1	0	-	1567	3103	3393	0.9145299
zheyou73v0_A10	347354	348795	BnaA10T0006600ZY	0	-	618	1441	1441	1.0000000
zheyou73v0_A10	349070	350831	BnaA10T0006700ZY	0	+	109	1209	1761	0.6865417
zheyou73v0_A10	351211	354756	BnaA10T0006800ZY	0	-	1109	2406	3545	0.6787024
zheyou73v0_A10	355452	356034	BnaA10T0006900ZY	0	-	27	433	582	0.7439862
zheyou73v0_A10	356676	358101	BnaA10T0007000ZY	0	+	1	22	1425	0.0154386
zheyou73v0_A10	359773	363328	BnaA10T0007100ZY	0	-	132	1615	3555	0.4542897
zheyou73v0_A10	373318	374898	BnaA10T0007200ZY	0	+	405	1499	1580	0.9487342
zheyou73v0_A10	375608	379172	BnaA10T0007300ZY	0	+	207	1686	3564	0.4730640
zheyou73v0_A10	380559	382586	BnaA10T0007400ZY	0	-	120	1187	2027	0.5855945
zheyou73v0_A10	383217	389353	BnaA10T0007500ZY	0	-	3649	5598	6136	0.9123207
zheyou73v0_A10	389679	391350	BnaA10T0007600ZY	0	-	816	1671	1671	1.0000000
zheyou73v0_A10	393242	394809	BnaA10T0007700ZY	0	-	1104	1567	1567	1.0000000
zheyou73v0_A10	393242	394809	BnaA10T0007700ZY.1	0	-	1104	1567	1567	1.0000000
zheyou73v0_A10	397738	407460	BnaA10T0007800ZY	0	+	934	3780	9722	0.3888089
zheyou73v0_A10	408147	418449	BnaA10T0007900ZY	0	-	4415	9646	10302	0.9363230
zheyou73v0_A10	422238	424993	BnaA10T0008000ZY	0	-	1967	2755	2755	1.0000000
zheyou73v0_A10	433983	434816	BnaA10T0008100ZY	0	-	635	833	833	1.0000000
zheyou73v0_A10	438510	439557	BnaA10T0008200ZY	0	-	666	1047	1047	1.0000000
zheyou73v0_A10	439877	443394	BnaA10T0008300ZY	0	-	414	1513	3517	0.4301962
zheyou73v0_A10	449031	450240	BnaA10T0008400ZY	0	-	657	1197	1209	0.9900745
zheyou73v0_A10	450295	452287	BnaA10T0008500ZY	0	-	304	1557	1992	0.7816265
zheyou73v0_A10	458283	459490	BnaA10T0008600ZY	0	-	0	0	1207	0.0000000
zheyou73v0_A10	459845	463924	BnaA10T0008700ZY	0	-	381	1775	4079	0.4351557
zheyou73v0_A10	464948	466687	BnaA10T0008800ZY	0	-	558	1576	1739	0.9062679
zheyou73v0_A10	472253	474151	BnaA10T0008900ZY	0	-	573	1898	1898	1.0000000
zheyou73v0_A10	477064	480270	BnaA10T0009000ZY	0	+	634	2771	3206	0.8643169
zheyou73v0_A10	480739	483782	BnaA10T0009100ZY	0	-	543	2233	3043	0.7338153
zheyou73v0_A10	484104	489242	BnaA10T0009200ZY	0	-	677	3140	5138	0.6111327
zheyou73v0_A10	489584	492011	BnaA10T0009300ZY	0	-	526	1854	2427	0.7639061
zheyou73v0_A10	492223	493388	BnaA10T0009400ZY	0	+	234	918	1165	0.7879828
zheyou73v0_A10	492845	497812	BnaA10T0009500ZY	0	-	1553	4572	4967	0.9204751
zheyou73v0_A10	500080	502714	BnaA10T0009600ZY	0	-	163	2416	2634	0.9172361
zheyou73v0_A10	500080	502714	BnaA10T0009600ZY.1	0	-	163	2416	2634	0.9172361
zheyou73v0_A10	502904	504526	BnaA10T0009700ZY	0	-	167	1207	1622	0.7441430
zheyou73v0_A10	505026	507198	BnaA10T0009800ZY	0	+	108	1133	2172	0.5216390
zheyou73v0_A10	505026	507198	BnaA10T0009800ZY.1	0	+	108	1133	2172	0.5216390
zheyou73v0_A10	507505	508964	BnaA10T0009900ZY	0	+	238	730	1459	0.5003427
zheyou73v0_A10	514953	518005	BnaA10T0010000ZY	0	-	35	872	3052	0.2857143
zheyou73v0_A10	518260	520955	BnaA10T0010100ZY	0	-	1004	2544	2695	0.9439703
zheyou73v0_A10	550665	553976	BnaA10T0010200ZY	0	+	718	2497	3311	0.7541528
zheyou73v0_A10	554124	555428	BnaA10T0010300ZY	0	-	129	965	1304	0.7400306
zheyou73v0_A10	564778	566771	BnaA10T0010400ZY	0	-	125	1378	1993	0.6914200
zheyou73v0_A10	567812	569485	BnaA10T0010500ZY	0	-	15	486	1673	0.2904961
zheyou73v0_A10	579296	579749	BnaA10T0010600ZY	0	-	165	453	453	1.0000000
zheyou73v0_A10	586208	586442	BnaA10T0010700ZY	0	-	98	220	234	0.9401709
zheyou73v0_A10	588004	589026	BnaA10T0010800ZY	0	-	117	591	1022	0.5782779
zheyou73v0_A10	589394	590247	BnaA10T0010900ZY	0	-	0	0	853	0.0000000
zheyou73v0_A10	591178	593475	BnaA10T0011000ZY	0	+	590	2245	2297	0.9773618
zheyou73v0_A10	598113	599524	BnaA10T0011100ZY	0	+	51	803	1411	0.5690999
zheyou73v0_A10	599979	604641	BnaA10T0011200ZY	0	-	1324	3824	4662	0.8202488
zheyou73v0_A10	611380	612786	BnaA10T0011300ZY	0	+	0	0	1406	0.0000000
zheyou73v0_A10	618842	619704	BnaA10T0011400ZY	0	-	153	838	862	0.9721578
zheyou73v0_A10	621599	624379	BnaA10T0011500ZY	0	+	569	2465	2780	0.8866907
zheyou73v0_A10	632087	633537	BnaA10T0011600ZY	0	+	106	512	1450	0.3531035
zheyou73v0_A10	633631	640736	BnaA10T0011700ZY	0	-	2894	6126	7105	0.8622097
zheyou73v0_A10	642757	645303	BnaA10T0011800ZY	0	-	246	1726	2546	0.6779262
zheyou73v0_A10	646261	649477	BnaA10T0011900ZY	0	-	1063	2987	3216	0.9287935
zheyou73v0_A10	653364	656588	BnaA10T0012000ZY	0	-	1695	3223	3224	0.9996898
zheyou73v0_A10	657226	658578	BnaA10T0012100ZY	0	-	196	1059	1352	0.7832840
zheyou73v0_A10	662953	666240	BnaA10T0012200ZY	0	+	438	2397	3287	0.7292364
zheyou73v0_A10	666234	667278	BnaA10T0012300ZY	0	-	462	1044	1044	1.0000000
zheyou73v0_A10	667509	668664	BnaA10T0012400ZY	0	+	199	964	1155	0.8346320
zheyou73v0_A10	678609	679406	BnaA10T0012500ZY	0	+	333	797	797	1.0000000
zheyou73v0_A10	682081	683588	BnaA10T0012600ZY	0	-	325	1231	1507	0.8168547
zheyou73v0_A10	687026	687281	BnaA10T0012700ZY	0	+	0	0	255	0.0000000
zheyou73v0_A10	687592	696441	BnaA10T0012800ZY	0	-	3851	7779	8849	0.8790824
zheyou73v0_A10	696973	698644	BnaA10T0012900ZY	0	+	917	1671	1671	1.0000000
zheyou73v0_A10	703442	709400	BnaA10T0013000ZY	0	-	438	3637	5958	0.6104397
zheyou73v0_A10	711922	712174	BnaA10T0013100ZY	0	-	324	252	252	1.0000000
zheyou73v0_A10	715537	718315	BnaA10T0013200ZY	0	-	817	2533	2778	0.9118071
zheyou73v0_A10	730627	731266	BnaA10T0013300ZY	0	-	666	639	639	1.0000000
zheyou73v0_A10	743821	744670	BnaA10T0013400ZY	0	-	672	849	849	1.0000000
zheyou73v0_A10	748393	749180	BnaA10T0013500ZY	0	-	0	0	787	0.0000000
zheyou73v0_A10	756747	757890	BnaA10T0013600ZY	0	+	104	295	1143	0.2580927
zheyou73v0_A10	777236	778062	BnaA10T0013700ZY	0	-	390	826	826	1.0000000
zheyou73v0_A10	810515	811393	BnaA10T0013800ZY	0	+	115	805	878	0.9168565
zheyou73v0_A10	822894	824354	BnaA10T0013900ZY	0	-	806	1460	1460	1.0000000
zheyou73v0_A10	824939	827749	BnaA10T0014000ZY	0	-	707	2457	2810	0.8743773
zheyou73v0_A10	824939	827749	BnaA10T0014000ZY.1	0	-	707	2457	2810	0.8743773
zheyou73v0_A10	841303	841721	BnaA10T0014100ZY	0	+	40	279	418	0.6674641
zheyou73v0_A10	847068	848883	BnaA10T0014200ZY	0	-	29	485	1815	0.2672176
zheyou73v0_A10	850263	855327	BnaA10T0014300ZY	0	+	484	3367	5064	0.6648894
zheyou73v0_A10	855981	856512	BnaA10T0014400ZY	0	+	82	525	531	0.9887006
zheyou73v0_A10	858395	859306	BnaA10T0014500ZY	0	-	25	837	911	0.9187706
zheyou73v0_A10	858395	859306	BnaA10T0014500ZY.1	0	-	25	837	911	0.9187706
zheyou73v0_A10	869459	872549	BnaA10T0014600ZY	0	-	558	2956	3090	0.9566343
zheyou73v0_A10	875696	879570	BnaA10T0014700ZY	0	-	288	3158	3874	0.8151781
zheyou73v0_A10	891376	896459	BnaA10T0014800ZY	0	+	852	3526	5083	0.6936848
zheyou73v0_A10	896934	897680	BnaA10T0014900ZY	0	-	342	746	746	1.0000000
zheyou73v0_A10	905045	905957	BnaA10T0015000ZY	0	-	62	623	912	0.6831141
zheyou73v0_A10	911385	913192	BnaA10T0015100ZY	0	+	282	1206	1807	0.6674045
zheyou73v0_A10	913527	914922	BnaA10T0015200ZY	0	-	675	1395	1395	1.0000000
zheyou73v0_A10	915275	916754	BnaA10T0015300ZY	0	-	630	1447	1479	0.9783638
zheyou73v0_A10	917371	918172	BnaA10T0015400ZY	0	+	105	694	801	0.8664170
zheyou73v0_A10	920800	921936	BnaA10T0015500ZY	0	+	202	1065	1136	0.9375000
zheyou73v0_A10	922209	925472	BnaA10T0015600ZY	0	-	550	2196	3263	0.6730003
zheyou73v0_A10	928573	928947	BnaA10T0015700ZY	0	+	0	0	374	0.0000000
zheyou73v0_A10	933466	935751	BnaA10T0015800ZY	0	-	437	1939	2285	0.8485777
zheyou73v0_A10	948412	949823	BnaA10T0015900ZY	0	-	403	1031	1411	0.7306874
zheyou73v0_A10	957596	958499	BnaA10T0016000ZY	0	-	16	211	903	0.2336656
zheyou73v0_A10	960283	965357	BnaA10T0016100ZY	0	-	274	2967	5074	0.5847458
zheyou73v0_A10	966664	971026	BnaA10T0016200ZY	0	+	1010	3782	4362	0.8670335
zheyou73v0_A10	966867	970777	BnaA10T0016200ZY.1	0	+	949	3330	3910	0.8516624
zheyou73v0_A10	971308	972006	BnaA10T0016300ZY	0	+	43	398	698	0.5702006
zheyou73v0_A10	980014	981797	BnaA10T0016400ZY	0	-	291	1710	1783	0.9590577
zheyou73v0_A10	982638	992690	BnaA10T0016500ZY	0	-	1452	8274	10052	0.8231198
zheyou73v0_A10	994459	998533	BnaA10T0016600ZY	0	-	49	390	4074	0.0957290
zheyou73v0_A10	998625	998956	BnaA10T0016700ZY	0	-	0	0	331	0.0000000
zheyou73v0_A10	1010194	1011755	BnaA10T0016800ZY	0	+	0	0	1561	0.0000000
zheyou73v0_A10	1014163	1019246	BnaA10T0016900ZY	0	+	630	1779	5083	0.3499902
zheyou73v0_A10	1019496	1020138	BnaA10T0017000ZY	0	-	2	143	642	0.2227414
zheyou73v0_A10	1020605	1021398	BnaA10T0017100ZY	0	-	16	416	793	0.5245901
zheyou73v0_A10	1032221	1034085	BnaA10T0017200ZY	0	+	387	1864	1864	1.0000000
zheyou73v0_A10	1034727	1037030	BnaA10T0017300ZY	0	-	1181	2123	2303	0.9218411
zheyou73v0_A10	1041030	1045789	BnaA10T0017400ZY	0	+	1756	4685	4759	0.9844505
zheyou73v0_A10	1047438	1048347	BnaA10T0017500ZY	0	-	432	909	909	1.0000000
zheyou73v0_A10	1050911	1053873	BnaA10T0017600ZY	0	-	953	2642	2962	0.8919649
zheyou73v0_A10	1050911	1053873	BnaA10T0017600ZY.1	0	-	953	2642	2962	0.8919649
zheyou73v0_A10	1055859	1057655	BnaA10T0017700ZY	0	-	303	1357	1796	0.7555679
zheyou73v0_A10	1061631	1063107	BnaA10T0017800ZY	0	+	613	1476	1476	1.0000000
zheyou73v0_A10	1079633	1080689	BnaA10T0017900ZY	0	+	0	0	1056	0.0000000
zheyou73v0_A10	1141494	1146909	BnaA10T0018000ZY	0	-	53	270	5415	0.0498615
zheyou73v0_A10	1141494	1146909	BnaA10T0018000ZY.1	0	-	53	270	5415	0.0498615
zheyou73v0_A10	1234900	1235419	BnaA10T0018100ZY	0	+	0	0	519	0.0000000
zheyou73v0_A10	1269051	1269870	BnaA10T0018200ZY	0	+	76	365	819	0.4456654
zheyou73v0_A10	1296803	1297386	BnaA10T0018300ZY	0	+	8	402	583	0.6895369
zheyou73v0_A10	1298318	1301156	BnaA10T0018400ZY	0	-	1	51	2838	0.0179704
zheyou73v0_A10	1308724	1309039	BnaA10T0018500ZY	0	-	2	8	315	0.0253968
zheyou73v0_A10	1309596	1309982	BnaA10T0018600ZY	0	-	0	0	386	0.0000000
zheyou73v0_A10	1311022	1331407	BnaA10T0018700ZY	0	-	1184	9217	20385	0.4521462
zheyou73v0_A10	1353039	1354395	BnaA10T0018800ZY	0	-	0	0	1356	0.0000000
zheyou73v0_A10	1355088	1355475	BnaA10T0018900ZY	0	-	0	0	387	0.0000000
zheyou73v0_A10	1361341	1366080	BnaA10T0019000ZY	0	+	209	2969	4739	0.6265035
zheyou73v0_A10	1393094	1395183	BnaA10T0019100ZY	0	-	0	0	2089	0.0000000
zheyou73v0_A10	1397042	1398981	BnaA10T0019200ZY	0	-	0	0	1939	0.0000000
zheyou73v0_A10	1402059	1402517	BnaA10T0019300ZY	0	-	0	0	458	0.0000000
zheyou73v0_A10	1402678	1403414	BnaA10T0019400ZY	0	-	0	0	736	0.0000000
zheyou73v0_A10	1423414	1425504	BnaA10T0019500ZY	0	-	0	0	2090	0.0000000
zheyou73v0_A10	1433296	1433890	BnaA10T0019600ZY	0	-	41	507	594	0.8535354
zheyou73v0_A10	1438679	1438901	BnaA10T0019700ZY	0	-	70	222	222	1.0000000
zheyou73v0_A10	1438922	1439245	BnaA10T0019800ZY	0	-	85	281	323	0.8699691
zheyou73v0_A10	1445278	1446707	BnaA10T0019900ZY	0	-	1	119	1429	0.0832750
zheyou73v0_A10	1448610	1449300	BnaA10T0020000ZY	0	-	35	595	690	0.8623188
zheyou73v0_A10	1450454	1454443	BnaA10T0020100ZY	0	+	93	1651	3989	0.4138882
zheyou73v0_A10	1455338	1455870	BnaA10T0020200ZY	0	-	0	0	532	0.0000000
zheyou73v0_A10	1532277	1532805	BnaA10T0020300ZY	0	-	8	211	528	0.3996212
zheyou73v0_A10	1532945	1534693	BnaA10T0020400ZY	0	-	1	59	1748	0.0337529
zheyou73v0_A10	1535006	1540387	BnaA10T0020500ZY	0	+	0	0	5381	0.0000000
zheyou73v0_A10	1544096	1550324	BnaA10T0020600ZY	0	-	24	227	6228	0.0364483
zheyou73v0_A10	1556620	1557235	BnaA10T0020700ZY	0	+	192	545	615	0.8861789
zheyou73v0_A10	1559208	1559837	BnaA10T0020800ZY	0	-	6	126	629	0.2003180
zheyou73v0_A10	1577908	1580289	BnaA10T0020900ZY	0	+	0	0	2381	0.0000000
zheyou73v0_A10	1577908	1580289	BnaA10T0020900ZY.1	0	+	0	0	2381	0.0000000
zheyou73v0_A10	1577908	1580289	BnaA10T0020900ZY.2	0	+	0	0	2381	0.0000000
zheyou73v0_A10	1577908	1580289	BnaA10T0020900ZY.3	0	+	0	0	2381	0.0000000
zheyou73v0_A10	1672264	1672896	BnaA10T0021000ZY	0	-	0	0	632	0.0000000
zheyou73v0_A10	1688455	1688641	BnaA10T0021100ZY	0	+	13	186	186	1.0000000
zheyou73v0_A10	1694802	1695341	BnaA10T0021200ZY	0	-	0	0	539	0.0000000
zheyou73v0_A10	1695702	1696475	BnaA10T0021300ZY	0	-	0	0	773	0.0000000
zheyou73v0_A10	1699373	1700755	BnaA10T0021400ZY	0	+	2	130	1382	0.0940666
zheyou73v0_A10	1790057	1794575	BnaA10T0021500ZY	0	+	0	0	4518	0.0000000
zheyou73v0_A10	1804321	1809910	BnaA10T0021600ZY	0	-	56	1155	5589	0.2066559
zheyou73v0_A10	1851659	1852540	BnaA10T0021700ZY	0	-	0	0	881	0.0000000
zheyou73v0_A10	1859977	1861085	BnaA10T0021800ZY	0	+	79	755	1108	0.6814079
zheyou73v0_A10	1861544	1864710	BnaA10T0021900ZY	0	+	402	2474	3166	0.7814277
zheyou73v0_A10	1865231	1868939	BnaA10T0022000ZY	0	+	1231	3174	3708	0.8559871
zheyou73v0_A10	1877622	1879044	BnaA10T0022100ZY	0	+	202	1187	1422	0.8347398
zheyou73v0_A10	1888341	1891397	BnaA10T0022200ZY	0	+	582	2691	3056	0.8805628
zheyou73v0_A10	1888341	1891397	BnaA10T0022200ZY.1	0	+	582	2691	3056	0.8805628
zheyou73v0_A10	1899713	1902753	BnaA10T0022300ZY	0	-	536	2876	3040	0.9460526
zheyou73v0_A10	1903140	1904500	BnaA10T0022400ZY	0	+	689	1360	1360	1.0000000
zheyou73v0_A10	1905161	1906060	BnaA10T0022500ZY	0	-	231	899	899	1.0000000
zheyou73v0_A10	1909446	1912332	BnaA10T0022600ZY	0	+	191	2270	2886	0.7865558
zheyou73v0_A10	1909446	1912332	BnaA10T0022600ZY.1	0	+	191	2270	2886	0.7865558
zheyou73v0_A10	1926261	1931442	BnaA10T0022700ZY	0	+	2424	5150	5181	0.9940166
zheyou73v0_A10	1932195	1938252	BnaA10T0022800ZY	0	+	1241	4278	6057	0.7062902
zheyou73v0_A10	1938675	1939356	BnaA10T0022900ZY	0	+	194	681	681	1.0000000
zheyou73v0_A10	1940060	1944988	BnaA10T0023000ZY	0	-	1300	4588	4928	0.9310065
zheyou73v0_A10	1945415	1946700	BnaA10T0023100ZY	0	-	336	1184	1285	0.9214008
zheyou73v0_A10	1950548	1952201	BnaA10T0023200ZY	0	+	352	1524	1653	0.9219601
zheyou73v0_A10	1952741	1954085	BnaA10T0023300ZY	0	-	418	1277	1344	0.9501488
zheyou73v0_A10	1954613	1956239	BnaA10T0023400ZY	0	-	1068	1626	1626	1.0000000
zheyou73v0_A10	1962293	1964131	BnaA10T0023500ZY	0	-	1188	1838	1838	1.0000000
zheyou73v0_A10	1975037	1977744	BnaA10T0023600ZY	0	+	479	2429	2707	0.8973033
zheyou73v0_A10	1978896	1980353	BnaA10T0023700ZY	0	+	170	1371	1457	0.9409746
zheyou73v0_A10	1980475	1982282	BnaA10T0023800ZY	0	-	206	1506	1807	0.8334256
zheyou73v0_A10	2003396	2003732	BnaA10T0023900ZY	0	-	222	336	336	1.0000000
zheyou73v0_A10	2007974	2008685	BnaA10T0024000ZY	0	+	160	685	711	0.9634318
zheyou73v0_A10	2014387	2016313	BnaA10T0024100ZY.1	0	+	0	0	1926	0.0000000
zheyou73v0_A10	2014425	2016081	BnaA10T0024100ZY	0	+	0	0	1656	0.0000000
zheyou73v0_A10	2016520	2019872	BnaA10T0024200ZY	0	-	4	19	3352	0.0056683
zheyou73v0_A10	2016520	2019203	BnaA10T0024200ZY.1	0	-	4	19	2683	0.0070816
zheyou73v0_A10	2036495	2038316	BnaA10T0024300ZY.1	0	+	39	103	1821	0.0565623
zheyou73v0_A10	2036533	2038189	BnaA10T0024300ZY	0	+	0	0	1656	0.0000000
zheyou73v0_A10	2041211	2042653	BnaA10T0024400ZY	0	-	260	1388	1442	0.9625520
zheyou73v0_A10	2046634	2048337	BnaA10T0024500ZY	0	+	492	1628	1703	0.9559601
zheyou73v0_A10	2052568	2054381	BnaA10T0024600ZY	0	-	730	1813	1813	1.0000000
zheyou73v0_A10	2054514	2056219	BnaA10T0024700ZY	0	-	271	1264	1705	0.7413490
zheyou73v0_A10	2056649	2058016	BnaA10T0024800ZY	0	+	320	843	1367	0.6166788
zheyou73v0_A10	2059982	2060472	BnaA10T0024900ZY	0	+	0	0	490	0.0000000
zheyou73v0_A10	2065114	2065366	BnaA10T0025000ZY	0	+	210	252	252	1.0000000
zheyou73v0_A10	2074108	2074709	BnaA10T0025100ZY	0	+	229	601	601	1.0000000
zheyou73v0_A10	2087188	2087619	BnaA10T0025200ZY	0	+	0	0	431	0.0000000
zheyou73v0_A10	2093979	2097592	BnaA10T0025300ZY	0	+	698	2459	3613	0.6805978
zheyou73v0_A10	2093979	2097592	BnaA10T0025300ZY.1	0	+	698	2459	3613	0.6805978
zheyou73v0_A10	2093979	2097592	BnaA10T0025300ZY.2	0	+	698	2459	3613	0.6805978
zheyou73v0_A10	2097714	2100540	BnaA10T0025400ZY	0	-	537	1868	2826	0.6610050
zheyou73v0_A10	2100866	2101983	BnaA10T0025500ZY	0	+	131	874	1117	0.7824530
zheyou73v0_A10	2104550	2105579	BnaA10T0025600ZY	0	-	189	925	1029	0.8989310
zheyou73v0_A10	2120496	2121107	BnaA10T0025700ZY	0	+	73	505	611	0.8265139
zheyou73v0_A10	2121345	2121829	BnaA10T0025800ZY	0	+	370	484	484	1.0000000
zheyou73v0_A10	2123645	2124359	BnaA10T0025900ZY	0	+	43	605	714	0.8473389
zheyou73v0_A10	2128485	2129224	BnaA10T0026000ZY	0	+	249	729	739	0.9864682
zheyou73v0_A10	2140857	2144682	BnaA10T0026100ZY	0	+	1007	3665	3825	0.9581699
zheyou73v0_A10	2144997	2146790	BnaA10T0026200ZY	0	+	1178	1793	1793	1.0000000
zheyou73v0_A10	2154077	2157342	BnaA10T0026300ZY	0	+	387	2831	3265	0.8670750
zheyou73v0_A10	2170075	2171018	BnaA10T0026400ZY	0	+	12	80	943	0.0848356
zheyou73v0_A10	2181700	2182340	BnaA10T0026500ZY	0	+	269	526	640	0.8218750
zheyou73v0_A10	2182662	2185035	BnaA10T0026600ZY	0	-	318	1969	2373	0.8297514
zheyou73v0_A10	2185907	2187298	BnaA10T0026700ZY	0	-	94	963	1391	0.6923077
zheyou73v0_A10	2187999	2189708	BnaA10T0026800ZY	0	-	731	1709	1709	1.0000000
zheyou73v0_A10	2190701	2194406	BnaA10T0026900ZY	0	+	793	3120	3705	0.8421053
zheyou73v0_A10	2194026	2194290	BnaA10T0027000ZY	0	-	25	240	264	0.9090909
zheyou73v0_A10	2196026	2206925	BnaA10T0027100ZY	0	+	1242	6546	10899	0.6006055
zheyou73v0_A10	2207253	2208531	BnaA10T0027200ZY	0	-	842	1278	1278	1.0000000
zheyou73v0_A10	2208976	2210067	BnaA10T0027300ZY	0	+	239	979	1091	0.8973419
zheyou73v0_A10	2210356	2212364	BnaA10T0027400ZY	0	-	61	1010	2008	0.5029880
zheyou73v0_A10	2221698	2222076	BnaA10T0027500ZY	0	-	291	378	378	1.0000000
zheyou73v0_A10	2226441	2227583	BnaA10T0027600ZY	0	+	457	1142	1142	1.0000000
zheyou73v0_A10	2227861	2228292	BnaA10T0027700ZY	0	-	19	253	431	0.5870070
zheyou73v0_A10	2228888	2232361	BnaA10T0027800ZY	0	+	980	3334	3473	0.9599770
zheyou73v0_A10	2232496	2233980	BnaA10T0027900ZY	0	-	215	1451	1484	0.9777628
zheyou73v0_A10	2233982	2241462	BnaA10T0028000ZY	0	-	447	4516	7480	0.6037433
zheyou73v0_A10	2248330	2250570	BnaA10T0028100ZY	0	-	933	1968	2240	0.8785715
zheyou73v0_A10	2254060	2255573	BnaA10T0028200ZY	0	+	241	1354	1513	0.8949108
zheyou73v0_A10	2258012	2261680	BnaA10T0028300ZY	0	-	734	2582	3668	0.7039258
zheyou73v0_A10	2262133	2267928	BnaA10T0028400ZY	0	-	496	3944	5795	0.6805867
zheyou73v0_A10	2268173	2270904	BnaA10T0028500ZY	0	+	151	747	2731	0.2735262
zheyou73v0_A10	2271453	2272602	BnaA10T0028600ZY	0	-	320	1149	1149	1.0000000
zheyou73v0_A10	2273828	2284731	BnaA10T0028700ZY	0	-	3899	10472	10903	0.9604696
zheyou73v0_A10	2289475	2291251	BnaA10T0028800ZY	0	-	187	1265	1776	0.7122748
zheyou73v0_A10	2296659	2300219	BnaA10T0028900ZY	0	+	2315	3116	3560	0.8752809
zheyou73v0_A10	2300799	2301250	BnaA10T0029000ZY	0	+	5	357	451	0.7915743
zheyou73v0_A10	2312850	2315974	BnaA10T0029100ZY	0	+	1032	2964	3124	0.9487836
zheyou73v0_A10	2316475	2317349	BnaA10T0029200ZY	0	+	237	606	874	0.6933638
zheyou73v0_A10	2317293	2319773	BnaA10T0029300ZY	0	-	208	1380	2480	0.5564516
zheyou73v0_A10	2317293	2319773	BnaA10T0029300ZY.1	0	-	208	1380	2480	0.5564516
zheyou73v0_A10	2324801	2329341	BnaA10T0029400ZY	0	-	1429	4122	4540	0.9079295
zheyou73v0_A10	2336334	2338366	BnaA10T0029500ZY	0	+	384	1779	2032	0.8754922
zheyou73v0_A10	2338676	2341143	BnaA10T0029600ZY	0	-	191	1421	2467	0.5760033
zheyou73v0_A10	2338676	2341143	BnaA10T0029600ZY.1	0	-	191	1421	2467	0.5760033
zheyou73v0_A10	2342243	2347762	BnaA10T0029700ZY	0	-	1300	3826	5519	0.6932415
zheyou73v0_A10	2348942	2349530	BnaA10T0029800ZY	0	+	38	400	588	0.6802721
zheyou73v0_A10	2349952	2355053	BnaA10T0029900ZY	0	-	1682	4946	5101	0.9696138
zheyou73v0_A10	2359492	2360012	BnaA10T0030000ZY	0	-	145	418	520	0.8038462
zheyou73v0_A10	2383975	2385303	BnaA10T0030100ZY	0	+	99	741	1328	0.5579819
zheyou73v0_A10	2388198	2388837	BnaA10T0030200ZY	0	+	170	498	639	0.7793427
zheyou73v0_A10	2389460	2392128	BnaA10T0030300ZY	0	-	458	2531	2668	0.9486507
zheyou73v0_A10	2393169	2395387	BnaA10T0030400ZY	0	+	1169	2178	2218	0.9819657
zheyou73v0_A10	2393169	2395387	BnaA10T0030400ZY.1	0	+	1169	2178	2218	0.9819657
zheyou73v0_A10	2396059	2398231	BnaA10T0030500ZY	0	-	875	2040	2172	0.9392265
zheyou73v0_A10	2409156	2411236	BnaA10T0030600ZY	0	-	899	2004	2080	0.9634615
zheyou73v0_A10	2413587	2414930	BnaA10T0030700ZY	0	-	156	1148	1343	0.8548027
zheyou73v0_A10	2413587	2414930	BnaA10T0030700ZY.1	0	-	156	1148	1343	0.8548027
zheyou73v0_A10	2415564	2417194	BnaA10T0030800ZY	0	-	176	1344	1630	0.8245399
zheyou73v0_A10	2418138	2419998	BnaA10T0030900ZY	0	+	920	1610	1860	0.8655914
zheyou73v0_A10	2421567	2422757	BnaA10T0031000ZY	0	-	91	703	1190	0.5907563
zheyou73v0_A10	2430660	2436046	BnaA10T0031100ZY	0	-	690	4277	5386	0.7940958
zheyou73v0_A10	2444595	2446502	BnaA10T0031200ZY	0	+	133	1222	1907	0.6407971
zheyou73v0_A10	2444595	2446502	BnaA10T0031200ZY.1	0	+	133	1222	1907	0.6407971
zheyou73v0_A10	2452030	2453630	BnaA10T0031300ZY	0	-	684	1600	1600	1.0000000
zheyou73v0_A10	2487940	2533668	BnaA10T0031400ZY	0	+	6949	25991	45728	0.5683826
zheyou73v0_A10	2538262	2539534	BnaA10T0031500ZY	0	-	277	977	1272	0.7680818
zheyou73v0_A10	2541446	2541656	BnaA10T0031600ZY	0	+	0	0	210	0.0000000
zheyou73v0_A10	2542834	2544433	BnaA10T0031700ZY	0	-	289	1310	1599	0.8192620
zheyou73v0_A10	2545504	2545837	BnaA10T0031800ZY	0	+	4	106	333	0.3183183
zheyou73v0_A10	2547101	2547650	BnaA10T0031900ZY	0	+	12	260	549	0.4735883
zheyou73v0_A10	2552633	2555145	BnaA10T0032000ZY	0	+	357	2415	2512	0.9613854
zheyou73v0_A10	2555488	2558825	BnaA10T0032100ZY	0	-	918	3185	3337	0.9544501
zheyou73v0_A10	2576909	2578994	BnaA10T0032200ZY	0	+	561	1937	2085	0.9290168
zheyou73v0_A10	2578667	2581031	BnaA10T0032300ZY	0	-	748	2324	2364	0.9830796
zheyou73v0_A10	2582093	2584443	BnaA10T0032400ZY	0	-	639	2350	2350	1.0000000
zheyou73v0_A10	2595075	2596509	BnaA10T0032500ZY	0	+	292	1408	1434	0.9818689
zheyou73v0_A10	2596741	2598178	BnaA10T0032600ZY	0	-	247	1316	1437	0.9157968
zheyou73v0_A10	2600298	2605669	BnaA10T0032700ZY	0	-	1603	3126	5371	0.5820145
zheyou73v0_A10	2613065	2616020	BnaA10T0032800ZY	0	+	412	2440	2955	0.8257191
zheyou73v0_A10	2618494	2618838	BnaA10T0032900ZY	0	-	2	184	344	0.5348837
zheyou73v0_A10	2620188	2622711	BnaA10T0033000ZY	0	-	923	2494	2523	0.9885057
zheyou73v0_A10	2624813	2625656	BnaA10T0033100ZY	0	-	254	843	843	1.0000000
zheyou73v0_A10	2626568	2627964	BnaA10T0033200ZY	0	-	545	1396	1396	1.0000000
zheyou73v0_A10	2628169	2629350	BnaA10T0033300ZY	0	+	192	1101	1181	0.9322608
zheyou73v0_A10	2647145	2649110	BnaA10T0033400ZY	0	+	533	1943	1965	0.9888040
zheyou73v0_A10	2658320	2660807	BnaA10T0033500ZY	0	-	1558	2487	2487	1.0000000
zheyou73v0_A10	2662827	2663299	BnaA10T0033600ZY	0	-	357	472	472	1.0000000
zheyou73v0_A10	2668914	2672172	BnaA10T0033700ZY	0	+	1002	3199	3258	0.9818907
zheyou73v0_A10	2673206	2674788	BnaA10T0033800ZY	0	-	701	1582	1582	1.0000000
zheyou73v0_A10	2683581	2685119	BnaA10T0033900ZY	0	-	274	1009	1538	0.6560468
zheyou73v0_A10	2683953	2685119	BnaA10T0033900ZY.1	0	-	274	1009	1166	0.8653516
zheyou73v0_A10	2685465	2686239	BnaA10T0034000ZY	0	-	60	678	774	0.8759690
zheyou73v0_A10	2688883	2690869	BnaA10T0034100ZY	0	-	571	1772	1986	0.8922457
zheyou73v0_A10	2693343	2694019	BnaA10T0034200ZY	0	-	69	601	676	0.8890532
zheyou73v0_A10	2700155	2700413	BnaA10T0034300ZY	0	-	79	258	258	1.0000000
zheyou73v0_A10	2703225	2703660	BnaA10T0034400ZY	0	-	351	435	435	1.0000000
zheyou73v0_A10	2711237	2714722	BnaA10T0034500ZY	0	-	1237	3358	3485	0.9635581
zheyou73v0_A10	2715290	2716745	BnaA10T0034600ZY	0	+	652	1455	1455	1.0000000
zheyou73v0_A10	2717412	2721355	BnaA10T0034700ZY	0	-	316	2286	3943	0.5797616
zheyou73v0_A10	2722347	2723787	BnaA10T0034800ZY	0	+	1099	1440	1440	1.0000000
zheyou73v0_A10	2740268	2740914	BnaA10T0034900ZY	0	+	22	254	646	0.3931889
zheyou73v0_A10	2742906	2743471	BnaA10T0035000ZY	0	+	381	565	565	1.0000000
zheyou73v0_A10	2749047	2751938	BnaA10T0035100ZY	0	+	1146	2293	2891	0.7931511
zheyou73v0_A10	2749047	2751938	BnaA10T0035100ZY.1	0	+	1146	2293	2891	0.7931511
zheyou73v0_A10	2752368	2765586	BnaA10T0035200ZY	0	-	2941	11294	13218	0.8544409
zheyou73v0_A10	2779407	2781696	BnaA10T0035300ZY	0	-	401	2213	2289	0.9667977
zheyou73v0_A10	2791630	2791953	BnaA10T0035400ZY	0	+	387	323	323	1.0000000
zheyou73v0_A10	2795059	2795843	BnaA10T0035500ZY	0	-	598	784	784	1.0000000
zheyou73v0_A10	2796306	2802461	BnaA10T0035600ZY	0	-	2590	5532	6155	0.8987815
zheyou73v0_A10	2803929	2805815	BnaA10T0035700ZY	0	-	828	1886	1886	1.0000000
zheyou73v0_A10	2809680	2811920	BnaA10T0035800ZY	0	+	788	2240	2240	1.0000000
zheyou73v0_A10	2840435	2842951	BnaA10T0035900ZY	0	+	98	860	2516	0.3418124
zheyou73v0_A10	2860918	2863518	BnaA10T0036000ZY	0	+	437	2183	2600	0.8396154
zheyou73v0_A10	2866551	2867877	BnaA10T0036100ZY	0	+	863	1326	1326	1.0000000
zheyou73v0_A10	2868068	2868649	BnaA10T0036200ZY	0	-	266	458	581	0.7882960
zheyou73v0_A10	2880882	2881617	BnaA10T0036300ZY	0	-	214	735	735	1.0000000
zheyou73v0_A10	2881682	2881977	BnaA10T0036400ZY	0	-	266	295	295	1.0000000
zheyou73v0_A10	2889878	2891659	BnaA10T0036500ZY	0	+	312	1313	1781	0.7372262
zheyou73v0_A10	2897573	2899299	BnaA10T0036600ZY	0	-	144	1258	1726	0.7288529
zheyou73v0_A10	2899596	2901454	BnaA10T0036700ZY	0	-	612	1858	1858	1.0000000
zheyou73v0_A10	2921494	2922166	BnaA10T0036800ZY	0	-	13	81	672	0.1205357
zheyou73v0_A10	2926252	2927744	BnaA10T0036900ZY	0	+	410	1467	1492	0.9832439
zheyou73v0_A10	2926252	2927744	BnaA10T0036900ZY.1	0	+	410	1467	1492	0.9832439
zheyou73v0_A10	2932590	2934056	BnaA10T0037000ZY	0	-	310	1084	1466	0.7394270
zheyou73v0_A10	2944468	2946455	BnaA10T0037100ZY	0	-	1615	1987	1987	1.0000000
zheyou73v0_A10	2952438	2959157	BnaA10T0037200ZY	0	-	1421	6098	6719	0.9075755
zheyou73v0_A10	2976306	2980677	BnaA10T0037300ZY	0	-	1097	3186	4371	0.7288950
zheyou73v0_A10	2976306	2980677	BnaA10T0037300ZY.1	0	-	1097	3186	4371	0.7288950
zheyou73v0_A10	2976306	2980677	BnaA10T0037300ZY.2	0	-	1097	3186	4371	0.7288950
zheyou73v0_A10	2989764	2990103	BnaA10T0037400ZY	0	-	436	339	339	1.0000000
zheyou73v0_A10	3063005	3064838	BnaA10T0037500ZY	0	-	382	1833	1833	1.0000000
zheyou73v0_A10	3076912	3079343	BnaA10T0037600ZY	0	-	0	0	2431	0.0000000
zheyou73v0_A10	3085969	3087134	BnaA10T0037700ZY	0	-	0	0	1165	0.0000000
zheyou73v0_A10	3094957	3097394	BnaA10T0037800ZY	0	-	0	0	2437	0.0000000
zheyou73v0_A10	3101361	3102628	BnaA10T0037900ZY	0	+	744	1267	1267	1.0000000
zheyou73v0_A10	3102862	3103535	BnaA10T0038000ZY	0	-	577	673	673	1.0000000
zheyou73v0_A10	3107571	3107730	BnaA10T0038100ZY	0	-	15	159	159	1.0000000
zheyou73v0_A10	3111936	3112908	BnaA10T0038200ZY	0	+	0	0	972	0.0000000
zheyou73v0_A10	3121977	3124623	BnaA10T0038300ZY	0	+	1014	2618	2646	0.9894180
zheyou73v0_A10	3125726	3128767	BnaA10T0038400ZY	0	-	878	2296	3041	0.7550148
zheyou73v0_A10	3130739	3132597	BnaA10T0038500ZY	0	-	180	1169	1858	0.6291711
zheyou73v0_A10	3132708	3134327	BnaA10T0038600ZY	0	-	342	1588	1619	0.9808524
zheyou73v0_A10	3153357	3153765	BnaA10T0038700ZY	0	-	426	408	408	1.0000000
zheyou73v0_A10	3173628	3174102	BnaA10T0038800ZY	0	-	240	474	474	1.0000000
zheyou73v0_A10	3182024	3185285	BnaA10T0038900ZY	0	+	188	2625	3261	0.8049678
zheyou73v0_A10	3185269	3187164	BnaA10T0039000ZY	0	-	280	1696	1895	0.8949868
zheyou73v0_A10	3185269	3187164	BnaA10T0039000ZY.1	0	-	280	1696	1895	0.8949868
zheyou73v0_A10	3189623	3190322	BnaA10T0039100ZY	0	+	421	699	699	1.0000000
zheyou73v0_A10	3220565	3222345	BnaA10T0039200ZY	0	-	650	1780	1780	1.0000000
zheyou73v0_A10	3223046	3223840	BnaA10T0039300ZY	0	+	200	794	794	1.0000000
zheyou73v0_A10	3235130	3237664	BnaA10T0039400ZY	0	+	391	1915	2534	0.7557222
zheyou73v0_A10	3235130	3237721	BnaA10T0039400ZY.1	0	+	406	1972	2591	0.7610961
zheyou73v0_A10	3235130	3237721	BnaA10T0039400ZY.2	0	+	406	1972	2591	0.7610961
zheyou73v0_A10	3253486	3253717	BnaA10T0039500ZY	0	-	0	0	231	0.0000000
zheyou73v0_A10	3253938	3255427	BnaA10T0039600ZY	0	-	0	0	1489	0.0000000
zheyou73v0_A10	3268901	3269132	BnaA10T0039700ZY	0	-	0	0	231	0.0000000
zheyou73v0_A10	3269351	3270840	BnaA10T0039800ZY	0	-	0	0	1489	0.0000000
zheyou73v0_A10	3287762	3288886	BnaA10T0039900ZY	0	-	78	1026	1124	0.9128114
zheyou73v0_A10	3344640	3345560	BnaA10T0040000ZY	0	-	270	920	920	1.0000000
zheyou73v0_A10	3366136	3367102	BnaA10T0040100ZY	0	-	545	966	966	1.0000000
zheyou73v0_A10	3372625	3374054	BnaA10T0040200ZY	0	-	306	1391	1429	0.9734080
zheyou73v0_A10	3378564	3379306	BnaA10T0040300ZY	0	-	557	742	742	1.0000000
zheyou73v0_A10	3379767	3381560	BnaA10T0040400ZY	0	-	460	1710	1793	0.9537089
zheyou73v0_A10	3383532	3388039	BnaA10T0040500ZY	0	-	1115	4244	4507	0.9416463
zheyou73v0_A10	3390201	3400151	BnaA10T0040600ZY	0	-	2301	9431	9950	0.9478392
zheyou73v0_A10	3438276	3440753	BnaA10T0040700ZY	0	+	1122	2477	2477	1.0000000
zheyou73v0_A10	3472978	3475443	BnaA10T0040800ZY.1	0	+	733	2453	2465	0.9951319
zheyou73v0_A10	3473139	3475443	BnaA10T0040800ZY	0	+	655	2292	2304	0.9947917
zheyou73v0_A10	3476160	3477912	BnaA10T0040900ZY	0	-	572	1752	1752	1.0000000
zheyou73v0_A10	3478746	3479080	BnaA10T0041000ZY	0	+	46	211	334	0.6317365
zheyou73v0_A10	3480469	3498054	BnaA10T0041100ZY	0	+	9944	15401	17585	0.8758032
zheyou73v0_A10	3505435	3508183	BnaA10T0041200ZY	0	+	290	2259	2748	0.8220524
zheyou73v0_A10	3539964	3542344	BnaA10T0041300ZY	0	-	170	2151	2380	0.9037815
zheyou73v0_A10	3550932	3554965	BnaA10T0041400ZY	0	+	39618	3225	4033	0.7996529
zheyou73v0_A10	3555933	3556707	BnaA10T0041500ZY	0	-	175	735	774	0.9496124
zheyou73v0_A10	3558971	3560335	BnaA10T0041600ZY	0	-	346	1364	1364	1.0000000
zheyou73v0_A10	3572571	3574280	BnaA10T0041700ZY	0	+	1	3	1709	0.0017554
zheyou73v0_A10	3586387	3587679	BnaA10T0041800ZY	0	-	62	696	1292	0.5386997
zheyou73v0_A10	3619211	3619377	BnaA10T0041900ZY	0	+	22	166	166	1.0000000
zheyou73v0_A10	3619749	3620707	BnaA10T0042000ZY	0	+	44	576	958	0.6012526
zheyou73v0_A10	3624940	3629653	BnaA10T0042100ZY	0	+	0	0	4713	0.0000000
zheyou73v0_A10	3747107	3751866	BnaA10T0042200ZY	0	+	229	1928	4759	0.4051271
zheyou73v0_A10	3754521	3755687	BnaA10T0042300ZY	0	+	258	1144	1166	0.9811321
zheyou73v0_A10	3796880	3804996	BnaA10T0042400ZY	0	-	2903	7807	8116	0.9619271
zheyou73v0_A10	3811094	3811271	BnaA10T0042500ZY	0	-	0	0	177	0.0000000
zheyou73v0_A10	3837683	3839904	BnaA10T0042600ZY	0	-	983	2220	2221	0.9995497
zheyou73v0_A10	3869395	3869838	BnaA10T0042700ZY	0	+	97	424	443	0.9571106
zheyou73v0_A10	3869999	3872639	BnaA10T0042800ZY	0	-	410	2383	2640	0.9026515
zheyou73v0_A10	3883911	3885650	BnaA10T0042900ZY	0	-	536	1607	1739	0.9240943
zheyou73v0_A10	3902038	3903615	BnaA10T0043000ZY	0	-	660	1536	1577	0.9740013
zheyou73v0_A10	3914780	3916434	BnaA10T0043100ZY	0	-	143	1348	1654	0.8149940
zheyou73v0_A10	3916968	3918370	BnaA10T0043200ZY	0	-	671	1336	1402	0.9529244
zheyou73v0_A10	3938690	3940641	BnaA10T0043300ZY	0	+	290	1671	1951	0.8564839
zheyou73v0_A10	3938690	3939929	BnaA10T0043300ZY.1	0	+	239	1122	1239	0.9055690
zheyou73v0_A10	3945264	3952855	BnaA10T0043400ZY	0	-	1450	5825	7591	0.7673561
zheyou73v0_A10	3945264	3952855	BnaA10T0043400ZY.1	0	-	1450	5825	7591	0.7673561
zheyou73v0_A10	3945264	3952855	BnaA10T0043400ZY.2	0	-	1450	5825	7591	0.7673561
zheyou73v0_A10	3945264	3952855	BnaA10T0043400ZY.3	0	-	1450	5825	7591	0.7673561
zheyou73v0_A10	3945264	3952855	BnaA10T0043400ZY.4	0	-	1450	5825	7591	0.7673561
zheyou73v0_A10	4034617	4037526	BnaA10T0043500ZY	0	+	0	0	2909	0.0000000
zheyou73v0_A10	4100112	4106215	BnaA10T0043600ZY	0	-	237	1902	6103	0.3116500
zheyou73v0_A10	4109318	4117509	BnaA10T0043700ZY	0	-	3045	8069	8191	0.9851056
zheyou73v0_A10	4138963	4139305	BnaA10T0043800ZY	0	-	147	342	342	1.0000000
zheyou73v0_A10	4152006	4153824	BnaA10T0043900ZY	0	-	674	1818	1818	1.0000000
zheyou73v0_A10	4172066	4174332	BnaA10T0044000ZY	0	-	1304	2266	2266	1.0000000
zheyou73v0_A10	4236215	4236828	BnaA10T0044100ZY	0	-	832	613	613	1.0000000
zheyou73v0_A10	4300035	4302421	BnaA10T0044200ZY	0	-	2436	2386	2386	1.0000000
zheyou73v0_A10	4355721	4358513	BnaA10T0044300ZY	0	+	1815	2792	2792	1.0000000
zheyou73v0_A10	4373821	4374963	BnaA10T0044400ZY	0	+	987	1142	1142	1.0000000
zheyou73v0_A10	4375467	4377626	BnaA10T0044500ZY	0	-	1484	2159	2159	1.0000000
zheyou73v0_A10	4382921	4384315	BnaA10T0044600ZY	0	+	825	1394	1394	1.0000000
zheyou73v0_A10	4411509	4411827	BnaA10T0044700ZY	0	-	251	318	318	1.0000000
zheyou73v0_A10	4432693	4434297	BnaA10T0044800ZY	0	+	768	1604	1604	1.0000000
zheyou73v0_A10	4434695	4435693	BnaA10T0044900ZY	0	+	65	986	998	0.9879760
zheyou73v0_A10	4470980	4473268	BnaA10T0045000ZY	0	-	957	2288	2288	1.0000000
zheyou73v0_A10	4483823	4486285	BnaA10T0045100ZY	0	+	3972	2462	2462	1.0000000
zheyou73v0_A10	4486393	4486806	BnaA10T0045200ZY	0	+	769	413	413	1.0000000
zheyou73v0_A10	4490354	4492115	BnaA10T0045300ZY	0	-	3426	1761	1761	1.0000000
zheyou73v0_A10	4498744	4500082	BnaA10T0045400ZY	0	+	1131	1307	1338	0.9768311
zheyou73v0_A10	4528512	4531341	BnaA10T0045500ZY	0	+	594	2537	2829	0.8967833
zheyou73v0_A10	4554070	4555030	BnaA10T0045600ZY	0	+	862	960	960	1.0000000
zheyou73v0_A10	4574785	4575482	BnaA10T0045700ZY	0	-	11	358	697	0.5136299
zheyou73v0_A10	4578765	4580307	BnaA10T0045800ZY	0	+	621	1542	1542	1.0000000
zheyou73v0_A10	4613319	4615865	BnaA10T0045900ZY	0	+	1272	2546	2546	1.0000000
zheyou73v0_A10	4629583	4634770	BnaA10T0046000ZY	0	+	2413	5187	5187	1.0000000
zheyou73v0_A10	4637384	4639793	BnaA10T0046100ZY	0	-	1414	2409	2409	1.0000000
zheyou73v0_A10	4663460	4663760	BnaA10T0046200ZY	0	-	2	104	300	0.3466667
zheyou73v0_A10	4673820	4684657	BnaA10T0046300ZY	0	+	3978	10278	10837	0.9484175
zheyou73v0_A10	4684986	4685966	BnaA10T0046400ZY	0	-	645	980	980	1.0000000
zheyou73v0_A10	4685977	4686209	BnaA10T0046500ZY	0	-	221	232	232	1.0000000
zheyou73v0_A10	4707615	4710040	BnaA10T0046600ZY	0	+	23	740	2425	0.3051547
zheyou73v0_A10	4707615	4710040	BnaA10T0046600ZY.1	0	+	23	740	2425	0.3051547
zheyou73v0_A10	4743237	4746324	BnaA10T0046700ZY	0	+	1596	3087	3087	1.0000000
zheyou73v0_A10	4754247	4755310	BnaA10T0046800ZY	0	+	750	1063	1063	1.0000000
zheyou73v0_A10	4768280	4770240	BnaA10T0046900ZY	0	+	1255	1960	1960	1.0000000
zheyou73v0_A10	4776757	4778577	BnaA10T0047000ZY	0	+	881	1820	1820	1.0000000
zheyou73v0_A10	4776757	4778577	BnaA10T0047000ZY.1	0	+	881	1820	1820	1.0000000
zheyou73v0_A10	4778615	4780675	BnaA10T0047100ZY	0	-	280	1304	2060	0.6330097
zheyou73v0_A10	4778615	4780675	BnaA10T0047100ZY.1	0	-	280	1304	2060	0.6330097
zheyou73v0_A10	4782993	4784700	BnaA10T0047200ZY	0	-	656	1707	1707	1.0000000
zheyou73v0_A10	4782993	4784700	BnaA10T0047200ZY.1	0	-	656	1707	1707	1.0000000
zheyou73v0_A10	4797908	4799471	BnaA10T0047300ZY	0	+	49	794	1563	0.5079975
zheyou73v0_A10	4797908	4799471	BnaA10T0047300ZY.1	0	+	49	794	1563	0.5079975
zheyou73v0_A10	4839059	4839656	BnaA10T0047400ZY	0	-	373	597	597	1.0000000
zheyou73v0_A10	4853499	4855628	BnaA10T0047500ZY	0	-	29	452	2129	0.2123062
zheyou73v0_A10	4877432	4877773	BnaA10T0047600ZY	0	-	12	116	341	0.3401760
zheyou73v0_A10	4879354	4882681	BnaA10T0047700ZY	0	-	91	2247	3327	0.6753832
zheyou73v0_A10	4886870	4890466	BnaA10T0047800ZY	0	+	124	2532	3596	0.7041157
zheyou73v0_A10	4892323	4893049	BnaA10T0047900ZY	0	+	83	537	726	0.7396694
zheyou73v0_A10	5001617	5002474	BnaA10T0048000ZY	0	+	0	0	857	0.0000000
zheyou73v0_A10	5042320	5045529	BnaA10T0048100ZY	0	-	44	257	3209	0.0800873
zheyou73v0_A10	5140884	5145423	BnaA10T0048200ZY	0	+	11	225	4539	0.0495704
zheyou73v0_A10	5168081	5191716	BnaA10T0048300ZY	0	+	1011	5311	23635	0.2247091
zheyou73v0_A10	5353587	5353950	BnaA10T0048400ZY	0	-	0	0	363	0.0000000
zheyou73v0_A10	5392345	5393584	BnaA10T0048500ZY	0	+	394	810	1239	0.6537530
zheyou73v0_A10	5410818	5411932	BnaA10T0048600ZY	0	+	255	1114	1114	1.0000000
zheyou73v0_A10	5414526	5415616	BnaA10T0048700ZY	0	-	70	471	1090	0.4321101
zheyou73v0_A10	5418598	5419762	BnaA10T0048800ZY	0	+	44	932	1164	0.8006873
zheyou73v0_A10	5419984	5420647	BnaA10T0048900ZY	0	+	24	236	663	0.3559578
zheyou73v0_A10	5422043	5424102	BnaA10T0049000ZY	0	-	176	1261	2059	0.6124332
zheyou73v0_A10	5437426	5439105	BnaA10T0049100ZY	0	+	68	1055	1679	0.6283502
zheyou73v0_A10	5443138	5445467	BnaA10T0049200ZY	0	-	64	1064	2329	0.4568484
zheyou73v0_A10	5447736	5450229	BnaA10T0049300ZY	0	-	411	1775	2493	0.7119936
zheyou73v0_A10	5447736	5450229	BnaA10T0049300ZY.1	0	-	411	1775	2493	0.7119936
zheyou73v0_A10	5454291	5456068	BnaA10T0049400ZY	0	-	33	801	1777	0.4507597
zheyou73v0_A10	5465207	5467635	BnaA10T0049500ZY	0	+	245	1414	2428	0.5823723
zheyou73v0_A10	5467797	5469861	BnaA10T0049600ZY	0	-	383	1866	2064	0.9040698
zheyou73v0_A10	5475668	5477266	BnaA10T0049700ZY	0	-	96	986	1598	0.6170213
zheyou73v0_A10	5491302	5492706	BnaA10T0049800ZY	0	-	395	1297	1404	0.9237892
zheyou73v0_A10	5502637	5508217	BnaA10T0049900ZY	0	+	917	4677	5580	0.8381720
zheyou73v0_A10	5508546	5509953	BnaA10T0050000ZY	0	-	98	1072	1407	0.7619048
zheyou73v0_A10	5529163	5531807	BnaA10T0050100ZY	0	-	287	1831	2644	0.6925113
zheyou73v0_A10	5561594	5564252	BnaA10T0050200ZY	0	+	62	1104	2658	0.4153499
zheyou73v0_A10	5574043	5577411	BnaA10T0050300ZY	0	-	739	2837	3368	0.8423397
zheyou73v0_A10	5601302	5603177	BnaA10T0050400ZY	0	-	126	976	1875	0.5205333
zheyou73v0_A10	5603942	5604990	BnaA10T0050500ZY	0	-	57	411	1048	0.3921756
zheyou73v0_A10	5603942	5604990	BnaA10T0050500ZY.1	0	-	57	411	1048	0.3921756
zheyou73v0_A10	5608256	5609030	BnaA10T0050600ZY	0	-	191	774	774	1.0000000
zheyou73v0_A10	5609133	5609398	BnaA10T0050700ZY	0	-	69	265	265	1.0000000
zheyou73v0_A10	5610883	5611348	BnaA10T0050800ZY	0	+	310	465	465	1.0000000
zheyou73v0_A10	5655016	5655406	BnaA10T0050900ZY	0	-	0	0	390	0.0000000
zheyou73v0_A10	5684364	5686517	BnaA10T0051000ZY	0	+	24	619	2153	0.2875058
zheyou73v0_A10	5763040	5763668	BnaA10T0051100ZY	0	-	338	628	628	1.0000000
zheyou73v0_A10	5779372	5781734	BnaA10T0051200ZY	0	-	56	856	2362	0.3624047
zheyou73v0_A10	5791411	5791686	BnaA10T0051300ZY	0	-	14	152	275	0.5527273
zheyou73v0_A10	5800152	5800574	BnaA10T0051400ZY	0	+	0	0	422	0.0000000
zheyou73v0_A10	5816701	5817340	BnaA10T0051500ZY	0	-	5	316	639	0.4945227
zheyou73v0_A10	5825731	5826701	BnaA10T0051600ZY	0	-	330	970	970	1.0000000
zheyou73v0_A10	5830693	5833351	BnaA10T0051700ZY	0	+	28	504	2658	0.1896162
zheyou73v0_A10	5842220	5844836	BnaA10T0051800ZY	0	+	106	638	2616	0.2438838
zheyou73v0_A10	5864777	5865282	BnaA10T0051900ZY	0	+	13	390	505	0.7722772
zheyou73v0_A10	5943414	5943804	BnaA10T0052000ZY	0	-	54	390	390	1.0000000
zheyou73v0_A10	5951815	5952463	BnaA10T0052100ZY	0	-	433	648	648	1.0000000
zheyou73v0_A10	5981809	5983641	BnaA10T0052200ZY	0	+	3	38	1832	0.0207424
zheyou73v0_A10	5990262	5993980	BnaA10T0052300ZY	0	+	153	2338	3718	0.6288327
zheyou73v0_A10	5994440	5997758	BnaA10T0052400ZY	0	+	1173	2806	3318	0.8456902
zheyou73v0_A10	5994440	5997758	BnaA10T0052400ZY.1	0	+	1173	2806	3318	0.8456902
zheyou73v0_A10	6000909	6001254	BnaA10T0052500ZY	0	+	0	0	345	0.0000000
zheyou73v0_A10	6012726	6013527	BnaA10T0052600ZY	0	-	0	0	801	0.0000000
zheyou73v0_A10	6074982	6076708	BnaA10T0052700ZY	0	+	769	1726	1726	1.0000000
zheyou73v0_A10	6093246	6095474	BnaA10T0052800ZY	0	+	1233	2228	2228	1.0000000
zheyou73v0_A10	6093390	6095474	BnaA10T0052800ZY.1	0	+	1186	2084	2084	1.0000000
zheyou73v0_A10	6095741	6098526	BnaA10T0052900ZY	0	-	1316	2785	2785	1.0000000
zheyou73v0_A10	6104344	6104626	BnaA10T0053000ZY	0	-	135	282	282	1.0000000
zheyou73v0_A10	6104633	6105354	BnaA10T0053100ZY	0	-	358	721	721	1.0000000
zheyou73v0_A10	6110553	6114967	BnaA10T0053200ZY	0	+	2177	4414	4414	1.0000000
zheyou73v0_A10	6236012	6242190	BnaA10T0053300ZY	0	+	3781	6178	6178	1.0000000
zheyou73v0_A10	6236012	6242190	BnaA10T0053300ZY.1	0	+	3781	6178	6178	1.0000000
zheyou73v0_A10	6236012	6242190	BnaA10T0053300ZY.2	0	+	3781	6178	6178	1.0000000
zheyou73v0_A10	6272372	6277185	BnaA10T0053400ZY	0	-	2085	4671	4813	0.9704966
zheyou73v0_A10	6333539	6335099	BnaA10T0053500ZY	0	-	737	1560	1560	1.0000000
zheyou73v0_A10	6333539	6335099	BnaA10T0053500ZY.1	0	-	737	1560	1560	1.0000000
zheyou73v0_A10	6333539	6335099	BnaA10T0053500ZY.2	0	-	737	1560	1560	1.0000000
zheyou73v0_A10	6333539	6335099	BnaA10T0053500ZY.3	0	-	737	1560	1560	1.0000000
zheyou73v0_A10	6333539	6335099	BnaA10T0053500ZY.4	0	-	737	1560	1560	1.0000000
zheyou73v0_A10	6333539	6335099	BnaA10T0053500ZY.5	0	-	737	1560	1560	1.0000000
zheyou73v0_A10	6343225	6344305	BnaA10T0053600ZY	0	-	372	1080	1080	1.0000000
zheyou73v0_A10	6344509	6345751	BnaA10T0053700ZY	0	+	103	507	1242	0.4082126
zheyou73v0_A10	6360775	6363466	BnaA10T0053800ZY	0	-	10	353	2691	0.1311780
zheyou73v0_A10	6365987	6369576	BnaA10T0053900ZY	0	+	1751	3589	3589	1.0000000
zheyou73v0_A10	6366132	6369576	BnaA10T0053900ZY.1	0	+	1687	3444	3444	1.0000000
zheyou73v0_A10	6371813	6375773	BnaA10T0054000ZY	0	+	2040	3960	3960	1.0000000
zheyou73v0_A10	6371813	6375773	BnaA10T0054000ZY.1	0	+	2040	3960	3960	1.0000000
zheyou73v0_A10	6382345	6386195	BnaA10T0054100ZY	0	-	2193	3850	3850	1.0000000
zheyou73v0_A10	6387265	6387526	BnaA10T0054200ZY	0	-	211	261	261	1.0000000
zheyou73v0_A10	6396780	6398176	BnaA10T0054300ZY	0	-	651	1396	1396	1.0000000
zheyou73v0_A10	6402175	6402942	BnaA10T0054400ZY	0	+	2	231	767	0.3011734
zheyou73v0_A10	6406346	6410596	BnaA10T0054500ZY	0	-	2123	4234	4250	0.9962353
zheyou73v0_A10	6415721	6419427	BnaA10T0054600ZY	0	+	1694	3706	3706	1.0000000
zheyou73v0_A10	6419711	6426097	BnaA10T0054700ZY	0	-	2852	6386	6386	1.0000000
zheyou73v0_A10	6459774	6463605	BnaA10T0054800ZY	0	+	1679	3831	3831	1.0000000
zheyou73v0_A10	6459774	6463605	BnaA10T0054800ZY.1	0	+	1679	3831	3831	1.0000000
zheyou73v0_A10	6459774	6463605	BnaA10T0054800ZY.2	0	+	1679	3831	3831	1.0000000
zheyou73v0_A10	6459774	6463605	BnaA10T0054800ZY.3	0	+	1679	3831	3831	1.0000000
zheyou73v0_A10	6465898	6466279	BnaA10T0054900ZY	0	-	4	271	381	0.7112861
zheyou73v0_A10	6497093	6497258	BnaA10T0055000ZY	0	-	161	165	165	1.0000000
zheyou73v0_A10	6513419	6516275	BnaA10T0055100ZY	0	+	1213	2856	2856	1.0000000
zheyou73v0_A10	6522989	6526875	BnaA10T0055200ZY	0	+	1952	3886	3886	1.0000000
zheyou73v0_A10	6545328	6545967	BnaA10T0055300ZY	0	-	0	0	639	0.0000000
zheyou73v0_A10	6575445	6577224	BnaA10T0055400ZY	0	+	55	1062	1779	0.5969646
zheyou73v0_A10	6581173	6583162	BnaA10T0055500ZY	0	-	6	198	1989	0.0995475
zheyou73v0_A10	6590857	6592110	BnaA10T0055600ZY	0	+	1521	547	1253	0.4365523
zheyou73v0_A10	6656220	6659208	BnaA10T0055700ZY	0	+	188	2455	2988	0.8216198
zheyou73v0_A10	6660629	6664190	BnaA10T0055800ZY	0	+	1572	3561	3561	1.0000000
zheyou73v0_A10	6664553	6665490	BnaA10T0055900ZY	0	-	331	937	937	1.0000000
zheyou73v0_A10	6666026	6666444	BnaA10T0056000ZY	0	+	115	418	418	1.0000000
zheyou73v0_A10	6668214	6668568	BnaA10T0056100ZY	0	+	161	354	354	1.0000000
zheyou73v0_A10	6669061	6669567	BnaA10T0056200ZY	0	-	319	506	506	1.0000000
zheyou73v0_A10	6675120	6677977	BnaA10T0056300ZY	0	-	767	2718	2857	0.9513476
zheyou73v0_A10	7488187	7488727	BnaA10T0056400ZY	0	+	9	385	540	0.7129630
zheyou73v0_A10	7717354	7719154	BnaA10T0056500ZY	0	+	0	0	1800	0.0000000
zheyou73v0_A10	9545957	9547168	BnaA10T0056600ZY	0	-	91	493	1211	0.4071016
zheyou73v0_A10	9547425	9547635	BnaA10T0056700ZY	0	+	0	0	210	0.0000000
zheyou73v0_A10	9547815	9548037	BnaA10T0056800ZY	0	+	0	0	222	0.0000000
zheyou73v0_A10	9560285	9561374	BnaA10T0056900ZY	0	+	0	0	1089	0.0000000
zheyou73v0_A10	9563743	9563953	BnaA10T0057000ZY	0	+	0	0	210	0.0000000
zheyou73v0_A10	9575083	9576018	BnaA10T0057100ZY	0	-	0	0	935	0.0000000
zheyou73v0_A10	9576375	9576804	BnaA10T0057200ZY	0	+	0	0	429	0.0000000
zheyou73v0_A10	9808954	9809595	BnaA10T0057300ZY	0	-	0	0	641	0.0000000
zheyou73v0_A10	9810881	9813172	BnaA10T0057400ZY	0	-	97	364	2291	0.1588826
zheyou73v0_A10	9814423	9816397	BnaA10T0057500ZY	0	-	1149	926	1974	0.4690983
zheyou73v0_A10	9816959	9817868	BnaA10T0057600ZY	0	-	96	373	909	0.4103410
zheyou73v0_A10	9827479	9829541	BnaA10T0057700ZY	0	+	964	2054	2062	0.9961203
zheyou73v0_A10	9831125	9832335	BnaA10T0057800ZY	0	+	647	1001	1210	0.8272727
zheyou73v0_A10	9832480	9832786	BnaA10T0057900ZY	0	+	1	1	306	0.0032680
zheyou73v0_A10	9833703	9834305	BnaA10T0058000ZY	0	+	0	0	602	0.0000000
zheyou73v0_A10	9834348	9834985	BnaA10T0058100ZY	0	+	0	0	637	0.0000000
zheyou73v0_A10	9865538	9866005	BnaA10T0058200ZY	0	-	0	0	467	0.0000000
zheyou73v0_A10	9866159	9867370	BnaA10T0058300ZY	0	-	0	0	1211	0.0000000
zheyou73v0_A10	9867627	9867837	BnaA10T0058400ZY	0	+	0	0	210	0.0000000
zheyou73v0_A10	9872995	9875320	BnaA10T0058500ZY	0	+	50	918	2325	0.3948387
zheyou73v0_A10	9880555	9880837	BnaA10T0058600ZY	0	+	130	282	282	1.0000000
zheyou73v0_A10	9889780	9892105	BnaA10T0058700ZY	0	+	455	1933	2325	0.8313978
zheyou73v0_A10	9893241	9893451	BnaA10T0058800ZY	0	+	108	210	210	1.0000000
zheyou73v0_A10	9897719	9898654	BnaA10T0058900ZY	0	-	9	325	935	0.3475936
zheyou73v0_A10	10064178	10064812	BnaA10T0059000ZY	0	+	0	0	634	0.0000000
zheyou73v0_A10	10851538	10854885	BnaA10T0059100ZY	0	-	0	0	3347	0.0000000
zheyou73v0_A10	10856372	10856888	BnaA10T0059200ZY	0	-	4	239	516	0.4631783
zheyou73v0_A10	10909627	10909840	BnaA10T0059300ZY	0	-	8	55	213	0.2582160
zheyou73v0_A10	10911613	10912000	BnaA10T0059400ZY	0	-	0	0	387	0.0000000
zheyou73v0_A10	10913105	10913626	BnaA10T0059500ZY	0	+	8	211	521	0.4049904
zheyou73v0_A10	10922950	10925957	BnaA10T0059600ZY	0	-	464	1554	3007	0.5167941
zheyou73v0_A10	10928688	10933476	BnaA10T0059700ZY	0	-	452	1896	4788	0.3959900
zheyou73v0_A10	10937403	10939885	BnaA10T0059800ZY	0	-	39	748	2482	0.3013699
zheyou73v0_A10	10940080	10941583	BnaA10T0059900ZY	0	-	29	696	1503	0.4630738
zheyou73v0_A10	10940080	10941583	BnaA10T0059900ZY.1	0	-	29	696	1503	0.4630738
zheyou73v0_A10	10951963	10955056	BnaA10T0060000ZY	0	-	57	939	3093	0.3035887
zheyou73v0_A10	10969930	10981939	BnaA10T0060100ZY	0	-	5061	11604	12009	0.9662753
zheyou73v0_A10	11012392	11016263	BnaA10T0060200ZY	0	-	365	2848	3871	0.7357272
zheyou73v0_A10	11037736	11039926	BnaA10T0060300ZY	0	-	230	1196	2190	0.5461187
zheyou73v0_A10	11049312	11052723	BnaA10T0060400ZY	0	+	106	2060	3411	0.6039284
zheyou73v0_A10	11075709	11076684	BnaA10T0060500ZY	0	-	159	917	975	0.9405128
zheyou73v0_A10	11077071	11078350	BnaA10T0060600ZY	0	-	130	966	1279	0.7552776
zheyou73v0_A10	11084942	11088193	BnaA10T0060700ZY	0	-	1105	3027	3251	0.9310981
zheyou73v0_A10	11091409	11093065	BnaA10T0060800ZY	0	-	255	1621	1656	0.9788647
zheyou73v0_A10	11096316	11096886	BnaA10T0060900ZY	0	-	18	457	570	0.8017544
zheyou73v0_A10	11190488	11194141	BnaA10T0061000ZY	0	-	729	2605	3653	0.7131125
zheyou73v0_A10	11194338	11195211	BnaA10T0061100ZY	0	+	76	823	873	0.9427263
zheyou73v0_A10	11220502	11224143	BnaA10T0061200ZY.1	0	+	281	2805	3641	0.7703928
zheyou73v0_A10	11220538	11224143	BnaA10T0061200ZY	0	+	281	2805	3605	0.7780860
zheyou73v0_A10	11221501	11224143	BnaA10T0061200ZY.2	0	+	232	2093	2642	0.7922029
zheyou73v0_A10	11224838	11225432	BnaA10T0061300ZY	0	-	502	594	594	1.0000000
zheyou73v0_A10	11228782	11230251	BnaA10T0061400ZY	0	+	643	1469	1469	1.0000000
zheyou73v0_A10	11230897	11232841	BnaA10T0061500ZY	0	-	164	1462	1944	0.7520576
zheyou73v0_A10	11239055	11241251	BnaA10T0061600ZY	0	-	164	1217	2196	0.5541894
zheyou73v0_A10	11264137	11265154	BnaA10T0061700ZY	0	+	156	988	1017	0.9714848
zheyou73v0_A10	11305072	11305687	BnaA10T0061800ZY	0	+	25	248	615	0.4032520
zheyou73v0_A10	11311260	11313269	BnaA10T0061900ZY	0	-	1017	1986	2009	0.9885515
zheyou73v0_A10	11311260	11313269	BnaA10T0061900ZY.1	0	-	1017	1986	2009	0.9885515
zheyou73v0_A10	11317880	11319048	BnaA10T0062000ZY	0	+	284	1168	1168	1.0000000
zheyou73v0_A10	11328528	11331534	BnaA10T0062100ZY	0	+	241	2558	3006	0.8509647
zheyou73v0_A10	11329484	11331534	BnaA10T0062100ZY.1	0	+	206	1875	2050	0.9146342
zheyou73v0_A10	11338653	11341448	BnaA10T0062200ZY	0	-	436	2532	2795	0.9059034
zheyou73v0_A10	11345434	11357946	BnaA10T0062300ZY	0	-	2894	10704	12512	0.8554987
zheyou73v0_A10	11359281	11360166	BnaA10T0062400ZY	0	-	36	326	885	0.3683616
zheyou73v0_A10	11361182	11370628	BnaA10T0062500ZY	0	+	849	5805	9446	0.6145458
zheyou73v0_A10	11374767	11375881	BnaA10T0062600ZY	0	+	119	730	1114	0.6552962
zheyou73v0_A10	11376373	11378737	BnaA10T0062700ZY	0	-	1088	1543	2364	0.6527073
zheyou73v0_A10	11392756	11393869	BnaA10T0062800ZY	0	+	346	939	1113	0.8436658
zheyou73v0_A10	11400790	11402885	BnaA10T0062900ZY	0	+	272	1876	2095	0.8954654
zheyou73v0_A10	11409641	11409893	BnaA10T0063000ZY	0	+	155	252	252	1.0000000
zheyou73v0_A10	11413169	11415830	BnaA10T0063100ZY	0	+	203	1573	2661	0.5911312
zheyou73v0_A10	11427583	11430847	BnaA10T0063200ZY	0	+	634	2766	3264	0.8474265
zheyou73v0_A10	11446345	11450032	BnaA10T0063300ZY	0	+	18	736	3687	0.1996203
zheyou73v0_A10	11458925	11460638	BnaA10T0063400ZY	0	-	43	880	1713	0.5137186
zheyou73v0_A10	11484174	11488546	BnaA10T0063500ZY	0	-	837	2327	4372	0.5322507
zheyou73v0_A10	11498042	11500065	BnaA10T0063600ZY	0	+	404	1776	2023	0.8779041
zheyou73v0_A10	11498042	11500065	BnaA10T0063600ZY.1	0	+	404	1776	2023	0.8779041
zheyou73v0_A10	11500417	11501395	BnaA10T0063700ZY	0	+	694	978	978	1.0000000
zheyou73v0_A10	11516862	11518639	BnaA10T0063800ZY	0	+	275	1259	1777	0.7084975
zheyou73v0_A10	11537312	11540292	BnaA10T0063900ZY	0	-	779	2577	2980	0.8647651
zheyou73v0_A10	11537312	11540169	BnaA10T0063900ZY.1	0	-	752	2454	2857	0.8589429
zheyou73v0_A10	11537312	11540292	BnaA10T0063900ZY.2	0	-	779	2577	2980	0.8647651
zheyou73v0_A10	11543685	11549204	BnaA10T0064000ZY	0	-	1225	4341	5519	0.7865555
zheyou73v0_A10	11543685	11549204	BnaA10T0064000ZY.1	0	-	1225	4341	5519	0.7865555
zheyou73v0_A10	11543685	11549204	BnaA10T0064000ZY.2	0	-	1225	4341	5519	0.7865555
zheyou73v0_A10	11543685	11549204	BnaA10T0064000ZY.3	0	-	1225	4341	5519	0.7865555
zheyou73v0_A10	11560963	11562540	BnaA10T0064100ZY	0	+	139	1225	1577	0.7767914
zheyou73v0_A10	11562357	11581743	BnaA10T0064200ZY	0	-	6208	17161	19386	0.8852264
zheyou73v0_A10	11588548	11588922	BnaA10T0064300ZY	0	+	56	292	374	0.7807487
zheyou73v0_A10	11589325	11591392	BnaA10T0064400ZY	0	+	477	2006	2067	0.9704886
zheyou73v0_A10	11589325	11591392	BnaA10T0064400ZY.1	0	+	477	2006	2067	0.9704886
zheyou73v0_A10	11591289	11592047	BnaA10T0064500ZY	0	-	280	758	758	1.0000000
zheyou73v0_A10	11592063	11593292	BnaA10T0064600ZY	0	-	331	1203	1229	0.9788446
zheyou73v0_A10	11596329	11596992	BnaA10T0064700ZY	0	-	139	449	663	0.6772248
zheyou73v0_A10	11600152	11601096	BnaA10T0064800ZY	0	-	286	652	944	0.6906779
zheyou73v0_A10	11619166	11621100	BnaA10T0064900ZY	0	-	264	1671	1934	0.8640124
zheyou73v0_A10	11622707	11622902	BnaA10T0065000ZY	0	-	29	140	195	0.7179487
zheyou73v0_A10	11634253	11634913	BnaA10T0065100ZY	0	+	26	550	660	0.8333333
zheyou73v0_A10	11639197	11639489	BnaA10T0065200ZY	0	+	40	290	292	0.9931507
zheyou73v0_A10	11655369	11658350	BnaA10T0065300ZY	0	+	246	2202	2981	0.7386783
zheyou73v0_A10	11658403	11659886	BnaA10T0065400ZY	0	-	107	949	1483	0.6399191
zheyou73v0_A10	11669164	11672035	BnaA10T0065500ZY	0	-	1370	2871	2871	1.0000000
zheyou73v0_A10	11679972	11681201	BnaA10T0065600ZY	0	-	79	894	1229	0.7274207
zheyou73v0_A10	11681750	11683191	BnaA10T0065700ZY	0	+	140	773	1441	0.5364330
zheyou73v0_A10	11683208	11684023	BnaA10T0065800ZY	0	-	81	815	815	1.0000000
zheyou73v0_A10	11684428	11686712	BnaA10T0065900ZY	0	-	433	2133	2284	0.9338879
zheyou73v0_A10	11707221	11708244	BnaA10T0066000ZY	0	+	20	392	1023	0.3831867
zheyou73v0_A10	11715520	11716009	BnaA10T0066100ZY	0	-	77	425	489	0.8691207
zheyou73v0_A10	11730576	11731694	BnaA10T0066200ZY	0	-	63	436	1118	0.3899821
zheyou73v0_A10	11730576	11731576	BnaA10T0066200ZY.1	0	-	55	318	1000	0.3180000
zheyou73v0_A10	11744648	11750318	BnaA10T0066300ZY	0	+	683	2601	5670	0.4587302
zheyou73v0_A10	11750610	11752127	BnaA10T0066400ZY	0	-	439	1418	1517	0.9347396
zheyou73v0_A10	11763860	11764776	BnaA10T0066500ZY	0	+	73	546	916	0.5960699
zheyou73v0_A10	11764926	11766961	BnaA10T0066600ZY	0	-	96	1116	2035	0.5484030
zheyou73v0_A10	11775010	11778319	BnaA10T0066700ZY	0	-	294	2381	3309	0.7195528
zheyou73v0_A10	11782114	11782339	BnaA10T0066800ZY	0	+	39	225	225	1.0000000
zheyou73v0_A10	11806379	11807792	BnaA10T0066900ZY	0	+	315	1383	1413	0.9787686
zheyou73v0_A10	11826631	11828742	BnaA10T0067000ZY	0	+	148	1253	2111	0.5935575
zheyou73v0_A10	11844496	11848261	BnaA10T0067100ZY	0	+	89	1357	3765	0.3604250
zheyou73v0_A10	11852956	11854037	BnaA10T0067200ZY	0	-	4	206	1081	0.1905643
zheyou73v0_A10	11856564	11858831	BnaA10T0067300ZY	0	-	142	1869	2267	0.8244376
zheyou73v0_A10	11856564	11858831	BnaA10T0067300ZY.1	0	-	142	1869	2267	0.8244376
zheyou73v0_A10	11868406	11870488	BnaA10T0067400ZY	0	-	49	851	2082	0.4087416
zheyou73v0_A10	11880155	11883056	BnaA10T0067500ZY	0	-	352	2465	2901	0.8497070
zheyou73v0_A10	11887034	11889422	BnaA10T0067600ZY	0	-	743	2165	2388	0.9066164
zheyou73v0_A10	11891064	11891913	BnaA10T0067700ZY	0	+	143	802	849	0.9446408
zheyou73v0_A10	11894251	11895669	BnaA10T0067800ZY	0	+	136	723	1418	0.5098730
zheyou73v0_A10	11902036	11904149	BnaA10T0067900ZY	0	+	741	2053	2113	0.9716043
zheyou73v0_A10	11907812	11908656	BnaA10T0068000ZY	0	+	447	844	844	1.0000000
zheyou73v0_A10	11919497	11924632	BnaA10T0068100ZY	0	+	1196	1841	5135	0.3585200
zheyou73v0_A10	11931090	11932577	BnaA10T0068200ZY	0	+	3	54	1487	0.0363147
zheyou73v0_A10	11931090	11932577	BnaA10T0068200ZY.1	0	+	3	54	1487	0.0363147
zheyou73v0_A10	11931090	11932577	BnaA10T0068200ZY.2	0	+	3	54	1487	0.0363147
zheyou73v0_A10	11952963	11954026	BnaA10T0068300ZY	0	+	261	979	1063	0.9209784
zheyou73v0_A10	11955178	11956320	BnaA10T0068400ZY	0	-	295	1141	1142	0.9991243
zheyou73v0_A10	11961683	11962005	BnaA10T0068500ZY	0	+	75	308	322	0.9565217
zheyou73v0_A10	11966697	11968531	BnaA10T0068600ZY	0	-	65	1186	1834	0.6466739
zheyou73v0_A10	11984315	11984830	BnaA10T0068700ZY	0	+	9	299	515	0.5805825
zheyou73v0_A10	12007396	12009938	BnaA10T0068800ZY	0	-	4	238	2542	0.0936271
zheyou73v0_A10	12019660	12021071	BnaA10T0068900ZY	0	+	0	0	1411	0.0000000
zheyou73v0_A10	12023187	12024209	BnaA10T0069000ZY	0	+	0	0	1022	0.0000000
zheyou73v0_A10	12041435	12045865	BnaA10T0069100ZY	0	+	547	2806	4430	0.6334086
zheyou73v0_A10	12041435	12045865	BnaA10T0069100ZY.1	0	+	547	2806	4430	0.6334086
zheyou73v0_A10	12041435	12042514	BnaA10T0069100ZY.2	0	+	166	606	1079	0.5616311
zheyou73v0_A10	12046204	12046604	BnaA10T0069200ZY	0	-	68	380	400	0.9500000
zheyou73v0_A10	12047666	12048167	BnaA10T0069300ZY	0	-	410	501	501	1.0000000
zheyou73v0_A10	12050266	12052535	BnaA10T0069400ZY	0	-	905	2098	2269	0.9246364
zheyou73v0_A10	12067737	12068754	BnaA10T0069500ZY	0	+	38	656	1017	0.6450344
zheyou73v0_A10	12075004	12076138	BnaA10T0069600ZY	0	-	118	733	1134	0.6463845
zheyou73v0_A10	12077714	12078503	BnaA10T0069700ZY	0	-	0	0	789	0.0000000
zheyou73v0_A10	12080400	12082359	BnaA10T0069800ZY	0	-	153	1836	1959	0.9372129
zheyou73v0_A10	12082967	12084320	BnaA10T0069900ZY	0	+	0	0	1353	0.0000000
zheyou73v0_A10	12082967	12084320	BnaA10T0069900ZY.1	0	+	0	0	1353	0.0000000
zheyou73v0_A10	12088188	12089743	BnaA10T0070000ZY	0	+	108	1273	1555	0.8186495
zheyou73v0_A10	12092055	12094998	BnaA10T0070100ZY	0	+	692	2828	2943	0.9609242
zheyou73v0_A10	12099676	12101923	BnaA10T0070200ZY	0	-	746	2034	2247	0.9052069
zheyou73v0_A10	12103005	12105471	BnaA10T0070300ZY	0	-	357	2343	2466	0.9501216
zheyou73v0_A10	12103005	12105471	BnaA10T0070300ZY.1	0	-	357	2343	2466	0.9501216
zheyou73v0_A10	12126295	12129803	BnaA10T0070400ZY	0	+	1044	2807	3508	0.8001710
zheyou73v0_A10	12130642	12131745	BnaA10T0070500ZY	0	+	314	948	1103	0.8594742
zheyou73v0_A10	12152594	12155121	BnaA10T0070600ZY	0	+	470	2191	2527	0.8670360
zheyou73v0_A10	12156083	12158403	BnaA10T0070700ZY	0	-	428	1809	2320	0.7797414
zheyou73v0_A10	12163497	12165864	BnaA10T0070800ZY	0	+	364	2226	2367	0.9404309
zheyou73v0_A10	12166492	12168604	BnaA10T0070900ZY	0	-	165	1988	2112	0.9412879
zheyou73v0_A10	12172584	12173985	BnaA10T0071000ZY	0	-	172	1373	1401	0.9800143
zheyou73v0_A10	12172584	12174054	BnaA10T0071000ZY.1	0	-	203	1442	1470	0.9809524
zheyou73v0_A10	12175225	12178469	BnaA10T0071100ZY	0	-	242	1782	3244	0.5493218
zheyou73v0_A10	12191781	12193977	BnaA10T0071200ZY	0	-	103	1625	2196	0.7399818
zheyou73v0_A10	12196658	12198509	BnaA10T0071300ZY	0	+	690	1648	1851	0.8903295
zheyou73v0_A10	12203342	12210504	BnaA10T0071400ZY	0	-	248	2145	7162	0.2994973
zheyou73v0_A10	12203342	12209276	BnaA10T0071400ZY.1	0	-	190	1533	5934	0.2583418
zheyou73v0_A10	12213337	12213805	BnaA10T0071500ZY	0	-	223	468	468	1.0000000
zheyou73v0_A10	12215456	12215987	BnaA10T0071600ZY	0	+	43	418	531	0.7871940
zheyou73v0_A10	12222787	12224490	BnaA10T0071700ZY	0	-	23	519	1703	0.3047563
zheyou73v0_A10	12222787	12224490	BnaA10T0071700ZY.1	0	-	23	519	1703	0.3047563
zheyou73v0_A10	12234165	12236164	BnaA10T0071800ZY	0	-	333	1622	1999	0.8114057
zheyou73v0_A10	12239086	12239553	BnaA10T0071900ZY	0	+	248	467	467	1.0000000
zheyou73v0_A10	12250746	12250962	BnaA10T0072000ZY	0	-	4	149	216	0.6898148
zheyou73v0_A10	12251239	12253489	BnaA10T0072100ZY	0	+	179	1515	2250	0.6733333
zheyou73v0_A10	12256034	12259714	BnaA10T0072200ZY	0	-	670	3433	3680	0.9328805
zheyou73v0_A10	12292626	12294361	BnaA10T0072300ZY	0	-	498	1499	1735	0.8639770
zheyou73v0_A10	12296760	12299638	BnaA10T0072400ZY	0	-	528	1684	2878	0.5851285
zheyou73v0_A10	12296760	12299638	BnaA10T0072400ZY.1	0	-	528	1684	2878	0.5851285
zheyou73v0_A10	12320798	12322884	BnaA10T0072500ZY	0	+	631	1647	2086	0.7895494
zheyou73v0_A10	12325379	12327741	BnaA10T0072600ZY	0	-	615	2022	2362	0.8560542
zheyou73v0_A10	12333129	12335034	BnaA10T0072700ZY	0	-	248	1534	1905	0.8052493
zheyou73v0_A10	12335652	12337070	BnaA10T0072800ZY	0	+	134	1020	1418	0.7193230
zheyou73v0_A10	12337284	12339396	BnaA10T0072900ZY	0	+	288	1300	2112	0.6155303
zheyou73v0_A10	12339901	12341149	BnaA10T0073000ZY	0	+	209	1010	1248	0.8092949
zheyou73v0_A10	12347046	12355700	BnaA10T0073100ZY	0	+	56	906	8654	0.1046915
zheyou73v0_A10	12363472	12364514	BnaA10T0073200ZY	0	+	174	957	1042	0.9184261
zheyou73v0_A10	12365670	12369132	BnaA10T0073300ZY	0	+	106	1304	3462	0.3766609
zheyou73v0_A10	12370735	12375223	BnaA10T0073400ZY	0	-	1082	3469	4488	0.7729501
zheyou73v0_A10	12370735	12375106	BnaA10T0073400ZY.1	0	-	1003	3352	4371	0.7668726
zheyou73v0_A10	12370735	12375106	BnaA10T0073400ZY.2	0	-	1003	3352	4371	0.7668726
zheyou73v0_A10	12392216	12394371	BnaA10T0073500ZY	0	+	544	2074	2155	0.9624130
zheyou73v0_A10	12494219	12496344	BnaA10T0073600ZY	0	-	1213	2125	2125	1.0000000
zheyou73v0_A10	12511529	12514348	BnaA10T0073700ZY	0	-	256	2105	2819	0.7467187
zheyou73v0_A10	12534553	12536471	BnaA10T0073800ZY	0	+	135	970	1918	0.5057352
zheyou73v0_A10	12538463	12540569	BnaA10T0073900ZY	0	+	653	2004	2106	0.9515669
zheyou73v0_A10	12541273	12542759	BnaA10T0074000ZY	0	-	669	1486	1486	1.0000000
zheyou73v0_A10	12546991	12549017	BnaA10T0074100ZY	0	-	548	1963	2026	0.9689043
zheyou73v0_A10	12570189	12574294	BnaA10T0074200ZY.1	0	+	961	3360	4105	0.8185140
zheyou73v0_A10	12573487	12574294	BnaA10T0074200ZY	0	+	5	126	807	0.1561338
zheyou73v0_A10	12581811	12582669	BnaA10T0074300ZY	0	+	4	100	858	0.1165501
zheyou73v0_A10	12600637	12603668	BnaA10T0074400ZY	0	-	87	880	3031	0.2903332
zheyou73v0_A10	12614724	12616307	BnaA10T0074500ZY	0	+	275	1501	1583	0.9481996
zheyou73v0_A10	12614724	12616333	BnaA10T0074500ZY.1	0	+	281	1527	1609	0.9490367
zheyou73v0_A10	12646358	12649864	BnaA10T0074600ZY	0	+	286	2246	3506	0.6406161
zheyou73v0_A10	12653189	12655515	BnaA10T0074700ZY	0	+	796	2157	2326	0.9273431
zheyou73v0_A10	12654769	12657454	BnaA10T0074800ZY	0	-	215	1206	2685	0.4491620
zheyou73v0_A10	12666149	12666770	BnaA10T0074900ZY	0	+	15	79	621	0.1272142
zheyou73v0_A10	12687219	12688349	BnaA10T0075000ZY	0	-	79	680	1130	0.6017699
zheyou73v0_A10	12696624	12698712	BnaA10T0075100ZY	0	-	318	1742	2088	0.8342912
zheyou73v0_A10	12705054	12705492	BnaA10T0075200ZY	0	+	2	46	438	0.1050228
zheyou73v0_A10	12722171	12724538	BnaA10T0075300ZY	0	-	444	2162	2367	0.9133925
zheyou73v0_A10	12733383	12733756	BnaA10T0075400ZY	0	+	165	373	373	1.0000000
zheyou73v0_A10	12735765	12740643	BnaA10T0075500ZY	0	-	699	3999	4878	0.8198032
zheyou73v0_A10	12735765	12740643	BnaA10T0075500ZY.1	0	-	699	3999	4878	0.8198032
zheyou73v0_A10	12735765	12740643	BnaA10T0075500ZY.2	0	-	699	3999	4878	0.8198032
zheyou73v0_A10	12743960	12744188	BnaA10T0075600ZY	0	+	0	0	228	0.0000000
zheyou73v0_A10	12771738	12772675	BnaA10T0075700ZY	0	-	302	904	937	0.9647812
zheyou73v0_A10	12805107	12805860	BnaA10T0075800ZY	0	-	50	406	753	0.5391766
zheyou73v0_A10	12815192	12815854	BnaA10T0075900ZY	0	+	470	662	662	1.0000000
zheyou73v0_A10	12828461	12833375	BnaA10T0076000ZY	0	-	29	1019	4914	0.2073667
zheyou73v0_A10	12828461	12833375	BnaA10T0076000ZY.1	0	-	29	1019	4914	0.2073667
zheyou73v0_A10	12838504	12839521	BnaA10T0076100ZY	0	+	50	768	1017	0.7551622
zheyou73v0_A10	12839602	12839815	BnaA10T0076200ZY	0	+	0	0	213	0.0000000
zheyou73v0_A10	12840076	12841327	BnaA10T0076300ZY	0	+	162	1095	1251	0.8752998
zheyou73v0_A10	12841717	12842930	BnaA10T0076400ZY	0	-	197	1050	1213	0.8656224
zheyou73v0_A10	12843330	12844131	BnaA10T0076500ZY	0	+	154	792	801	0.9887640
zheyou73v0_A10	12844515	12846924	BnaA10T0076600ZY	0	-	567	2219	2409	0.9211291
zheyou73v0_A10	12844515	12846924	BnaA10T0076600ZY.1	0	-	567	2219	2409	0.9211291
zheyou73v0_A10	12848492	12851235	BnaA10T0076700ZY.1	0	+	118	1301	2743	0.4742982
zheyou73v0_A10	12848492	12851235	BnaA10T0076700ZY.2	0	+	118	1301	2743	0.4742982
zheyou73v0_A10	12848823	12851459	BnaA10T0076700ZY	0	+	77	1159	2636	0.4396813
zheyou73v0_A10	12856757	12857972	BnaA10T0076800ZY	0	+	6	254	1215	0.2090535
zheyou73v0_A10	12860520	12861435	BnaA10T0076900ZY	0	-	141	674	915	0.7366120
zheyou73v0_A10	12874411	12874798	BnaA10T0077000ZY	0	-	6	133	387	0.3436693
zheyou73v0_A10	12885723	12888581	BnaA10T0077100ZY	0	+	157	2152	2858	0.7529741
zheyou73v0_A10	12890530	12891703	BnaA10T0077200ZY.1	0	+	81	645	1173	0.5498721
zheyou73v0_A10	12890540	12891703	BnaA10T0077200ZY	0	+	77	635	1163	0.5460017
zheyou73v0_A10	12895517	12902671	BnaA10T0077300ZY	0	+	279	4507	7154	0.6299972
zheyou73v0_A10	12911545	12918128	BnaA10T0077400ZY	0	+	1620	4269	6583	0.6484885
zheyou73v0_A10	12924366	12927838	BnaA10T0077500ZY	0	+	591	1962	3472	0.5650921
zheyou73v0_A10	12926900	12930176	BnaA10T0077600ZY	0	-	2287	3012	3276	0.9194139
zheyou73v0_A10	12933309	12934772	BnaA10T0077700ZY	0	+	541	1463	1463	1.0000000
zheyou73v0_A10	12945850	12949204	BnaA10T0077800ZY	0	+	483	1708	3354	0.5092427
zheyou73v0_A10	12945973	12949204	BnaA10T0077800ZY.1	0	+	437	1585	3231	0.4905602
zheyou73v0_A10	12954363	12957169	BnaA10T0077900ZY	0	+	1355	2806	2806	1.0000000
zheyou73v0_A10	12962871	12963835	BnaA10T0078000ZY	0	+	235	963	964	0.9989626
zheyou73v0_A10	12964736	12969304	BnaA10T0078100ZY	0	-	1470	4254	4568	0.9312609
zheyou73v0_A10	12964736	12969304	BnaA10T0078100ZY.1	0	-	1470	4254	4568	0.9312609
zheyou73v0_A10	12969814	12972102	BnaA10T0078200ZY	0	-	663	2271	2288	0.9925699
zheyou73v0_A10	12973703	12975279	BnaA10T0078300ZY	0	-	69	1028	1576	0.6522843
zheyou73v0_A10	12994816	12996006	BnaA10T0078400ZY	0	+	38	438	1190	0.3680672
zheyou73v0_A10	12994816	12996006	BnaA10T0078400ZY.1	0	+	38	438	1190	0.3680672
zheyou73v0_A10	13004159	13004739	BnaA10T0078500ZY	0	+	295	580	580	1.0000000
zheyou73v0_A10	13010691	13011077	BnaA10T0078600ZY	0	-	157	386	386	1.0000000
zheyou73v0_A10	13011899	13014363	BnaA10T0078700ZY	0	-	186	1902	2464	0.7719156
zheyou73v0_A10	13061426	13062384	BnaA10T0078800ZY	0	-	220	938	958	0.9791232
zheyou73v0_A10	13078643	13079562	BnaA10T0078900ZY	0	+	35	268	919	0.2916213
zheyou73v0_A10	13082824	13085683	BnaA10T0079000ZY	0	+	288	2371	2859	0.8293110
zheyou73v0_A10	13090376	13092356	BnaA10T0079100ZY	0	+	295	1769	1980	0.8934343
zheyou73v0_A10	13103630	13104836	BnaA10T0079200ZY	0	-	24	599	1206	0.4966832
zheyou73v0_A10	13137802	13139388	BnaA10T0079300ZY	0	-	431	1425	1586	0.8984867
zheyou73v0_A10	13146580	13147812	BnaA10T0079400ZY	0	+	431	1232	1232	1.0000000
zheyou73v0_A10	13148341	13150460	BnaA10T0079500ZY	0	-	686	2037	2119	0.9613025
zheyou73v0_A10	13152893	13153196	BnaA10T0079600ZY	0	+	0	0	303	0.0000000
zheyou73v0_A10	13157591	13161466	BnaA10T0079700ZY	0	+	906	3739	3875	0.9649032
zheyou73v0_A10	13161558	13163737	BnaA10T0079800ZY	0	-	83	1410	2179	0.6470858
zheyou73v0_A10	13193696	13204960	BnaA10T0079900ZY	0	+	3878	9936	11264	0.8821023
zheyou73v0_A10	13212259	13214102	BnaA10T0080000ZY	0	+	354	1771	1843	0.9609333
zheyou73v0_A10	13259009	13260969	BnaA10T0080100ZY.1	0	+	197	1631	1960	0.8321428
zheyou73v0_A10	13259444	13260969	BnaA10T0080100ZY	0	+	178	1196	1525	0.7842623
zheyou73v0_A10	13259444	13260969	BnaA10T0080100ZY.2	0	+	178	1196	1525	0.7842623
zheyou73v0_A10	13264932	13270909	BnaA10T0080200ZY	0	+	692	4345	5977	0.7269533
zheyou73v0_A10	13264932	13270909	BnaA10T0080200ZY.1	0	+	692	4345	5977	0.7269533
zheyou73v0_A10	13271835	13275327	BnaA10T0080300ZY	0	+	819	3144	3492	0.9003437
zheyou73v0_A10	13275862	13279792	BnaA10T0080400ZY	0	+	227	1058	3930	0.2692112
zheyou73v0_A10	13291917	13292650	BnaA10T0080500ZY	0	+	16	482	733	0.6575716
zheyou73v0_A10	13293920	13295327	BnaA10T0080600ZY	0	-	327	1357	1407	0.9644634
zheyou73v0_A10	13294396	13295327	BnaA10T0080600ZY.1	0	-	217	898	931	0.9645543
zheyou73v0_A10	13296165	13299064	BnaA10T0080700ZY	0	-	73	1184	2899	0.4084167
zheyou73v0_A10	13326118	13329362	BnaA10T0080800ZY	0	+	21	850	3244	0.2620222
zheyou73v0_A10	13331399	13336973	BnaA10T0080900ZY	0	-	660	3717	5574	0.6668461
zheyou73v0_A10	13365509	13366005	BnaA10T0081000ZY	0	+	14	277	496	0.5584677
zheyou73v0_A10	13366103	13371973	BnaA10T0081100ZY	0	+	1307	4413	5870	0.7517887
zheyou73v0_A10	13372001	13374352	BnaA10T0081200ZY	0	-	467	1899	2351	0.8077414
zheyou73v0_A10	13376547	13378345	BnaA10T0081300ZY	0	-	227	1318	1798	0.7330367
zheyou73v0_A10	13377018	13378345	BnaA10T0081300ZY.1	0	-	205	1098	1327	0.8274303
zheyou73v0_A10	13378489	13379331	BnaA10T0081400ZY	0	+	97	772	842	0.9168646
zheyou73v0_A10	13390307	13391017	BnaA10T0081500ZY	0	-	544	710	710	1.0000000
zheyou73v0_A10	13427047	13427212	BnaA10T0081600ZY	0	+	0	0	165	0.0000000
zheyou73v0_A10	13429058	13429666	BnaA10T0081700ZY	0	+	227	438	608	0.7203947
zheyou73v0_A10	13442491	13443695	BnaA10T0081800ZY	0	+	765	1173	1204	0.9742525
zheyou73v0_A10	13444895	13453128	BnaA10T0081900ZY	0	+	296	3421	8233	0.4155229
zheyou73v0_A10	13453344	13453500	BnaA10T0082000ZY	0	+	21	156	156	1.0000000
zheyou73v0_A10	13454562	13456061	BnaA10T0082100ZY	0	+	28	590	1499	0.3935957
zheyou73v0_A10	13459094	13461611	BnaA10T0082200ZY	0	+	752	2168	2517	0.8613428
zheyou73v0_A10	13461695	13462004	BnaA10T0082300ZY	0	+	11	248	309	0.8025890
zheyou73v0_A10	13475435	13476072	BnaA10T0082400ZY	0	-	237	637	637	1.0000000
zheyou73v0_A10	13482258	13485251	BnaA10T0082500ZY	0	-	696	2608	2993	0.8713665
zheyou73v0_A10	13490904	13491350	BnaA10T0082600ZY	0	-	119	431	446	0.9663677
zheyou73v0_A10	13492597	13493617	BnaA10T0082700ZY	0	-	31	290	1020	0.2843137
zheyou73v0_A10	13509913	13513699	BnaA10T0082800ZY	0	+	249	2271	3786	0.5998415
zheyou73v0_A10	13513958	13514386	BnaA10T0082900ZY	0	+	5	24	428	0.0560748
zheyou73v0_A10	13521795	13522972	BnaA10T0083000ZY	0	+	680	1177	1177	1.0000000
zheyou73v0_A10	13524614	13527612	BnaA10T0083100ZY	0	+	319	2116	2998	0.7058039
zheyou73v0_A10	13524614	13527612	BnaA10T0083100ZY.1	0	+	319	2116	2998	0.7058039
zheyou73v0_A10	13527941	13530865	BnaA10T0083200ZY	0	+	1231	2919	2924	0.9982900
zheyou73v0_A10	13542453	13543126	BnaA10T0083300ZY	0	+	41	363	673	0.5393759
zheyou73v0_A10	13554544	13555612	BnaA10T0083400ZY	0	+	7	256	1068	0.2397004
zheyou73v0_A10	13559346	13561040	BnaA10T0083500ZY	0	+	236	1556	1694	0.9185360
zheyou73v0_A10	13567804	13571752	BnaA10T0083600ZY	0	-	904	3917	3948	0.9921479
zheyou73v0_A10	13567804	13571752	BnaA10T0083600ZY.1	0	-	904	3917	3948	0.9921479
zheyou73v0_A10	13576747	13579895	BnaA10T0083700ZY	0	+	882	3082	3148	0.9790343
zheyou73v0_A10	13577278	13579895	BnaA10T0083700ZY.1	0	+	771	2563	2617	0.9793657
zheyou73v0_A10	13610247	13613418	BnaA10T0083800ZY	0	+	154	2237	3171	0.7054557
zheyou73v0_A10	13613459	13614186	BnaA10T0083900ZY	0	-	25	529	727	0.7276478
zheyou73v0_A10	13634609	13636247	BnaA10T0084000ZY	0	-	58	649	1638	0.3962149
zheyou73v0_A10	13634609	13636247	BnaA10T0084000ZY.1	0	-	58	649	1638	0.3962149
zheyou73v0_A10	13641705	13643443	BnaA10T0084100ZY	0	-	13	476	1738	0.2738780
zheyou73v0_A10	13671997	13673404	BnaA10T0084200ZY	0	-	60	771	1407	0.5479744
zheyou73v0_A10	13680579	13682163	BnaA10T0084300ZY	0	-	53	464	1584	0.2929293
zheyou73v0_A10	13683721	13684465	BnaA10T0084400ZY	0	-	63	406	744	0.5456989
zheyou73v0_A10	13684790	13687406	BnaA10T0084500ZY	0	-	511	2446	2616	0.9350153
zheyou73v0_A10	13692511	13694013	BnaA10T0084600ZY	0	+	319	1340	1502	0.8921438
zheyou73v0_A10	13705387	13707882	BnaA10T0084700ZY	0	+	94	1332	2495	0.5338677
zheyou73v0_A10	13712130	13713803	BnaA10T0084800ZY	0	+	39	757	1673	0.4524806
zheyou73v0_A10	13715342	13716788	BnaA10T0084900ZY	0	+	159	1368	1446	0.9460581
zheyou73v0_A10	13723028	13724559	BnaA10T0085000ZY	0	-	116	812	1531	0.5303723
zheyou73v0_A10	13734607	13734974	BnaA10T0085100ZY	0	+	82	367	367	1.0000000
zheyou73v0_A10	13754209	13760244	BnaA10T0085200ZY	0	+	1932	5362	6035	0.8884838
zheyou73v0_A10	13760675	13761277	BnaA10T0085300ZY	0	-	110	424	602	0.7043189
zheyou73v0_A10	13778268	13781541	BnaA10T0085400ZY	0	+	657	2728	3273	0.8334861
zheyou73v0_A10	13782915	13785357	BnaA10T0085500ZY	0	-	414	1739	2442	0.7121212
zheyou73v0_A10	13786999	13788889	BnaA10T0085600ZY	0	+	12	271	1890	0.1433862
zheyou73v0_A10	13790436	13792262	BnaA10T0085700ZY	0	-	182	1347	1826	0.7376780
zheyou73v0_A10	13792981	13796298	BnaA10T0085800ZY	0	-	255	1829	3317	0.5514019
zheyou73v0_A10	13805135	13806513	BnaA10T0085900ZY	0	-	164	904	1378	0.6560232
zheyou73v0_A10	13807021	13813632	BnaA10T0086000ZY	0	-	1461	4553	6611	0.6887007
zheyou73v0_A10	13809361	13813632	BnaA10T0086000ZY.1	0	-	527	2478	4271	0.5801920
zheyou73v0_A10	13825450	13826499	BnaA10T0086100ZY	0	+	2	151	1049	0.1439466
zheyou73v0_A10	13827429	13827796	BnaA10T0086200ZY	0	+	0	0	367	0.0000000
zheyou73v0_A10	13831842	13833918	BnaA10T0086300ZY	0	+	1	87	2076	0.0419075
zheyou73v0_A10	13831842	13833918	BnaA10T0086300ZY.1	0	+	1	87	2076	0.0419075
zheyou73v0_A10	13831842	13833918	BnaA10T0086300ZY.2	0	+	1	87	2076	0.0419075
zheyou73v0_A10	13831842	13833918	BnaA10T0086300ZY.3	0	+	1	87	2076	0.0419075
zheyou73v0_A10	13831842	13833918	BnaA10T0086300ZY.4	0	+	1	87	2076	0.0419075
zheyou73v0_A10	13831842	13833918	BnaA10T0086300ZY.5	0	+	1	87	2076	0.0419075
zheyou73v0_A10	13842885	13847483	BnaA10T0086400ZY	0	+	487	2897	4598	0.6300566
zheyou73v0_A10	13850106	13851213	BnaA10T0086500ZY	0	+	25	298	1107	0.2691960
zheyou73v0_A10	13851284	13857005	BnaA10T0086600ZY	0	-	856	3638	5721	0.6359028
zheyou73v0_A10	13887391	13888058	BnaA10T0086700ZY	0	-	157	667	667	1.0000000
zheyou73v0_A10	13892034	13892930	BnaA10T0086800ZY	0	-	392	896	896	1.0000000
zheyou73v0_A10	13898951	13899975	BnaA10T0086900ZY	0	+	310	1024	1024	1.0000000
zheyou73v0_A10	13903258	13906422	BnaA10T0087000ZY	0	-	110	1360	3164	0.4298356
zheyou73v0_A10	13920114	13921095	BnaA10T0087100ZY	0	-	95	846	981	0.8623853
zheyou73v0_A10	13921792	13924521	BnaA10T0087200ZY	0	-	302	2188	2729	0.8017589
zheyou73v0_A10	13927945	13929909	BnaA10T0087300ZY	0	+	335	1386	1964	0.7057027
zheyou73v0_A10	13930881	13937790	BnaA10T0087400ZY	0	-	1470	4202	6909	0.6081922
zheyou73v0_A10	13955269	13955869	BnaA10T0087500ZY	0	-	315	600	600	1.0000000
zheyou73v0_A10	13962400	13964575	BnaA10T0087600ZY	0	+	66	1206	2175	0.5544828
zheyou73v0_A10	13987054	13987884	BnaA10T0087700ZY	0	-	428	741	830	0.8927711
zheyou73v0_A10	13997841	13999540	BnaA10T0087800ZY	0	+	176	1087	1699	0.6397881
zheyou73v0_A10	14001478	14003198	BnaA10T0087900ZY	0	+	274	1533	1720	0.8912790
zheyou73v0_A10	14003532	14006026	BnaA10T0088000ZY	0	-	473	2353	2494	0.9434643
zheyou73v0_A10	14010534	14018229	BnaA10T0088100ZY	0	-	1421	5761	7695	0.7486680
zheyou73v0_A10	14020395	14024350	BnaA10T0088200ZY	0	-	1287	3365	3955	0.8508217
zheyou73v0_A10	14024912	14026882	BnaA10T0088300ZY	0	-	315	1589	1970	0.8065990
zheyou73v0_A10	14036091	14037405	BnaA10T0088400ZY	0	-	175	884	1314	0.6727549
zheyou73v0_A10	14036091	14037405	BnaA10T0088400ZY.1	0	-	175	884	1314	0.6727549
zheyou73v0_A10	14039407	14041002	BnaA10T0088500ZY	0	-	679	1595	1595	1.0000000
zheyou73v0_A10	14041385	14041691	BnaA10T0088600ZY	0	+	9	233	306	0.7614379
zheyou73v0_A10	14046007	14046304	BnaA10T0088700ZY	0	+	16	108	297	0.3636364
zheyou73v0_A10	14050763	14052883	BnaA10T0088800ZY	0	-	205	1140	2120	0.5377358
zheyou73v0_A10	14060480	14061107	BnaA10T0088900ZY	0	+	125	561	627	0.8947368
zheyou73v0_A10	14061626	14064677	BnaA10T0089000ZY	0	-	553	1895	3051	0.6211078
zheyou73v0_A10	14078998	14085616	BnaA10T0089100ZY	0	+	2470	6606	6618	0.9981868
zheyou73v0_A10	14089241	14090095	BnaA10T0089200ZY	0	+	133	660	854	0.7728337
zheyou73v0_A10	14100809	14105144	BnaA10T0089300ZY	0	+	351	3300	4335	0.7612457
zheyou73v0_A10	14108054	14109497	BnaA10T0089400ZY	0	+	59	981	1443	0.6798337
zheyou73v0_A10	14115117	14116618	BnaA10T0089500ZY	0	+	611	1501	1501	1.0000000
zheyou73v0_A10	14116390	14119777	BnaA10T0089600ZY	0	-	377	2172	3387	0.6412755
zheyou73v0_A10	14127245	14128661	BnaA10T0089700ZY	0	+	1186	1416	1416	1.0000000
zheyou73v0_A10	14145898	14148880	BnaA10T0089800ZY	0	-	305	2769	2982	0.9285714
zheyou73v0_A10	14155599	14159759	BnaA10T0089900ZY	0	-	933	3755	4160	0.9026442
zheyou73v0_A10	14161026	14162704	BnaA10T0090000ZY	0	+	77	658	1678	0.3921335
zheyou73v0_A10	14189780	14191004	BnaA10T0090100ZY	0	-	303	1224	1224	1.0000000
zheyou73v0_A10	14198248	14198857	BnaA10T0090200ZY	0	+	634	609	609	1.0000000
zheyou73v0_A10	14228857	14231412	BnaA10T0090300ZY	0	+	356	2022	2555	0.7913894
zheyou73v0_A10	14228857	14231412	BnaA10T0090300ZY.1	0	+	356	2022	2555	0.7913894
zheyou73v0_A10	14232471	14234490	BnaA10T0090400ZY	0	-	90	1289	2019	0.6384349
zheyou73v0_A10	14242321	14244913	BnaA10T0090500ZY	0	-	288	1569	2592	0.6053241
zheyou73v0_A10	14249774	14251034	BnaA10T0090600ZY	0	-	182	940	1260	0.7460318
zheyou73v0_A10	14253308	14254949	BnaA10T0090700ZY	0	-	295	1159	1641	0.7062767
zheyou73v0_A10	14255204	14256587	BnaA10T0090800ZY	0	+	620	1383	1383	1.0000000
zheyou73v0_A10	14257946	14260410	BnaA10T0090900ZY	0	+	463	1559	2464	0.6327111
zheyou73v0_A10	14262370	14264154	BnaA10T0091000ZY	0	-	264	1122	1784	0.6289238
zheyou73v0_A10	14264766	14265905	BnaA10T0091100ZY	0	+	71	893	1139	0.7840211
zheyou73v0_A10	14266347	14268997	BnaA10T0091200ZY	0	+	107	1348	2650	0.5086793
zheyou73v0_A10	14269558	14271789	BnaA10T0091300ZY	0	+	279	1665	2231	0.7463021
zheyou73v0_A10	14273427	14273806	BnaA10T0091400ZY	0	-	1	30	379	0.0791557
zheyou73v0_A10	14274511	14277472	BnaA10T0091500ZY	0	-	33	536	2961	0.1810199
zheyou73v0_A10	14280955	14282207	BnaA10T0091600ZY	0	-	112	934	1252	0.7460064
zheyou73v0_A10	14284881	14285675	BnaA10T0091700ZY	0	-	119	591	794	0.7443325
zheyou73v0_A10	14292929	14294753	BnaA10T0091800ZY	0	-	63	1244	1824	0.6820176
zheyou73v0_A10	14297656	14299530	BnaA10T0091900ZY	0	-	524	1829	1874	0.9759872
zheyou73v0_A10	14301715	14302876	BnaA10T0092000ZY	0	+	170	994	1161	0.8561585
zheyou73v0_A10	14305546	14306223	BnaA10T0092100ZY	0	+	84	646	677	0.9542097
zheyou73v0_A10	14311421	14313373	BnaA10T0092200ZY	0	-	9	433	1952	0.2218238
zheyou73v0_A10	14328734	14331043	BnaA10T0092300ZY	0	+	208	1878	2309	0.8133391
zheyou73v0_A10	14333507	14338372	BnaA10T0092400ZY	0	+	2081	4334	4865	0.8908530
zheyou73v0_A10	14343168	14347951	BnaA10T0092500ZY	0	+	499	3395	4783	0.7098055
zheyou73v0_A10	14348531	14351722	BnaA10T0092600ZY	0	+	336	2448	3191	0.7671576
zheyou73v0_A10	14356181	14357507	BnaA10T0092700ZY	0	-	35	606	1326	0.4570136
zheyou73v0_A10	14371905	14372391	BnaA10T0092800ZY	0	+	5	157	486	0.3230453
zheyou73v0_A10	14376770	14377836	BnaA10T0092900ZY	0	+	457	1062	1066	0.9962476
zheyou73v0_A10	14377591	14380952	BnaA10T0093000ZY	0	-	1131	2915	3361	0.8673014
zheyou73v0_A10	14381722	14382180	BnaA10T0093100ZY	0	+	160	458	458	1.0000000
zheyou73v0_A10	14383284	14384282	BnaA10T0093200ZY	0	+	536	998	998	1.0000000
zheyou73v0_A10	14384716	14385925	BnaA10T0093300ZY	0	-	640	1209	1209	1.0000000
zheyou73v0_A10	14395360	14397457	BnaA10T0093400ZY	0	+	263	1278	2097	0.6094421
zheyou73v0_A10	14399496	14401145	BnaA10T0093500ZY	0	+	362	1632	1649	0.9896907
zheyou73v0_A10	14402718	14404537	BnaA10T0093600ZY	0	+	373	1438	1819	0.7905443
zheyou73v0_A10	14404966	14405632	BnaA10T0093700ZY	0	-	212	666	666	1.0000000
zheyou73v0_A10	14407159	14407972	BnaA10T0093800ZY	0	+	337	813	813	1.0000000
zheyou73v0_A10	14410862	14413900	BnaA10T0093900ZY	0	+	304	1889	3038	0.6217906
zheyou73v0_A10	14414950	14416358	BnaA10T0094000ZY	0	+	43	664	1408	0.4715909
zheyou73v0_A10	14416698	14420754	BnaA10T0094100ZY	0	-	76	1181	4056	0.2911736
zheyou73v0_A10	14430745	14432414	BnaA10T0094200ZY	0	-	172	1502	1669	0.8999401
zheyou73v0_A10	14432658	14437440	BnaA10T0094300ZY	0	-	571	3465	4782	0.7245922
zheyou73v0_A10	14440475	14442615	BnaA10T0094400ZY	0	-	489	1667	2140	0.7789720
zheyou73v0_A10	14445040	14446171	BnaA10T0094500ZY	0	-	83	503	1131	0.4447392
zheyou73v0_A10	14466246	14468322	BnaA10T0094600ZY	0	-	461	1943	2076	0.9359345
zheyou73v0_A10	14479452	14480472	BnaA10T0094700ZY	0	-	32	607	1020	0.5950980
zheyou73v0_A10	14484951	14485965	BnaA10T0094800ZY	0	-	161	686	1014	0.6765286
zheyou73v0_A10	14488651	14489928	BnaA10T0094900ZY	0	-	332	797	1277	0.6241190
zheyou73v0_A10	14491392	14496506	BnaA10T0095000ZY	0	-	1042	3939	5114	0.7702386
zheyou73v0_A10	14512988	14516657	BnaA10T0095100ZY	0	-	818	3015	3669	0.8217498
zheyou73v0_A10	14519551	14524086	BnaA10T0095200ZY	0	+	198	2548	4535	0.5618523
zheyou73v0_A10	14524215	14526485	BnaA10T0095300ZY	0	-	280	2108	2270	0.9286343
zheyou73v0_A10	14528021	14528183	BnaA10T0095400ZY	0	+	34	162	162	1.0000000
zheyou73v0_A10	14528187	14528848	BnaA10T0095500ZY	0	+	108	661	661	1.0000000
zheyou73v0_A10	14530035	14531555	BnaA10T0095600ZY	0	-	150	1414	1520	0.9302632
zheyou73v0_A10	14533305	14535348	BnaA10T0095700ZY	0	+	143	1483	2043	0.7258933
zheyou73v0_A10	14539402	14541669	BnaA10T0095800ZY	0	+	198	1887	2267	0.8323776
zheyou73v0_A10	14542240	14546691	BnaA10T0095900ZY	0	-	401	3209	4451	0.7209616
zheyou73v0_A10	14551634	14552690	BnaA10T0096000ZY	0	-	65	431	1056	0.4081439
zheyou73v0_A10	14557134	14558785	BnaA10T0096100ZY	0	-	298	1043	1651	0.6317384
zheyou73v0_A10	14560341	14561604	BnaA10T0096200ZY	0	-	95	945	1263	0.7482185
zheyou73v0_A10	14570836	14572330	BnaA10T0096300ZY	0	-	87	550	1494	0.3681392
zheyou73v0_A10	14582420	14583748	BnaA10T0096400ZY	0	-	77	1038	1328	0.7816265
zheyou73v0_A10	14586737	14587720	BnaA10T0096500ZY	0	-	153	655	983	0.6663276
zheyou73v0_A10	14605612	14606121	BnaA10T0096600ZY	0	+	139	406	509	0.7976424
zheyou73v0_A10	14621930	14623637	BnaA10T0096700ZY	0	+	403	1447	1707	0.8476860
zheyou73v0_A10	14624100	14626969	BnaA10T0096800ZY	0	-	1318	2869	2869	1.0000000
zheyou73v0_A10	14627375	14629380	BnaA10T0096900ZY	0	+	435	1828	2005	0.9117207
zheyou73v0_A10	14629683	14635701	BnaA10T0097000ZY	0	-	329	2706	6018	0.4496510
zheyou73v0_A10	14637995	14638508	BnaA10T0097100ZY	0	-	4	31	513	0.0604289
zheyou73v0_A10	14642364	14642862	BnaA10T0097200ZY	0	+	115	484	498	0.9718875
zheyou73v0_A10	14651489	14653195	BnaA10T0097300ZY	0	+	281	1549	1706	0.9079719
zheyou73v0_A10	14653163	14654211	BnaA10T0097400ZY	0	-	459	1048	1048	1.0000000
zheyou73v0_A10	14653163	14654211	BnaA10T0097400ZY.1	0	-	459	1048	1048	1.0000000
zheyou73v0_A10	14656476	14657270	BnaA10T0097500ZY	0	-	464	794	794	1.0000000
zheyou73v0_A10	14657292	14660119	BnaA10T0097600ZY	0	-	1297	2781	2827	0.9837283
zheyou73v0_A10	14663596	14663944	BnaA10T0097700ZY	0	+	43	348	348	1.0000000
zheyou73v0_A10	14667049	14671326	BnaA10T0097800ZY	0	+	1482	4045	4277	0.9457564
zheyou73v0_A10	14671942	14674878	BnaA10T0097900ZY	0	-	255	2398	2936	0.8167575
zheyou73v0_A10	14671942	14674878	BnaA10T0097900ZY.1	0	-	255	2398	2936	0.8167575
zheyou73v0_A10	14675703	14677871	BnaA10T0098000ZY	0	-	351	1715	2168	0.7910517
zheyou73v0_A10	14682882	14685450	BnaA10T0098100ZY	0	-	282	2121	2568	0.8259346
zheyou73v0_A10	14686004	14686475	BnaA10T0098200ZY	0	-	159	471	471	1.0000000
zheyou73v0_A10	14686780	14689467	BnaA10T0098300ZY	0	-	439	2539	2687	0.9449200
zheyou73v0_A10	14689879	14691766	BnaA10T0098400ZY	0	-	121	1145	1887	0.6067833
zheyou73v0_A10	14689879	14691563	BnaA10T0098400ZY.1	0	-	81	942	1684	0.5593824
zheyou73v0_A10	14689879	14691563	BnaA10T0098400ZY.3	0	-	81	942	1684	0.5593824
zheyou73v0_A10	14690128	14691563	BnaA10T0098400ZY.2	0	-	44	693	1435	0.4829268
zheyou73v0_A10	14694341	14696375	BnaA10T0098500ZY	0	+	37	982	2034	0.4827925
zheyou73v0_A10	14697793	14701817	BnaA10T0098600ZY	0	+	880	3364	4024	0.8359841
zheyou73v0_A10	14709138	14712570	BnaA10T0098700ZY	0	+	743	3077	3432	0.8965617
zheyou73v0_A10	14719140	14721904	BnaA10T0098800ZY	0	+	466	2061	2764	0.7456585
zheyou73v0_A10	14723273	14725092	BnaA10T0098900ZY	0	+	322	1819	1819	1.0000000
zheyou73v0_A10	14725242	14727287	BnaA10T0099000ZY	0	-	51	584	2045	0.2855746
zheyou73v0_A10	14731579	14734827	BnaA10T0099100ZY	0	-	215	2079	3248	0.6400862
zheyou73v0_A10	14735406	14736939	BnaA10T0099200ZY	0	-	156	1162	1533	0.7579909
zheyou73v0_A10	14737217	14739589	BnaA10T0099300ZY	0	-	391	2078	2372	0.8760540
zheyou73v0_A10	14744882	14745456	BnaA10T0099400ZY	0	+	38	272	574	0.4738676
zheyou73v0_A10	14753829	14756298	BnaA10T0099500ZY	0	+	147	1448	2469	0.5864723
zheyou73v0_A10	14757686	14760408	BnaA10T0099600ZY	0	-	71	654	2722	0.2402645
zheyou73v0_A10	14768287	14768644	BnaA10T0099700ZY	0	+	325	357	357	1.0000000
zheyou73v0_A10	14772857	14773832	BnaA10T0099800ZY	0	+	50	398	975	0.4082051
zheyou73v0_A10	14780392	14781983	BnaA10T0099900ZY	0	+	253	1183	1591	0.7435575
zheyou73v0_A10	14783869	14784122	BnaA10T0100000ZY	0	+	88	253	253	1.0000000
zheyou73v0_A10	14807369	14810993	BnaA10T0100100ZY	0	+	1452	3498	3624	0.9652318
zheyou73v0_A10	14813111	14817088	BnaA10T0100200ZY	0	-	1403	3773	3977	0.9487051
zheyou73v0_A10	14813111	14817088	BnaA10T0100200ZY.1	0	-	1403	3773	3977	0.9487051
zheyou73v0_A10	14834330	14835293	BnaA10T0100300ZY	0	-	4	161	963	0.1671859
zheyou73v0_A10	14837566	14839700	BnaA10T0100400ZY	0	+	1028	2134	2134	1.0000000
zheyou73v0_A10	14840207	14845495	BnaA10T0100500ZY	0	+	381	2399	5288	0.4536687
zheyou73v0_A10	14846448	14848634	BnaA10T0100600ZY	0	+	160	1779	2186	0.8138152
zheyou73v0_A10	14849990	14850971	BnaA10T0100700ZY	0	-	83	655	981	0.6676860
zheyou73v0_A10	14852838	14854299	BnaA10T0100800ZY	0	+	206	471	1461	0.3223819
zheyou73v0_A10	14855678	14856392	BnaA10T0100900ZY	0	+	115	529	714	0.7408963
zheyou73v0_A10	14855918	14859160	BnaA10T0101000ZY	0	-	336	2526	3242	0.7791487
zheyou73v0_A10	14859563	14862352	BnaA10T0101100ZY	0	+	303	1621	2789	0.5812119
zheyou73v0_A10	14863963	14865585	BnaA10T0101200ZY	0	+	0	0	1622	0.0000000
zheyou73v0_A10	14866508	14867831	BnaA10T0101300ZY	0	+	355	1283	1323	0.9697657
zheyou73v0_A10	14870791	14873585	BnaA10T0101400ZY	0	+	143	1382	2794	0.4946314
zheyou73v0_A10	14875263	14881680	BnaA10T0101500ZY	0	+	62	1668	6417	0.2599345
zheyou73v0_A10	14893835	14895257	BnaA10T0101600ZY	0	+	21	229	1422	0.1610408
zheyou73v0_A10	14895873	14896634	BnaA10T0101700ZY	0	-	252	761	761	1.0000000
zheyou73v0_A10	14901084	14903862	BnaA10T0101800ZY	0	+	354	1791	2778	0.6447084
zheyou73v0_A10	14906947	14908540	BnaA10T0101900ZY	0	+	26	426	1593	0.2674200
zheyou73v0_A10	14909797	14911779	BnaA10T0102000ZY	0	-	876	1595	1982	0.8047427
zheyou73v0_A10	14912968	14916871	BnaA10T0102100ZY	0	+	386	2920	3903	0.7481425
zheyou73v0_A10	14917599	14918542	BnaA10T0102200ZY	0	-	66	729	943	0.7730647
zheyou73v0_A10	14918901	14922801	BnaA10T0102300ZY	0	-	851	3369	3900	0.8638462
zheyou73v0_A10	14977118	14978960	BnaA10T0102400ZY	0	-	443	1842	1842	1.0000000
zheyou73v0_A10	15004013	15007413	BnaA10T0102500ZY	0	+	205	2612	3400	0.7682353
zheyou73v0_A10	15007677	15009685	BnaA10T0102600ZY	0	-	784	2008	2008	1.0000000
zheyou73v0_A10	15007677	15009685	BnaA10T0102600ZY.1	0	-	784	2008	2008	1.0000000
zheyou73v0_A10	15010990	15011712	BnaA10T0102700ZY	0	-	237	722	722	1.0000000
zheyou73v0_A10	15017189	15022283	BnaA10T0102800ZY	0	+	1376	3895	5094	0.7646251
zheyou73v0_A10	15023971	15026829	BnaA10T0102900ZY	0	-	4	260	2858	0.0909727
zheyou73v0_A10	15028939	15029251	BnaA10T0103000ZY	0	-	1	150	312	0.4807692
zheyou73v0_A10	15050028	15051480	BnaA10T0103100ZY	0	+	20	573	1452	0.3946281
zheyou73v0_A10	15051927	15053029	BnaA10T0103200ZY	0	-	16	301	1102	0.2731397
zheyou73v0_A10	15059232	15059547	BnaA10T0103300ZY	0	+	0	0	315	0.0000000
zheyou73v0_A10	15060137	15061006	BnaA10T0103400ZY	0	-	2	57	869	0.0655926
zheyou73v0_A10	15065444	15073153	BnaA10T0103500ZY	0	+	511	3495	7709	0.4533662
zheyou73v0_A10	15073745	15076212	BnaA10T0103600ZY	0	-	316	1688	2467	0.6842319
zheyou73v0_A10	15082573	15087139	BnaA10T0103700ZY	0	-	1479	3748	4566	0.8208498
zheyou73v0_A10	15088371	15094169	BnaA10T0103800ZY	0	-	304	2962	5798	0.5108658
zheyou73v0_A10	15099187	15099920	BnaA10T0103900ZY	0	+	9	46	733	0.0627558
zheyou73v0_A10	15100259	15102571	BnaA10T0104000ZY	0	-	129	1133	2312	0.4900519
zheyou73v0_A10	15108240	15108805	BnaA10T0104100ZY	0	+	1593	565	565	1.0000000
zheyou73v0_A10	15113252	15114684	BnaA10T0104200ZY	0	+	221	1358	1432	0.9483240
zheyou73v0_A10	15115285	15116481	BnaA10T0104300ZY	0	+	284	973	1196	0.8135452
zheyou73v0_A10	15123300	15126030	BnaA10T0104400ZY	0	+	415	1984	2730	0.7267399
zheyou73v0_A10	15124209	15126030	BnaA10T0104400ZY.1	0	+	396	1467	1821	0.8056013
zheyou73v0_A10	15126635	15127250	BnaA10T0104500ZY	0	+	358	615	615	1.0000000
zheyou73v0_A10	15131287	15133316	BnaA10T0104600ZY	0	+	79	815	2029	0.4016757
zheyou73v0_A10	15133648	15134714	BnaA10T0104700ZY	0	-	342	1042	1066	0.9774860
zheyou73v0_A10	15148654	15150796	BnaA10T0104800ZY	0	+	362	1890	2142	0.8823529
zheyou73v0_A10	15148654	15150796	BnaA10T0104800ZY.1	0	+	362	1890	2142	0.8823529
zheyou73v0_A10	15151861	15152255	BnaA10T0104900ZY	0	+	43	324	394	0.8223350
zheyou73v0_A10	15157880	15159741	BnaA10T0105000ZY	0	+	364	1621	1861	0.8710371
zheyou73v0_A10	15164365	15164593	BnaA10T0105100ZY	0	+	0	0	228	0.0000000
zheyou73v0_A10	15165375	15166562	BnaA10T0105200ZY	0	-	0	0	1187	0.0000000
zheyou73v0_A10	15169146	15169575	BnaA10T0105300ZY	0	+	6	86	429	0.2004662
zheyou73v0_A10	15180645	15182645	BnaA10T0105400ZY	0	-	806	2000	2000	1.0000000
zheyou73v0_A10	15180645	15182465	BnaA10T0105400ZY.1	0	-	738	1820	1820	1.0000000
zheyou73v0_A10	15183387	15185569	BnaA10T0105500ZY	0	+	97	1251	2182	0.5733272
zheyou73v0_A10	15185866	15186750	BnaA10T0105600ZY	0	-	46	461	884	0.5214932
zheyou73v0_A10	15187032	15188631	BnaA10T0105700ZY	0	+	57	1072	1599	0.6704190
zheyou73v0_A10	15188629	15191702	BnaA10T0105800ZY	0	-	68	1316	3073	0.4282460
zheyou73v0_A10	15202197	15204958	BnaA10T0105900ZY	0	+	278	2011	2761	0.7283593
zheyou73v0_A10	15208769	15210850	BnaA10T0106000ZY	0	+	433	1514	2081	0.7275348
zheyou73v0_A10	15210875	15211615	BnaA10T0106100ZY	0	-	282	740	740	1.0000000
zheyou73v0_A10	15211711	15214481	BnaA10T0106200ZY	0	+	384	2310	2770	0.8339350
zheyou73v0_A10	15215463	15216149	BnaA10T0106300ZY	0	-	59	553	686	0.8061224
zheyou73v0_A10	15217140	15218366	BnaA10T0106400ZY	0	+	56	796	1226	0.6492659
zheyou73v0_A10	15218514	15223858	BnaA10T0106500ZY	0	-	150	2325	5344	0.4350674
zheyou73v0_A10	15224118	15228791	BnaA10T0106600ZY	0	-	560	2453	4673	0.5249305
zheyou73v0_A10	15230645	15233535	BnaA10T0106700ZY	0	+	866	2723	2890	0.9422145
zheyou73v0_A10	15234129	15237186	BnaA10T0106800ZY	0	-	408	2055	3057	0.6722277
zheyou73v0_A10	15237373	15239393	BnaA10T0106900ZY	0	-	434	1804	2020	0.8930693
zheyou73v0_A10	15242144	15252919	BnaA10T0107000ZY	0	+	1413	9350	10775	0.8677494
zheyou73v0_A10	15266367	15268311	BnaA10T0107100ZY	0	+	670	1944	1944	1.0000000
zheyou73v0_A10	15286277	15288264	BnaA10T0107200ZY	0	-	420	1650	1987	0.8303976
zheyou73v0_A10	15297889	15298616	BnaA10T0107300ZY	0	-	388	727	727	1.0000000
zheyou73v0_A10	15299504	15304361	BnaA10T0107400ZY	0	-	2108	4645	4857	0.9563516
zheyou73v0_A10	15316064	15319494	BnaA10T0107500ZY	0	-	637	2247	3430	0.6551020
zheyou73v0_A10	15316695	15319494	BnaA10T0107500ZY.1	0	-	410	1654	2799	0.5909253
zheyou73v0_A10	15320460	15321492	BnaA10T0107600ZY	0	+	208	785	1032	0.7606589
zheyou73v0_A10	15323355	15324567	BnaA10T0107700ZY	0	+	816	1212	1212	1.0000000
zheyou73v0_A10	15333421	15334427	BnaA10T0107800ZY	0	+	440	1006	1006	1.0000000
zheyou73v0_A10	15333421	15334750	BnaA10T0107800ZY.1	0	+	671	1329	1329	1.0000000
zheyou73v0_A10	15337330	15342125	BnaA10T0107900ZY	0	-	1494	4248	4795	0.8859228
zheyou73v0_A10	15350420	15351101	BnaA10T0108000ZY	0	-	484	660	681	0.9691630
zheyou73v0_A10	15351814	15352874	BnaA10T0108100ZY	0	+	508	1060	1060	1.0000000
zheyou73v0_A10	15356836	15359718	BnaA10T0108200ZY	0	+	530	1995	2882	0.6922276
zheyou73v0_A10	15371111	15373943	BnaA10T0108300ZY	0	-	21	524	2832	0.1850283
zheyou73v0_A10	15378843	15379175	BnaA10T0108400ZY	0	+	29	216	332	0.6506024
zheyou73v0_A10	15398116	15399238	BnaA10T0108500ZY	0	-	57	702	1122	0.6256685
zheyou73v0_A10	15429384	15430525	BnaA10T0108600ZY	0	-	153	880	1141	0.7712533
zheyou73v0_A10	15429384	15430525	BnaA10T0108600ZY.1	0	-	153	880	1141	0.7712533
zheyou73v0_A10	15437895	15438105	BnaA10T0108700ZY	0	-	204	210	210	1.0000000
zheyou73v0_A10	15439571	15442892	BnaA10T0108800ZY	0	+	532	2735	3321	0.8235471
zheyou73v0_A10	15439571	15442049	BnaA10T0108800ZY.1	0	+	337	1892	2478	0.7635190
zheyou73v0_A10	15439571	15442892	BnaA10T0108800ZY.2	0	+	532	2735	3321	0.8235471
zheyou73v0_A10	15443613	15444900	BnaA10T0108900ZY	0	+	137	1155	1287	0.8974359
zheyou73v0_A10	15445874	15448333	BnaA10T0109000ZY	0	+	504	2265	2459	0.9211062
zheyou73v0_A10	15449123	15452346	BnaA10T0109100ZY	0	+	522	2128	3223	0.6602544
zheyou73v0_A10	15454102	15454579	BnaA10T0109200ZY	0	+	156	255	477	0.5345912
zheyou73v0_A10	15461164	15462423	BnaA10T0109300ZY	0	-	294	945	1259	0.7505957
zheyou73v0_A10	15461164	15462423	BnaA10T0109300ZY.1	0	-	294	945	1259	0.7505957
zheyou73v0_A10	15467922	15469539	BnaA10T0109400ZY	0	+	198	1282	1617	0.7928262
zheyou73v0_A10	15470501	15472083	BnaA10T0109500ZY	0	+	712	1582	1582	1.0000000
zheyou73v0_A10	15477669	15479898	BnaA10T0109600ZY	0	+	254	972	2229	0.4360700
zheyou73v0_A10	15484961	15488385	BnaA10T0109700ZY	0	+	598	3268	3424	0.9544392
zheyou73v0_A10	15497640	15505012	BnaA10T0109800ZY	0	-	959	4635	7372	0.6287304
zheyou73v0_A10	15521824	15522580	BnaA10T0109900ZY	0	+	374	756	756	1.0000000
zheyou73v0_A10	15529680	15529884	BnaA10T0110000ZY	0	-	50	183	204	0.8970588
zheyou73v0_A10	15558265	15558679	BnaA10T0110100ZY	0	-	350	414	414	1.0000000
zheyou73v0_A10	15563174	15567395	BnaA10T0110200ZY	0	+	256	2857	4221	0.6768538
zheyou73v0_A10	15567987	15570154	BnaA10T0110300ZY	0	+	880	2117	2167	0.9769266
zheyou73v0_A10	15570922	15576258	BnaA10T0110400ZY	0	+	587	3925	5336	0.7355697
zheyou73v0_A10	15576829	15583164	BnaA10T0110500ZY	0	-	788	4988	6335	0.7873718
zheyou73v0_A10	15585147	15585724	BnaA10T0110600ZY	0	+	0	0	577	0.0000000
zheyou73v0_A10	15585757	15586447	BnaA10T0110700ZY	0	+	138	595	690	0.8623188
zheyou73v0_A10	15586538	15587629	BnaA10T0110800ZY	0	-	40	763	1091	0.6993584
zheyou73v0_A10	15586538	15587629	BnaA10T0110800ZY.1	0	-	40	763	1091	0.6993584
zheyou73v0_A10	15594665	15596092	BnaA10T0110900ZY	0	+	3	150	1427	0.1051156
zheyou73v0_A10	15597443	15597838	BnaA10T0111000ZY	0	-	0	0	395	0.0000000
zheyou73v0_A10	15599831	15601188	BnaA10T0111100ZY	0	-	0	0	1357	0.0000000
zheyou73v0_A10	15599831	15601188	BnaA10T0111100ZY.1	0	-	0	0	1357	0.0000000
zheyou73v0_A10	15610696	15612574	BnaA10T0111200ZY	0	-	0	0	1878	0.0000000
zheyou73v0_A10	15615684	15619427	BnaA10T0111300ZY	0	+	2	264	3743	0.0705317
zheyou73v0_A10	15619520	15622760	BnaA10T0111400ZY	0	-	0	0	3240	0.0000000
zheyou73v0_A10	15619520	15622760	BnaA10T0111400ZY.1	0	-	0	0	3240	0.0000000
zheyou73v0_A10	15619520	15622760	BnaA10T0111400ZY.2	0	-	0	0	3240	0.0000000
zheyou73v0_A10	15635849	15636537	BnaA10T0111500ZY	0	-	0	0	688	0.0000000
zheyou73v0_A10	15643067	15646307	BnaA10T0111600ZY	0	+	1	29	3240	0.0089506
zheyou73v0_A10	15643067	15646307	BnaA10T0111600ZY.1	0	+	1	29	3240	0.0089506
zheyou73v0_A10	15646400	15650147	BnaA10T0111700ZY	0	-	60	1163	3747	0.3103817
zheyou73v0_A10	15662531	15665559	BnaA10T0111800ZY	0	+	852	3002	3028	0.9914135
zheyou73v0_A10	15666164	15669376	BnaA10T0111900ZY	0	-	663	2937	3212	0.9143836
zheyou73v0_A10	15666164	15669376	BnaA10T0111900ZY.1	0	-	663	2937	3212	0.9143836
zheyou73v0_A10	15670433	15670971	BnaA10T0112000ZY	0	-	387	538	538	1.0000000
zheyou73v0_A10	15682052	15684480	BnaA10T0112100ZY	0	+	346	2030	2428	0.8360791
zheyou73v0_A10	15688308	15689280	BnaA10T0112200ZY	0	+	431	972	972	1.0000000
zheyou73v0_A10	15703069	15704878	BnaA10T0112300ZY	0	+	522	1637	1809	0.9049199
zheyou73v0_A10	15704442	15707976	BnaA10T0112400ZY	0	-	983	3474	3534	0.9830221
zheyou73v0_A10	15708697	15711725	BnaA10T0112500ZY	0	-	431	2908	3028	0.9603699
zheyou73v0_A10	15708697	15711725	BnaA10T0112500ZY.1	0	-	431	2908	3028	0.9603699
zheyou73v0_A10	15708697	15711283	BnaA10T0112500ZY.2	0	-	425	2538	2586	0.9814385
zheyou73v0_A10	15715230	15715912	BnaA10T0112600ZY	0	-	197	682	682	1.0000000
zheyou73v0_A10	15716138	15718483	BnaA10T0112700ZY	0	-	362	1699	2345	0.7245203
zheyou73v0_A10	15716138	15718483	BnaA10T0112700ZY.1	0	-	362	1699	2345	0.7245203
zheyou73v0_A10	15720516	15725679	BnaA10T0112800ZY	0	+	329	3090	5163	0.5984892
zheyou73v0_A10	15726888	15729782	BnaA10T0112900ZY	0	+	641	2728	2894	0.9426399
zheyou73v0_A10	15735019	15737041	BnaA10T0113000ZY	0	+	629	1797	2022	0.8887240
zheyou73v0_A10	15737082	15738205	BnaA10T0113100ZY	0	+	173	596	1123	0.5307213
zheyou73v0_A10	15739072	15741408	BnaA10T0113200ZY	0	-	656	2184	2336	0.9349315
zheyou73v0_A10	15744679	15745417	BnaA10T0113300ZY	0	+	8	361	738	0.4891599
zheyou73v0_A10	15749727	15755192	BnaA10T0113400ZY	0	-	728	3811	5465	0.6973467
zheyou73v0_A10	15749727	15755098	BnaA10T0113400ZY.1	0	-	728	3811	5371	0.7095513
zheyou73v0_A10	15764799	15765922	BnaA10T0113500ZY	0	+	429	1123	1123	1.0000000
zheyou73v0_A10	15766853	15772532	BnaA10T0113600ZY	0	-	133	2181	5679	0.3840465
zheyou73v0_A10	15777174	15778102	BnaA10T0113700ZY	0	+	30	394	928	0.4245690
zheyou73v0_A10	15778355	15780366	BnaA10T0113800ZY	0	-	201	1727	2011	0.8587767
zheyou73v0_A10	15780703	15782789	BnaA10T0113900ZY	0	+	78	1168	2086	0.5599233
zheyou73v0_A10	15786854	15788676	BnaA10T0114000ZY	0	-	228	1614	1822	0.8858398
zheyou73v0_A10	15789849	15790334	BnaA10T0114100ZY	0	-	413	485	485	1.0000000
zheyou73v0_A10	15791918	15792512	BnaA10T0114200ZY	0	-	0	0	594	0.0000000
zheyou73v0_A10	15795282	15799161	BnaA10T0114300ZY	0	-	556	3692	3879	0.9517917
zheyou73v0_A10	15807730	15808470	BnaA10T0114400ZY	0	-	21	366	740	0.4945946
zheyou73v0_A10	15823522	15825590	BnaA10T0114500ZY	0	+	1107	2068	2068	1.0000000
zheyou73v0_A10	15837662	15838770	BnaA10T0114600ZY	0	-	71	372	1108	0.3357401
zheyou73v0_A10	15847003	15850603	BnaA10T0114700ZY	0	-	487	2801	3600	0.7780555
zheyou73v0_A10	15851075	15855245	BnaA10T0114800ZY	0	-	1526	4123	4170	0.9887290
zheyou73v0_A10	15860722	15864511	BnaA10T0114900ZY	0	-	2324	3789	3789	1.0000000
zheyou73v0_A10	15871139	15871472	BnaA10T0115000ZY	0	+	65	333	333	1.0000000
zheyou73v0_A10	15880810	15882730	BnaA10T0115100ZY	0	-	116	1156	1920	0.6020833
zheyou73v0_A10	15886666	15887293	BnaA10T0115200ZY	0	+	88	307	627	0.4896332
zheyou73v0_A10	15888633	15891825	BnaA10T0115300ZY	0	+	838	2827	3192	0.8856516
zheyou73v0_A10	15920235	15921779	BnaA10T0115400ZY	0	+	122	1360	1544	0.8808290
zheyou73v0_A10	15931361	15934206	BnaA10T0115500ZY	0	-	392	1750	2845	0.6151142
zheyou73v0_A10	15947074	15947963	BnaA10T0115600ZY	0	-	120	476	889	0.5354331
zheyou73v0_A10	15969266	15969539	BnaA10T0115700ZY	0	+	14	273	273	1.0000000
zheyou73v0_A10	15975041	15978585	BnaA10T0115800ZY	0	+	249	2349	3544	0.6628104
zheyou73v0_A10	15981692	15983519	BnaA10T0115900ZY	0	-	875	1827	1827	1.0000000
zheyou73v0_A10	15991285	15993368	BnaA10T0116000ZY	0	-	238	1774	2083	0.8516563
zheyou73v0_A10	15998970	15999210	BnaA10T0116100ZY	0	+	35	230	240	0.9583333
zheyou73v0_A10	15999363	16001400	BnaA10T0116200ZY	0	-	115	1244	2037	0.6107020
zheyou73v0_A10	16004457	16005396	BnaA10T0116300ZY	0	-	6	100	939	0.1064963
zheyou73v0_A10	16009547	16010082	BnaA10T0116400ZY	0	-	43	520	535	0.9719626
zheyou73v0_A10	16013715	16014976	BnaA10T0116500ZY	0	-	418	1187	1261	0.9413164
zheyou73v0_A10	16013715	16014976	BnaA10T0116500ZY.1	0	-	418	1187	1261	0.9413164
zheyou73v0_A10	16024884	16028629	BnaA10T0116600ZY	0	+	669	2742	3745	0.7321762
zheyou73v0_A10	16024884	16028629	BnaA10T0116600ZY.1	0	+	669	2742	3745	0.7321762
zheyou73v0_A10	16024884	16028629	BnaA10T0116600ZY.2	0	+	669	2742	3745	0.7321762
zheyou73v0_A10	16025501	16028629	BnaA10T0116600ZY.3	0	+	624	2301	3128	0.7356138
zheyou73v0_A10	16028768	16030050	BnaA10T0116700ZY	0	-	136	748	1282	0.5834633
zheyou73v0_A10	16031997	16032547	BnaA10T0116800ZY	0	+	19	302	550	0.5490909
zheyou73v0_A10	16032570	16034627	BnaA10T0116900ZY	0	-	388	1914	2057	0.9304813
zheyou73v0_A10	16035395	16037568	BnaA10T0117000ZY	0	-	63	658	2173	0.3028072
zheyou73v0_A10	16039679	16042121	BnaA10T0117100ZY	0	+	385	2045	2442	0.8374283
zheyou73v0_A10	16039679	16042121	BnaA10T0117100ZY.1	0	+	385	2045	2442	0.8374283
zheyou73v0_A10	16042404	16044062	BnaA10T0117200ZY	0	-	228	1226	1658	0.7394451
zheyou73v0_A10	16044179	16045751	BnaA10T0117300ZY	0	-	520	1449	1572	0.9217557
zheyou73v0_A10	16046935	16048060	BnaA10T0117400ZY	0	-	784	1125	1125	1.0000000
zheyou73v0_A10	16048516	16049537	BnaA10T0117500ZY	0	+	318	1021	1021	1.0000000
zheyou73v0_A10	16050608	16055014	BnaA10T0117600ZY	0	-	873	3876	4406	0.8797095
zheyou73v0_A10	16060862	16063360	BnaA10T0117700ZY	0	+	362	1773	2498	0.7097678
zheyou73v0_A10	16067371	16070181	BnaA10T0117800ZY	0	+	201	1694	2810	0.6028470
zheyou73v0_A10	16075252	16076312	BnaA10T0117900ZY	0	-	156	690	1060	0.6509434
zheyou73v0_A10	16077628	16079002	BnaA10T0118000ZY	0	+	81	946	1374	0.6885007
zheyou73v0_A10	16080124	16085209	BnaA10T0118100ZY	0	+	750	3345	5085	0.6578171
zheyou73v0_A10	16085530	16089124	BnaA10T0118200ZY	0	-	358	1980	3594	0.5509182
zheyou73v0_A10	16089845	16091261	BnaA10T0118300ZY	0	+	360	1088	1416	0.7683616
zheyou73v0_A10	16094389	16096635	BnaA10T0118400ZY	0	-	125	1536	2246	0.6838825
zheyou73v0_A10	16109545	16115542	BnaA10T0118500ZY	0	+	552	3799	5997	0.6334834
zheyou73v0_A10	16115822	16117058	BnaA10T0118600ZY	0	+	103	1089	1236	0.8810679
zheyou73v0_A10	16117620	16118355	BnaA10T0118700ZY	0	-	50	575	735	0.7823129
zheyou73v0_A10	16118963	16121353	BnaA10T0118800ZY	0	-	186	1847	2390	0.7728034
zheyou73v0_A10	16121655	16127397	BnaA10T0118900ZY	0	+	1629	5497	5742	0.9573320
zheyou73v0_A10	16128326	16134150	BnaA10T0119000ZY	0	+	1253	4895	5824	0.8404877
zheyou73v0_A10	16137857	16140004	BnaA10T0119100ZY	0	+	207	1716	2147	0.7992548
zheyou73v0_A10	16139977	16140893	BnaA10T0119200ZY	0	-	67	756	916	0.8253275
zheyou73v0_A10	16141078	16142192	BnaA10T0119300ZY	0	+	254	1086	1114	0.9748654
zheyou73v0_A10	16143193	16147635	BnaA10T0119400ZY	0	+	703	3441	4442	0.7746511
zheyou73v0_A10	16153100	16155190	BnaA10T0119500ZY	0	+	406	1691	2090	0.8090909
zheyou73v0_A10	16157495	16159328	BnaA10T0119600ZY	0	+	261	1609	1833	0.8777959
zheyou73v0_A10	16159651	16162001	BnaA10T0119700ZY	0	-	381	1852	2350	0.7880851
zheyou73v0_A10	16162227	16167780	BnaA10T0119800ZY	0	+	737	4942	5553	0.8899694
zheyou73v0_A10	16169384	16172087	BnaA10T0119900ZY	0	+	134	2004	2703	0.7413985
zheyou73v0_A10	16174975	16175313	BnaA10T0120000ZY	0	+	21	255	338	0.7544379
zheyou73v0_A10	16175712	16177104	BnaA10T0120100ZY	0	-	93	973	1392	0.6989943
zheyou73v0_A10	16181044	16181642	BnaA10T0120200ZY	0	+	221	598	598	1.0000000
zheyou73v0_A10	16182424	16190105	BnaA10T0120300ZY	0	+	593	3674	7681	0.4783231
zheyou73v0_A10	16190484	16191877	BnaA10T0120400ZY	0	+	216	832	1393	0.5972721
zheyou73v0_A10	16192552	16195049	BnaA10T0120500ZY	0	-	282	1830	2497	0.7328795
zheyou73v0_A10	16195369	16200162	BnaA10T0120600ZY	0	+	258	3431	4793	0.7158356
zheyou73v0_A10	16201882	16204765	BnaA10T0120700ZY	0	-	100	1080	2883	0.3746098
zheyou73v0_A10	16214808	16217017	BnaA10T0120800ZY	0	-	388	1861	2209	0.8424627
zheyou73v0_A10	16217362	16219050	BnaA10T0120900ZY	0	-	155	1311	1688	0.7766588
zheyou73v0_A10	16219311	16220893	BnaA10T0121000ZY	0	+	147	1041	1582	0.6580278
zheyou73v0_A10	16221889	16222453	BnaA10T0121100ZY	0	-	55	459	564	0.8138298
zheyou73v0_A10	16227768	16228322	BnaA10T0121200ZY	0	-	65	307	554	0.5541517
zheyou73v0_A10	16231954	16237878	BnaA10T0121300ZY	0	-	293	2152	5924	0.3632680
zheyou73v0_A10	16254988	16255909	BnaA10T0121400ZY	0	+	7	244	921	0.2649294
zheyou73v0_A10	16258491	16260888	BnaA10T0121500ZY	0	+	338	2008	2397	0.8377138
zheyou73v0_A10	16258491	16260888	BnaA10T0121500ZY.1	0	+	338	2008	2397	0.8377138
zheyou73v0_A10	16261289	16264871	BnaA10T0121600ZY	0	-	256	2132	3582	0.5951982
zheyou73v0_A10	16280612	16280888	BnaA10T0121700ZY	0	-	20	220	276	0.7971014
zheyou73v0_A10	16282066	16282982	BnaA10T0121800ZY	0	-	325	889	916	0.9705240
zheyou73v0_A10	16283696	16284774	BnaA10T0121900ZY	0	-	31	965	1078	0.8951762
zheyou73v0_A10	16292530	16296167	BnaA10T0122000ZY	0	-	994	3378	3637	0.9287875
zheyou73v0_A10	16312200	16316857	BnaA10T0122100ZY	0	-	920	3345	4657	0.7182736
zheyou73v0_A10	16323014	16325842	BnaA10T0122200ZY	0	+	17	893	2828	0.3157709
zheyou73v0_A10	16325775	16326929	BnaA10T0122300ZY	0	-	97	924	1154	0.8006932
zheyou73v0_A10	16336895	16338308	BnaA10T0122400ZY	0	+	94	940	1413	0.6652513
zheyou73v0_A10	16338685	16338992	BnaA10T0122500ZY	0	-	8	132	307	0.4299674
zheyou73v0_A10	16339222	16341715	BnaA10T0122600ZY	0	+	791	2312	2493	0.9273967
zheyou73v0_A10	16351065	16353808	BnaA10T0122700ZY.1	0	-	185	1445	2743	0.5267955
zheyou73v0_A10	16351065	16353808	BnaA10T0122700ZY.2	0	-	185	1445	2743	0.5267955
zheyou73v0_A10	16351200	16353583	BnaA10T0122700ZY	0	-	141	1197	2383	0.5023080
zheyou73v0_A10	16361600	16364321	BnaA10T0122800ZY	0	-	155	1533	2721	0.5633958
zheyou73v0_A10	16365224	16367766	BnaA10T0122900ZY	0	-	82	1063	2542	0.4181747
zheyou73v0_A10	16368869	16370630	BnaA10T0123000ZY	0	+	94	774	1761	0.4395230
zheyou73v0_A10	16370744	16372787	BnaA10T0123100ZY	0	-	435	1862	2043	0.9114048
zheyou73v0_A10	16373132	16374670	BnaA10T0123200ZY	0	-	657	1423	1538	0.9252276
zheyou73v0_A10	16376669	16377833	BnaA10T0123300ZY	0	+	51	469	1164	0.4029210
zheyou73v0_A10	16382642	16383868	BnaA10T0123400ZY	0	-	18	483	1226	0.3939641
zheyou73v0_A10	16384544	16385861	BnaA10T0123500ZY	0	+	537	1317	1317	1.0000000
zheyou73v0_A10	16385938	16387513	BnaA10T0123600ZY	0	-	568	1575	1575	1.0000000
zheyou73v0_A10	16389362	16389858	BnaA10T0123700ZY	0	-	37	440	496	0.8870968
zheyou73v0_A10	16399981	16402751	BnaA10T0123800ZY	0	+	196	1603	2770	0.5787004
zheyou73v0_A10	16410934	16411595	BnaA10T0123900ZY	0	+	183	551	661	0.8335855
zheyou73v0_A10	16412008	16415666	BnaA10T0124000ZY	0	-	649	3074	3658	0.8403499
zheyou73v0_A10	16422392	16423407	BnaA10T0124100ZY	0	+	0	0	1015	0.0000000
zheyou73v0_A10	16430453	16434428	BnaA10T0124200ZY	0	+	330	2266	3975	0.5700629
zheyou73v0_A10	16435794	16436703	BnaA10T0124300ZY	0	+	49	584	909	0.6424642
zheyou73v0_A10	16437451	16439353	BnaA10T0124400ZY	0	-	191	1442	1902	0.7581493
zheyou73v0_A10	16439974	16454718	BnaA10T0124500ZY	0	-	6349	13467	14744	0.9133885
zheyou73v0_A10	16455063	16457955	BnaA10T0124600ZY	0	-	6	341	2892	0.1179115
zheyou73v0_A10	16460232	16461051	BnaA10T0124700ZY	0	+	442	819	819	1.0000000
zheyou73v0_A10	16461299	16463131	BnaA10T0124800ZY	0	-	539	1743	1832	0.9514192
zheyou73v0_A10	16466150	16468506	BnaA10T0124900ZY	0	+	157	816	2356	0.3463497
zheyou73v0_A10	16474655	16476932	BnaA10T0125000ZY	0	-	498	1872	2277	0.8221344
zheyou73v0_A10	16485894	16487448	BnaA10T0125100ZY	0	-	125	1169	1554	0.7522523
zheyou73v0_A10	16491111	16491492	BnaA10T0125200ZY	0	+	0	0	381	0.0000000
zheyou73v0_A10	16498254	16499029	BnaA10T0125300ZY	0	+	226	775	775	1.0000000
zheyou73v0_A10	16506413	16509117	BnaA10T0125400ZY	0	+	87	1464	2704	0.5414201
zheyou73v0_A10	16506413	16509117	BnaA10T0125400ZY.1	0	+	87	1464	2704	0.5414201
zheyou73v0_A10	16506413	16509117	BnaA10T0125400ZY.2	0	+	87	1464	2704	0.5414201
zheyou73v0_A10	16509247	16511688	BnaA10T0125500ZY	0	-	888	2441	2441	1.0000000
zheyou73v0_A10	16515982	16518694	BnaA10T0125600ZY	0	+	204	2272	2712	0.8377581
zheyou73v0_A10	16529913	16543716	BnaA10T0125700ZY	0	+	885	9148	13803	0.6627545
zheyou73v0_A10	16550241	16551092	BnaA10T0125800ZY	0	-	0	0	851	0.0000000
zheyou73v0_A10	16551250	16552218	BnaA10T0125900ZY	0	-	0	0	968	0.0000000
zheyou73v0_A10	16563275	16563528	BnaA10T0126000ZY	0	+	6	64	253	0.2529644
zheyou73v0_A10	16564920	16567118	BnaA10T0126100ZY	0	-	370	1574	2198	0.7161055
zheyou73v0_A10	16574983	16578524	BnaA10T0126200ZY	0	-	2058	3532	3541	0.9974583
zheyou73v0_A10	16584306	16586415	BnaA10T0126300ZY	0	+	54	1094	2109	0.5187293
zheyou73v0_A10	16586526	16589438	BnaA10T0126400ZY	0	-	311	1614	2912	0.5542582
zheyou73v0_A10	16589674	16591529	BnaA10T0126500ZY	0	-	712	1801	1855	0.9708895
zheyou73v0_A10	16589674	16591529	BnaA10T0126500ZY.1	0	-	712	1801	1855	0.9708895
zheyou73v0_A10	16615991	16618260	BnaA10T0126600ZY	0	+	244	1568	2269	0.6910533
zheyou73v0_A10	16619808	16624327	BnaA10T0126700ZY	0	+	1164	4163	4519	0.9212215
zheyou73v0_A10	16624371	16628856	BnaA10T0126800ZY	0	-	858	3954	4485	0.8816053
zheyou73v0_A10	16628936	16629872	BnaA10T0126900ZY	0	-	594	936	936	1.0000000
zheyou73v0_A10	16630806	16632798	BnaA10T0127000ZY	0	-	368	1745	1992	0.8760040
zheyou73v0_A10	16630806	16632798	BnaA10T0127000ZY.1	0	-	368	1745	1992	0.8760040
zheyou73v0_A10	16637629	16639705	BnaA10T0127100ZY	0	-	616	1690	2076	0.8140655
zheyou73v0_A10	16641879	16642818	BnaA10T0127200ZY	0	+	419	865	939	0.9211928
zheyou73v0_A10	16645556	16646051	BnaA10T0127300ZY	0	+	0	0	495	0.0000000
zheyou73v0_A10	16647745	16650938	BnaA10T0127400ZY	0	+	434	2749	3193	0.8609458
zheyou73v0_A10	16660862	16661926	BnaA10T0127500ZY	0	+	280	1057	1064	0.9934211
zheyou73v0_A10	16664595	16665633	BnaA10T0127600ZY	0	+	152	591	1038	0.5693642
zheyou73v0_A10	16674265	16677773	BnaA10T0127700ZY.1	0	+	970	3261	3508	0.9295895
zheyou73v0_A10	16674267	16677773	BnaA10T0127700ZY	0	+	970	3259	3506	0.9295493
zheyou73v0_A10	16674267	16677773	BnaA10T0127700ZY.2	0	+	970	3259	3506	0.9295493
zheyou73v0_A10	16674267	16677773	BnaA10T0127700ZY.3	0	+	970	3259	3506	0.9295493
zheyou73v0_A10	16683296	16683761	BnaA10T0127800ZY	0	-	21	238	465	0.5118279
zheyou73v0_A10	16690525	16691539	BnaA10T0127900ZY	0	+	3	278	1014	0.2741617
zheyou73v0_A10	16694616	16697426	BnaA10T0128000ZY	0	+	178	2014	2810	0.7167260
zheyou73v0_A10	16697608	16698946	BnaA10T0128100ZY	0	-	459	1120	1338	0.8370702
zheyou73v0_A10	16699930	16701252	BnaA10T0128200ZY	0	-	378	1322	1322	1.0000000
zheyou73v0_A10	16702848	16703615	BnaA10T0128300ZY	0	+	9	209	767	0.2724902
zheyou73v0_A10	16712919	16713524	BnaA10T0128400ZY	0	-	5	247	605	0.4082645
zheyou73v0_A10	16716610	16717927	BnaA10T0128500ZY	0	-	6	206	1317	0.1564161
zheyou73v0_A10	16729676	16730498	BnaA10T0128600ZY	0	+	14	169	822	0.2055961
zheyou73v0_A10	16741689	16742464	BnaA10T0128700ZY	0	-	26	227	775	0.2929032
zheyou73v0_A10	16751294	16754916	BnaA10T0128800ZY	0	+	868	3090	3622	0.8531199
zheyou73v0_A10	16755855	16758638	BnaA10T0128900ZY	0	+	375	1944	2783	0.6985267
zheyou73v0_A10	16759128	16761023	BnaA10T0129000ZY	0	+	136	1011	1895	0.5335093
zheyou73v0_A10	16761645	16769354	BnaA10T0129100ZY	0	+	1345	4795	7709	0.6220003
zheyou73v0_A10	16774321	16778475	BnaA10T0129200ZY	0	+	832	3528	4154	0.8493019
zheyou73v0_A10	16782967	16784767	BnaA10T0129300ZY	0	+	178	1406	1800	0.7811111
zheyou73v0_A10	16785058	16786250	BnaA10T0129400ZY	0	-	166	1192	1192	1.0000000
zheyou73v0_A10	16786812	16788853	BnaA10T0129500ZY	0	-	910	1989	2041	0.9745223
zheyou73v0_A10	16790778	16792221	BnaA10T0129600ZY	0	-	143	1058	1443	0.7331947
zheyou73v0_A10	16792957	16794916	BnaA10T0129700ZY	0	+	226	1124	1959	0.5737621
zheyou73v0_A10	16796585	16798256	BnaA10T0129800ZY	0	+	112	620	1671	0.3710353
zheyou73v0_A10	16805640	16807034	BnaA10T0129900ZY	0	-	317	1097	1394	0.7869440
zheyou73v0_A10	16807906	16814402	BnaA10T0130000ZY	0	-	219	1061	6496	0.1633313
zheyou73v0_A10	16816009	16817663	BnaA10T0130100ZY	0	-	184	1236	1654	0.7472793
zheyou73v0_A10	16822123	16823853	BnaA10T0130200ZY	0	-	245	1576	1730	0.9109827
zheyou73v0_A10	16823920	16825713	BnaA10T0130300ZY	0	+	211	1763	1793	0.9832683
zheyou73v0_A10	16826054	16827134	BnaA10T0130400ZY	0	+	155	552	1080	0.5111111
zheyou73v0_A10	16842521	16843175	BnaA10T0130500ZY	0	+	87	504	654	0.7706422
zheyou73v0_A10	16850551	16851652	BnaA10T0130600ZY	0	+	951	1101	1101	1.0000000
zheyou73v0_A10	16852868	16853924	BnaA10T0130700ZY	0	+	159	898	1056	0.8503788
zheyou73v0_A10	16854232	16855000	BnaA10T0130800ZY	0	-	26	575	768	0.7486979
zheyou73v0_A10	16905842	16912511	BnaA10T0130900ZY	0	+	952	4102	6669	0.6150847
zheyou73v0_A10	16919869	16920370	BnaA10T0131000ZY	0	+	439	501	501	1.0000000
zheyou73v0_A10	16920406	16921042	BnaA10T0131100ZY	0	+	439	636	636	1.0000000
zheyou73v0_A10	16930443	16933228	BnaA10T0131200ZY	0	-	285	1725	2785	0.6193896
zheyou73v0_A10	16938925	16939408	BnaA10T0131300ZY	0	+	138	471	483	0.9751553
zheyou73v0_A10	16946894	16956007	BnaA10T0131400ZY	0	-	478	2873	9113	0.3152639
zheyou73v0_A10	16962330	16964288	BnaA10T0131500ZY	0	-	818	1891	1958	0.9657814
zheyou73v0_A10	16965526	16966333	BnaA10T0131600ZY	0	-	145	736	807	0.9120198
zheyou73v0_A10	16983491	16984451	BnaA10T0131700ZY	0	-	183	960	960	1.0000000
zheyou73v0_A10	16986485	16987640	BnaA10T0131800ZY	0	-	22	562	1155	0.4865801
zheyou73v0_A10	16986485	16987640	BnaA10T0131800ZY.1	0	-	22	562	1155	0.4865801
zheyou73v0_A10	16993598	16994429	BnaA10T0131900ZY	0	-	0	0	831	0.0000000
zheyou73v0_A10	17007761	17010217	BnaA10T0132000ZY	0	+	200	1670	2456	0.6799674
zheyou73v0_A10	17012111	17013637	BnaA10T0132100ZY	0	-	290	1318	1526	0.8636959
zheyou73v0_A10	17014125	17016274	BnaA10T0132200ZY	0	+	892	1267	2149	0.5895765
zheyou73v0_A10	17030303	17030674	BnaA10T0132300ZY	0	+	4	110	371	0.2964959
zheyou73v0_A10	17035019	17035388	BnaA10T0132400ZY	0	+	59	245	369	0.6639566
zheyou73v0_A10	17035650	17036972	BnaA10T0132500ZY	0	-	324	1203	1322	0.9099849
zheyou73v0_A10	17037515	17039077	BnaA10T0132600ZY	0	-	100	971	1562	0.6216390
zheyou73v0_A10	17043866	17046625	BnaA10T0132700ZY	0	-	1135	2539	2759	0.9202610
zheyou73v0_A10	17049748	17051336	BnaA10T0132800ZY	0	+	347	1283	1588	0.8079345
zheyou73v0_A10	17049748	17050725	BnaA10T0132800ZY.1	0	+	40	696	977	0.7123849
zheyou73v0_A10	17049748	17051336	BnaA10T0132800ZY.2	0	+	347	1283	1588	0.8079345
zheyou73v0_A10	17051421	17054335	BnaA10T0132900ZY	0	-	408	2466	2914	0.8462594
zheyou73v0_A10	17054790	17057173	BnaA10T0133000ZY	0	+	511	1386	2383	0.5816198
zheyou73v0_A10	17061287	17063637	BnaA10T0133100ZY	0	-	819	2215	2350	0.9425532
zheyou73v0_A10	17088119	17090624	BnaA10T0133200ZY	0	+	460	1969	2505	0.7860280
zheyou73v0_A10	17098605	17103542	BnaA10T0133300ZY	0	+	1864	4573	4937	0.9262710
zheyou73v0_A10	17106558	17108177	BnaA10T0133400ZY	0	-	655	1520	1619	0.9388511
zheyou73v0_A10	17109109	17112288	BnaA10T0133500ZY	0	-	473	2792	3179	0.8782636
zheyou73v0_A10	17109109	17112289	BnaA10T0133500ZY.1	0	-	473	2793	3180	0.8783019
zheyou73v0_A10	17112793	17113919	BnaA10T0133600ZY	0	+	24	247	1126	0.2193606
zheyou73v0_A10	17130479	17134073	BnaA10T0133700ZY	0	+	1394	3290	3594	0.9154146
zheyou73v0_A10	17134118	17135525	BnaA10T0133800ZY	0	-	238	933	1407	0.6631130
zheyou73v0_A10	17134118	17135525	BnaA10T0133800ZY.1	0	-	238	933	1407	0.6631130
zheyou73v0_A10	17134118	17135525	BnaA10T0133800ZY.2	0	-	238	933	1407	0.6631130
zheyou73v0_A10	17136860	17138187	BnaA10T0133900ZY	0	-	105	955	1327	0.7196684
zheyou73v0_A10	17136860	17138187	BnaA10T0133900ZY.1	0	-	105	955	1327	0.7196684
zheyou73v0_A10	17136860	17138187	BnaA10T0133900ZY.2	0	-	105	955	1327	0.7196684
zheyou73v0_A10	17138712	17144084	BnaA10T0134000ZY	0	+	44	1448	5372	0.2695458
zheyou73v0_A10	17157442	17158420	BnaA10T0134100ZY	0	-	99	372	978	0.3803681
zheyou73v0_A10	17162185	17165835	BnaA10T0134200ZY	0	-	26	962	3650	0.2635616
zheyou73v0_A10	17166862	17168007	BnaA10T0134300ZY	0	+	391	1145	1145	1.0000000
zheyou73v0_A10	17175978	17177069	BnaA10T0134400ZY	0	+	169	772	1091	0.7076077
zheyou73v0_A10	17183774	17188392	BnaA10T0134500ZY	0	-	426	2594	4618	0.5617150
zheyou73v0_A10	17188689	17192035	BnaA10T0134600ZY	0	+	220	2552	3346	0.7627017
zheyou73v0_A10	17193257	17195984	BnaA10T0134700ZY	0	+	264	1974	2727	0.7238724
zheyou73v0_A10	17221631	17223970	BnaA10T0134800ZY	0	+	195	1955	2339	0.8358273
zheyou73v0_A10	17230812	17233258	BnaA10T0134900ZY	0	+	129	1463	2446	0.5981194
zheyou73v0_A10	17233757	17235405	BnaA10T0135000ZY	0	+	248	1518	1648	0.9211165
zheyou73v0_A10	17254003	17256022	BnaA10T0135100ZY	0	+	21	623	2019	0.3085686
zheyou73v0_A10	17256107	17260377	BnaA10T0135200ZY	0	+	1727	3935	4270	0.9215457
zheyou73v0_A10	17261496	17262512	BnaA10T0135300ZY	0	+	96	480	1016	0.4724410
zheyou73v0_A10	17268315	17269230	BnaA10T0135400ZY	0	+	95	666	915	0.7278689
zheyou73v0_A10	17271554	17273157	BnaA10T0135500ZY	0	+	699	1603	1603	1.0000000
zheyou73v0_A10	17280729	17282023	BnaA10T0135600ZY	0	-	195	1178	1294	0.9103555
zheyou73v0_A10	17287850	17288520	BnaA10T0135700ZY	0	+	92	414	670	0.6179104
zheyou73v0_A10	17301320	17303518	BnaA10T0135800ZY	0	+	637	2052	2198	0.9335760
zheyou73v0_A10	17303874	17306701	BnaA10T0135900ZY	0	-	1352	2728	2827	0.9649805
zheyou73v0_A10	17309636	17310772	BnaA10T0136000ZY	0	-	402	1136	1136	1.0000000
zheyou73v0_A10	17315227	17317717	BnaA10T0136100ZY	0	+	230	1598	2490	0.6417671
zheyou73v0_A10	17317955	17319176	BnaA10T0136200ZY	0	-	256	1084	1221	0.8877969
zheyou73v0_A10	17321988	17324558	BnaA10T0136300ZY	0	+	889	2409	2570	0.9373541
zheyou73v0_A10	17328625	17329762	BnaA10T0136400ZY	0	-	0	0	1137	0.0000000
zheyou73v0_A10	17331563	17332418	BnaA10T0136500ZY	0	-	154	548	855	0.6409357
zheyou73v0_A10	17333810	17341057	BnaA10T0136600ZY	0	+	1895	6302	7247	0.8696012
zheyou73v0_A10	17333810	17341057	BnaA10T0136600ZY.1	0	+	1895	6302	7247	0.8696012
zheyou73v0_A10	17333810	17341057	BnaA10T0136600ZY.2	0	+	1895	6302	7247	0.8696012
zheyou73v0_A10	17333810	17341057	BnaA10T0136600ZY.3	0	+	1895	6302	7247	0.8696012
zheyou73v0_A10	17354782	17359108	BnaA10T0136700ZY	0	-	1551	4270	4326	0.9870550
zheyou73v0_A10	17365425	17365846	BnaA10T0136800ZY	0	-	44	218	421	0.5178148
zheyou73v0_A10	17366567	17367383	BnaA10T0136900ZY	0	+	87	626	816	0.7671568
zheyou73v0_A10	17368612	17369428	BnaA10T0137000ZY	0	+	26	482	816	0.5906863
zheyou73v0_A10	17369839	17370921	BnaA10T0137100ZY	0	-	103	840	1082	0.7763401
zheyou73v0_A10	17371958	17373622	BnaA10T0137200ZY	0	-	281	1346	1664	0.8088942
zheyou73v0_A10	17374131	17376411	BnaA10T0137300ZY	0	-	850	2167	2280	0.9504386
zheyou73v0_A10	17378814	17379158	BnaA10T0137400ZY	0	-	3	61	344	0.1773256
zheyou73v0_A10	17381089	17384353	BnaA10T0137500ZY	0	+	930	3075	3264	0.9420956
zheyou73v0_A10	17384769	17387014	BnaA10T0137600ZY	0	+	357	1442	2245	0.6423163
zheyou73v0_A10	17404573	17407595	BnaA10T0137700ZY	0	+	848	2903	3022	0.9606221
zheyou73v0_A10	17404573	17407595	BnaA10T0137700ZY.1	0	+	848	2903	3022	0.9606221
zheyou73v0_A10	17404573	17407595	BnaA10T0137700ZY.2	0	+	848	2903	3022	0.9606221
zheyou73v0_A10	17404573	17406861	BnaA10T0137700ZY.3	0	+	722	2172	2288	0.9493007
zheyou73v0_A10	17408147	17409734	BnaA10T0137800ZY	0	+	513	1518	1587	0.9565217
zheyou73v0_A10	17410742	17414496	BnaA10T0137900ZY	0	+	280	2878	3754	0.7666489
zheyou73v0_A10	17415077	17415476	BnaA10T0138000ZY	0	-	74	335	399	0.8395990
zheyou73v0_A10	17419783	17422458	BnaA10T0138100ZY	0	+	58	1115	2675	0.4168224
zheyou73v0_A10	17424460	17424784	BnaA10T0138200ZY	0	-	125	324	324	1.0000000
zheyou73v0_A10	17426930	17429449	BnaA10T0138300ZY	0	+	951	2008	2519	0.7971417
zheyou73v0_A10	17429923	17432845	BnaA10T0138400ZY	0	-	347	2426	2922	0.8302532
zheyou73v0_A10	17433127	17433940	BnaA10T0138500ZY	0	-	330	786	813	0.9667897
zheyou73v0_A10	17435300	17436659	BnaA10T0138600ZY	0	-	238	1218	1359	0.8962473
zheyou73v0_A10	17445276	17445979	BnaA10T0138700ZY	0	-	53	412	703	0.5860597
zheyou73v0_A10	17447564	17448722	BnaA10T0138800ZY	0	+	80	979	1158	0.8454232
zheyou73v0_A10	17457235	17458043	BnaA10T0138900ZY	0	-	216	808	808	1.0000000
zheyou73v0_A10	17465165	17465991	BnaA10T0139000ZY	0	+	65	712	826	0.8619854
zheyou73v0_A10	17493838	17498719	BnaA10T0139100ZY	0	+	600	3546	4881	0.7264905
zheyou73v0_A10	17499037	17502516	BnaA10T0139200ZY	0	-	117	1675	3479	0.4814602
zheyou73v0_A10	17529616	17533896	BnaA10T0139300ZY	0	-	207	2727	4280	0.6371495
zheyou73v0_A10	17541705	17546595	BnaA10T0139400ZY	0	-	1250	4888	4890	0.9995910
zheyou73v0_A10	17559594	17563452	BnaA10T0139500ZY	0	+	239	2280	3858	0.5909798
zheyou73v0_A10	17567234	17569683	BnaA10T0139600ZY	0	+	242	1276	2449	0.5210290
zheyou73v0_A10	17572476	17573134	BnaA10T0139700ZY	0	+	30	335	658	0.5091186
zheyou73v0_A10	17582156	17584120	BnaA10T0139800ZY	0	+	235	1185	1964	0.6033605
zheyou73v0_A10	17592415	17593849	BnaA10T0139900ZY	0	-	357	1228	1434	0.8563459
zheyou73v0_A10	17597433	17598968	BnaA10T0140000ZY	0	-	184	1304	1535	0.8495114
zheyou73v0_A10	17603887	17604986	BnaA10T0140100ZY	0	+	325	829	1099	0.7543221
zheyou73v0_A10	17613043	17613446	BnaA10T0140200ZY	0	-	244	403	403	1.0000000
zheyou73v0_A10	17615871	17616351	BnaA10T0140300ZY	0	+	32	263	480	0.5479167
zheyou73v0_A10	17616650	17619643	BnaA10T0140400ZY	0	-	375	2265	2993	0.7567658
zheyou73v0_A10	17628068	17629533	BnaA10T0140500ZY	0	-	346	1465	1465	1.0000000
zheyou73v0_A10	17628068	17629533	BnaA10T0140500ZY.1	0	-	346	1465	1465	1.0000000
zheyou73v0_A10	17631270	17632901	BnaA10T0140600ZY	0	-	280	1364	1631	0.8362967
zheyou73v0_A10	17658260	17660167	BnaA10T0140700ZY	0	+	235	1631	1907	0.8552700
zheyou73v0_A10	17660496	17662675	BnaA10T0140800ZY	0	-	229	2034	2179	0.9334557
zheyou73v0_A10	17664216	17667432	BnaA10T0140900ZY	0	+	796	2258	3216	0.7021144
zheyou73v0_A10	17676608	17677739	BnaA10T0141000ZY	0	+	8	174	1131	0.1538462
zheyou73v0_A10	17683023	17684181	BnaA10T0141100ZY	0	+	120	1004	1158	0.8670121
zheyou73v0_A10	17685231	17685657	BnaA10T0141200ZY	0	+	65	417	426	0.9788733
zheyou73v0_A10	17686095	17686601	BnaA10T0141300ZY	0	-	134	445	506	0.8794466
zheyou73v0_A10	17690676	17693119	BnaA10T0141400ZY	0	+	360	2070	2443	0.8473189
zheyou73v0_A10	17694088	17696529	BnaA10T0141500ZY	0	+	353	1897	2441	0.7771405
zheyou73v0_A10	17696654	17700060	BnaA10T0141600ZY	0	-	1087	3355	3406	0.9850264
zheyou73v0_A10	17705449	17705962	BnaA10T0141700ZY	0	+	0	0	513	0.0000000
zheyou73v0_A10	17720313	17720874	BnaA10T0141800ZY	0	-	402	561	561	1.0000000
zheyou73v0_A10	17723688	17725952	BnaA10T0141900ZY	0	+	462	1970	2264	0.8701413
zheyou73v0_A10	17723688	17725043	BnaA10T0141900ZY.1	0	+	166	1187	1355	0.8760148
zheyou73v0_A10	17725998	17726343	BnaA10T0142000ZY	0	+	60	319	345	0.9246377
zheyou73v0_A10	17727160	17728609	BnaA10T0142100ZY	0	+	955	1449	1449	1.0000000
zheyou73v0_A10	17732135	17739988	BnaA10T0142200ZY	0	+	1184	5897	7853	0.7509232
zheyou73v0_A10	17748535	17754892	BnaA10T0142300ZY	0	+	621	3851	6357	0.6057889
zheyou73v0_A10	17756864	17757324	BnaA10T0142400ZY	0	+	336	460	460	1.0000000
zheyou73v0_A10	17757312	17759244	BnaA10T0142500ZY	0	-	649	1895	1932	0.9808488
zheyou73v0_A10	17759536	17763563	BnaA10T0142600ZY	0	-	401	2858	4027	0.7097095
zheyou73v0_A10	17766793	17768523	BnaA10T0142700ZY	0	-	156	930	1730	0.5375723
zheyou73v0_A10	17784489	17785154	BnaA10T0142800ZY	0	-	97	663	665	0.9969925
zheyou73v0_A10	17805256	17806390	BnaA10T0142900ZY	0	+	16	556	1134	0.4902998
zheyou73v0_A10	17810056	17811496	BnaA10T0143000ZY	0	+	2	54	1440	0.0375000
zheyou73v0_A10	17815860	17817308	BnaA10T0143100ZY	0	+	11	412	1448	0.2845304
zheyou73v0_A10	17817341	17817781	BnaA10T0143200ZY	0	-	10	166	440	0.3772727
zheyou73v0_A10	17822003	17826135	BnaA10T0143300ZY	0	+	595	2215	4132	0.5360600
zheyou73v0_A10	17822003	17826135	BnaA10T0143300ZY.1	0	+	595	2215	4132	0.5360600
zheyou73v0_A10	17823527	17826135	BnaA10T0143300ZY.2	0	+	314	1689	2608	0.6476227
zheyou73v0_A10	17829856	17834804	BnaA10T0143400ZY	0	-	611	3029	4948	0.6121665
zheyou73v0_A10	17829856	17834804	BnaA10T0143400ZY.1	0	-	611	3029	4948	0.6121665
zheyou73v0_A10	17843117	17847716	BnaA10T0143500ZY	0	+	646	3223	4599	0.7008045
zheyou73v0_A10	17852900	17856505	BnaA10T0143600ZY	0	-	771	3481	3605	0.9656034
zheyou73v0_A10	17863436	17865638	BnaA10T0143700ZY	0	+	573	2003	2202	0.9096276
zheyou73v0_A10	17878326	17884196	BnaA10T0143800ZY	0	+	190	2410	5870	0.4105622
zheyou73v0_A10	17889140	17889350	BnaA10T0143900ZY	0	-	193	210	210	1.0000000
zheyou73v0_A10	17890823	17891868	BnaA10T0144000ZY	0	-	3	94	1045	0.0899522
zheyou73v0_A10	17894322	17897948	BnaA10T0144100ZY	0	-	2328	3626	3626	1.0000000
zheyou73v0_A10	17931360	17934104	BnaA10T0144200ZY	0	+	876	2478	2744	0.9030612
zheyou73v0_A10	17938031	17940397	BnaA10T0144300ZY	0	+	407	1844	2366	0.7793745
zheyou73v0_A10	17942640	17944374	BnaA10T0144400ZY	0	+	244	1121	1734	0.6464821
zheyou73v0_A10	17949172	17950765	BnaA10T0144500ZY	0	+	650	1548	1593	0.9717514
zheyou73v0_A10	17952967	17953704	BnaA10T0144600ZY	0	+	250	737	737	1.0000000
zheyou73v0_A10	17957256	17960051	BnaA10T0144700ZY	0	+	408	2444	2795	0.8744186
zheyou73v0_A10	17960799	17961823	BnaA10T0144800ZY	0	+	120	805	1024	0.7861328
zheyou73v0_A10	17961833	17962425	BnaA10T0144900ZY	0	-	137	451	592	0.7618243
zheyou73v0_A10	17963584	17967271	BnaA10T0145000ZY	0	-	216	1120	3687	0.3037700
zheyou73v0_A10	17968714	17969913	BnaA10T0145100ZY	0	-	237	883	1199	0.7364470
zheyou73v0_A10	17968714	17969913	BnaA10T0145100ZY.1	0	-	237	883	1199	0.7364470
zheyou73v0_A10	17970777	17972669	BnaA10T0145200ZY	0	-	90	871	1892	0.4603594
zheyou73v0_A10	17970777	17972669	BnaA10T0145200ZY.1	0	-	90	871	1892	0.4603594
zheyou73v0_A10	17973726	17974431	BnaA10T0145300ZY	0	-	476	705	705	1.0000000
zheyou73v0_A10	17974920	17982996	BnaA10T0145400ZY	0	+	838	4473	8076	0.5538633
zheyou73v0_A10	17984799	17987206	BnaA10T0145500ZY	0	-	1444	2284	2407	0.9488990
zheyou73v0_A10	17995441	17996137	BnaA10T0145600ZY	0	-	46	312	696	0.4482759
zheyou73v0_A10	17997167	17997782	BnaA10T0145700ZY	0	-	81	561	615	0.9121951
zheyou73v0_A10	17998405	17999052	BnaA10T0145800ZY	0	+	267	557	647	0.8608965
zheyou73v0_A10	17999235	18000148	BnaA10T0145900ZY	0	+	110	294	913	0.3220153
zheyou73v0_A10	18029356	18030961	BnaA10T0146000ZY	0	+	288	1033	1605	0.6436137
zheyou73v0_A10	18037749	18040346	BnaA10T0146100ZY	0	+	1204	2597	2597	1.0000000
zheyou73v0_A10	18043928	18046139	BnaA10T0146200ZY	0	+	399	1776	2211	0.8032565
zheyou73v0_A10	18048900	18050878	BnaA10T0146300ZY	0	+	111	321	1978	0.1622851
zheyou73v0_A10	18052686	18058771	BnaA10T0146400ZY	0	+	1106	4656	6085	0.7651602
zheyou73v0_A10	18059048	18060630	BnaA10T0146500ZY	0	+	68	1183	1582	0.7477876
zheyou73v0_A10	18060919	18067048	BnaA10T0146600ZY	0	-	1745	5810	6129	0.9479523
zheyou73v0_A10	18083904	18085268	BnaA10T0146700ZY	0	+	218	1079	1364	0.7910557
zheyou73v0_A10	18085351	18087014	BnaA10T0146800ZY	0	-	148	1270	1663	0.7636801
zheyou73v0_A10	18089976	18090865	BnaA10T0146900ZY	0	+	19	397	889	0.4465692
zheyou73v0_A10	18095237	18100090	BnaA10T0147000ZY	0	+	2702	4707	4853	0.9699155
zheyou73v0_A10	18103703	18104924	BnaA10T0147100ZY	0	+	136	720	1221	0.5896806
zheyou73v0_A10	18105595	18111372	BnaA10T0147200ZY	0	-	741	4362	5777	0.7550632
zheyou73v0_A10	18111915	18113748	BnaA10T0147300ZY	0	+	467	1746	1833	0.9525368
zheyou73v0_A10	18113239	18113566	BnaA10T0147400ZY	0	-	48	272	327	0.8318043
zheyou73v0_A10	18131087	18134213	BnaA10T0147500ZY	0	-	255	2591	3126	0.8288547
zheyou73v0_A10	18149913	18151268	BnaA10T0147600ZY	0	-	347	1278	1355	0.9431734
zheyou73v0_A10	18149913	18151268	BnaA10T0147600ZY.1	0	-	347	1278	1355	0.9431734
zheyou73v0_A10	18151786	18154925	BnaA10T0147700ZY	0	-	608	2660	3139	0.8474036
zheyou73v0_A10	18157576	18162303	BnaA10T0147800ZY	0	-	1110	3644	4727	0.7708907
zheyou73v0_A10	18162566	18164906	BnaA10T0147900ZY	0	-	143	1024	2340	0.4376068
zheyou73v0_A10	18162566	18164002	BnaA10T0147900ZY.1	0	-	73	358	1436	0.2493036
zheyou73v0_A10	18171110	18171623	BnaA10T0148000ZY	0	-	197	513	513	1.0000000
zheyou73v0_A10	18173632	18178172	BnaA10T0148100ZY	0	+	559	3616	4540	0.7964758
zheyou73v0_A10	18179054	18183782	BnaA10T0148200ZY	0	-	1144	3922	4728	0.8295262
zheyou73v0_A10	18195419	18200046	BnaA10T0148300ZY	0	-	220	2347	4627	0.5072401
zheyou73v0_A10	18206621	18208301	BnaA10T0148400ZY	0	+	271	1491	1680	0.8875000
zheyou73v0_A10	18208507	18210040	BnaA10T0148500ZY	0	-	99	954	1533	0.6223092
zheyou73v0_A10	18213438	18217839	BnaA10T0148600ZY	0	-	783	2762	4401	0.6275846
zheyou73v0_A10	18221323	18228991	BnaA10T0148700ZY	0	-	1194	5810	7668	0.7576943
zheyou73v0_A10	18232504	18234929	BnaA10T0148800ZY	0	-	472	2236	2425	0.9220619
zheyou73v0_A10	18237372	18240813	BnaA10T0148900ZY	0	-	220	1919	3441	0.5576867
zheyou73v0_A10	18242500	18243829	BnaA10T0149000ZY	0	-	297	1286	1329	0.9676449
zheyou73v0_A10	18246238	18250675	BnaA10T0149100ZY	0	+	553	2512	4437	0.5661483
zheyou73v0_A10	18246238	18250675	BnaA10T0149100ZY.1	0	+	553	2512	4437	0.5661483
zheyou73v0_A10	18249644	18250688	BnaA10T0149200ZY	0	-	294	1044	1044	1.0000000
zheyou73v0_A10	18250884	18253066	BnaA10T0149300ZY	0	+	209	1186	2182	0.5435380
zheyou73v0_A10	18254191	18254356	BnaA10T0149400ZY	0	+	17	38	165	0.2303030
zheyou73v0_A10	18254874	18259852	BnaA10T0149500ZY	0	+	189	2706	4978	0.5435918
zheyou73v0_A10	18260424	18261981	BnaA10T0149600ZY	0	+	137	1477	1557	0.9486191
zheyou73v0_A10	18262929	18266597	BnaA10T0149700ZY	0	+	650	3538	3668	0.9645584
zheyou73v0_A10	18267153	18268165	BnaA10T0149800ZY	0	-	40	530	1012	0.5237154
zheyou73v0_A10	18268535	18277306	BnaA10T0149900ZY	0	-	1657	7083	8771	0.8075476
zheyou73v0_A10	18287449	18290544	BnaA10T0150000ZY	0	+	638	2443	3095	0.7893376
zheyou73v0_A10	18297261	18301744	BnaA10T0150100ZY	0	-	690	3386	4483	0.7552978
zheyou73v0_A10	18303989	18305489	BnaA10T0150200ZY	0	-	250	1343	1500	0.8953333
zheyou73v0_A10	18308275	18310836	BnaA10T0150300ZY	0	+	248	1839	2561	0.7180789
zheyou73v0_A10	18308275	18310836	BnaA10T0150300ZY.1	0	+	248	1839	2561	0.7180789
zheyou73v0_A10	18324144	18325621	BnaA10T0150400ZY	0	-	133	970	1477	0.6567366
zheyou73v0_A10	18324144	18325621	BnaA10T0150400ZY.1	0	-	133	970	1477	0.6567366
zheyou73v0_A10	18326037	18329128	BnaA10T0150500ZY	0	+	458	2573	3091	0.8324167
zheyou73v0_A10	18330885	18331407	BnaA10T0150600ZY	0	+	13	262	522	0.5019157
zheyou73v0_A10	18334594	18335272	BnaA10T0150700ZY	0	-	194	678	678	1.0000000
zheyou73v0_A10	18343738	18352020	BnaA10T0150800ZY	0	+	1742	6187	8282	0.7470418
zheyou73v0_A10	18361592	18364910	BnaA10T0150900ZY	0	+	171	2237	3318	0.6742013
zheyou73v0_A10	18369208	18369832	BnaA10T0151000ZY	0	+	91	581	624	0.9310898
zheyou73v0_A10	18371771	18373853	BnaA10T0151100ZY	0	-	488	1916	2082	0.9202690
zheyou73v0_A10	18371771	18373853	BnaA10T0151100ZY.1	0	-	488	1916	2082	0.9202690
zheyou73v0_A10	18376176	18377035	BnaA10T0151200ZY	0	+	269	853	859	0.9930151
zheyou73v0_A10	18381090	18382155	BnaA10T0151300ZY	0	+	542	1065	1065	1.0000000
zheyou73v0_A10	18386041	18391442	BnaA10T0151400ZY	0	+	952	4034	5401	0.7468987
zheyou73v0_A10	18391761	18399313	BnaA10T0151500ZY	0	-	1924	6377	7552	0.8444121
zheyou73v0_A10	18399439	18401811	BnaA10T0151600ZY	0	-	691	2343	2372	0.9877740
zheyou73v0_A10	18413634	18416111	BnaA10T0151700ZY	0	-	16	684	2477	0.2761405
zheyou73v0_A10	18416956	18419790	BnaA10T0151800ZY	0	-	499	1811	2834	0.6390261
zheyou73v0_A10	18424503	18425375	BnaA10T0151900ZY	0	+	80	623	872	0.7144495
zheyou73v0_A10	18428248	18429165	BnaA10T0152000ZY	0	+	150	834	917	0.9094875
zheyou73v0_A10	18430321	18438292	BnaA10T0152100ZY	0	+	486	4796	7971	0.6016811
zheyou73v0_A10	18441880	18442848	BnaA10T0152200ZY	0	+	118	611	968	0.6311983
zheyou73v0_A10	18443596	18447396	BnaA10T0152300ZY	0	-	471	3270	3800	0.8605263
zheyou73v0_A10	18449021	18453394	BnaA10T0152400ZY	0	-	679	3705	4373	0.8472444
zheyou73v0_A10	18449150	18450704	BnaA10T0152500ZY	0	+	162	1168	1554	0.7516087
zheyou73v0_A10	18454789	18456059	BnaA10T0152600ZY	0	+	151	1020	1270	0.8031496
zheyou73v0_A10	18456582	18457629	BnaA10T0152700ZY	0	-	250	828	1047	0.7908310
zheyou73v0_A10	18463221	18464827	BnaA10T0152800ZY	0	-	8	19	1606	0.0118306
zheyou73v0_A10	18472784	18475213	BnaA10T0152900ZY	0	+	496	1714	2429	0.7056402
zheyou73v0_A10	18476013	18478194	BnaA10T0153000ZY	0	+	754	1959	2181	0.8982118
zheyou73v0_A10	18478470	18479454	BnaA10T0153100ZY	0	-	156	895	984	0.9095529
zheyou73v0_A10	18481587	18484931	BnaA10T0153200ZY	0	-	448	2304	3344	0.6889952
zheyou73v0_A10	18487884	18490361	BnaA10T0153300ZY	0	+	99	1377	2477	0.5559144
zheyou73v0_A10	18490901	18492608	BnaA10T0153400ZY	0	-	89	409	1707	0.2396016
zheyou73v0_A10	18497185	18501789	BnaA10T0153500ZY	0	+	359	3051	4604	0.6626846
zheyou73v0_A10	18502241	18505531	BnaA10T0153600ZY	0	-	1143	3255	3290	0.9893617
zheyou73v0_A10	18507352	18508736	BnaA10T0153700ZY	0	-	407	1311	1384	0.9472544
zheyou73v0_A10	18510305	18510839	BnaA10T0153800ZY	0	+	84	322	534	0.6029962
zheyou73v0_A10	18511687	18516144	BnaA10T0153900ZY	0	-	501	2938	4457	0.6591878
zheyou73v0_A10	18517387	18518425	BnaA10T0154000ZY	0	-	110	859	1038	0.8275530
zheyou73v0_A10	18522082	18531380	BnaA10T0154100ZY	0	+	971	5282	9298	0.5680792
zheyou73v0_A10	18531894	18533313	BnaA10T0154200ZY	0	-	75	777	1419	0.5475687
zheyou73v0_A10	18534233	18537394	BnaA10T0154300ZY	0	+	271	2271	3161	0.7184435
zheyou73v0_A10	18537568	18539048	BnaA10T0154400ZY	0	+	150	1340	1480	0.9054054
zheyou73v0_A10	18541400	18545677	BnaA10T0154500ZY	0	+	359	1777	4277	0.4154781
zheyou73v0_A10	18549199	18551732	BnaA10T0154600ZY	0	+	410	1035	2533	0.4086064
zheyou73v0_A10	18552701	18556029	BnaA10T0154700ZY	0	+	151	670	3328	0.2013221
zheyou73v0_A10	18556289	18559434	BnaA10T0154800ZY	0	-	205	1879	3145	0.5974563
zheyou73v0_A10	18562711	18565001	BnaA10T0154900ZY	0	-	212	1711	2290	0.7471616
zheyou73v0_A10	18566348	18568366	BnaA10T0155000ZY	0	-	408	1651	2018	0.8181368
zheyou73v0_A10	18571292	18571837	BnaA10T0155100ZY	0	-	288	545	545	1.0000000
zheyou73v0_A10	18575924	18607993	BnaA10T0155200ZY	0	-	2913	12964	32069	0.4042533
zheyou73v0_A10	18575924	18607575	BnaA10T0155200ZY.1	0	-	2833	12547	31651	0.3964172
zheyou73v0_A10	18609346	18610366	BnaA10T0155300ZY	0	-	279	1020	1020	1.0000000
zheyou73v0_A10	18613884	18615005	BnaA10T0155400ZY	0	+	404	1005	1121	0.8965210
zheyou73v0_A10	18613884	18615005	BnaA10T0155400ZY.1	0	+	404	1005	1121	0.8965210
zheyou73v0_A10	18616561	18619418	BnaA10T0155500ZY	0	-	362	1833	2857	0.6415821
zheyou73v0_A10	18625243	18626095	BnaA10T0155600ZY	0	+	0	0	852	0.0000000
zheyou73v0_A10	18630810	18632267	BnaA10T0155700ZY	0	+	139	838	1457	0.5751544
zheyou73v0_A10	18632458	18635022	BnaA10T0155800ZY	0	+	617	2218	2564	0.8650546
zheyou73v0_A10	18632458	18635022	BnaA10T0155800ZY.1	0	+	617	2218	2564	0.8650546
zheyou73v0_A10	18634942	18635302	BnaA10T0155900ZY	0	-	13	228	360	0.6333333
zheyou73v0_A10	18636215	18637720	BnaA10T0156000ZY	0	+	319	1324	1505	0.8797342
zheyou73v0_A10	18638266	18641242	BnaA10T0156100ZY	0	+	710	2958	2976	0.9939516
zheyou73v0_A10	18643801	18646004	BnaA10T0156200ZY	0	+	392	1651	2203	0.7494326
zheyou73v0_A10	18648607	18650519	BnaA10T0156300ZY	0	+	153	774	1912	0.4048117
zheyou73v0_A10	18648607	18650519	BnaA10T0156300ZY.1	0	+	153	774	1912	0.4048117
zheyou73v0_A10	18653972	18655795	BnaA10T0156400ZY	0	+	178	1157	1823	0.6346681
zheyou73v0_A10	18658486	18660625	BnaA10T0156500ZY	0	+	236	1204	2139	0.5628799
zheyou73v0_A10	18662771	18663563	BnaA10T0156600ZY	0	-	226	698	792	0.8813131
zheyou73v0_A10	18666466	18667828	BnaA10T0156700ZY	0	-	150	827	1362	0.6071953
zheyou73v0_A10	18674399	18675849	BnaA10T0156800ZY	0	+	46	593	1450	0.4089655
zheyou73v0_A10	18676205	18676914	BnaA10T0156900ZY	0	+	50	603	709	0.8504937
zheyou73v0_A10	18677151	18679043	BnaA10T0157000ZY	0	+	43	689	1892	0.3641649
zheyou73v0_A10	18677151	18679043	BnaA10T0157000ZY.1	0	+	43	689	1892	0.3641649
zheyou73v0_A10	18681586	18687844	BnaA10T0157100ZY	0	+	178	2024	6258	0.3234260
zheyou73v0_A10	18688810	18689575	BnaA10T0157200ZY	0	+	87	765	765	1.0000000
zheyou73v0_A10	18689886	18691556	BnaA10T0157300ZY	0	-	76	1345	1670	0.8053892
zheyou73v0_A10	18699943	18701600	BnaA10T0157400ZY	0	+	79	1080	1657	0.6517803
zheyou73v0_A10	18702490	18704363	BnaA10T0157500ZY	0	+	352	1492	1873	0.7965830
zheyou73v0_A10	18704437	18706217	BnaA10T0157600ZY	0	-	230	1282	1780	0.7202247
zheyou73v0_A10	18706330	18709239	BnaA10T0157700ZY	0	-	1420	2730	2909	0.9384668
zheyou73v0_A10	18709449	18712567	BnaA10T0157800ZY	0	-	142	1050	3118	0.3367543
zheyou73v0_A10	18709449	18712567	BnaA10T0157800ZY.2	0	-	142	1050	3118	0.3367543
zheyou73v0_A10	18709449	18711344	BnaA10T0157800ZY.3	0	-	139	805	1895	0.4248021
zheyou73v0_A10	18709818	18712567	BnaA10T0157800ZY.1	0	-	88	725	2749	0.2637323
zheyou73v0_A10	18715466	18716993	BnaA10T0157900ZY	0	-	173	928	1527	0.6077276
zheyou73v0_A10	18721289	18727142	BnaA10T0158000ZY	0	-	980	3505	5853	0.5988382
zheyou73v0_A10	18730267	18732924	BnaA10T0158100ZY	0	-	363	1881	2657	0.7079413
zheyou73v0_A10	18733269	18733643	BnaA10T0158200ZY	0	+	90	365	374	0.9759358
zheyou73v0_A10	18737791	18738602	BnaA10T0158300ZY	0	+	23	355	811	0.4377312
zheyou73v0_A10	18738894	18741301	BnaA10T0158400ZY	0	-	406	1564	2407	0.6497715
zheyou73v0_A10	18744866	18749548	BnaA10T0158500ZY	0	-	1198	3888	4682	0.8304144
zheyou73v0_A10	18751950	18756429	BnaA10T0158600ZY	0	+	122	2272	4479	0.5072561
zheyou73v0_A10	18757647	18758965	BnaA10T0158700ZY	0	+	73	745	1318	0.5652504
zheyou73v0_A10	18762013	18764301	BnaA10T0158800ZY	0	+	29	749	2288	0.3273602
zheyou73v0_A10	18764950	18767551	BnaA10T0158900ZY	0	-	113	1168	2601	0.4490581
zheyou73v0_A10	18771300	18774794	BnaA10T0159000ZY	0	-	491	2703	3494	0.7736119
zheyou73v0_A10	18779733	18786311	BnaA10T0159100ZY	0	+	69	880	6578	0.1337793
zheyou73v0_A10	18788344	18790038	BnaA10T0159200ZY	0	-	18	592	1694	0.3494687
zheyou73v0_A10	18792003	18795527	BnaA10T0159300ZY	0	-	221	1878	3524	0.5329171
zheyou73v0_A10	18797242	18798716	BnaA10T0159400ZY	0	+	249	1233	1474	0.8364993
zheyou73v0_A10	18799155	18801828	BnaA10T0159500ZY	0	+	1007	2419	2673	0.9049757
zheyou73v0_A10	18802020	18804155	BnaA10T0159600ZY	0	-	95	1225	2135	0.5737705
zheyou73v0_A10	18802020	18804155	BnaA10T0159600ZY.1	0	-	95	1225	2135	0.5737705
zheyou73v0_A10	18804845	18805387	BnaA10T0159700ZY	0	+	0	0	542	0.0000000
zheyou73v0_A10	18804845	18805852	BnaA10T0159700ZY.1	0	+	72	354	1007	0.3515392
zheyou73v0_A10	18806378	18810105	BnaA10T0159800ZY	0	-	268	2631	3727	0.7059297
zheyou73v0_A10	18811471	18813758	BnaA10T0159900ZY	0	+	207	1736	2287	0.7590730
zheyou73v0_A10	18814121	18815942	BnaA10T0160000ZY	0	-	519	1703	1821	0.9352005
zheyou73v0_A10	18817939	18822949	BnaA10T0160100ZY	0	+	1164	3882	5010	0.7748503
zheyou73v0_A10	18822956	18825248	BnaA10T0160200ZY	0	+	621	1615	2292	0.7046248
zheyou73v0_A10	18825712	18830196	BnaA10T0160300ZY	0	-	416	2748	4484	0.6128457
zheyou73v0_A10	18831242	18837290	BnaA10T0160400ZY	0	-	534	3476	6048	0.5747355
zheyou73v0_A10	18842014	18844557	BnaA10T0160500ZY	0	-	642	2170	2543	0.8533229
zheyou73v0_A10	18842014	18844471	BnaA10T0160500ZY.1	0	-	600	2084	2457	0.8481889
zheyou73v0_A10	18850642	18851706	BnaA10T0160600ZY	0	+	33	722	1064	0.6785714
zheyou73v0_A10	18853479	18857940	BnaA10T0160700ZY	0	+	70	1075	4461	0.2409774
zheyou73v0_A10	18861756	18863634	BnaA10T0160800ZY	0	+	55	857	1878	0.4563365
zheyou73v0_A10	18864291	18864939	BnaA10T0160900ZY	0	-	297	648	648	1.0000000
zheyou73v0_A10	18865711	18868162	BnaA10T0161000ZY	0	-	786	2287	2451	0.9330885
zheyou73v0_A10	18868705	18869696	BnaA10T0161100ZY	0	-	89	429	991	0.4328961
zheyou73v0_A10	18870361	18873512	BnaA10T0161200ZY	0	-	1061	3065	3151	0.9727071
zheyou73v0_A10	18879930	18880865	BnaA10T0161300ZY	0	+	59	610	935	0.6524064
zheyou73v0_A10	18889209	18892158	BnaA10T0161400ZY	0	+	364	2252	2949	0.7636487
zheyou73v0_A10	18892165	18892860	BnaA10T0161500ZY	0	-	11	348	695	0.5007194
zheyou73v0_A10	18893889	18894759	BnaA10T0161600ZY	0	-	143	791	870	0.9091954
zheyou73v0_A10	18896151	18898489	BnaA10T0161700ZY	0	-	530	2234	2338	0.9555175
zheyou73v0_A10	18898993	18900929	BnaA10T0161800ZY	0	-	242	1512	1936	0.7809917
zheyou73v0_A10	18903954	18906949	BnaA10T0161900ZY	0	-	1040	2630	2995	0.8781302
zheyou73v0_A10	18903954	18906949	BnaA10T0161900ZY.1	0	-	1040	2630	2995	0.8781302
zheyou73v0_A10	18913249	18917547	BnaA10T0162000ZY	0	+	921	3731	4298	0.8680782
zheyou73v0_A10	18916352	18917495	BnaA10T0162100ZY	0	-	42	917	1143	0.8022747
zheyou73v0_A10	18981070	18982618	BnaA10T0162200ZY	0	-	187	1161	1548	0.7500000
zheyou73v0_A10	18993973	18995874	BnaA10T0162300ZY	0	-	512	1702	1901	0.8953183
zheyou73v0_A10	19029242	19031397	BnaA10T0162400ZY	0	-	517	1822	2155	0.8454756
zheyou73v0_A10	19031918	19034130	BnaA10T0162500ZY	0	-	578	2208	2212	0.9981917
zheyou73v0_A10	19035302	19037322	BnaA10T0162600ZY	0	-	290	1805	2020	0.8935643
zheyou73v0_A10	19038882	19041458	BnaA10T0162700ZY	0	-	548	1986	2576	0.7709627
zheyou73v0_A10	19052583	19054112	BnaA10T0162800ZY	0	+	222	1427	1529	0.9332897
zheyou73v0_A10	19057795	19059500	BnaA10T0162900ZY	0	+	718	1321	1705	0.7747800
zheyou73v0_A10	19059859	19062285	BnaA10T0163000ZY	0	+	490	2308	2426	0.9513603
zheyou73v0_A10	19064659	19067625	BnaA10T0163100ZY	0	+	451	2545	2966	0.8580580
zheyou73v0_A10	19067791	19070514	BnaA10T0163200ZY	0	-	784	2650	2723	0.9731913
zheyou73v0_A10	19073726	19076662	BnaA10T0163300ZY	0	+	518	2637	2936	0.8981608
zheyou73v0_A10	19076877	19077685	BnaA10T0163400ZY	0	+	6	340	808	0.4207921
zheyou73v0_A10	19079310	19080975	BnaA10T0163500ZY	0	+	378	1648	1665	0.9897898
zheyou73v0_A10	19081233	19083202	BnaA10T0163600ZY	0	-	570	1928	1969	0.9791772
zheyou73v0_A10	19101333	19102573	BnaA10T0163700ZY	0	+	127	1116	1240	0.9000000
zheyou73v0_A10	19104179	19104744	BnaA10T0163800ZY	0	-	137	565	565	1.0000000
zheyou73v0_A10	19106954	19108505	BnaA10T0163900ZY	0	+	164	1447	1551	0.9329465
zheyou73v0_A10	19108830	19115951	BnaA10T0164000ZY	0	-	1518	4203	7121	0.5902261
zheyou73v0_A10	19127068	19130079	BnaA10T0164100ZY	0	-	113	1169	3011	0.3882431
zheyou73v0_A10	19132236	19136260	BnaA10T0164200ZY	0	-	601	3181	4024	0.7905070
zheyou73v0_A10	19139991	19141355	BnaA10T0164300ZY	0	-	272	1282	1364	0.9398827
zheyou73v0_A10	19139991	19141355	BnaA10T0164300ZY.1	0	-	272	1282	1364	0.9398827
zheyou73v0_A10	19142739	19145785	BnaA10T0164400ZY	0	-	235	2084	3046	0.6841760
zheyou73v0_A10	19149858	19153116	BnaA10T0164500ZY	0	-	802	3222	3258	0.9889503
zheyou73v0_A10	19153847	19159153	BnaA10T0164600ZY	0	+	96	1800	5306	0.3392386
zheyou73v0_A10	19161756	19162499	BnaA10T0164700ZY	0	+	6	19	743	0.0255720
zheyou73v0_A10	19168269	19170209	BnaA10T0164800ZY	0	+	164	1000	1940	0.5154639
zheyou73v0_A10	19172497	19174621	BnaA10T0164900ZY	0	-	319	1484	2124	0.6986817
zheyou73v0_A10	19178408	19178879	BnaA10T0165000ZY	0	+	126	471	471	1.0000000
zheyou73v0_A10	19178910	19182610	BnaA10T0165100ZY	0	-	570	2838	3700	0.7670270
zheyou73v0_A10	19179075	19180314	BnaA10T0165200ZY	0	+	209	649	1239	0.5238096
zheyou73v0_A10	19184885	19191034	BnaA10T0165300ZY	0	-	841	4264	6149	0.6934461
zheyou73v0_A10	19191755	19197328	BnaA10T0165400ZY	0	+	326	2656	5573	0.4765835
zheyou73v0_A10	19197756	19200645	BnaA10T0165500ZY	0	-	242	1988	2889	0.6881274
zheyou73v0_A10	19209687	19210425	BnaA10T0165600ZY	0	+	172	715	738	0.9688347
zheyou73v0_A10	19211537	19214984	BnaA10T0165700ZY	0	+	1369	3278	3447	0.9509718
zheyou73v0_A10	19223574	19225370	BnaA10T0165800ZY	0	-	154	1343	1796	0.7477728
zheyou73v0_A10	19239446	19240400	BnaA10T0165900ZY	0	+	0	0	954	0.0000000
zheyou73v0_A10	19242418	19245010	BnaA10T0166000ZY	0	-	400	2279	2592	0.8792439
zheyou73v0_A10	19242418	19245010	BnaA10T0166000ZY.1	0	-	400	2279	2592	0.8792439
zheyou73v0_A10	19254957	19261857	BnaA10T0166100ZY	0	+	567	4124	6900	0.5976812
zheyou73v0_A10	19276178	19279108	BnaA10T0166200ZY	0	+	626	2335	2930	0.7969283
zheyou73v0_A10	19289029	19296407	BnaA10T0166300ZY	0	-	993	4681	7378	0.6344538
zheyou73v0_A10	19297139	19299903	BnaA10T0166400ZY	0	+	1088	2652	2764	0.9594790
zheyou73v0_A10	19300239	19302762	BnaA10T0166500ZY	0	-	96	1782	2523	0.7063020
zheyou73v0_A10	19303438	19307240	BnaA10T0166600ZY	0	+	175	1925	3802	0.5063125
zheyou73v0_A10	19308629	19309883	BnaA10T0166700ZY	0	+	383	941	1254	0.7503987
zheyou73v0_A10	19310073	19310697	BnaA10T0166800ZY	0	+	207	604	624	0.9679487
zheyou73v0_A10	19320262	19332581	BnaA10T0166900ZY	0	+	850	5760	12319	0.4675704
zheyou73v0_A10	19333564	19333992	BnaA10T0167000ZY	0	+	112	428	428	1.0000000
zheyou73v0_A10	19338718	19340354	BnaA10T0167100ZY	0	-	86	408	1636	0.2493888
zheyou73v0_A10	19338718	19340354	BnaA10T0167100ZY.1	0	-	86	408	1636	0.2493888
zheyou73v0_A10	19338718	19340354	BnaA10T0167100ZY.2	0	-	86	408	1636	0.2493888
zheyou73v0_A10	19348195	19349731	BnaA10T0167200ZY	0	+	65	793	1536	0.5162761
zheyou73v0_A10	19350551	19359726	BnaA10T0167300ZY	0	+	769	6352	9175	0.6923161
zheyou73v0_A10	19375384	19378274	BnaA10T0167400ZY	0	+	463	2165	2890	0.7491350
zheyou73v0_A10	19381514	19381971	BnaA10T0167500ZY	0	+	0	0	457	0.0000000
zheyou73v0_A10	19386331	19387869	BnaA10T0167600ZY	0	+	90	1022	1538	0.6644993
zheyou73v0_A10	19388822	19390147	BnaA10T0167700ZY	0	-	201	1126	1325	0.8498113
zheyou73v0_A10	19398786	19400565	BnaA10T0167800ZY	0	+	1028	1779	1779	1.0000000
zheyou73v0_A10	19401752	19407093	BnaA10T0167900ZY	0	+	690	4305	5341	0.8060288
zheyou73v0_A10	19401752	19407093	BnaA10T0167900ZY.1	0	+	690	4305	5341	0.8060288
zheyou73v0_A10	19407915	19409510	BnaA10T0168000ZY	0	+	172	1263	1595	0.7918496
zheyou73v0_A10	19409731	19410728	BnaA10T0168100ZY	0	-	206	866	997	0.8686058
zheyou73v0_A10	19411487	19413142	BnaA10T0168200ZY	0	-	316	1649	1655	0.9963746
zheyou73v0_A10	19416149	19420109	BnaA10T0168300ZY	0	+	328	2769	3960	0.6992424
zheyou73v0_A10	19424202	19426629	BnaA10T0168400ZY	0	-	565	2331	2427	0.9604450
zheyou73v0_A10	19424202	19426629	BnaA10T0168400ZY.1	0	-	565	2331	2427	0.9604450
zheyou73v0_A10	19424202	19426629	BnaA10T0168400ZY.2	0	-	565	2331	2427	0.9604450
zheyou73v0_A10	19430793	19431098	BnaA10T0168500ZY	0	+	35	231	305	0.7573770
zheyou73v0_A10	19431375	19432882	BnaA10T0168600ZY	0	-	563	1348	1507	0.8944924
zheyou73v0_A10	19436921	19438911	BnaA10T0168700ZY	0	-	566	1760	1990	0.8844221
zheyou73v0_A10	19441461	19442818	BnaA10T0168800ZY	0	-	913	1357	1357	1.0000000
zheyou73v0_A10	19448396	19450397	BnaA10T0168900ZY	0	-	104	1215	2001	0.6071964
zheyou73v0_A10	19468836	19469274	BnaA10T0169000ZY	0	-	120	438	438	1.0000000
zheyou73v0_A10	19469921	19473074	BnaA10T0169100ZY	0	-	89	1391	3153	0.4411671
zheyou73v0_A10	19479999	19480471	BnaA10T0169200ZY	0	+	277	472	472	1.0000000
zheyou73v0_A10	19481600	19484910	BnaA10T0169300ZY	0	-	341	2445	3310	0.7386707
zheyou73v0_A10	19488480	19493489	BnaA10T0169400ZY	0	-	610	2777	5009	0.5544021
zheyou73v0_A10	19500043	19501522	BnaA10T0169500ZY	0	-	27	531	1479	0.3590264
zheyou73v0_A10	19503491	19505983	BnaA10T0169600ZY	0	-	392	2097	2492	0.8414928
zheyou73v0_A10	19503491	19505983	BnaA10T0169600ZY.1	0	-	392	2097	2492	0.8414928
zheyou73v0_A10	19509669	19511171	BnaA10T0169700ZY	0	+	4	28	1502	0.0186418
zheyou73v0_A10	19521913	19523981	BnaA10T0169800ZY	0	+	103	560	2068	0.2707931
zheyou73v0_A10	19525110	19526835	BnaA10T0169900ZY	0	-	274	1653	1725	0.9582609
zheyou73v0_A10	19530142	19531728	BnaA10T0170000ZY	0	-	237	1402	1586	0.8839849
zheyou73v0_A10	19539597	19541761	BnaA10T0170100ZY	0	+	218	1483	2164	0.6853050
zheyou73v0_A10	19543341	19545386	BnaA10T0170200ZY	0	-	64	964	2045	0.4713936
zheyou73v0_A10	19549889	19552563	BnaA10T0170300ZY	0	+	324	1573	2674	0.5882573
zheyou73v0_A10	19556517	19558443	BnaA10T0170400ZY	0	+	42	1099	1926	0.5706127
zheyou73v0_A10	19556517	19558443	BnaA10T0170400ZY.1	0	+	42	1099	1926	0.5706127
zheyou73v0_A10	19558854	19561187	BnaA10T0170500ZY	0	+	123	1307	2333	0.5602229
zheyou73v0_A10	19563126	19565054	BnaA10T0170600ZY	0	+	18	517	1928	0.2681535
zheyou73v0_A10	19565839	19567440	BnaA10T0170700ZY	0	-	103	932	1601	0.5821362
zheyou73v0_A10	19570785	19572887	BnaA10T0170800ZY	0	+	414	1993	2102	0.9481446
zheyou73v0_A10	19581896	19587144	BnaA10T0170900ZY	0	+	173	3289	5248	0.6267149
zheyou73v0_A10	19581896	19585816	BnaA10T0170900ZY.1	0	+	146	2609	3920	0.6655612
zheyou73v0_A10	19591617	19593463	BnaA10T0171000ZY	0	+	261	1438	1846	0.7789816
zheyou73v0_A10	19594099	19596001	BnaA10T0171100ZY	0	+	190	1643	1902	0.8638275
zheyou73v0_A10	19596189	19597284	BnaA10T0171200ZY	0	+	2	39	1095	0.0356164
zheyou73v0_A10	19610495	19612392	BnaA10T0171300ZY	0	+	3	15	1897	0.0079072
zheyou73v0_A10	19612648	19613857	BnaA10T0171400ZY	0	-	119	893	1209	0.7386270
zheyou73v0_A10	19613900	19614510	BnaA10T0171500ZY	0	+	219	565	610	0.9262295
zheyou73v0_A10	19614965	19616555	BnaA10T0171600ZY	0	+	378	727	1590	0.4572327
zheyou73v0_A10	19616472	19618901	BnaA10T0171700ZY	0	-	15	304	2429	0.1251544
zheyou73v0_A10	19619923	19620988	BnaA10T0171800ZY	0	+	0	0	1065	0.0000000
zheyou73v0_A10	19623161	19623955	BnaA10T0171900ZY	0	+	74	381	794	0.4798489
zheyou73v0_A10	19624233	19628119	BnaA10T0172000ZY	0	-	80	1919	3886	0.4938240
zheyou73v0_A10	19629957	19631126	BnaA10T0172100ZY	0	-	52	634	1169	0.5423439
zheyou73v0_A10	19632707	19634196	BnaA10T0172200ZY	0	+	510	1323	1489	0.8885158
zheyou73v0_A10	19634554	19637022	BnaA10T0172300ZY	0	+	502	2236	2468	0.9059967
zheyou73v0_A10	19637193	19639213	BnaA10T0172400ZY	0	+	118	1241	2020	0.6143565
zheyou73v0_A10	19639980	19642918	BnaA10T0172500ZY	0	-	48	671	2938	0.2283867
zheyou73v0_A10	19644157	19646211	BnaA10T0172600ZY	0	+	59	1210	2054	0.5890945
zheyou73v0_A10	19646802	19647318	BnaA10T0172700ZY	0	+	178	247	516	0.4786822
zheyou73v0_A10	19647495	19647747	BnaA10T0172800ZY	0	-	111	252	252	1.0000000
zheyou73v0_A10	19650189	19651394	BnaA10T0172900ZY	0	+	655	1134	1205	0.9410788
zheyou73v0_A10	19652222	19652798	BnaA10T0173000ZY	0	+	344	560	576	0.9722222
zheyou73v0_A10	19653836	19655373	BnaA10T0173100ZY	0	-	4	279	1537	0.1815224
zheyou73v0_A10	19656871	19661015	BnaA10T0173200ZY	0	-	913	3070	4144	0.7408301
zheyou73v0_A10	19665317	19668514	BnaA10T0173300ZY	0	+	467	2501	3197	0.7822959
zheyou73v0_A10	19674611	19676698	BnaA10T0173400ZY	0	-	779	1946	2087	0.9324389
zheyou73v0_A10	19677207	19681034	BnaA10T0173500ZY	0	-	1065	3100	3827	0.8100340
zheyou73v0_A10	19681273	19683085	BnaA10T0173600ZY	0	+	287	1667	1812	0.9199779
zheyou73v0_A10	19681273	19683085	BnaA10T0173600ZY.1	0	+	287	1667	1812	0.9199779
zheyou73v0_A10	19682924	19684115	BnaA10T0173700ZY	0	-	91	659	1191	0.5533165
zheyou73v0_A10	19685101	19687146	BnaA10T0173800ZY	0	+	24	711	2045	0.3476773
zheyou73v0_A10	19687432	19688523	BnaA10T0173900ZY	0	-	8	379	1091	0.3473877
zheyou73v0_A10	19702066	19706057	BnaA10T0174000ZY	0	-	460	2789	3991	0.6988224
zheyou73v0_A10	19705416	19706057	BnaA10T0174000ZY.1	0	-	10	208	641	0.3244930
zheyou73v0_A10	19720491	19725039	BnaA10T0174100ZY	0	+	102	1979	4548	0.4351363
zheyou73v0_A10	19734064	19736156	BnaA10T0174200ZY	0	+	189	1860	2092	0.8891013
zheyou73v0_A10	19736523	19738884	BnaA10T0174300ZY	0	+	730	2059	2361	0.8720881
zheyou73v0_A10	19739109	19739499	BnaA10T0174400ZY	0	-	84	374	390	0.9589744
zheyou73v0_A10	19739716	19745030	BnaA10T0174500ZY	0	-	179	2826	5314	0.5318028
zheyou73v0_A10	19747630	19750349	BnaA10T0174600ZY	0	+	271	1333	2719	0.4902538
zheyou73v0_A10	19754169	19758422	BnaA10T0174700ZY	0	+	519	2974	4253	0.6992711
zheyou73v0_A10	19762426	19765383	BnaA10T0174800ZY	0	+	528	2612	2957	0.8833277
zheyou73v0_A10	19765480	19766560	BnaA10T0174900ZY	0	-	392	1080	1080	1.0000000
zheyou73v0_A10	19767180	19768789	BnaA10T0175000ZY	0	-	816	1575	1609	0.9788688
zheyou73v0_A10	19770679	19772956	BnaA10T0175100ZY	0	+	665	1270	2277	0.5577514
zheyou73v0_A10	19773491	19773884	BnaA10T0175200ZY	0	-	33	373	393	0.9491094
zheyou73v0_A10	19774297	19774714	BnaA10T0175300ZY	0	-	128	417	417	1.0000000
zheyou73v0_A10	19775004	19775956	BnaA10T0175400ZY	0	-	521	952	952	1.0000000
zheyou73v0_A10	19777253	19779841	BnaA10T0175500ZY	0	+	898	2270	2588	0.8771252
zheyou73v0_A10	19780571	19780880	BnaA10T0175600ZY	0	+	2	79	309	0.2556634
zheyou73v0_A10	19782182	19783045	BnaA10T0175700ZY	0	+	0	0	863	0.0000000
zheyou73v0_A10	19784090	19784345	BnaA10T0175800ZY	0	+	317	255	255	1.0000000
zheyou73v0_A10	19798919	19800906	BnaA10T0175900ZY	0	-	382	1674	1987	0.8424761
zheyou73v0_A10	19801467	19809149	BnaA10T0176000ZY	0	-	736	2138	7682	0.2783130
zheyou73v0_A10	19811762	19813716	BnaA10T0176100ZY	0	+	336	1463	1954	0.7487206
zheyou73v0_A10	19813577	19816666	BnaA10T0176200ZY	0	-	230	2195	3089	0.7105860
zheyou73v0_A10	19817263	19822259	BnaA10T0176300ZY	0	-	322	3463	4996	0.6931545
zheyou73v0_A10	19823210	19826103	BnaA10T0176400ZY	0	-	269	2086	2893	0.7210508
zheyou73v0_A10	19823210	19826103	BnaA10T0176400ZY.1	0	-	269	2086	2893	0.7210508
zheyou73v0_A10	19823210	19826103	BnaA10T0176400ZY.2	0	-	269	2086	2893	0.7210508
zheyou73v0_A10	19826529	19828311	BnaA10T0176500ZY	0	-	160	1468	1782	0.8237935
zheyou73v0_A10	19829166	19831173	BnaA10T0176600ZY	0	+	153	1468	2007	0.7314399
zheyou73v0_A10	19829166	19831173	BnaA10T0176600ZY.1	0	+	153	1468	2007	0.7314399
zheyou73v0_A10	19831683	19834236	BnaA10T0176700ZY	0	-	42	1145	2553	0.4484920
zheyou73v0_A10	19834696	19839739	BnaA10T0176800ZY	0	+	282	3032	5043	0.6012294
zheyou73v0_A10	19842858	19844667	BnaA10T0176900ZY	0	+	175	1144	1809	0.6323936
zheyou73v0_A10	19845372	19847750	BnaA10T0177000ZY	0	+	348	1953	2378	0.8212784
zheyou73v0_A10	19847825	19848804	BnaA10T0177100ZY	0	-	379	969	979	0.9897855
zheyou73v0_A10	19850631	19852318	BnaA10T0177200ZY	0	+	631	1552	1687	0.9199763
zheyou73v0_A10	19853087	19858302	BnaA10T0177300ZY	0	+	680	3080	5215	0.5906040
zheyou73v0_A10	19853087	19858302	BnaA10T0177300ZY.1	0	+	680	3080	5215	0.5906040
zheyou73v0_A10	19858707	19860289	BnaA10T0177400ZY	0	-	293	1171	1582	0.7402022
zheyou73v0_A10	19863643	19864890	BnaA10T0177500ZY	0	-	153	530	1247	0.4250200
zheyou73v0_A10	19865378	19870178	BnaA10T0177600ZY	0	+	496	2837	4800	0.5910417
zheyou73v0_A10	19870535	19880146	BnaA10T0177700ZY	0	-	855	5121	9611	0.5328270
zheyou73v0_A10	19880426	19883669	BnaA10T0177800ZY	0	-	579	2758	3243	0.8504471
zheyou73v0_A10	19884343	19887272	BnaA10T0177900ZY	0	-	60	1103	2929	0.3765790
zheyou73v0_A10	19890093	19896872	BnaA10T0178000ZY	0	-	843	4820	6779	0.7110193
zheyou73v0_A10	19897057	19898704	BnaA10T0178100ZY	0	-	262	1298	1647	0.7880996
zheyou73v0_A10	19897057	19898704	BnaA10T0178100ZY.1	0	-	262	1298	1647	0.7880996
zheyou73v0_A10	19901605	19902604	BnaA10T0178200ZY	0	-	0	0	999	0.0000000
zheyou73v0_A10	19906567	19907366	BnaA10T0178300ZY	0	-	16	288	799	0.3604506
zheyou73v0_A10	19913564	19918736	BnaA10T0178400ZY	0	-	457	3302	5172	0.6384377
zheyou73v0_A10	19919468	19925082	BnaA10T0178500ZY	0	+	755	3837	5614	0.6834699
zheyou73v0_A10	19925163	19926496	BnaA10T0178600ZY	0	+	404	1202	1333	0.9017254
zheyou73v0_A10	19926861	19928427	BnaA10T0178700ZY	0	+	523	1235	1566	0.7886335
zheyou73v0_A10	19928980	19930477	BnaA10T0178800ZY	0	-	141	1276	1497	0.8523714
zheyou73v0_A10	19935500	19938836	BnaA10T0178900ZY	0	-	1122	3259	3336	0.9769185
zheyou73v0_A10	19941757	19945013	BnaA10T0179000ZY	0	+	627	3082	3256	0.9465602
zheyou73v0_A10	19949794	19951774	BnaA10T0179100ZY	0	-	81	945	1980	0.4772727
zheyou73v0_A10	19954671	19956953	BnaA10T0179200ZY	0	-	86	1176	2282	0.5153374
zheyou73v0_A10	19965590	19968555	BnaA10T0179300ZY	0	+	261	1756	2965	0.5922428
zheyou73v0_A10	19982506	19987830	BnaA10T0179400ZY	0	+	524	3816	5324	0.7167543
zheyou73v0_A10	19987854	19989007	BnaA10T0179500ZY	0	-	85	914	1153	0.7927147
zheyou73v0_A10	19989535	19991799	BnaA10T0179600ZY	0	-	852	1889	2264	0.8343639
zheyou73v0_A10	19995639	19997710	BnaA10T0179700ZY	0	-	498	1369	2071	0.6610333
zheyou73v0_A10	19998273	20000589	BnaA10T0179800ZY	0	-	293	1762	2316	0.7607945
zheyou73v0_A10	20001171	20003433	BnaA10T0179900ZY	0	+	76	1213	2262	0.5362511
zheyou73v0_A10	20004767	20005409	BnaA10T0180000ZY	0	+	3	201	642	0.3130841
zheyou73v0_A10	20006240	20007743	BnaA10T0180100ZY	0	+	518	1457	1503	0.9693946
zheyou73v0_A10	20006240	20007743	BnaA10T0180100ZY.1	0	+	518	1457	1503	0.9693946
zheyou73v0_A10	20006240	20007743	BnaA10T0180100ZY.2	0	+	518	1457	1503	0.9693946
zheyou73v0_A10	20006240	20007743	BnaA10T0180100ZY.3	0	+	518	1457	1503	0.9693946
zheyou73v0_A10	20008322	20009055	BnaA10T0180200ZY	0	-	41	595	733	0.8117326
zheyou73v0_A10	20023610	20024589	BnaA10T0180300ZY	0	+	0	0	979	0.0000000
zheyou73v0_A10	20039571	20041796	BnaA10T0180400ZY	0	-	90	982	2225	0.4413483
zheyou73v0_A10	20042431	20046874	BnaA10T0180500ZY	0	-	390	2320	4443	0.5221697
zheyou73v0_A10	20048350	20055680	BnaA10T0180600ZY	0	+	961	4109	7330	0.5605730
zheyou73v0_A10	20048350	20055680	BnaA10T0180600ZY.1	0	+	961	4109	7330	0.5605730
zheyou73v0_A10	20057840	20059658	BnaA10T0180700ZY	0	+	137	1252	1818	0.6886688
zheyou73v0_A10	20062333	20068293	BnaA10T0180800ZY	0	-	2008	5219	5960	0.8756711
zheyou73v0_A10	20062333	20068293	BnaA10T0180800ZY.1	0	-	2008	5219	5960	0.8756711
zheyou73v0_A10	20068705	20072629	BnaA10T0180900ZY	0	-	1306	3735	3924	0.9518349
zheyou73v0_A10	20073169	20073898	BnaA10T0181000ZY	0	+	32	455	729	0.6241426
zheyou73v0_A10	20073939	20077015	BnaA10T0181100ZY	0	-	925	2622	3076	0.8524057
zheyou73v0_A10	20078539	20081266	BnaA10T0181200ZY	0	-	353	2177	2727	0.7983131
zheyou73v0_A10	20085385	20087406	BnaA10T0181300ZY	0	+	256	1799	2021	0.8901534
zheyou73v0_A10	20088904	20092030	BnaA10T0181400ZY	0	+	1108	2889	3126	0.9241843
zheyou73v0_A10	20092730	20093526	BnaA10T0181500ZY	0	+	73	735	796	0.9233668
zheyou73v0_A10	20095104	20095730	BnaA10T0181600ZY	0	-	11	255	626	0.4073482
zheyou73v0_A10	20097432	20100624	BnaA10T0181700ZY	0	+	195	1467	3192	0.4595865
zheyou73v0_A10	20097432	20100624	BnaA10T0181700ZY.1	0	+	195	1467	3192	0.4595865
zheyou73v0_A10	20101078	20102680	BnaA10T0181800ZY	0	-	538	1448	1602	0.9038702
zheyou73v0_A10	20103472	20106701	BnaA10T0181900ZY	0	-	786	2487	3229	0.7702075
zheyou73v0_A10	20103472	20106701	BnaA10T0181900ZY.1	0	-	786	2487	3229	0.7702075
zheyou73v0_A10	20107934	20109163	BnaA10T0182000ZY	0	+	199	815	1229	0.6631408
zheyou73v0_A10	20109392	20110377	BnaA10T0182100ZY	0	-	151	985	985	1.0000000
zheyou73v0_A10	20111811	20113690	BnaA10T0182200ZY	0	-	46	1295	1879	0.6891964
zheyou73v0_A10	20119269	20120889	BnaA10T0182300ZY	0	+	272	1502	1620	0.9271605
zheyou73v0_A10	20122138	20124157	BnaA10T0182400ZY	0	+	231	1218	2019	0.6032689
zheyou73v0_A10	20124623	20126730	BnaA10T0182500ZY	0	+	307	1569	2107	0.7446607
zheyou73v0_A10	20127622	20132808	BnaA10T0182600ZY	0	+	1921	4957	5186	0.9558427
zheyou73v0_A10	20133465	20135997	BnaA10T0182700ZY	0	+	259	1474	2532	0.5821485
zheyou73v0_A10	20141519	20142800	BnaA10T0182800ZY	0	+	274	990	1281	0.7728337
zheyou73v0_A10	20144559	20147896	BnaA10T0182900ZY	0	+	1118	3215	3337	0.9634402
zheyou73v0_A10	20148232	20149070	BnaA10T0183000ZY	0	-	336	838	838	1.0000000
zheyou73v0_A10	20149429	20151990	BnaA10T0183100ZY	0	+	435	2048	2561	0.7996876
zheyou73v0_A10	20152216	20154568	BnaA10T0183200ZY	0	-	707	1969	2352	0.8371599
zheyou73v0_A10	20152216	20154568	BnaA10T0183200ZY.1	0	-	707	1969	2352	0.8371599
zheyou73v0_A10	20160737	20160890	BnaA10T0183300ZY	0	+	2	78	153	0.5098040
zheyou73v0_A10	20161216	20163778	BnaA10T0183400ZY	0	-	167	1181	2562	0.4609680
zheyou73v0_A10	20164759	20165998	BnaA10T0183500ZY	0	-	59	824	1239	0.6650525
zheyou73v0_A10	20166186	20170238	BnaA10T0183600ZY	0	-	541	3136	4052	0.7739388
zheyou73v0_A10	20172094	20175198	BnaA10T0183700ZY	0	-	608	2339	3104	0.7535438
zheyou73v0_A10	20195225	20197547	BnaA10T0183800ZY	0	-	463	1847	2322	0.7954350
zheyou73v0_A10	20197943	20198998	BnaA10T0183900ZY	0	-	114	672	1055	0.6369668
zheyou73v0_A10	20201759	20202866	BnaA10T0184000ZY	0	-	130	1025	1107	0.9259259
zheyou73v0_A10	20203023	20203209	BnaA10T0184100ZY	0	-	84	186	186	1.0000000
zheyou73v0_A10	20207184	20209661	BnaA10T0184200ZY	0	+	265	2024	2477	0.8171175
zheyou73v0_A10	20210424	20211858	BnaA10T0184300ZY	0	+	89	979	1434	0.6827057
zheyou73v0_A10	20212030	20213607	BnaA10T0184400ZY	0	-	458	1278	1577	0.8103995
zheyou73v0_A10	20215324	20216902	BnaA10T0184500ZY	0	+	32	785	1578	0.4974651
zheyou73v0_A10	20218442	20221635	BnaA10T0184600ZY	0	+	1064	2946	3193	0.9226433
zheyou73v0_A10	20223122	20224366	BnaA10T0184700ZY	0	+	215	1177	1244	0.9461415
zheyou73v0_A10	20227558	20228974	BnaA10T0184800ZY	0	+	412	1216	1416	0.8587571
zheyou73v0_A10	20231270	20232061	BnaA10T0184900ZY	0	-	210	780	791	0.9860936
zheyou73v0_A10	20240701	20241568	BnaA10T0185000ZY	0	-	747	867	867	1.0000000
zheyou73v0_A10	20244028	20247246	BnaA10T0185100ZY	0	-	1023	3174	3218	0.9863269
zheyou73v0_A10	20244028	20247246	BnaA10T0185100ZY.1	0	-	1023	3174	3218	0.9863269
zheyou73v0_A10	20247630	20248884	BnaA10T0185200ZY	0	+	289	1087	1254	0.8668262
zheyou73v0_A10	20251584	20254681	BnaA10T0185300ZY	0	+	797	2396	3097	0.7736519
zheyou73v0_A10	20251584	20254681	BnaA10T0185300ZY.1	0	+	797	2396	3097	0.7736519
zheyou73v0_A10	20254711	20255618	BnaA10T0185400ZY	0	-	323	907	907	1.0000000
zheyou73v0_A10	20258596	20260027	BnaA10T0185500ZY	0	+	156	1273	1431	0.8895877
zheyou73v0_A10	20260444	20260927	BnaA10T0185600ZY	0	+	125	414	483	0.8571429
zheyou73v0_A10	20261041	20261902	BnaA10T0185700ZY	0	-	169	673	861	0.7816492
zheyou73v0_A10	20270135	20272230	BnaA10T0185800ZY	0	+	209	795	2095	0.3794749
zheyou73v0_A10	20273362	20275924	BnaA10T0185900ZY	0	-	732	2518	2562	0.9828259
zheyou73v0_A10	20276752	20277541	BnaA10T0186000ZY	0	-	86	625	789	0.7921420
zheyou73v0_A10	20278617	20281417	BnaA10T0186100ZY	0	+	1528	2674	2800	0.9550000
zheyou73v0_A10	20281689	20291183	BnaA10T0186200ZY	0	-	2069	7828	9494	0.8245208
zheyou73v0_A10	20292471	20293311	BnaA10T0186300ZY	0	-	406	840	840	1.0000000
zheyou73v0_A10	20292471	20293212	BnaA10T0186300ZY.1	0	-	352	741	741	1.0000000
zheyou73v0_A10	20300236	20305449	BnaA10T0186400ZY	0	-	1235	3882	5213	0.7446768
zheyou73v0_A10	20315843	20319353	BnaA10T0186500ZY	0	+	902	3190	3510	0.9088319
zheyou73v0_A10	20315843	20319353	BnaA10T0186500ZY.1	0	+	902	3190	3510	0.9088319
zheyou73v0_A10	20319522	20320611	BnaA10T0186600ZY	0	-	261	993	1089	0.9118457
zheyou73v0_A10	20322017	20325008	BnaA10T0186700ZY	0	+	720	2491	2991	0.8328318
zheyou73v0_A10	20322017	20325008	BnaA10T0186700ZY.1	0	+	720	2491	2991	0.8328318
zheyou73v0_A10	20325506	20329558	BnaA10T0186800ZY	0	+	557	3583	4052	0.8842547
zheyou73v0_A10	20331572	20341205	BnaA10T0186900ZY	0	+	1231	6308	9633	0.6548324
zheyou73v0_A10	20341286	20343253	BnaA10T0187000ZY	0	-	857	1967	1967	1.0000000
zheyou73v0_A10	20350013	20352060	BnaA10T0187100ZY	0	+	282	1608	2047	0.7855398
zheyou73v0_A10	20353255	20355896	BnaA10T0187200ZY	0	+	322	2061	2641	0.7803862
zheyou73v0_A10	20353991	20355896	BnaA10T0187200ZY.1	0	+	217	1400	1905	0.7349082
zheyou73v0_A10	20358379	20362069	BnaA10T0187300ZY	0	+	526	2584	3690	0.7002710
zheyou73v0_A10	20364555	20367452	BnaA10T0187400ZY	0	+	246	2002	2897	0.6910597
zheyou73v0_A10	20370483	20375774	BnaA10T0187500ZY	0	+	847	2806	5291	0.5303345
zheyou73v0_A10	20376048	20377768	BnaA10T0187600ZY	0	-	292	1504	1720	0.8744186
zheyou73v0_A10	20378885	20379736	BnaA10T0187700ZY	0	+	94	678	851	0.7967098
zheyou73v0_A10	20380570	20382430	BnaA10T0187800ZY	0	+	71	1321	1860	0.7102150
zheyou73v0_A10	20382204	20384167	BnaA10T0187900ZY	0	-	310	1537	1963	0.7829852
zheyou73v0_A10	20385087	20389109	BnaA10T0188000ZY	0	-	1074	3954	4022	0.9830930
zheyou73v0_A10	20391353	20392072	BnaA10T0188100ZY	0	-	263	719	719	1.0000000
zheyou73v0_A10	20393236	20395197	BnaA10T0188200ZY	0	-	352	1661	1961	0.8470168
zheyou73v0_A10	20393236	20395197	BnaA10T0188200ZY.1	0	-	352	1661	1961	0.8470168
zheyou73v0_A10	20397741	20399356	BnaA10T0188300ZY	0	+	344	1519	1615	0.9405573
zheyou73v0_A10	20399715	20400481	BnaA10T0188400ZY	0	-	527	766	766	1.0000000
zheyou73v0_A10	20403267	20405312	BnaA10T0188500ZY	0	-	653	1483	2045	0.7251834
zheyou73v0_A10	20407036	20408074	BnaA10T0188600ZY	0	-	600	1038	1038	1.0000000
zheyou73v0_A10	20410294	20411705	BnaA10T0188700ZY	0	+	594	1411	1411	1.0000000
zheyou73v0_A10	20410294	20411705	BnaA10T0188700ZY.1	0	+	594	1411	1411	1.0000000
zheyou73v0_A10	20412335	20412708	BnaA10T0188800ZY	0	+	47	373	373	1.0000000
zheyou73v0_A10	20412767	20418006	BnaA10T0188900ZY	0	+	241	2139	5239	0.4082840
zheyou73v0_A10	20419067	20424157	BnaA10T0189000ZY	0	+	941	2954	5090	0.5803536
zheyou73v0_A10	20426815	20428095	BnaA10T0189100ZY	0	+	27	464	1280	0.3625000
zheyou73v0_A10	20428674	20429797	BnaA10T0189200ZY	0	+	372	1017	1123	0.9056100
zheyou73v0_A10	20431579	20432196	BnaA10T0189300ZY	0	+	174	617	617	1.0000000
zheyou73v0_A10	20432474	20435687	BnaA10T0189400ZY	0	-	130	1464	3213	0.4556489
zheyou73v0_A10	20440342	20441517	BnaA10T0189500ZY	0	+	12	439	1175	0.3736170
zheyou73v0_A10	20458242	20460028	BnaA10T0189600ZY	0	+	72	431	1786	0.2413214
zheyou73v0_A10	20465544	20468408	BnaA10T0189700ZY	0	-	269	2408	2864	0.8407821
zheyou73v0_A10	20468924	20471352	BnaA10T0189800ZY	0	-	80	1227	2428	0.5053542
zheyou73v0_A10	20477500	20479686	BnaA10T0189900ZY	0	-	264	1802	2186	0.8243367
zheyou73v0_A10	20483417	20485654	BnaA10T0190000ZY	0	-	192	1607	2237	0.7183728
zheyou73v0_A10	20487374	20492111	BnaA10T0190100ZY	0	+	1174	3498	4737	0.7384421
zheyou73v0_A10	20503547	20514618	BnaA10T0190200ZY	0	-	691	4414	11071	0.3986993
zheyou73v0_A10	20527756	20530768	BnaA10T0190300ZY	0	+	127	545	3012	0.1809429
zheyou73v0_A10	20532395	20536385	BnaA10T0190400ZY	0	+	649	2025	3990	0.5075188
zheyou73v0_A10	20536749	20538818	BnaA10T0190500ZY	0	-	1175	1879	2069	0.9081682
zheyou73v0_A10	20540719	20540890	BnaA10T0190600ZY	0	-	0	0	171	0.0000000
zheyou73v0_A10	20540959	20546410	BnaA10T0190700ZY	0	-	563	4142	5451	0.7598606
zheyou73v0_A10	20548770	20551209	BnaA10T0190800ZY	0	-	756	2191	2439	0.8983190
zheyou73v0_A10	20552377	20555787	BnaA10T0190900ZY	0	+	938	3027	3410	0.8876833
zheyou73v0_A10	20555925	20557792	BnaA10T0191000ZY	0	-	139	1472	1867	0.7884306
zheyou73v0_A10	20561056	20562671	BnaA10T0191100ZY	0	+	344	1419	1615	0.8786378
zheyou73v0_A10	20563023	20564615	BnaA10T0191200ZY	0	-	188	1195	1592	0.7506281
zheyou73v0_A10	20568410	20568768	BnaA10T0191300ZY	0	-	143	358	358	1.0000000
zheyou73v0_A10	20569435	20572222	BnaA10T0191400ZY	0	+	112	1354	2787	0.4858271
zheyou73v0_A10	20572978	20575927	BnaA10T0191500ZY	0	-	1019	2842	2949	0.9637165
zheyou73v0_A10	20580218	20581074	BnaA10T0191600ZY	0	+	381	821	856	0.9591122
zheyou73v0_A10	20583892	20584881	BnaA10T0191700ZY	0	-	324	989	989	1.0000000
zheyou73v0_A10	20589954	20595311	BnaA10T0191800ZY	0	+	796	3878	5357	0.7239127
zheyou73v0_A10	20589954	20595311	BnaA10T0191800ZY.1	0	+	796	3878	5357	0.7239127
zheyou73v0_A10	20589954	20595311	BnaA10T0191800ZY.2	0	+	796	3878	5357	0.7239127
zheyou73v0_A10	20600012	20602712	BnaA10T0191900ZY	0	+	204	1677	2700	0.6211111
zheyou73v0_A10	20608623	20609245	BnaA10T0192000ZY	0	+	69	524	622	0.8424437
zheyou73v0_A10	20609792	20610904	BnaA10T0192100ZY	0	+	346	1107	1112	0.9955036
zheyou73v0_A10	20613419	20616345	BnaA10T0192200ZY	0	+	339	2028	2926	0.6930964
zheyou73v0_A10	20615957	20617911	BnaA10T0192300ZY	0	-	42	694	1954	0.3551689
zheyou73v0_A10	20620605	20624198	BnaA10T0192400ZY	0	+	266	2287	3593	0.6365154
zheyou73v0_A10	20620605	20624198	BnaA10T0192400ZY.1	0	+	266	2287	3593	0.6365154
zheyou73v0_A10	20624410	20625785	BnaA10T0192500ZY	0	-	233	1095	1375	0.7963637
zheyou73v0_A10	20626424	20631043	BnaA10T0192600ZY	0	+	191	2635	4619	0.5704698
zheyou73v0_A10	20636833	20640320	BnaA10T0192700ZY	0	+	1461	3446	3487	0.9882420
zheyou73v0_A10	20636833	20640320	BnaA10T0192700ZY.1	0	+	1461	3446	3487	0.9882420
zheyou73v0_A10	20647070	20648758	BnaA10T0192800ZY	0	-	342	1619	1688	0.9591232
zheyou73v0_A10	20651760	20654660	BnaA10T0192900ZY	0	+	350	2066	2900	0.7124138
zheyou73v0_A10	20655212	20657446	BnaA10T0193000ZY	0	+	446	2112	2234	0.9453894
zheyou73v0_A10	20657631	20659146	BnaA10T0193100ZY	0	-	246	1137	1515	0.7504951
zheyou73v0_A10	20660702	20663328	BnaA10T0193200ZY	0	+	568	2282	2626	0.8690023
zheyou73v0_A10	20664134	20664667	BnaA10T0193300ZY	0	+	206	533	533	1.0000000
zheyou73v0_A10	20665201	20668052	BnaA10T0193400ZY	0	-	464	2612	2851	0.9161698
zheyou73v0_A10	20677644	20679736	BnaA10T0193500ZY	0	+	175	1497	2092	0.7155831
zheyou73v0_A10	20678707	20679736	BnaA10T0193500ZY.1	0	+	136	906	1029	0.8804665
zheyou73v0_A10	20680514	20681442	BnaA10T0193600ZY	0	+	172	844	928	0.9094828
zheyou73v0_A10	20683340	20688911	BnaA10T0193700ZY	0	+	1693	4529	5571	0.8129600
zheyou73v0_A10	20695352	20697495	BnaA10T0193800ZY	0	-	180	1484	2143	0.6924872
zheyou73v0_A10	20701281	20701506	BnaA10T0193900ZY	0	+	158	225	225	1.0000000
zheyou73v0_A10	20703143	20704102	BnaA10T0194000ZY	0	+	425	959	959	1.0000000
zheyou73v0_A10	20704176	20706362	BnaA10T0194100ZY	0	-	466	2146	2186	0.9817017
zheyou73v0_A10	20707794	20708853	BnaA10T0194200ZY	0	-	133	797	1059	0.7525968
zheyou73v0_A10	20709529	20715148	BnaA10T0194300ZY	0	-	939	5001	5619	0.8900160
zheyou73v0_A10	20715567	20716873	BnaA10T0194400ZY	0	+	59	839	1306	0.6424196
zheyou73v0_A10	20716945	20720763	BnaA10T0194500ZY	0	-	673	3181	3818	0.8331587
zheyou73v0_A10	20725499	20729540	BnaA10T0194600ZY	0	+	1755	4027	4041	0.9965355
zheyou73v0_A10	20725499	20729540	BnaA10T0194600ZY.1	0	+	1755	4027	4041	0.9965355
zheyou73v0_A10	20731241	20734059	BnaA10T0194700ZY	0	+	309	2202	2818	0.7814053
zheyou73v0_A10	20734828	20738543	BnaA10T0194800ZY	0	+	703	3389	3715	0.9122477
zheyou73v0_A10	20734828	20738543	BnaA10T0194800ZY.1	0	+	703	3389	3715	0.9122477
zheyou73v0_A10	20739371	20741113	BnaA10T0194900ZY	0	+	79	732	1742	0.4202067
zheyou73v0_A10	20742504	20743929	BnaA10T0195000ZY	0	+	286	1242	1425	0.8715789
zheyou73v0_A10	20744083	20747286	BnaA10T0195100ZY	0	-	1189	2931	3203	0.9150796
zheyou73v0_A10	20749477	20749690	BnaA10T0195200ZY	0	+	1	88	213	0.4131455
zheyou73v0_A10	20755455	20756446	BnaA10T0195300ZY	0	+	182	752	991	0.7588295
zheyou73v0_A10	20756825	20759098	BnaA10T0195400ZY	0	+	450	1721	2273	0.7571492
zheyou73v0_A10	20759115	20761083	BnaA10T0195500ZY	0	-	292	1392	1968	0.7073171
zheyou73v0_A10	20764379	20766607	BnaA10T0195600ZY	0	+	343	1987	2228	0.8918312
zheyou73v0_A10	20767035	20767386	BnaA10T0195700ZY	0	-	222	351	351	1.0000000
zheyou73v0_A10	20769384	20770962	BnaA10T0195800ZY	0	-	624	1578	1578	1.0000000
zheyou73v0_A10	20771617	20773262	BnaA10T0195900ZY	0	+	199	1393	1645	0.8468085
zheyou73v0_A10	20774011	20775666	BnaA10T0196000ZY	0	-	703	1646	1655	0.9945619
zheyou73v0_A10	20776699	20779315	BnaA10T0196100ZY	0	+	409	2394	2616	0.9151376
zheyou73v0_A10	20779959	20780427	BnaA10T0196200ZY	0	-	229	468	468	1.0000000
zheyou73v0_A10	20784794	20786201	BnaA10T0196300ZY	0	-	196	1157	1407	0.8223170
zheyou73v0_A10	20786715	20789194	BnaA10T0196400ZY	0	+	58	1707	2479	0.6885841
zheyou73v0_A10	20790278	20791622	BnaA10T0196500ZY	0	+	163	1279	1344	0.9516369
zheyou73v0_A10	20792394	20796515	BnaA10T0196600ZY	0	+	487	3258	4121	0.7905848
zheyou73v0_A10	20793605	20796515	BnaA10T0196600ZY.1	0	+	382	2212	2910	0.7601374
zheyou73v0_A10	20802936	20804666	BnaA10T0196700ZY	0	+	825	1681	1730	0.9716763
zheyou73v0_A10	20804953	20806030	BnaA10T0196800ZY	0	+	200	1019	1077	0.9461467
zheyou73v0_A10	20807959	20808774	BnaA10T0196900ZY	0	+	175	815	815	1.0000000
zheyou73v0_A10	20810145	20811413	BnaA10T0197000ZY	0	+	202	776	1268	0.6119874
zheyou73v0_A10	20813594	20814723	BnaA10T0197100ZY	0	-	296	1129	1129	1.0000000
zheyou73v0_A10	20816312	20817250	BnaA10T0197200ZY	0	+	28	654	938	0.6972281
zheyou73v0_A10	20818695	20822161	BnaA10T0197300ZY	0	-	1492	3466	3466	1.0000000
zheyou73v0_A10	20826881	20828548	BnaA10T0197400ZY	0	-	692	1564	1667	0.9382123
zheyou73v0_A10	20829516	20831127	BnaA10T0197500ZY	0	+	506	1384	1611	0.8590937
zheyou73v0_A10	20832168	20832366	BnaA10T0197600ZY	0	+	47	198	198	1.0000000
zheyou73v0_A10	20832708	20833621	BnaA10T0197700ZY	0	+	17	406	913	0.4446878
zheyou73v0_A10	20834390	20845097	BnaA10T0197800ZY	0	-	3358	9578	10707	0.8945550
zheyou73v0_A10	20850171	20852049	BnaA10T0197900ZY	0	+	624	1834	1878	0.9765708
zheyou73v0_A10	20852301	20853615	BnaA10T0198000ZY	0	-	130	1106	1314	0.8417047
zheyou73v0_A10	20854486	20859231	BnaA10T0198100ZY	0	+	1031	4512	4745	0.9508957
zheyou73v0_A10	20860823	20862718	BnaA10T0198200ZY	0	+	658	1894	1895	0.9994723
zheyou73v0_A10	20862859	20866385	BnaA10T0198300ZY	0	-	1511	3511	3526	0.9957459
zheyou73v0_A10	20867154	20871070	BnaA10T0198400ZY	0	-	1210	3595	3916	0.9180286
zheyou73v0_A10	20878685	20881344	BnaA10T0198500ZY	0	+	1405	2659	2659	1.0000000
zheyou73v0_A10	20881871	20883702	BnaA10T0198600ZY	0	-	447	1763	1831	0.9628618
zheyou73v0_A10	20884931	20887104	BnaA10T0198700ZY	0	-	491	2055	2173	0.9456972
zheyou73v0_A10	20888354	20892290	BnaA10T0198800ZY	0	+	1220	3761	3936	0.9555386
zheyou73v0_A10	20888354	20892290	BnaA10T0198800ZY.1	0	+	1220	3761	3936	0.9555386
zheyou73v0_A10	20892599	20895859	BnaA10T0198900ZY	0	-	865	2904	3260	0.8907976
zheyou73v0_A10	20897674	20899696	BnaA10T0199000ZY	0	-	1098	2022	2022	1.0000000
zheyou73v0_A10	20900461	20905369	BnaA10T0199100ZY	0	+	1139	4140	4908	0.8435208
zheyou73v0_A10	20900461	20905369	BnaA10T0199100ZY.1	0	+	1139	4140	4908	0.8435208
zheyou73v0_A10	20905620	20909371	BnaA10T0199200ZY	0	+	279	2627	3751	0.7003466
zheyou73v0_A10	20909712	20911227	BnaA10T0199300ZY	0	+	300	1400	1515	0.9240924
zheyou73v0_A10	20913083	20914330	BnaA10T0199400ZY	0	+	57	785	1247	0.6295108
zheyou73v0_A10	20916258	20919421	BnaA10T0199500ZY	0	+	597	3062	3163	0.9680683
zheyou73v0_A10	20918753	20919410	BnaA10T0199600ZY	0	-	97	608	657	0.9254186
zheyou73v0_A10	20919784	20923925	BnaA10T0199700ZY	0	-	799	3043	4141	0.7348467
zheyou73v0_A10	20926582	20927728	BnaA10T0199800ZY	0	+	797	1146	1146	1.0000000
zheyou73v0_A10	20929612	20930789	BnaA10T0199900ZY	0	-	404	1167	1177	0.9915038
zheyou73v0_A10	20929863	20930789	BnaA10T0199900ZY.1	0	-	256	916	926	0.9892009
zheyou73v0_A10	20931151	20932835	BnaA10T0200000ZY	0	+	276	1671	1684	0.9922803
zheyou73v0_A10	20933109	20934546	BnaA10T0200100ZY	0	+	425	1414	1437	0.9839944
zheyou73v0_A10	20935071	20937524	BnaA10T0200200ZY	0	+	531	2200	2453	0.8968610
zheyou73v0_A10	20937580	20941960	BnaA10T0200300ZY	0	-	340	2665	4380	0.6084475
zheyou73v0_A10	20947105	20949389	BnaA10T0200400ZY	0	+	798	2157	2284	0.9443958
zheyou73v0_A10	20962707	20964343	BnaA10T0200500ZY	0	-	804	1636	1636	1.0000000
zheyou73v0_A10	20965965	20970750	BnaA10T0200600ZY	0	+	863	4349	4785	0.9088819
zheyou73v0_A10	20971075	20971225	BnaA10T0200700ZY	0	-	120	150	150	1.0000000
zheyou73v0_A10	20971857	20973185	BnaA10T0200800ZY	0	+	48	597	1328	0.4495482
zheyou73v0_A10	20973352	20976419	BnaA10T0200900ZY	0	-	216	2583	3067	0.8421910
zheyou73v0_A10	20976690	20978960	BnaA10T0201000ZY	0	+	237	2167	2270	0.9546255
zheyou73v0_A10	20979217	20982653	BnaA10T0201100ZY	0	-	1519	3436	3436	1.0000000
zheyou73v0_A10	20983706	20991535	BnaA10T0201200ZY	0	-	3641	7498	7829	0.9577213
zheyou73v0_A10	20996987	20999145	BnaA10T0201300ZY	0	+	273	1590	2158	0.7367933
zheyou73v0_A10	20999157	21001709	BnaA10T0201400ZY	0	-	374	2108	2552	0.8260188
zheyou73v0_A10	21006048	21009338	BnaA10T0201500ZY	0	-	336	2609	3290	0.7930091
zheyou73v0_A10	21006048	21009338	BnaA10T0201500ZY.1	0	-	336	2609	3290	0.7930091
zheyou73v0_A10	21006048	21009338	BnaA10T0201500ZY.2	0	-	336	2609	3290	0.7930091
zheyou73v0_A10	21012593	21013479	BnaA10T0201600ZY	0	-	290	886	886	1.0000000
zheyou73v0_A10	21014307	21014760	BnaA10T0201700ZY	0	-	148	453	453	1.0000000
zheyou73v0_A10	21015249	21016308	BnaA10T0201800ZY	0	-	35	587	1059	0.5542965
zheyou73v0_A10	21016984	21018263	BnaA10T0201900ZY	0	+	232	1026	1279	0.8021892
zheyou73v0_A10	21016984	21018263	BnaA10T0201900ZY.1	0	+	232	1026	1279	0.8021892
zheyou73v0_A10	21023353	21024613	BnaA10T0202000ZY	0	-	149	1072	1260	0.8507937
zheyou73v0_A10	21051893	21054607	BnaA10T0202100ZY	0	+	612	2607	2714	0.9605748
zheyou73v0_A10	21055503	21058197	BnaA10T0202200ZY	0	-	625	2544	2694	0.9443207
zheyou73v0_A10	21059547	21061476	BnaA10T0202300ZY	0	+	255	1754	1929	0.9092794
zheyou73v0_A10	21062434	21063755	BnaA10T0202400ZY	0	+	103	828	1321	0.6267979
zheyou73v0_A10	21065877	21069993	BnaA10T0202500ZY	0	-	526	3246	4116	0.7886297
zheyou73v0_A10	21071077	21073593	BnaA10T0202600ZY	0	-	612	2235	2516	0.8883148
zheyou73v0_A10	21073969	21075439	BnaA10T0202700ZY	0	-	185	1249	1470	0.8496599
zheyou73v0_A10	21078041	21079152	BnaA10T0202800ZY	0	+	360	1102	1111	0.9918992
zheyou73v0_A10	21081615	21082862	BnaA10T0202900ZY	0	+	294	1185	1247	0.9502807
zheyou73v0_A10	21083106	21084754	BnaA10T0203000ZY	0	-	161	1186	1648	0.7196602
zheyou73v0_A10	21083106	21084293	BnaA10T0203000ZY.1	0	-	148	804	1187	0.6773378
zheyou73v0_A10	21084995	21089118	BnaA10T0203100ZY	0	-	786	3386	4123	0.8212467
zheyou73v0_A10	21085548	21089069	BnaA10T0203100ZY.1	0	-	675	2796	3521	0.7940926
zheyou73v0_A10	21091927	21094059	BnaA10T0203200ZY	0	+	469	1995	2132	0.9357411
zheyou73v0_A10	21094330	21097198	BnaA10T0203300ZY	0	-	441	2218	2868	0.7733612
zheyou73v0_A10	21097344	21100552	BnaA10T0203400ZY	0	+	1065	3208	3208	1.0000000
zheyou73v0_A10	21097344	21100392	BnaA10T0203400ZY.1	0	+	992	3048	3048	1.0000000
zheyou73v0_A10	21101747	21111714	BnaA10T0203500ZY	0	+	1374	8008	9967	0.8034514
zheyou73v0_A10	21112825	21113428	BnaA10T0203600ZY	0	+	31	419	603	0.6948590
zheyou73v0_A10	21115720	21117423	BnaA10T0203700ZY	0	+	395	1703	1703	1.0000000
zheyou73v0_A10	21128402	21129813	BnaA10T0203800ZY	0	+	47	804	1411	0.5698087
zheyou73v0_A10	21131692	21132817	BnaA10T0203900ZY	0	-	238	1064	1125	0.9457778
zheyou73v0_A10	21139614	21140903	BnaA10T0204000ZY	0	-	343	954	1289	0.7401086
zheyou73v0_A10	21147422	21147827	BnaA10T0204100ZY	0	-	18	322	405	0.7950617
zheyou73v0_A10	21155892	21158330	BnaA10T0204200ZY	0	+	382	1502	2438	0.6160787
zheyou73v0_A10	21159347	21161127	BnaA10T0204300ZY	0	+	153	1089	1780	0.6117977
zheyou73v0_A10	21162508	21162739	BnaA10T0204400ZY	0	+	36	231	231	1.0000000
zheyou73v0_A10	21165945	21168076	BnaA10T0204500ZY	0	+	1091	2066	2131	0.9694979
zheyou73v0_A10	21169924	21172041	BnaA10T0204600ZY	0	+	201	1392	2117	0.6575342
zheyou73v0_A10	21172382	21175154	BnaA10T0204700ZY	0	-	379	2606	2772	0.9401155
zheyou73v0_A10	21176128	21178295	BnaA10T0204800ZY	0	+	487	2151	2167	0.9926165
zheyou73v0_A10	21178823	21180967	BnaA10T0204900ZY	0	+	201	2031	2144	0.9472948
zheyou73v0_A10	21181959	21184141	BnaA10T0205000ZY	0	+	1054	2182	2182	1.0000000
zheyou73v0_A10	21184446	21186232	BnaA10T0205100ZY	0	-	401	1620	1786	0.9070548
zheyou73v0_A10	21186840	21188401	BnaA10T0205200ZY	0	-	465	1511	1561	0.9679692
zheyou73v0_A10	21188426	21188855	BnaA10T0205300ZY	0	-	44	339	429	0.7902098
zheyou73v0_A10	21190355	21193264	BnaA10T0205400ZY	0	-	580	2454	2909	0.8435889
zheyou73v0_A10	21194765	21197347	BnaA10T0205500ZY	0	-	166	1488	2582	0.5762975
zheyou73v0_A10	21202817	21203831	BnaA10T0205600ZY	0	-	205	1014	1014	1.0000000
zheyou73v0_A10	21207843	21208228	BnaA10T0205700ZY	0	-	0	0	385	0.0000000
zheyou73v0_A10	21208339	21210962	BnaA10T0205800ZY	0	-	62	737	2623	0.2809760
zheyou73v0_A10	21212009	21212499	BnaA10T0205900ZY	0	+	129	428	490	0.8734694
zheyou73v0_A10	21214896	21218018	BnaA10T0206000ZY	0	+	173	2187	3122	0.7005125
zheyou73v0_A10	21214896	21217640	BnaA10T0206000ZY.1	0	+	136	1924	2744	0.7011662
zheyou73v0_A10	21219005	21224250	BnaA10T0206100ZY	0	+	433	2753	5245	0.5248808
zheyou73v0_A10	21225430	21227445	BnaA10T0206200ZY	0	+	1196	2015	2015	1.0000000
zheyou73v0_A10	21228071	21235350	BnaA10T0206300ZY	0	-	770	5338	7279	0.7333425
zheyou73v0_A10	21238482	21239381	BnaA10T0206400ZY	0	+	167	840	899	0.9343715
zheyou73v0_A10	21239661	21241134	BnaA10T0206500ZY	0	-	149	1281	1473	0.8696538
zheyou73v0_A10	21241323	21247279	BnaA10T0206600ZY	0	+	1294	5062	5956	0.8498992
zheyou73v0_A10	21247571	21249009	BnaA10T0206700ZY	0	+	59	531	1438	0.3692629
zheyou73v0_A10	21249128	21253863	BnaA10T0206800ZY	0	-	389	2621	4735	0.5535375
zheyou73v0_A10	21253832	21256396	BnaA10T0206900ZY	0	+	250	2077	2564	0.8100624
zheyou73v0_A10	21263611	21264423	BnaA10T0207000ZY	0	+	41	386	812	0.4753695
zheyou73v0_A10	21268732	21269988	BnaA10T0207100ZY	0	+	12	415	1256	0.3304140
zheyou73v0_A10	21273592	21274725	BnaA10T0207200ZY	0	-	363	1116	1133	0.9849956
zheyou73v0_A10	21275144	21276709	BnaA10T0207300ZY	0	+	212	1078	1565	0.6888179
zheyou73v0_A10	21277081	21278348	BnaA10T0207400ZY	0	+	111	1069	1267	0.8437253
zheyou73v0_A10	21277649	21280918	BnaA10T0207500ZY	0	-	146	2180	3269	0.6668706
zheyou73v0_A10	21286531	21288481	BnaA10T0207600ZY	0	+	1172	1950	1950	1.0000000
zheyou73v0_A10	21286531	21288481	BnaA10T0207600ZY.1	0	+	1172	1950	1950	1.0000000
zheyou73v0_A10	21286531	21288481	BnaA10T0207600ZY.2	0	+	1172	1950	1950	1.0000000
zheyou73v0_A10	21289016	21289707	BnaA10T0207700ZY	0	-	41	203	691	0.2937771
zheyou73v0_A10	21291299	21294083	BnaA10T0207800ZY	0	+	811	2070	2784	0.7435345
zheyou73v0_A10	21291299	21294083	BnaA10T0207800ZY.1	0	+	811	2070	2784	0.7435345
zheyou73v0_A10	21294142	21294870	BnaA10T0207900ZY	0	-	79	263	728	0.3612637
zheyou73v0_A10	21294989	21297002	BnaA10T0208000ZY	0	-	283	1475	2013	0.7327372
zheyou73v0_A10	21297625	21301050	BnaA10T0208100ZY	0	+	579	2530	3425	0.7386861
zheyou73v0_A10	21301292	21301994	BnaA10T0208200ZY	0	+	59	546	702	0.7777778
zheyou73v0_A10	21301292	21302212	BnaA10T0208200ZY.1	0	+	71	603	920	0.6554348
zheyou73v0_A10	21302496	21303082	BnaA10T0208300ZY	0	-	57	586	586	1.0000000
zheyou73v0_A10	21305286	21310435	BnaA10T0208400ZY	0	+	1606	4951	5149	0.9615459
zheyou73v0_A10	21311743	21312504	BnaA10T0208500ZY	0	+	305	729	761	0.9579501
zheyou73v0_A10	21312829	21315365	BnaA10T0208600ZY	0	-	1150	2471	2536	0.9743691
zheyou73v0_A10	21316508	21318996	BnaA10T0208700ZY	0	+	269	1996	2488	0.8022508
zheyou73v0_A10	21317330	21320582	BnaA10T0208800ZY	0	-	280	2157	3252	0.6632841
zheyou73v0_A10	21320801	21323553	BnaA10T0208900ZY	0	-	100	1528	2752	0.5552326
zheyou73v0_A10	21326031	21329124	BnaA10T0209000ZY	0	+	191	2148	3093	0.6944714
zheyou73v0_A10	21331571	21332591	BnaA10T0209100ZY	0	-	6	317	1020	0.3107843
zheyou73v0_A10	21334744	21337272	BnaA10T0209200ZY	0	-	1016	2203	2528	0.8714399
zheyou73v0_A10	21337743	21338417	BnaA10T0209300ZY	0	+	109	662	674	0.9821959
zheyou73v0_A10	21341145	21343212	BnaA10T0209400ZY	0	+	362	1769	2067	0.8558297
zheyou73v0_A10	21344070	21346792	BnaA10T0209500ZY	0	+	366	2053	2722	0.7542248
zheyou73v0_A10	21352622	21353142	BnaA10T0209600ZY	0	+	449	520	520	1.0000000
zheyou73v0_A10	21353953	21356654	BnaA10T0209700ZY	0	+	349	1771	2701	0.6556831
zheyou73v0_A10	21353953	21356654	BnaA10T0209700ZY.1	0	+	349	1771	2701	0.6556831
zheyou73v0_A10	21357792	21359828	BnaA10T0209800ZY	0	-	203	1835	2036	0.9012770
zheyou73v0_A10	21357792	21359715	BnaA10T0209800ZY.1	0	-	202	1740	1923	0.9048362
zheyou73v0_A10	21357792	21359828	BnaA10T0209800ZY.2	0	-	203	1835	2036	0.9012770
zheyou73v0_A10	21367211	21367889	BnaA10T0209900ZY	0	+	0	0	678	0.0000000
zheyou73v0_A10	21377076	21377627	BnaA10T0210000ZY	0	+	60	163	551	0.2958258
zheyou73v0_A10	21380528	21382851	BnaA10T0210100ZY	0	-	474	1965	2323	0.8458889
zheyou73v0_A10	21384359	21386129	BnaA10T0210200ZY	0	+	182	1590	1770	0.8983051
zheyou73v0_A10	21386258	21388429	BnaA10T0210300ZY	0	-	869	2120	2171	0.9765085
zheyou73v0_A10	21391527	21392382	BnaA10T0210400ZY	0	-	66	604	855	0.7064328
zheyou73v0_A10	21400712	21402848	BnaA10T0210500ZY	0	+	95	1556	2136	0.7284644
zheyou73v0_A10	21403161	21404888	BnaA10T0210600ZY	0	-	271	1449	1727	0.8390272
zheyou73v0_A10	21406513	21407970	BnaA10T0210700ZY	0	+	114	1043	1457	0.7158545
zheyou73v0_A10	21408791	21409292	BnaA10T0210800ZY	0	+	145	501	501	1.0000000
zheyou73v0_A10	21409404	21411162	BnaA10T0210900ZY	0	-	557	1728	1758	0.9829351
zheyou73v0_A10	21411811	21416389	BnaA10T0211000ZY	0	+	574	1957	4578	0.4274792
zheyou73v0_A10	21419531	21421732	BnaA10T0211100ZY	0	+	116	1044	2201	0.4743299
zheyou73v0_A10	21422026	21423433	BnaA10T0211200ZY	0	-	91	679	1407	0.4825871
zheyou73v0_A10	21426444	21426905	BnaA10T0211300ZY	0	-	135	424	461	0.9197397
zheyou73v0_A10	21428484	21430609	BnaA10T0211400ZY	0	-	186	1624	2125	0.7642353
zheyou73v0_A10	21431055	21434339	BnaA10T0211500ZY	0	-	229	1814	3284	0.5523751
zheyou73v0_A10	21439669	21447607	BnaA10T0211600ZY	0	+	539	5402	7938	0.6805241
zheyou73v0_A10	21449131	21451489	BnaA10T0211700ZY	0	-	38	500	2358	0.2120441
zheyou73v0_A10	21454371	21458916	BnaA10T0211800ZY	0	+	2302	4545	4545	1.0000000
zheyou73v0_A10	21461174	21484564	BnaA10T0211900ZY	0	-	1999	12144	23390	0.5191962
zheyou73v0_A10	21490297	21492395	BnaA10T0212000ZY	0	-	217	1824	2098	0.8693994
zheyou73v0_A10	21493450	21495571	BnaA10T0212100ZY	0	-	174	1620	2121	0.7637907
zheyou73v0_A10	21493450	21495571	BnaA10T0212100ZY.1	0	-	174	1620	2121	0.7637907
zheyou73v0_A10	21495712	21496983	BnaA10T0212200ZY	0	-	91	1189	1271	0.9354839
zheyou73v0_A10	21495712	21496983	BnaA10T0212200ZY.1	0	-	91	1189	1271	0.9354839
zheyou73v0_A10	21497342	21498608	BnaA10T0212300ZY	0	+	114	963	1266	0.7606635
zheyou73v0_A10	21499051	21501739	BnaA10T0212400ZY	0	+	547	2349	2688	0.8738839
zheyou73v0_A10	21506653	21507563	BnaA10T0212500ZY	0	+	132	777	910	0.8538461
zheyou73v0_A10	21515882	21524135	BnaA10T0212600ZY	0	+	2222	7741	8253	0.9379619
zheyou73v0_A10	21526220	21527075	BnaA10T0212700ZY	0	+	69	705	855	0.8245614
zheyou73v0_A10	21529314	21530350	BnaA10T0212800ZY	0	+	129	1002	1036	0.9671814
zheyou73v0_A10	21534372	21540674	BnaA10T0212900ZY	0	-	641	2690	6302	0.4268486
zheyou73v0_A10	21546796	21551059	BnaA10T0213000ZY	0	-	1192	3895	4263	0.9136758
zheyou73v0_A10	21551688	21553388	BnaA10T0213100ZY	0	-	377	1681	1700	0.9888235
zheyou73v0_A10	21553959	21555873	BnaA10T0213200ZY	0	+	793	1914	1914	1.0000000
zheyou73v0_A10	21557868	21561353	BnaA10T0213300ZY	0	+	776	2951	3485	0.8467719
zheyou73v0_A10	21567074	21568861	BnaA10T0213400ZY	0	+	160	1667	1787	0.9328483
zheyou73v0_A10	21569071	21571253	BnaA10T0213500ZY	0	-	758	1603	2182	0.7346471
zheyou73v0_A10	21569071	21571253	BnaA10T0213500ZY.1	0	-	758	1603	2182	0.7346471
zheyou73v0_A10	21571691	21572711	BnaA10T0213600ZY	0	+	421	1020	1020	1.0000000
zheyou73v0_A10	21574745	21578006	BnaA10T0213700ZY	0	-	359	2305	3261	0.7068384
zheyou73v0_A10	21584217	21585687	BnaA10T0213800ZY	0	+	44	928	1470	0.6312925
zheyou73v0_A10	21586548	21590345	BnaA10T0213900ZY	0	+	1243	3583	3797	0.9436397
zheyou73v0_A10	21590977	21592655	BnaA10T0214000ZY	0	+	780	1678	1678	1.0000000
zheyou73v0_A10	21592715	21594929	BnaA10T0214100ZY	0	-	278	1644	2214	0.7425475
zheyou73v0_A10	21596687	21599860	BnaA10T0214200ZY	0	-	877	2907	3173	0.9161677
zheyou73v0_A10	21600182	21604081	BnaA10T0214300ZY	0	-	1112	3246	3899	0.8325211
zheyou73v0_A10	21606852	21608438	BnaA10T0214400ZY	0	+	367	1534	1586	0.9672131
zheyou73v0_A10	21606852	21608438	BnaA10T0214400ZY.1	0	+	367	1534	1586	0.9672131
zheyou73v0_A10	21614320	21619328	BnaA10T0214500ZY	0	+	1855	4617	5008	0.9219249
zheyou73v0_A10	21622467	21624533	BnaA10T0214600ZY	0	-	559	1785	2066	0.8639884
zheyou73v0_A10	21626195	21629630	BnaA10T0214700ZY	0	+	950	3320	3435	0.9665211
zheyou73v0_A10	21626195	21629630	BnaA10T0214700ZY.1	0	+	950	3320	3435	0.9665211
zheyou73v0_A10	21626195	21629630	BnaA10T0214700ZY.2	0	+	950	3320	3435	0.9665211
zheyou73v0_A10	21626195	21629630	BnaA10T0214700ZY.3	0	+	950	3320	3435	0.9665211
zheyou73v0_A10	21631304	21632808	BnaA10T0214800ZY	0	+	588	1493	1504	0.9926862
zheyou73v0_A10	21634938	21635931	BnaA10T0214900ZY	0	+	373	993	993	1.0000000
zheyou73v0_A10	21639999	21643442	BnaA10T0215000ZY	0	-	1884	3443	3443	1.0000000
zheyou73v0_A10	21644053	21645266	BnaA10T0215100ZY	0	+	617	1213	1213	1.0000000
zheyou73v0_A10	21645821	21647259	BnaA10T0215200ZY	0	-	283	1201	1438	0.8351877
zheyou73v0_A10	21653976	21654904	BnaA10T0215300ZY	0	-	73	896	928	0.9655172
zheyou73v0_A10	21658324	21661357	BnaA10T0215400ZY	0	-	500	1993	3033	0.6571051
zheyou73v0_A10	21665439	21666368	BnaA10T0215500ZY	0	-	351	929	929	1.0000000
zheyou73v0_A10	21670843	21672034	BnaA10T0215600ZY	0	+	503	1191	1191	1.0000000
zheyou73v0_A10	21674492	21677759	BnaA10T0215700ZY	0	-	679	3183	3267	0.9742883
zheyou73v0_A10	21679120	21679690	BnaA10T0215800ZY	0	-	65	570	570	1.0000000
zheyou73v0_A10	21682893	21684201	BnaA10T0215900ZY	0	+	3	178	1308	0.1360856
zheyou73v0_A10	21686183	21687296	BnaA10T0216000ZY	0	+	659	1113	1113	1.0000000
zheyou73v0_A10	21687598	21688252	BnaA10T0216100ZY	0	-	116	637	654	0.9740061
zheyou73v0_A10	21691610	21692970	BnaA10T0216200ZY	0	-	347	1349	1360	0.9919118
zheyou73v0_A10	21694165	21694905	BnaA10T0216300ZY	0	+	102	516	740	0.6972973
zheyou73v0_A10	21697578	21702713	BnaA10T0216400ZY	0	-	153	2213	5135	0.4309640
zheyou73v0_A10	21703023	21706740	BnaA10T0216500ZY	0	+	1456	3689	3717	0.9924670
zheyou73v0_A10	21708177	21710514	BnaA10T0216600ZY	0	+	835	2337	2337	1.0000000
zheyou73v0_A10	21710913	21712974	BnaA10T0216700ZY	0	-	222	1760	2061	0.8539544
zheyou73v0_A10	21716503	21717667	BnaA10T0216800ZY	0	+	242	1052	1164	0.9037800
zheyou73v0_A10	21719707	21720433	BnaA10T0216900ZY	0	-	52	489	726	0.6735537
zheyou73v0_A10	21725375	21726117	BnaA10T0217000ZY	0	-	82	556	742	0.7493262
zheyou73v0_A10	21730593	21731943	BnaA10T0217100ZY	0	-	462	1350	1350	1.0000000
zheyou73v0_A10	21737327	21741726	BnaA10T0217200ZY	0	+	1107	3860	4399	0.8774722
zheyou73v0_A10	21737327	21742073	BnaA10T0217200ZY.1	0	+	1253	4207	4746	0.8864307
zheyou73v0_A10	21737327	21741425	BnaA10T0217200ZY.2	0	+	1033	3564	4098	0.8696925
zheyou73v0_A10	21743861	21745157	BnaA10T0217300ZY	0	+	136	889	1296	0.6859568
zheyou73v0_A10	21746861	21748833	BnaA10T0217400ZY	0	-	415	1643	1972	0.8331643
zheyou73v0_A10	21749050	21750950	BnaA10T0217500ZY	0	-	939	1900	1900	1.0000000
zheyou73v0_A10	21751568	21759390	BnaA10T0217600ZY	0	+	1686	6598	7822	0.8435183
zheyou73v0_A10	21753164	21759390	BnaA10T0217600ZY.1	0	+	1031	5002	6226	0.8034050
zheyou73v0_A10	21761896	21775967	BnaA10T0217700ZY	0	+	1646	7179	14071	0.5101983
zheyou73v0_A10	21779412	21780960	BnaA10T0217800ZY	0	+	213	1346	1548	0.8695090
zheyou73v0_A10	21781712	21784588	BnaA10T0217900ZY	0	+	1156	2513	2876	0.8737831
zheyou73v0_A10	21785630	21802017	BnaA10T0218000ZY	0	+	4851	13688	16387	0.8352963
zheyou73v0_A10	21802227	21804242	BnaA10T0218100ZY	0	-	372	1795	2015	0.8908188
zheyou73v0_A10	21810309	21810630	BnaA10T0218200ZY	0	+	85	321	321	1.0000000
zheyou73v0_A10	21810865	21811484	BnaA10T0218300ZY	0	-	182	613	619	0.9903070
zheyou73v0_A10	21811824	21812886	BnaA10T0218400ZY	0	-	211	1009	1062	0.9500942
zheyou73v0_A10	21815498	21818336	BnaA10T0218500ZY	0	+	914	2684	2838	0.9457364
zheyou73v0_A10	21818697	21819176	BnaA10T0218600ZY	0	-	368	479	479	1.0000000
zheyou73v0_A10	21820284	21821105	BnaA10T0218700ZY	0	-	219	799	821	0.9732034
zheyou73v0_A10	21824011	21825133	BnaA10T0218800ZY	0	+	359	1120	1122	0.9982175
zheyou73v0_A10	21825517	21827136	BnaA10T0218900ZY	0	-	90	810	1619	0.5003088
zheyou73v0_A10	21828521	21830015	BnaA10T0219000ZY	0	-	52	334	1494	0.2235609
zheyou73v0_A10	21831362	21832424	BnaA10T0219100ZY	0	-	96	945	1062	0.8898305
zheyou73v0_A10	21840190	21841929	BnaA10T0219200ZY	0	-	115	907	1739	0.5215641
zheyou73v0_A10	21843732	21846865	BnaA10T0219300ZY	0	+	726	2793	3133	0.8914778
zheyou73v0_A10	21843732	21846865	BnaA10T0219300ZY.1	0	+	726	2793	3133	0.8914778
zheyou73v0_A10	21851509	21853139	BnaA10T0219400ZY	0	+	114	1198	1630	0.7349693
zheyou73v0_A10	21853474	21853935	BnaA10T0219500ZY	0	-	142	461	461	1.0000000
zheyou73v0_A10	21856081	21858696	BnaA10T0219600ZY	0	+	607	2408	2615	0.9208413
zheyou73v0_A10	21859141	21863684	BnaA10T0219700ZY	0	-	1076	4328	4543	0.9526744
zheyou73v0_A10	21872038	21874814	BnaA10T0219800ZY	0	-	213	1486	2776	0.5353026
zheyou73v0_A10	21875258	21879551	BnaA10T0219900ZY	0	+	784	3390	4293	0.7896576
zheyou73v0_A10	21879613	21881635	BnaA10T0220000ZY	0	+	24	523	2022	0.2586548
zheyou73v0_A10	21882057	21886655	BnaA10T0220100ZY	0	-	781	2696	4598	0.5863419
zheyou73v0_A10	21888094	21889632	BnaA10T0220200ZY	0	+	615	1538	1538	1.0000000
zheyou73v0_A10	21897891	21899794	BnaA10T0220300ZY	0	+	725	1785	1903	0.9379926
zheyou73v0_A10	21902550	21903289	BnaA10T0220400ZY	0	+	477	739	739	1.0000000
zheyou73v0_A10	21904509	21907926	BnaA10T0220500ZY	0	+	1701	3417	3417	1.0000000
zheyou73v0_A10	21908680	21911432	BnaA10T0220600ZY	0	+	934	2520	2752	0.9156977
zheyou73v0_A10	21912430	21922733	BnaA10T0220700ZY	0	+	1781	7633	10303	0.7408522
zheyou73v0_A10	21922900	21924369	BnaA10T0220800ZY	0	-	157	855	1469	0.5820286
zheyou73v0_A10	21929594	21931084	BnaA10T0220900ZY	0	-	258	1285	1490	0.8624161
zheyou73v0_A10	21931504	21937194	BnaA10T0221000ZY	0	-	1276	5158	5690	0.9065027
zheyou73v0_A10	21937966	21939638	BnaA10T0221100ZY	0	+	316	1599	1672	0.9563397
zheyou73v0_A10	21939539	21940493	BnaA10T0221200ZY	0	-	37	816	954	0.8553459
zheyou73v0_A10	21940858	21943243	BnaA10T0221300ZY	0	+	1052	2267	2385	0.9505241
zheyou73v0_A10	21946518	21947284	BnaA10T0221400ZY	0	+	206	766	766	1.0000000
zheyou73v0_A10	21947794	21949125	BnaA10T0221500ZY	0	-	235	1013	1331	0.7610819
zheyou73v0_A10	21947794	21949125	BnaA10T0221500ZY.1	0	-	235	1013	1331	0.7610819
zheyou73v0_A10	21959405	21960569	BnaA10T0221600ZY	0	-	130	621	1164	0.5335051
zheyou73v0_A10	21973724	21976410	BnaA10T0221700ZY	0	+	436	2384	2686	0.8875651
zheyou73v0_A10	21976760	21977940	BnaA10T0221800ZY	0	-	536	1180	1180	1.0000000
zheyou73v0_A10	21979321	21981922	BnaA10T0221900ZY	0	+	1539	2601	2601	1.0000000
zheyou73v0_A10	21984437	21986484	BnaA10T0222000ZY	0	+	702	1611	2047	0.7870054
zheyou73v0_A10	21987196	21989005	BnaA10T0222100ZY	0	+	14	487	1809	0.2692095
zheyou73v0_A10	21989045	21989757	BnaA10T0222200ZY	0	-	4	72	712	0.1011236
zheyou73v0_A10	21990574	21993540	BnaA10T0222300ZY	0	-	215	1103	2966	0.3718813
zheyou73v0_A10	22005388	22014062	BnaA10T0222400ZY	0	+	838	4586	8674	0.5287065
zheyou73v0_A10	22024647	22029196	BnaA10T0222500ZY	0	+	947	4000	4549	0.8793141
zheyou73v0_A10	22030317	22032566	BnaA10T0222600ZY	0	+	364	1144	2249	0.5086705
zheyou73v0_A10	22046529	22048993	BnaA10T0222700ZY	0	-	205	1603	2464	0.6505682
zheyou73v0_A10	22054027	22056086	BnaA10T0222800ZY	0	+	258	1447	2059	0.7027683
zheyou73v0_A10	22058009	22060299	BnaA10T0222900ZY	0	-	984	2290	2290	1.0000000
zheyou73v0_A10	22060811	22062686	BnaA10T0223000ZY	0	+	496	1842	1875	0.9824000
zheyou73v0_A10	22063248	22063521	BnaA10T0223100ZY	0	+	209	273	273	1.0000000
zheyou73v0_A10	22063939	22064287	BnaA10T0223200ZY	0	-	143	311	348	0.8936782
zheyou73v0_A10	22068224	22070688	BnaA10T0223300ZY.1	0	+	541	2344	2464	0.9512987
zheyou73v0_A10	22068224	22070688	BnaA10T0223300ZY.2	0	+	541	2344	2464	0.9512987
zheyou73v0_A10	22068608	22070688	BnaA10T0223300ZY	0	+	501	1960	2080	0.9423077
zheyou73v0_A10	22073539	22076842	BnaA10T0223400ZY	0	-	796	3166	3303	0.9585226
zheyou73v0_A10	22078590	22081648	BnaA10T0223500ZY	0	-	575	2778	3058	0.9084369
zheyou73v0_A10	22082719	22083157	BnaA10T0223600ZY	0	-	4	180	438	0.4109589
zheyou73v0_A10	22083523	22084631	BnaA10T0223700ZY	0	+	393	1108	1108	1.0000000
zheyou73v0_A10	22084846	22085182	BnaA10T0223800ZY	0	-	25	244	336	0.7261904
zheyou73v0_A10	22092525	22092950	BnaA10T0223900ZY	0	-	26	340	425	0.8000000
zheyou73v0_A10	22096957	22098918	BnaA10T0224000ZY	0	-	84	1059	1961	0.5400306
zheyou73v0_A10	22107102	22114163	BnaA10T0224100ZY	0	-	442	2696	7061	0.3818156
zheyou73v0_A10	22115223	22118584	BnaA10T0224200ZY	0	+	1269	3037	3361	0.9036001
zheyou73v0_A10	22118314	22119775	BnaA10T0224300ZY	0	-	182	1208	1461	0.8268309
zheyou73v0_A10	22120228	22122808	BnaA10T0224400ZY	0	+	1092	2580	2580	1.0000000
zheyou73v0_A10	22126016	22129629	BnaA10T0224500ZY	0	+	1451	3364	3613	0.9310822
zheyou73v0_A10	22130110	22130371	BnaA10T0224600ZY	0	-	101	261	261	1.0000000
zheyou73v0_A10	22132040	22134032	BnaA10T0224700ZY	0	+	654	1861	1992	0.9342369
zheyou73v0_A10	22135357	22138283	BnaA10T0224800ZY	0	-	834	2847	2926	0.9730007
zheyou73v0_A10	22138468	22139547	BnaA10T0224900ZY	0	+	208	1038	1079	0.9620019
zheyou73v0_A10	22140097	22141856	BnaA10T0225000ZY	0	-	149	1220	1759	0.6935759
zheyou73v0_A10	22146480	22146851	BnaA10T0225100ZY	0	-	123	325	371	0.8760108
zheyou73v0_A10	22148791	22150740	BnaA10T0225200ZY	0	+	165	1494	1949	0.7665470
zheyou73v0_A10	22154353	22154795	BnaA10T0225300ZY	0	-	2	111	442	0.2511312
zheyou73v0_A10	22155156	22156468	BnaA10T0225400ZY	0	-	80	824	1312	0.6280488
zheyou73v0_A10	22160644	22162750	BnaA10T0225500ZY	0	-	119	1437	2106	0.6823362
zheyou73v0_A10	22167633	22170077	BnaA10T0225600ZY	0	+	233	1634	2444	0.6685761
zheyou73v0_A10	22170786	22175002	BnaA10T0225700ZY	0	+	293	3024	4216	0.7172676
zheyou73v0_A10	22175386	22177440	BnaA10T0225800ZY	0	+	533	1920	2054	0.9347615
zheyou73v0_A10	22177753	22179456	BnaA10T0225900ZY	0	+	347	1686	1703	0.9900176
zheyou73v0_A10	22189656	22191368	BnaA10T0226000ZY	0	+	406	1590	1712	0.9287383
zheyou73v0_A10	22193613	22195263	BnaA10T0226100ZY	0	-	322	1529	1650	0.9266667
zheyou73v0_A10	22195708	22196979	BnaA10T0226200ZY	0	-	388	1212	1271	0.9535798
zheyou73v0_A10	22197525	22200222	BnaA10T0226300ZY	0	-	751	2425	2697	0.8991472
zheyou73v0_A10	22200742	22201611	BnaA10T0226400ZY	0	+	227	857	869	0.9861910
zheyou73v0_A10	22204553	22205325	BnaA10T0226500ZY	0	+	76	642	772	0.8316062
zheyou73v0_A10	22208077	22208336	BnaA10T0226600ZY	0	+	218	259	259	1.0000000
zheyou73v0_A10	22208614	22210284	BnaA10T0226700ZY	0	+	689	1624	1670	0.9724551
zheyou73v0_A10	22213606	22214519	BnaA10T0226800ZY	0	-	17	259	913	0.2836802
zheyou73v0_A10	22226594	22227761	BnaA10T0226900ZY	0	-	292	1167	1167	1.0000000
zheyou73v0_A10	22228161	22231475	BnaA10T0227000ZY	0	-	102	1915	3314	0.5778515
zheyou73v0_A10	22228161	22231005	BnaA10T0227000ZY.1	0	-	89	1523	2844	0.5355133
zheyou73v0_A10	22232332	22236948	BnaA10T0227100ZY	0	-	783	4029	4616	0.8728336
zheyou73v0_A10	22237541	22239724	BnaA10T0227200ZY	0	-	48	621	2183	0.2844709
zheyou73v0_A10	22240172	22241992	BnaA10T0227300ZY	0	+	95	960	1820	0.5274726
zheyou73v0_A10	22243140	22245718	BnaA10T0227400ZY	0	+	450	1878	2578	0.7284717
zheyou73v0_A10	22249127	22251152	BnaA10T0227500ZY	0	+	353	1802	2025	0.8898765
zheyou73v0_A10	22249127	22251152	BnaA10T0227500ZY.1	0	+	353	1802	2025	0.8898765
zheyou73v0_A10	22251317	22253650	BnaA10T0227600ZY	0	+	188	1723	2333	0.7385341
zheyou73v0_A10	22253668	22254700	BnaA10T0227700ZY	0	+	141	988	1032	0.9573643
zheyou73v0_A10	22255251	22256073	BnaA10T0227800ZY	0	+	522	822	822	1.0000000
zheyou73v0_A10	22256294	22257741	BnaA10T0227900ZY	0	+	167	832	1447	0.5749827
zheyou73v0_A10	22257994	22260786	BnaA10T0228000ZY	0	-	307	1997	2792	0.7152579
zheyou73v0_A10	22261210	22262129	BnaA10T0228100ZY	0	+	68	584	919	0.6354733
zheyou73v0_A10	22261210	22262129	BnaA10T0228100ZY.1	0	+	68	584	919	0.6354733
zheyou73v0_A10	22269072	22271289	BnaA10T0228200ZY	0	-	181	1275	2217	0.5751015
zheyou73v0_A10	22278444	22279507	BnaA10T0228300ZY	0	+	276	1063	1063	1.0000000
zheyou73v0_A10	22279379	22281520	BnaA10T0228400ZY	0	-	1242	2141	2141	1.0000000
zheyou73v0_A10	22281806	22282855	BnaA10T0228500ZY	0	+	204	846	1049	0.8064824
zheyou73v0_A10	22284521	22286090	BnaA10T0228600ZY	0	-	86	867	1569	0.5525813
zheyou73v0_A10	22287736	22290005	BnaA10T0228700ZY	0	+	153	1027	2269	0.4526223
zheyou73v0_A10	22290875	22293087	BnaA10T0228800ZY	0	+	598	2130	2212	0.9629295
zheyou73v0_A10	22293411	22297206	BnaA10T0228900ZY	0	+	395	1984	3795	0.5227932
zheyou73v0_A10	22301339	22304190	BnaA10T0229000ZY	0	-	576	2663	2851	0.9340582
zheyou73v0_A10	22304601	22307029	BnaA10T0229100ZY	0	+	466	2275	2428	0.9369852
zheyou73v0_A10	22307490	22310378	BnaA10T0229200ZY	0	-	526	2651	2888	0.9179363
zheyou73v0_A10	22312809	22314799	BnaA10T0229300ZY	0	-	344	1976	1990	0.9929648
zheyou73v0_A10	22312809	22314799	BnaA10T0229300ZY.1	0	-	344	1976	1990	0.9929648
zheyou73v0_A10	22315443	22319793	BnaA10T0229400ZY	0	+	289	2565	4350	0.5896552
zheyou73v0_A10	22319958	22326552	BnaA10T0229500ZY	0	-	1075	5324	6594	0.8074006
zheyou73v0_A10	22329203	22331314	BnaA10T0229600ZY	0	-	601	1856	2111	0.8792042
zheyou73v0_A10	22329203	22331468	BnaA10T0229600ZY.1	0	-	653	2010	2265	0.8874172
zheyou73v0_A10	22331813	22334392	BnaA10T0229700ZY	0	+	408	2127	2579	0.8247383
zheyou73v0_A10	22334137	22336319	BnaA10T0229800ZY	0	-	430	2037	2182	0.9335472
zheyou73v0_A10	22338810	22341113	BnaA10T0229900ZY	0	+	605	2264	2303	0.9830655
zheyou73v0_A10	22341871	22346187	BnaA10T0230000ZY	0	+	458	2899	4316	0.6716868
zheyou73v0_A10	22346265	22348001	BnaA10T0230100ZY	0	-	802	1715	1736	0.9879032
zheyou73v0_A10	22348416	22349901	BnaA10T0230200ZY	0	-	388	933	1485	0.6282828
zheyou73v0_A10	22348416	22349676	BnaA10T0230200ZY.1	0	-	317	770	1260	0.6111111
zheyou73v0_A10	22350774	22351998	BnaA10T0230300ZY	0	+	15	210	1224	0.1715686
zheyou73v0_A10	22353940	22355504	BnaA10T0230400ZY	0	+	431	1223	1564	0.7819693
zheyou73v0_A10	22355728	22356760	BnaA10T0230500ZY	0	-	329	1006	1032	0.9748062
zheyou73v0_A10	22357906	22358286	BnaA10T0230600ZY	0	+	105	374	380	0.9842106
zheyou73v0_A10	22361629	22364708	BnaA10T0230700ZY	0	-	267	1915	3079	0.6219552
zheyou73v0_A10	22367574	22374253	BnaA10T0230800ZY	0	-	111	2165	6679	0.3241503
zheyou73v0_A10	22374605	22376596	BnaA10T0230900ZY	0	-	63	887	1991	0.4455048
zheyou73v0_A10	22377294	22378618	BnaA10T0231000ZY	0	+	181	827	1324	0.6246223
zheyou73v0_A10	22378794	22380488	BnaA10T0231100ZY	0	+	389	1511	1694	0.8919716
zheyou73v0_A10	22380536	22383637	BnaA10T0231200ZY	0	+	69	1404	3101	0.4527572
zheyou73v0_A10	22383293	22388994	BnaA10T0231300ZY	0	-	1327	4950	5701	0.8682687
zheyou73v0_A10	22383293	22388994	BnaA10T0231300ZY.1	0	-	1327	4950	5701	0.8682687
zheyou73v0_A10	22391693	22393781	BnaA10T0231400ZY	0	-	39	647	2088	0.3098659
zheyou73v0_A10	22393946	22396681	BnaA10T0231500ZY	0	-	82	1485	2735	0.5429616
zheyou73v0_A10	22397848	22398895	BnaA10T0231600ZY	0	-	107	528	1047	0.5042980
zheyou73v0_A10	22406780	22407109	BnaA10T0231700ZY	0	+	85	329	329	1.0000000
zheyou73v0_A10	22407733	22410199	BnaA10T0231800ZY	0	+	156	1459	2466	0.5916464
zheyou73v0_A10	22410543	22413404	BnaA10T0231900ZY	0	-	108	1569	2861	0.5484096
zheyou73v0_A10	22414290	22415059	BnaA10T0232000ZY	0	-	107	627	769	0.8153446
zheyou73v0_A10	22415445	22417765	BnaA10T0232100ZY	0	+	252	1866	2320	0.8043103
zheyou73v0_A10	22419734	22426128	BnaA10T0232200ZY	0	-	917	4864	6394	0.7607132
zheyou73v0_A10	22426879	22430217	BnaA10T0232300ZY	0	-	49	565	3338	0.1692630
zheyou73v0_A10	22431794	22432878	BnaA10T0232400ZY	0	+	73	713	1084	0.6577491
zheyou73v0_A10	22434426	22435617	BnaA10T0232500ZY	0	+	172	1093	1191	0.9177162
zheyou73v0_A10	22436417	22442212	BnaA10T0232600ZY	0	+	526	2353	5795	0.4060397
zheyou73v0_A10	22444628	22447031	BnaA10T0232700ZY	0	-	878	2067	2403	0.8601748
zheyou73v0_A10	22454376	22455139	BnaA10T0232800ZY	0	-	269	763	763	1.0000000
zheyou73v0_A10	22457725	22459337	BnaA10T0232900ZY	0	+	526	1367	1612	0.8480149
zheyou73v0_A10	22459592	22462533	BnaA10T0233000ZY	0	+	350	1757	2941	0.5974159
zheyou73v0_A10	22462580	22464955	BnaA10T0233100ZY	0	+	400	2168	2375	0.9128421
zheyou73v0_A10	22467718	22468126	BnaA10T0233200ZY	0	+	402	408	408	1.0000000
zheyou73v0_A10	22469837	22471399	BnaA10T0233300ZY	0	-	362	1425	1562	0.9122919
zheyou73v0_A10	22477296	22480479	BnaA10T0233400ZY	0	+	932	2702	3183	0.8488847
zheyou73v0_A10	22477296	22480111	BnaA10T0233400ZY.1	0	+	885	2338	2815	0.8305506
zheyou73v0_A10	22477296	22480479	BnaA10T0233400ZY.2	0	+	932	2702	3183	0.8488847
zheyou73v0_A10	22481230	22483345	BnaA10T0233500ZY	0	+	873	2115	2115	1.0000000
zheyou73v0_A10	22483685	22489998	BnaA10T0233600ZY	0	+	1716	5782	6313	0.9158878
zheyou73v0_A10	22492354	22493471	BnaA10T0233700ZY	0	+	533	1117	1117	1.0000000
zheyou73v0_A10	22493786	22496379	BnaA10T0233800ZY	0	-	1057	2446	2593	0.9433089
zheyou73v0_A10	22496974	22498766	BnaA10T0233900ZY	0	-	934	1751	1792	0.9771205
zheyou73v0_A10	22502341	22504533	BnaA10T0234000ZY	0	-	720	1824	2192	0.8321168
zheyou73v0_A10	22504951	22508789	BnaA10T0234100ZY	0	-	125	1594	3838	0.4153205
zheyou73v0_A10	22509393	22511216	BnaA10T0234200ZY	0	-	243	1547	1823	0.8486012
zheyou73v0_A10	22512774	22513844	BnaA10T0234300ZY	0	+	24	118	1070	0.1102804
zheyou73v0_A10	22516308	22519428	BnaA10T0234400ZY	0	-	188	1758	3120	0.5634615
zheyou73v0_A10	22516308	22519428	BnaA10T0234400ZY.1	0	-	188	1758	3120	0.5634615
zheyou73v0_A10	22524778	22529499	BnaA10T0234500ZY	0	+	776	4081	4721	0.8644355
zheyou73v0_A10	22531675	22534223	BnaA10T0234600ZY	0	-	458	1967	2548	0.7719780
zheyou73v0_A10	22538592	22540828	BnaA10T0234700ZY	0	+	893	2119	2236	0.9476744
zheyou73v0_A10	22550163	22552945	BnaA10T0234800ZY	0	+	414	1863	2782	0.6696621
zheyou73v0_A10	22553642	22556243	BnaA10T0234900ZY	0	-	2225	2601	2601	1.0000000
zheyou73v0_A10	22558928	22565985	BnaA10T0235000ZY	0	-	2004	6345	7057	0.8991073
zheyou73v0_A10	22567225	22575213	BnaA10T0235100ZY	0	+	1574	6406	7988	0.8019530
zheyou73v0_A10	22567225	22575213	BnaA10T0235100ZY.1	0	+	1574	6406	7988	0.8019530
zheyou73v0_A10	22573820	22575188	BnaA10T0235200ZY	0	-	65	735	1368	0.5372807
zheyou73v0_A10	22575710	22576544	BnaA10T0235300ZY	0	-	134	429	834	0.5143885
zheyou73v0_A10	22577007	22584715	BnaA10T0235400ZY	0	-	658	5466	7708	0.7091334
zheyou73v0_A10	22587850	22589164	BnaA10T0235500ZY	0	+	525	1314	1314	1.0000000
zheyou73v0_A10	22589606	22590664	BnaA10T0235600ZY	0	+	202	877	1058	0.8289225
zheyou73v0_A10	22593494	22595078	BnaA10T0235700ZY	0	-	71	938	1584	0.5921717
zheyou73v0_A10	22608778	22610815	BnaA10T0235800ZY	0	-	68	1352	2037	0.6637211
zheyou73v0_A10	22612723	22614870	BnaA10T0235900ZY	0	-	168	1723	2147	0.8025151
zheyou73v0_A10	22616681	22617155	BnaA10T0236000ZY	0	+	50	394	474	0.8312236
zheyou73v0_A10	22617447	22619437	BnaA10T0236100ZY	0	-	659	1640	1990	0.8241206
zheyou73v0_A10	22623910	22625796	BnaA10T0236200ZY	0	-	638	1735	1886	0.9199364
zheyou73v0_A10	22623910	22625796	BnaA10T0236200ZY.1	0	-	638	1735	1886	0.9199364
zheyou73v0_A10	22626463	22627925	BnaA10T0236300ZY	0	-	90	738	1462	0.5047880
zheyou73v0_A10	22628583	22630471	BnaA10T0236400ZY	0	-	357	1700	1888	0.9004237
zheyou73v0_A10	22632903	22634742	BnaA10T0236500ZY	0	+	91	831	1839	0.4518760
zheyou73v0_A10	22635231	22636745	BnaA10T0236600ZY	0	+	140	1073	1514	0.7087186
zheyou73v0_A10	22636772	22639169	BnaA10T0236700ZY	0	-	211	1760	2397	0.7342511
zheyou73v0_A10	22636772	22639169	BnaA10T0236700ZY.1	0	-	211	1760	2397	0.7342511
zheyou73v0_A10	22636772	22639169	BnaA10T0236700ZY.2	0	-	211	1760	2397	0.7342511
zheyou73v0_A10	22636772	22639169	BnaA10T0236700ZY.3	0	-	211	1760	2397	0.7342511
zheyou73v0_A10	22640255	22641952	BnaA10T0236800ZY	0	+	170	1222	1697	0.7200943
zheyou73v0_A10	22642201	22647276	BnaA10T0236900ZY	0	+	552	3590	5075	0.7073892
zheyou73v0_A10	22647922	22648835	BnaA10T0237000ZY	0	-	68	634	913	0.6944140
zheyou73v0_A10	22649580	22655124	BnaA10T0237100ZY	0	-	1352	5076	5544	0.9155844
zheyou73v0_A10	22657428	22659125	BnaA10T0237200ZY	0	+	369	1639	1697	0.9658220
zheyou73v0_A10	22663447	22665579	BnaA10T0237300ZY	0	-	6	314	2132	0.1472795
zheyou73v0_A10	22670401	22672151	BnaA10T0237400ZY	0	-	187	889	1750	0.5080000
zheyou73v0_A10	22670401	22672151	BnaA10T0237400ZY.1	0	-	187	889	1750	0.5080000
zheyou73v0_A10	22677814	22681812	BnaA10T0237500ZY	0	+	857	3070	3998	0.7678840
zheyou73v0_A10	22683654	22685182	BnaA10T0237600ZY	0	-	34	1024	1528	0.6701571
zheyou73v0_A10	22683654	22685182	BnaA10T0237600ZY.1	0	-	34	1024	1528	0.6701571
zheyou73v0_A10	22686296	22686915	BnaA10T0237700ZY	0	+	78	506	619	0.8174475
zheyou73v0_A10	22687445	22688887	BnaA10T0237800ZY	0	+	41	596	1442	0.4133148
zheyou73v0_A10	22689249	22690693	BnaA10T0237900ZY	0	-	635	1444	1444	1.0000000
zheyou73v0_A10	22691328	22693078	BnaA10T0238000ZY	0	-	217	1395	1750	0.7971429
zheyou73v0_A10	22691328	22693078	BnaA10T0238000ZY.1	0	-	217	1395	1750	0.7971429
zheyou73v0_A10	22693374	22696494	BnaA10T0238100ZY	0	+	539	2233	3120	0.7157052
zheyou73v0_A10	22698148	22701850	BnaA10T0238200ZY	0	+	373	2667	3702	0.7204214
zheyou73v0_A10	22704563	22708268	BnaA10T0238300ZY	0	+	175	2114	3705	0.5705803
zheyou73v0_A10	22715163	22716180	BnaA10T0238400ZY	0	-	226	987	1017	0.9705015
zheyou73v0_A10	22720435	22724937	BnaA10T0238500ZY	0	+	764	3978	4502	0.8836073
zheyou73v0_A10	22725988	22729651	BnaA10T0238600ZY	0	+	922	3202	3663	0.8741469
zheyou73v0_A10	22725988	22728699	BnaA10T0238600ZY.1	0	+	875	2499	2711	0.9218001
zheyou73v0_A10	22731094	22738305	BnaA10T0238700ZY	0	+	1371	5953	7211	0.8255443
zheyou73v0_A10	22743580	22744552	BnaA10T0238800ZY	0	+	525	972	972	1.0000000
zheyou73v0_A10	22744829	22748091	BnaA10T0238900ZY	0	-	969	3262	3262	1.0000000
zheyou73v0_A10	22744829	22747706	BnaA10T0238900ZY.1	0	-	850	2877	2877	1.0000000
zheyou73v0_A10	22750393	22752126	BnaA10T0239000ZY	0	+	115	1147	1733	0.6618580
zheyou73v0_A10	22752331	22755717	BnaA10T0239100ZY	0	+	626	3003	3386	0.8868872
zheyou73v0_A10	22752331	22755717	BnaA10T0239100ZY.1	0	+	626	3003	3386	0.8868872
zheyou73v0_A10	22761290	22765111	BnaA10T0239200ZY	0	-	146	2164	3821	0.5663439
zheyou73v0_A10	22769365	22771304	BnaA10T0239300ZY	0	+	169	750	1939	0.3867973
zheyou73v0_A10	22773019	22774910	BnaA10T0239400ZY	0	+	205	1020	1891	0.5393971
zheyou73v0_A10	22775536	22776352	BnaA10T0239500ZY	0	-	70	531	816	0.6507353
zheyou73v0_A10	22778828	22779812	BnaA10T0239600ZY	0	-	102	897	984	0.9115854
zheyou73v0_A10	22780354	22781570	BnaA10T0239700ZY	0	-	177	700	1216	0.5756579
zheyou73v0_A10	22781900	22782807	BnaA10T0239800ZY	0	-	226	907	907	1.0000000
zheyou73v0_A10	22786012	22788216	BnaA10T0239900ZY	0	+	309	1602	2204	0.7268602
zheyou73v0_A10	22789904	22790645	BnaA10T0240000ZY	0	+	53	583	741	0.7867746
zheyou73v0_A10	22791010	22791905	BnaA10T0240100ZY	0	-	160	804	895	0.8983240
zheyou73v0_A10	22797338	22798076	BnaA10T0240200ZY	0	-	364	720	738	0.9756098
zheyou73v0_A10	22811504	22813681	BnaA10T0240300ZY	0	-	1531	1925	2177	0.8842444
zheyou73v0_A10	22816267	22816971	BnaA10T0240400ZY	0	-	0	0	704	0.0000000
zheyou73v0_A10	22819056	22820459	BnaA10T0240500ZY	0	+	197	1021	1403	0.7277263
zheyou73v0_A10	22821018	22823533	BnaA10T0240600ZY	0	-	390	1816	2515	0.7220676
zheyou73v0_A10	22824887	22826646	BnaA10T0240700ZY	0	-	558	1708	1759	0.9710063
zheyou73v0_A10	22830544	22833765	BnaA10T0240800ZY	0	+	1406	3047	3221	0.9459795
zheyou73v0_A10	22830544	22833565	BnaA10T0240800ZY.1	0	+	1372	2978	3021	0.9857663
zheyou73v0_A10	22834009	22835677	BnaA10T0240900ZY	0	+	332	1560	1668	0.9352518
zheyou73v0_A10	22838323	22839673	BnaA10T0241000ZY	0	+	6	119	1350	0.0881481
zheyou73v0_A10	22850425	22851973	BnaA10T0241100ZY	0	+	196	1084	1548	0.7002584
zheyou73v0_A10	22857775	22859756	BnaA10T0241200ZY	0	+	801	1911	1981	0.9646643
zheyou73v0_A10	22857775	22859756	BnaA10T0241200ZY.1	0	+	801	1911	1981	0.9646643
zheyou73v0_A10	22859794	22862145	BnaA10T0241300ZY	0	+	537	1603	2351	0.6818375
zheyou73v0_A10	22863532	22866062	BnaA10T0241400ZY	0	-	1128	2452	2530	0.9691700
zheyou73v0_A10	22863532	22865690	BnaA10T0241400ZY.1	0	-	901	2080	2158	0.9638554
zheyou73v0_A10	22866873	22869559	BnaA10T0241500ZY	0	+	294	2141	2686	0.7970961
zheyou73v0_A10	22869688	22872283	BnaA10T0241600ZY	0	-	145	1708	2595	0.6581888
zheyou73v0_A10	22877717	22878809	BnaA10T0241700ZY	0	-	299	897	1092	0.8214286
zheyou73v0_A10	22886644	22892554	BnaA10T0241800ZY	0	-	319	3464	5910	0.5861252
zheyou73v0_A10	22893490	22896125	BnaA10T0241900ZY	0	+	758	2635	2635	1.0000000
zheyou73v0_A10	22896743	22900426	BnaA10T0242000ZY	0	-	875	3353	3683	0.9103991
zheyou73v0_A10	22900745	22904161	BnaA10T0242100ZY	0	-	1393	3283	3416	0.9610656
zheyou73v0_A10	22906992	22909627	BnaA10T0242200ZY	0	-	2210	2635	2635	1.0000000
zheyou73v0_A10	22917443	22918127	BnaA10T0242300ZY	0	+	257	684	684	1.0000000
zheyou73v0_A10	22918939	22921318	BnaA10T0242400ZY	0	+	1105	2322	2379	0.9760404
zheyou73v0_A10	22921753	22922567	BnaA10T0242500ZY	0	+	301	762	814	0.9361179
zheyou73v0_A10	22923318	22924950	BnaA10T0242600ZY	0	+	485	1462	1632	0.8958333
zheyou73v0_A10	22925139	22927098	BnaA10T0242700ZY	0	-	45	982	1959	0.5012761
zheyou73v0_A10	22932199	22933018	BnaA10T0242800ZY	0	-	67	535	819	0.6532357
zheyou73v0_A10	22934119	22935833	BnaA10T0242900ZY	0	+	235	1251	1714	0.7298716
zheyou73v0_A10	22939043	22940515	BnaA10T0243000ZY	0	+	450	1394	1472	0.9470109
zheyou73v0_A10	22946181	22948268	BnaA10T0243100ZY	0	+	477	1778	2087	0.8519406
zheyou73v0_A10	22949853	22952707	BnaA10T0243200ZY	0	-	465	2121	2854	0.7431675
zheyou73v0_A10	22950676	22952707	BnaA10T0243200ZY.1	0	-	392	1589	2031	0.7823732
zheyou73v0_A10	22953864	22955391	BnaA10T0243300ZY	0	+	973	1527	1527	1.0000000
zheyou73v0_A10	22953864	22955391	BnaA10T0243300ZY.1	0	+	973	1527	1527	1.0000000
zheyou73v0_A10	22953864	22955391	BnaA10T0243300ZY.2	0	+	973	1527	1527	1.0000000
zheyou73v0_A10	22953864	22955391	BnaA10T0243300ZY.3	0	+	973	1527	1527	1.0000000
zheyou73v0_A10	22953864	22955391	BnaA10T0243300ZY.4	0	+	973	1527	1527	1.0000000
zheyou73v0_A10	22955915	22958378	BnaA10T0243400ZY	0	-	561	1271	2463	0.5160373
zheyou73v0_A10	22958763	22962067	BnaA10T0243500ZY	0	-	0	0	3304	0.0000000
zheyou73v0_A10	22958763	22962067	BnaA10T0243500ZY.1	0	-	0	0	3304	0.0000000
zheyou73v0_A10	22958763	22962067	BnaA10T0243500ZY.2	0	-	0	0	3304	0.0000000
zheyou73v0_A10	22967494	22971094	BnaA10T0243600ZY	0	+	2	203	3600	0.0563889
zheyou73v0_A10	22972182	22974775	BnaA10T0243700ZY	0	+	1052	1782	2593	0.6872349
zheyou73v0_A10	22983830	22992156	BnaA10T0243800ZY	0	+	881	5957	8326	0.7154696
zheyou73v0_A10	22992686	22994317	BnaA10T0243900ZY	0	-	495	1404	1631	0.8608216
zheyou73v0_A10	22994541	22998097	BnaA10T0244000ZY	0	+	1020	3231	3556	0.9086052
zheyou73v0_A10	22998508	23001555	BnaA10T0244100ZY	0	+	522	2678	3047	0.8788972
zheyou73v0_A10	23009624	23011636	BnaA10T0244200ZY	0	+	207	1878	2012	0.9333996
zheyou73v0_A10	23009624	23011636	BnaA10T0244200ZY.1	0	+	207	1878	2012	0.9333996
zheyou73v0_A10	23011828	23013724	BnaA10T0244300ZY	0	+	124	1164	1896	0.6139240
zheyou73v0_A10	23013776	23016890	BnaA10T0244400ZY	0	+	904	3063	3114	0.9836224
zheyou73v0_A10	23020442	23025968	BnaA10T0244500ZY	0	+	956	4872	5526	0.8816504
zheyou73v0_A10	23020442	23025968	BnaA10T0244500ZY.1	0	+	956	4872	5526	0.8816504
zheyou73v0_A10	23020442	23025225	BnaA10T0244500ZY.4	0	+	892	4241	4783	0.8866820
zheyou73v0_A10	23022141	23025968	BnaA10T0244500ZY.3	0	+	460	3265	3827	0.8531487
zheyou73v0_A10	23022593	23025968	BnaA10T0244500ZY.2	0	+	360	2813	3375	0.8334815
zheyou73v0_A10	23027495	23029584	BnaA10T0244600ZY	0	+	38	829	2089	0.3968406
zheyou73v0_A10	23029962	23031401	BnaA10T0244700ZY	0	-	264	1386	1439	0.9631689
zheyou73v0_A10	23036199	23037416	BnaA10T0244800ZY	0	+	425	1091	1217	0.8964667
zheyou73v0_A10	23036199	23037416	BnaA10T0244800ZY.1	0	+	425	1091	1217	0.8964667
zheyou73v0_A10	23038150	23038882	BnaA10T0244900ZY	0	+	6	250	732	0.3415301
zheyou73v0_A10	23038226	23043017	BnaA10T0245000ZY	0	-	452	2798	4791	0.5840117
zheyou73v0_A10	23044757	23047147	BnaA10T0245100ZY	0	+	543	2127	2390	0.8899581
zheyou73v0_A10	23047702	23048591	BnaA10T0245200ZY	0	+	123	854	889	0.9606299
zheyou73v0_A10	23049393	23051842	BnaA10T0245300ZY	0	+	664	2397	2449	0.9787669
zheyou73v0_A10	23052229	23053546	BnaA10T0245400ZY	0	+	202	1249	1317	0.9483675
zheyou73v0_A10	23053738	23056756	BnaA10T0245500ZY	0	-	750	3018	3018	1.0000000
zheyou73v0_A10	23058322	23060513	BnaA10T0245600ZY	0	-	248	1728	2191	0.7886810
zheyou73v0_A10	23065703	23066207	BnaA10T0245700ZY	0	-	173	489	504	0.9702381
zheyou73v0_A10	23067410	23070467	BnaA10T0245800ZY	0	-	466	1940	3057	0.6346091
zheyou73v0_A10	23071059	23075423	BnaA10T0245900ZY	0	-	180	1931	4364	0.4424840
zheyou73v0_A10	23077625	23079346	BnaA10T0246000ZY	0	-	470	1496	1721	0.8692620
zheyou73v0_A10	23080734	23081099	BnaA10T0246100ZY	0	+	108	342	365	0.9369863
zheyou73v0_A10	23082997	23084228	BnaA10T0246200ZY	0	+	21	539	1231	0.4378554
zheyou73v0_A10	23084534	23085974	BnaA10T0246300ZY	0	+	373	1010	1440	0.7013889
zheyou73v0_A10	23086555	23088833	BnaA10T0246400ZY	0	-	610	2107	2278	0.9249341
zheyou73v0_A10	23089308	23089554	BnaA10T0246500ZY	0	+	49	246	246	1.0000000
zheyou73v0_A10	23099347	23103005	BnaA10T0246600ZY	0	+	1012	3319	3658	0.9073264
zheyou73v0_A10	23103401	23105173	BnaA10T0246700ZY	0	-	684	1710	1772	0.9650113
zheyou73v0_A10	23106116	23106566	BnaA10T0246800ZY	0	+	42	440	450	0.9777778
zheyou73v0_A10	23106752	23107615	BnaA10T0246900ZY	0	-	619	863	863	1.0000000
zheyou73v0_A10	23111191	23112428	BnaA10T0247000ZY	0	-	56	896	1237	0.7243330
zheyou73v0_A10	23131741	23134037	BnaA10T0247100ZY	0	+	190	1556	2296	0.6777003
zheyou73v0_A10	23140922	23142996	BnaA10T0247200ZY	0	+	425	1742	2074	0.8399228
zheyou73v0_A10	23140922	23143011	BnaA10T0247200ZY.1	0	+	425	1757	2089	0.8410723
zheyou73v0_A10	23146141	23146908	BnaA10T0247300ZY	0	-	140	690	767	0.8996089
zheyou73v0_A10	23147150	23151685	BnaA10T0247400ZY	0	-	1127	3913	4535	0.8628445
zheyou73v0_A10	23152662	23154837	BnaA10T0247500ZY	0	-	1132	2175	2175	1.0000000
zheyou73v0_A10	23155353	23157149	BnaA10T0247600ZY	0	-	243	1497	1796	0.8335189
zheyou73v0_A10	23160089	23163151	BnaA10T0247700ZY	0	+	900	2976	3062	0.9719138
zheyou73v0_A10	23163338	23163807	BnaA10T0247800ZY	0	+	117	469	469	1.0000000
zheyou73v0_A10	23164214	23165327	BnaA10T0247900ZY	0	-	462	1113	1113	1.0000000
zheyou73v0_A10	23167316	23175332	BnaA10T0248000ZY	0	-	300	3258	8016	0.4064371
zheyou73v0_A10	23175442	23179460	BnaA10T0248100ZY	0	-	656	3191	4018	0.7941762
zheyou73v0_A10	23188577	23189426	BnaA10T0248200ZY	0	+	29	475	849	0.5594817
zheyou73v0_A10	23191367	23192144	BnaA10T0248300ZY	0	+	157	718	777	0.9240669
zheyou73v0_A10	23195375	23196711	BnaA10T0248400ZY	0	+	546	1331	1336	0.9962575
zheyou73v0_A10	23196984	23201956	BnaA10T0248500ZY	0	-	1487	4323	4972	0.8694690
zheyou73v0_A10	23202190	23203280	BnaA10T0248600ZY	0	+	422	1090	1090	1.0000000
zheyou73v0_A10	23203611	23207794	BnaA10T0248700ZY	0	+	1975	4119	4183	0.9847000
zheyou73v0_A10	23209355	23213244	BnaA10T0248800ZY	0	-	1143	3376	3889	0.8680895
zheyou73v0_A10	23215497	23216803	BnaA10T0248900ZY	0	+	330	803	1306	0.6148545
zheyou73v0_A10	23217297	23217678	BnaA10T0249000ZY	0	-	94	381	381	1.0000000
zheyou73v0_A10	23218740	23219387	BnaA10T0249100ZY	0	-	138	647	647	1.0000000
zheyou73v0_A10	23222693	23225264	BnaA10T0249200ZY	0	-	783	2412	2571	0.9381564
zheyou73v0_A10	23226977	23229815	BnaA10T0249300ZY	0	+	1385	2838	2838	1.0000000
zheyou73v0_A10	23226977	23229815	BnaA10T0249300ZY.1	0	+	1385	2838	2838	1.0000000
zheyou73v0_A10	23230039	23232194	BnaA10T0249400ZY	0	+	399	1508	2155	0.6997680
zheyou73v0_A10	23232320	23234381	BnaA10T0249500ZY	0	-	75	1239	2061	0.6011645
zheyou73v0_A10	23241418	23243652	BnaA10T0249600ZY	0	-	431	1490	2234	0.6669651
zheyou73v0_A10	23244908	23254941	BnaA10T0249700ZY	0	-	2538	7982	10033	0.7955746
zheyou73v0_A10	23255967	23258673	BnaA10T0249800ZY	0	-	276	2115	2706	0.7815965
zheyou73v0_A10	23260093	23262586	BnaA10T0249900ZY	0	-	300	1890	2493	0.7581227
zheyou73v0_A10	23264551	23265271	BnaA10T0250000ZY	0	-	2	25	720	0.0347222
zheyou73v0_A10	23269411	23271999	BnaA10T0250100ZY	0	+	143	1206	2588	0.4659969
zheyou73v0_A10	23275298	23277726	BnaA10T0250200ZY	0	+	67	1081	2428	0.4452224
zheyou73v0_A10	23277509	23279032	BnaA10T0250300ZY	0	-	201	1301	1523	0.8542351
zheyou73v0_A10	23280477	23282381	BnaA10T0250400ZY	0	+	766	1838	1904	0.9653361
zheyou73v0_A10	23286446	23287885	BnaA10T0250500ZY	0	-	69	965	1439	0.6706046
zheyou73v0_A10	23288602	23293742	BnaA10T0250600ZY	0	+	968	4606	5140	0.8961089
zheyou73v0_A10	23291606	23293742	BnaA10T0250600ZY.1	0	+	477	2074	2136	0.9709738
zheyou73v0_A10	23295022	23296497	BnaA10T0250700ZY	0	+	158	971	1475	0.6583051
zheyou73v0_A10	23298139	23300265	BnaA10T0250800ZY	0	-	284	1575	2126	0.7408279
zheyou73v0_A10	23301215	23301892	BnaA10T0250900ZY	0	-	38	364	677	0.5376662
zheyou73v0_A10	23305728	23307174	BnaA10T0251000ZY	0	-	206	1321	1446	0.9135546
zheyou73v0_A10	23309186	23312111	BnaA10T0251100ZY	0	+	712	2767	2925	0.9459829
zheyou73v0_A10	23312612	23313806	BnaA10T0251200ZY	0	-	255	1085	1194	0.9087102
zheyou73v0_A10	23318375	23321597	BnaA10T0251300ZY	0	+	1115	3079	3222	0.9556176
zheyou73v0_A10	23329460	23333173	BnaA10T0251400ZY	0	+	703	3177	3713	0.8556423
zheyou73v0_A10	23333383	23337079	BnaA10T0251500ZY	0	-	1202	3220	3696	0.8712121
zheyou73v0_A10	23337523	23338831	BnaA10T0251600ZY	0	+	127	1169	1308	0.8937309
zheyou73v0_A10	23339614	23343722	BnaA10T0251700ZY	0	+	371	3767	4108	0.9169912
zheyou73v0_A10	23344185	23345661	BnaA10T0251800ZY	0	-	256	1150	1476	0.7791328
zheyou73v0_A10	23346636	23348223	BnaA10T0251900ZY	0	+	544	1540	1587	0.9703844
zheyou73v0_A10	23348540	23354742	BnaA10T0252000ZY	0	-	602	3708	6202	0.5978717
zheyou73v0_A10	23355404	23356689	BnaA10T0252100ZY	0	+	740	1285	1285	1.0000000
zheyou73v0_A10	23356732	23360215	BnaA10T0252200ZY	0	-	662	2127	3483	0.6106805
zheyou73v0_A10	23360568	23362555	BnaA10T0252300ZY	0	+	158	1648	1987	0.8293911
zheyou73v0_A10	23362910	23363465	BnaA10T0252400ZY	0	-	17	490	555	0.8828829
zheyou73v0_A10	23363959	23368719	BnaA10T0252500ZY	0	-	1823	4396	4760	0.9235294
zheyou73v0_A10	23369880	23373056	BnaA10T0252600ZY	0	-	886	2751	3176	0.8661839
zheyou73v0_A10	23374719	23375831	BnaA10T0252700ZY	0	-	26	712	1112	0.6402878
zheyou73v0_A10	23377607	23380001	BnaA10T0252800ZY	0	-	740	2394	2394	1.0000000
zheyou73v0_A10	23380792	23383563	BnaA10T0252900ZY	0	-	360	2181	2771	0.7870805
zheyou73v0_A10	23385147	23385974	BnaA10T0253000ZY	0	-	137	720	827	0.8706167
zheyou73v0_A10	23386692	23387887	BnaA10T0253100ZY	0	+	59	753	1195	0.6301255
zheyou73v0_A10	23387759	23388695	BnaA10T0253200ZY	0	-	100	567	936	0.6057692
zheyou73v0_A10	23389033	23390066	BnaA10T0253300ZY	0	-	110	650	1033	0.6292352
zheyou73v0_A10	23390668	23390884	BnaA10T0253400ZY	0	-	26	158	216	0.7314815
zheyou73v0_A10	23392055	23394004	BnaA10T0253500ZY	0	-	314	1558	1949	0.7993843
zheyou73v0_A10	23393951	23400138	BnaA10T0253600ZY	0	+	1303	5291	6187	0.8551802
zheyou73v0_A10	23400440	23401648	BnaA10T0253700ZY	0	+	829	1172	1208	0.9701987
zheyou73v0_A10	23401753	23404785	BnaA10T0253800ZY	0	-	1307	2997	3032	0.9884565
zheyou73v0_A10	23405305	23405641	BnaA10T0253900ZY	0	+	152	336	336	1.0000000
zheyou73v0_A10	23406229	23407418	BnaA10T0254000ZY	0	-	417	1018	1189	0.8561817
zheyou73v0_A10	23411804	23414730	BnaA10T0254100ZY	0	+	323	834	2926	0.2850308
zheyou73v0_A10	23416470	23418019	BnaA10T0254200ZY	0	-	737	1545	1549	0.9974177
zheyou73v0_A10	23416470	23418019	BnaA10T0254200ZY.1	0	-	737	1545	1549	0.9974177
zheyou73v0_A10	23419549	23421620	BnaA10T0254300ZY	0	+	279	1023	2071	0.4939643
zheyou73v0_A10	23422552	23423242	BnaA10T0254400ZY	0	+	220	690	690	1.0000000
zheyou73v0_A10	23424493	23426807	BnaA10T0254500ZY	0	+	806	2212	2314	0.9559205
zheyou73v0_A10	23426825	23428843	BnaA10T0254600ZY	0	-	833	1954	2018	0.9682854
zheyou73v0_A10	23429275	23429779	BnaA10T0254700ZY	0	-	132	504	504	1.0000000
zheyou73v0_A10	23430329	23434872	BnaA10T0254800ZY	0	-	559	4055	4543	0.8925820
zheyou73v0_A10	23435378	23437942	BnaA10T0254900ZY	0	+	106	1520	2564	0.5928237
zheyou73v0_A10	23438166	23440523	BnaA10T0255000ZY	0	-	255	1500	2357	0.6364022
zheyou73v0_A10	23443464	23443848	BnaA10T0255100ZY	0	-	202	384	384	1.0000000
zheyou73v0_A10	23443909	23446114	BnaA10T0255200ZY	0	-	127	1295	2205	0.5873016
zheyou73v0_A10	23448647	23450846	BnaA10T0255300ZY	0	-	596	2147	2199	0.9763529
zheyou73v0_A10	23453662	23456482	BnaA10T0255400ZY	0	-	400	2301	2820	0.8159574
zheyou73v0_A10	23457150	23457660	BnaA10T0255500ZY	0	-	1	85	510	0.1666667
zheyou73v0_A10	23458698	23459993	BnaA10T0255600ZY	0	-	78	708	1295	0.5467181
zheyou73v0_A10	23491353	23494979	BnaA10T0255700ZY	0	-	55	1265	3626	0.3488693
zheyou73v0_A10	23495644	23499126	BnaA10T0255800ZY	0	+	775	3147	3482	0.9037910
zheyou73v0_A10	23501088	23505089	BnaA10T0255900ZY	0	+	326	2786	4001	0.6963259
zheyou73v0_A10	23506510	23507371	BnaA10T0256000ZY	0	+	215	734	861	0.8524971
zheyou73v0_A10	23508952	23511630	BnaA10T0256100ZY	0	+	509	2154	2678	0.8043316
zheyou73v0_A10	23512281	23514757	BnaA10T0256200ZY	0	+	134	1625	2476	0.6563005
zheyou73v0_A10	23514781	23519431	BnaA10T0256300ZY	0	-	335	2586	4650	0.5561290
zheyou73v0_A10	23522597	23524703	BnaA10T0256400ZY	0	+	477	1965	2106	0.9330484
zheyou73v0_A10	23525020	23526032	BnaA10T0256500ZY	0	-	252	1007	1012	0.9950593
zheyou73v0_A10	23526189	23528297	BnaA10T0256600ZY	0	+	236	1550	2108	0.7352941
zheyou73v0_A10	23528306	23533761	BnaA10T0256700ZY	0	-	445	3854	5455	0.7065078
zheyou73v0_A10	23536668	23537097	BnaA10T0256800ZY	0	-	38	412	429	0.9603730
zheyou73v0_A10	23539528	23543150	BnaA10T0256900ZY	0	-	692	3017	3622	0.8329652
zheyou73v0_A10	23543896	23545056	BnaA10T0257000ZY	0	+	673	1160	1160	1.0000000
zheyou73v0_A10	23546586	23549511	BnaA10T0257100ZY	0	+	440	2446	2925	0.8362393
zheyou73v0_A10	23549574	23551286	BnaA10T0257200ZY	0	-	292	1662	1712	0.9707944
zheyou73v0_A10	23555158	23558318	BnaA10T0257300ZY	0	+	965	3111	3160	0.9844937
zheyou73v0_A10	23562153	23563608	BnaA10T0257400ZY	0	+	689	1455	1455	1.0000000
zheyou73v0_A10	23562153	23563479	BnaA10T0257400ZY.1	0	+	683	1326	1326	1.0000000
zheyou73v0_A10	23564270	23569039	BnaA10T0257500ZY	0	-	18	332	4769	0.0696163
zheyou73v0_A10	23584407	23585541	BnaA10T0257600ZY	0	+	185	1069	1134	0.9426808
zheyou73v0_A10	23586816	23589224	BnaA10T0257700ZY	0	-	338	1963	2408	0.8151993
zheyou73v0_A10	23591415	23593112	BnaA10T0257800ZY	0	+	830	1694	1697	0.9982322
zheyou73v0_A10	23595038	23596020	BnaA10T0257900ZY	0	-	175	621	982	0.6323829
zheyou73v0_A10	23600852	23602209	BnaA10T0258000ZY	0	+	550	1149	1357	0.8467207
zheyou73v0_A10	23602499	23606781	BnaA10T0258100ZY	0	-	512	3204	4282	0.7482485
zheyou73v0_A10	23607229	23608278	BnaA10T0258200ZY	0	-	70	770	1049	0.7340324
zheyou73v0_A10	23609253	23609952	BnaA10T0258300ZY	0	+	9	221	699	0.3161660
zheyou73v0_A10	23611449	23613760	BnaA10T0258400ZY	0	+	624	1942	2311	0.8403289
zheyou73v0_A10	23613995	23617441	BnaA10T0258500ZY	0	-	819	3352	3446	0.9727220
zheyou73v0_A10	23618639	23621202	BnaA10T0258600ZY	0	+	636	2531	2563	0.9875146
zheyou73v0_A10	23618639	23621202	BnaA10T0258600ZY.1	0	+	636	2531	2563	0.9875146
zheyou73v0_A10	23621841	23622981	BnaA10T0258700ZY	0	-	413	1140	1140	1.0000000
zheyou73v0_A10	23623374	23624877	BnaA10T0258800ZY	0	-	331	1474	1503	0.9807053
zheyou73v0_A10	23625376	23627980	BnaA10T0258900ZY	0	-	722	2374	2604	0.9116743
zheyou73v0_A10	23628179	23629388	BnaA10T0259000ZY	0	+	390	1204	1209	0.9958643
zheyou73v0_A10	23628192	23631056	BnaA10T0259100ZY	0	-	1042	2776	2864	0.9692737
zheyou73v0_A10	23631283	23634628	BnaA10T0259200ZY	0	-	1136	3233	3345	0.9665172
zheyou73v0_A10	23635447	23651966	BnaA10T0259300ZY	0	-	2191	7334	16519	0.4439736
zheyou73v0_A10	23659686	23662644	BnaA10T0259400ZY	0	+	1193	2958	2958	1.0000000
zheyou73v0_A10	23663476	23668559	BnaA10T0259500ZY	0	+	1244	4823	5083	0.9488491
zheyou73v0_A10	23670646	23672046	BnaA10T0259600ZY	0	+	528	1364	1400	0.9742857
zheyou73v0_A10	23674342	23676825	BnaA10T0259700ZY	0	-	765	2043	2483	0.8227950
zheyou73v0_A10	23677412	23680420	BnaA10T0259800ZY	0	-	834	2798	3008	0.9301862
zheyou73v0_A10	23681833	23683983	BnaA10T0259900ZY	0	-	301	1712	2150	0.7962791
zheyou73v0_A10	23686306	23692369	BnaA10T0260000ZY	0	+	1342	5360	6063	0.8840508
zheyou73v0_A10	23696394	23699583	BnaA10T0260100ZY	0	+	335	2685	3189	0.8419567
zheyou73v0_A10	23696394	23699583	BnaA10T0260100ZY.1	0	+	335	2685	3189	0.8419567
zheyou73v0_A10	23701122	23708461	BnaA10T0260200ZY	0	-	1117	5968	7339	0.8131898
zheyou73v0_A10	23701122	23708461	BnaA10T0260200ZY.1	0	-	1117	5968	7339	0.8131898
zheyou73v0_A10	23708902	23717497	BnaA10T0260300ZY	0	-	2419	6431	8595	0.7482257
zheyou73v0_A10	23722910	23729598	BnaA10T0260400ZY	0	-	3036	6599	6688	0.9866926
zheyou73v0_A10	23730181	23730568	BnaA10T0260500ZY	0	-	129	387	387	1.0000000
zheyou73v0_A10	23747988	23748871	BnaA10T0260600ZY	0	+	233	880	883	0.9966025
zheyou73v0_A10	23749467	23750363	BnaA10T0260700ZY	0	-	703	896	896	1.0000000
zheyou73v0_A10	23750439	23752192	BnaA10T0260800ZY	0	+	948	1753	1753	1.0000000
zheyou73v0_A10	23754573	23756148	BnaA10T0260900ZY	0	-	1317	1575	1575	1.0000000
zheyou73v0_A10	23776213	23777983	BnaA10T0261000ZY	0	-	1338	1770	1770	1.0000000
zheyou73v0_A10	23781753	23782023	BnaA10T0261100ZY	0	-	266	270	270	1.0000000
zheyou73v0_A10	23786436	23790481	BnaA10T0261200ZY	0	-	984	3450	4045	0.8529048
zheyou73v0_A10	23793367	23804221	BnaA10T0261300ZY	0	+	2155	6528	10854	0.6014373
zheyou73v0_A10	23804943	23811523	BnaA10T0261400ZY	0	-	1794	5522	6580	0.8392097
zheyou73v0_A10	23821515	23823557	BnaA10T0261500ZY	0	+	1140	2042	2042	1.0000000
zheyou73v0_A10	23823626	23824624	BnaA10T0261600ZY	0	+	646	998	998	1.0000000
zheyou73v0_A10	23825004	23826782	BnaA10T0261700ZY	0	-	1324	1778	1778	1.0000000
zheyou73v0_A10	23828181	23832676	BnaA10T0261800ZY	0	-	1335	4391	4495	0.9768632
zheyou73v0_A10	23835331	23838361	BnaA10T0261900ZY	0	+	1179	3001	3030	0.9904290
zheyou73v0_A10	23838434	23839571	BnaA10T0262000ZY	0	-	288	1109	1137	0.9753738
zheyou73v0_A10	23840086	23841439	BnaA10T0262100ZY	0	-	248	1231	1353	0.9098300
zheyou73v0_A10	23842820	23844437	BnaA10T0262200ZY	0	+	171	1040	1617	0.6431664
zheyou73v0_A10	23845558	23847516	BnaA10T0262300ZY	0	-	379	1795	1958	0.9167518
zheyou73v0_A10	23845558	23847516	BnaA10T0262300ZY.1	0	-	379	1795	1958	0.9167518
zheyou73v0_A10	23848304	23850025	BnaA10T0262400ZY	0	+	650	1651	1721	0.9593260
zheyou73v0_A10	23851478	23852552	BnaA10T0262500ZY	0	-	572	1074	1074	1.0000000
zheyou73v0_A10	23853005	23860693	BnaA10T0262600ZY	0	-	677	6179	7688	0.8037201
zheyou73v0_A10	23862195	23863735	BnaA10T0262700ZY	0	-	105	752	1540	0.4883117
zheyou73v0_A10	23868773	23871957	BnaA10T0262800ZY	0	+	306	2462	3184	0.7732412
zheyou73v0_A10	23875138	23875531	BnaA10T0262900ZY	0	-	20	71	393	0.1806616
zheyou73v0_A10	23877602	23882219	BnaA10T0263000ZY	0	-	1836	3996	4617	0.8654971
zheyou73v0_A10	23882802	23885509	BnaA10T0263100ZY	0	-	315	1692	2707	0.6250462
zheyou73v0_A10	23891116	23895074	BnaA10T0263200ZY	0	-	1357	3864	3958	0.9762506
zheyou73v0_A10	23891116	23895324	BnaA10T0263200ZY.1	0	-	1423	4114	4208	0.9776616
zheyou73v0_A10	23895974	23896220	BnaA10T0263300ZY	0	+	241	246	246	1.0000000
zheyou73v0_A10	23898491	23903408	BnaA10T0263400ZY	0	+	1413	4585	4917	0.9324791
zheyou73v0_A10	23904433	23907070	BnaA10T0263500ZY	0	+	708	2322	2637	0.8805461
zheyou73v0_A10	23908470	23910364	BnaA10T0263600ZY	0	-	719	1558	1894	0.8225977
zheyou73v0_A10	23912989	23914093	BnaA10T0263700ZY	0	+	291	1094	1104	0.9909420
zheyou73v0_A10	23914159	23916841	BnaA10T0263800ZY	0	+	894	2608	2682	0.9724087
zheyou73v0_A10	23917867	23918455	BnaA10T0263900ZY	0	+	338	588	588	1.0000000
zheyou73v0_A10	23921194	23922665	BnaA10T0264000ZY	0	+	317	1195	1471	0.8123726
zheyou73v0_A10	23927528	23930735	BnaA10T0264100ZY	0	+	839	2968	3207	0.9254755
zheyou73v0_A10	23931215	23934038	BnaA10T0264200ZY	0	+	391	1629	2823	0.5770457
zheyou73v0_A10	23934320	23935475	BnaA10T0264300ZY	0	-	428	1155	1155	1.0000000
zheyou73v0_A10	23936288	23939127	BnaA10T0264400ZY	0	-	677	2503	2839	0.8816485
zheyou73v0_A10	23939833	23940356	BnaA10T0264500ZY	0	-	33	400	523	0.7648184
zheyou73v0_A10	23943159	23945558	BnaA10T0264600ZY	0	+	603	2091	2399	0.8716131
zheyou73v0_A10	23947821	23948296	BnaA10T0264700ZY	0	+	39	184	475	0.3873684
zheyou73v0_A10	23949150	23949833	BnaA10T0264800ZY	0	+	402	683	683	1.0000000
zheyou73v0_A10	23949150	23949833	BnaA10T0264800ZY.1	0	+	402	683	683	1.0000000
zheyou73v0_A10	23952775	23953841	BnaA10T0264900ZY	0	+	35	717	1066	0.6726079
zheyou73v0_A10	23958687	23961056	BnaA10T0265000ZY	0	+	588	1996	2369	0.8425496
zheyou73v0_A10	23962367	23964126	BnaA10T0265100ZY	0	-	233	1282	1759	0.7288232
zheyou73v0_A10	23970051	23971558	BnaA10T0265200ZY	0	-	118	594	1507	0.3941606
zheyou73v0_A10	23980147	23982597	BnaA10T0265300ZY	0	-	790	2261	2450	0.9228572
zheyou73v0_A10	23987840	23992864	BnaA10T0265400ZY	0	+	1327	4467	5024	0.8891321
zheyou73v0_A10	23988759	23992864	BnaA10T0265400ZY.1	0	+	1083	3591	4105	0.8747869
zheyou73v0_A10	23996270	23998077	BnaA10T0265500ZY	0	-	729	1807	1807	1.0000000
zheyou73v0_A10	24004440	24009858	BnaA10T0265600ZY	0	+	1440	4573	5418	0.8440384
zheyou73v0_A10	24004440	24009858	BnaA10T0265600ZY.1	0	+	1440	4573	5418	0.8440384
zheyou73v0_A10	24010868	24012343	BnaA10T0265700ZY	0	+	484	993	1475	0.6732203
zheyou73v0_A10	24012658	24014038	BnaA10T0265800ZY	0	-	269	1346	1380	0.9753623
zheyou73v0_A10	24012658	24014038	BnaA10T0265800ZY.1	0	-	269	1346	1380	0.9753623
zheyou73v0_A10	24018171	24019911	BnaA10T0265900ZY	0	+	153	1210	1740	0.6954023
zheyou73v0_A10	24020355	24021942	BnaA10T0266000ZY	0	+	231	1458	1587	0.9187146
zheyou73v0_A10	24024518	24027380	BnaA10T0266100ZY	0	-	260	1832	2862	0.6401118
zheyou73v0_A10	24036391	24039710	BnaA10T0266200ZY	0	-	668	2909	3319	0.8764688
zheyou73v0_A10	24048650	24054516	BnaA10T0266300ZY	0	-	1774	5423	5866	0.9244801
zheyou73v0_A10	24055444	24058532	BnaA10T0266400ZY	0	-	366	2122	3088	0.6871762
zheyou73v0_A10	24066333	24067392	BnaA10T0266500ZY	0	+	117	790	1059	0.7459868
zheyou73v0_A10	24069901	24073989	BnaA10T0266600ZY	0	-	1045	3819	4088	0.9341977
zheyou73v0_A10	24080386	24082184	BnaA10T0266700ZY	0	+	673	1798	1798	1.0000000
zheyou73v0_A10	24082569	24083367	BnaA10T0266800ZY	0	-	85	572	798	0.7167920
zheyou73v0_A10	24095741	24097226	BnaA10T0266900ZY	0	-	1003	1485	1485	1.0000000
zheyou73v0_A10	24097695	24098923	BnaA10T0267000ZY	0	-	664	1224	1228	0.9967427
zheyou73v0_A10	24098084	24098923	BnaA10T0267000ZY.1	0	-	403	835	839	0.9952324
zheyou73v0_A10	24100117	24100828	BnaA10T0267100ZY	0	+	542	711	711	1.0000000
zheyou73v0_A10	24101909	24105423	BnaA10T0267200ZY	0	+	969	2789	3514	0.7936824
zheyou73v0_A10	24101909	24105423	BnaA10T0267200ZY.1	0	+	969	2789	3514	0.7936824
zheyou73v0_A10	24105818	24110932	BnaA10T0267300ZY	0	-	2438	4979	5114	0.9736019
zheyou73v0_A10	24105818	24110932	BnaA10T0267300ZY.1	0	-	2438	4979	5114	0.9736019
zheyou73v0_A10	24111520	24113334	BnaA10T0267400ZY	0	+	911	1788	1814	0.9856670
zheyou73v0_A10	24117059	24124628	BnaA10T0267500ZY	0	-	207	1528	7569	0.2018761
zheyou73v0_A10	24125178	24127036	BnaA10T0267600ZY	0	-	203	1085	1858	0.5839612
zheyou73v0_A10	24125178	24127036	BnaA10T0267600ZY.1	0	-	203	1085	1858	0.5839612
zheyou73v0_A10	24131958	24134121	BnaA10T0267700ZY	0	-	1335	2163	2163	1.0000000
zheyou73v0_A10	24131958	24134121	BnaA10T0267700ZY.1	0	-	1335	2163	2163	1.0000000
zheyou73v0_A10	24137092	24137649	BnaA10T0267800ZY	0	+	291	557	557	1.0000000
zheyou73v0_A10	24137739	24140284	BnaA10T0267900ZY	0	-	904	2331	2545	0.9159136
zheyou73v0_A10	24140934	24142641	BnaA10T0268000ZY	0	-	448	1450	1707	0.8494435
zheyou73v0_A10	24142875	24143058	BnaA10T0268100ZY	0	-	19	94	183	0.5136612
zheyou73v0_A10	24143462	24148885	BnaA10T0268200ZY	0	-	600	2821	5423	0.5201918
zheyou73v0_A10	24156028	24159007	BnaA10T0268300ZY	0	+	473	2508	2979	0.8418933
zheyou73v0_A10	24158713	24166514	BnaA10T0268400ZY	0	-	86411	7773	7801	0.9964107
zheyou73v0_A10	24171976	24172802	BnaA10T0268500ZY	0	-	155	771	826	0.9334140
zheyou73v0_A10	24173672	24175196	BnaA10T0268600ZY	0	+	529	1480	1524	0.9711286
zheyou73v0_A10	24173672	24175196	BnaA10T0268600ZY.1	0	+	529	1480	1524	0.9711286
zheyou73v0_A10	24183208	24183645	BnaA10T0268700ZY	0	+	16	250	437	0.5720824
zheyou73v0_A10	24184398	24185340	BnaA10T0268800ZY	0	+	182	776	942	0.8237792
zheyou73v0_A10	24188764	24189240	BnaA10T0268900ZY	0	+	373	476	476	1.0000000
zheyou73v0_A10	24190074	24192597	BnaA10T0269000ZY	0	-	621	2254	2523	0.8933809
zheyou73v0_A10	24190074	24192293	BnaA10T0269000ZY.1	0	-	576	1950	2219	0.8787742
zheyou73v0_A10	24190074	24192597	BnaA10T0269000ZY.2	0	-	621	2254	2523	0.8933809
zheyou73v0_A10	24190074	24192597	BnaA10T0269000ZY.3	0	-	621	2254	2523	0.8933809
zheyou73v0_A10	24194317	24197354	BnaA10T0269100ZY	0	-	561	2508	3037	0.8258150
zheyou73v0_A10	24194317	24195401	BnaA10T0269100ZY.1	0	-	377	1050	1084	0.9686347
zheyou73v0_A10	24201509	24203250	BnaA10T0269200ZY	0	-	538	1602	1741	0.9201608
zheyou73v0_A10	24204889	24205442	BnaA10T0269300ZY	0	+	106	526	553	0.9511754
zheyou73v0_A10	24205512	24206044	BnaA10T0269400ZY	0	+	40	532	532	1.0000000
zheyou73v0_A10	24207356	24208339	BnaA10T0269500ZY	0	+	576	948	983	0.9643947
zheyou73v0_A10	24208893	24214036	BnaA10T0269600ZY	0	+	1811	5143	5143	1.0000000
zheyou73v0_A10	24214678	24215714	BnaA10T0269700ZY	0	+	208	1034	1036	0.9980695
zheyou73v0_A10	24214863	24215714	BnaA10T0269700ZY.1	0	+	193	849	851	0.9976498
zheyou73v0_A10	24215732	24218502	BnaA10T0269800ZY	0	-	545	2473	2770	0.8927798
zheyou73v0_A10	24215732	24218502	BnaA10T0269800ZY.1	0	-	545	2473	2770	0.8927798
zheyou73v0_A10	24215732	24218502	BnaA10T0269800ZY.2	0	-	545	2473	2770	0.8927798
zheyou73v0_A10	24219036	24220120	BnaA10T0269900ZY	0	+	218	1009	1084	0.9308118
zheyou73v0_A10	24220924	24222926	BnaA10T0270000ZY	0	-	438	1829	2002	0.9135864
zheyou73v0_A10	24225779	24227394	BnaA10T0270100ZY	0	+	136	1233	1615	0.7634675
zheyou73v0_A10	24227479	24229192	BnaA10T0270200ZY	0	-	201	1336	1713	0.7799183
zheyou73v0_A10	24229918	24233774	BnaA10T0270300ZY	0	-	1502	3754	3856	0.9735477
zheyou73v0_A10	24234097	24237966	BnaA10T0270400ZY	0	+	724	3550	3869	0.9175497
zheyou73v0_A10	24238237	24239782	BnaA10T0270500ZY	0	-	92	1170	1545	0.7572815
zheyou73v0_A10	24240340	24243712	BnaA10T0270600ZY	0	+	465	2895	3372	0.8585410
zheyou73v0_A10	24240340	24243712	BnaA10T0270600ZY.1	0	+	465	2895	3372	0.8585410
zheyou73v0_A10	24240340	24243712	BnaA10T0270600ZY.2	0	+	465	2895	3372	0.8585410
zheyou73v0_A10	24248339	24250810	BnaA10T0270700ZY	0	+	434	2280	2471	0.9227034
zheyou73v0_A10	24252811	24253615	BnaA10T0270800ZY	0	+	333	804	804	1.0000000
zheyou73v0_A10	24254996	24256333	BnaA10T0270900ZY	0	-	50	905	1337	0.6768886
zheyou73v0_A10	24262210	24263332	BnaA10T0271000ZY	0	-	182	683	1122	0.6087344
zheyou73v0_A10	24264566	24266451	BnaA10T0271100ZY	0	-	1233	1885	1885	1.0000000
zheyou73v0_A10	24266730	24267291	BnaA10T0271200ZY	0	-	48	359	561	0.6399287
zheyou73v0_A10	24269520	24270764	BnaA10T0271300ZY	0	+	194	943	1244	0.7580386
zheyou73v0_A10	24269961	24271824	BnaA10T0271400ZY	0	-	582	1842	1863	0.9887279
zheyou73v0_A10	24275515	24276222	BnaA10T0271500ZY	0	+	362	707	707	1.0000000
zheyou73v0_A10	24278232	24280306	BnaA10T0271600ZY	0	-	496	1886	2074	0.9093539
zheyou73v0_A10	24281940	24282913	BnaA10T0271700ZY	0	-	688	973	973	1.0000000
zheyou73v0_A10	24283474	24284649	BnaA10T0271800ZY	0	+	438	1116	1175	0.9497873
zheyou73v0_A10	24286598	24287506	BnaA10T0271900ZY	0	-	436	908	908	1.0000000
zheyou73v0_A10	24291109	24291590	BnaA10T0272000ZY	0	+	130	422	481	0.8773389
zheyou73v0_A10	24293254	24298421	BnaA10T0272100ZY	0	-	1523	4069	5167	0.7874976
zheyou73v0_A10	24303873	24306837	BnaA10T0272200ZY	0	+	620	2749	2964	0.9274629
zheyou73v0_A10	24303873	24306837	BnaA10T0272200ZY.1	0	+	620	2749	2964	0.9274629
zheyou73v0_A10	24310093	24310463	BnaA10T0272300ZY	0	-	97	370	370	1.0000000
zheyou73v0_A10	24315518	24318226	BnaA10T0272400ZY	0	+	372	1759	2708	0.6495569
zheyou73v0_A10	24334538	24336573	BnaA10T0272500ZY	0	-	1	37	2035	0.0181818
zheyou73v0_A10	24334538	24336573	BnaA10T0272500ZY.1	0	-	1	37	2035	0.0181818
zheyou73v0_A10	24337556	24338140	BnaA10T0272600ZY	0	-	0	0	584	0.0000000
zheyou73v0_A10	24339252	24343412	BnaA10T0272700ZY	0	-	2	20	4160	0.0048077
zheyou73v0_A10	24345112	24346809	BnaA10T0272800ZY	0	+	0	0	1697	0.0000000
zheyou73v0_A10	24367516	24371595	BnaA10T0272900ZY	0	-	0	0	4079	0.0000000
zheyou73v0_A10	24372725	24376161	BnaA10T0273000ZY	0	+	23	135	3436	0.0392899
zheyou73v0_A10	24377714	24378110	BnaA10T0273100ZY	0	+	2	151	396	0.3813131
zheyou73v0_A10	24378483	24381590	BnaA10T0273200ZY	0	-	1	40	3107	0.0128742
zheyou73v0_A10	24382438	24382896	BnaA10T0273300ZY	0	-	6	203	458	0.4432314
zheyou73v0_A10	24385019	24387726	BnaA10T0273400ZY	0	+	0	0	2707	0.0000000
zheyou73v0_A10	24387774	24396294	BnaA10T0273500ZY	0	-	135	555	8520	0.0651408
zheyou73v0_A10	24387774	24396294	BnaA10T0273500ZY.1	0	-	135	555	8520	0.0651408
zheyou73v0_A10	24399725	24401379	BnaA10T0273600ZY	0	+	2	22	1654	0.0133011
zheyou73v0_A10	24401597	24402478	BnaA10T0273700ZY	0	-	18	358	881	0.4063564
zheyou73v0_A10	24402827	24404544	BnaA10T0273800ZY	0	+	213	965	1717	0.5620268
zheyou73v0_A10	24406056	24407915	BnaA10T0273900ZY	0	-	2	92	1859	0.0494890
zheyou73v0_A10	24410769	24414866	BnaA10T0274000ZY	0	-	2	235	4097	0.0573590
zheyou73v0_A10	24415099	24416632	BnaA10T0274100ZY	0	-	0	0	1533	0.0000000
zheyou73v0_A10	24417331	24419484	BnaA10T0274200ZY	0	-	2	34	2153	0.0157919
zheyou73v0_A10	24417331	24419484	BnaA10T0274200ZY.1	0	-	2	34	2153	0.0157919
zheyou73v0_A10	24427420	24428009	BnaA10T0274300ZY	0	+	0	0	589	0.0000000
zheyou73v0_A10	24428170	24429615	BnaA10T0274400ZY	0	-	0	0	1445	0.0000000
zheyou73v0_A10	24428170	24429615	BnaA10T0274400ZY.1	0	-	0	0	1445	0.0000000
zheyou73v0_A10	24430823	24433433	BnaA10T0274500ZY	0	-	0	0	2610	0.0000000
zheyou73v0_A10	24435216	24436204	BnaA10T0274600ZY	0	-	0	0	988	0.0000000
zheyou73v0_A10	24436391	24437225	BnaA10T0274700ZY	0	-	0	0	834	0.0000000
zheyou73v0_A10	24438653	24440855	BnaA10T0274800ZY	0	+	11	412	2202	0.1871026
zheyou73v0_A10	24441439	24442983	BnaA10T0274900ZY	0	-	18	302	1544	0.1955959
zheyou73v0_A10	24444845	24447220	BnaA10T0275000ZY	0	-	0	0	2375	0.0000000
zheyou73v0_A10	24448036	24448891	BnaA10T0275100ZY	0	-	27	21	855	0.0245614
zheyou73v0_A10	24450035	24450290	BnaA10T0275200ZY	0	+	12	6	255	0.0235294
zheyou73v0_A10	24452427	24453958	BnaA10T0275300ZY	0	-	0	0	1531	0.0000000
zheyou73v0_A10	24454877	24460104	BnaA10T0275400ZY	0	+	32	458	5227	0.0876220
zheyou73v0_A10	24454877	24460104	BnaA10T0275400ZY.1	0	+	32	458	5227	0.0876220
zheyou73v0_A10	24462392	24466186	BnaA10T0275500ZY	0	-	7	141	3794	0.0371639
zheyou73v0_A10	24462392	24466186	BnaA10T0275500ZY.1	0	-	7	141	3794	0.0371639
zheyou73v0_A10	24474058	24475914	BnaA10T0275600ZY	0	+	2	20	1856	0.0107759
zheyou73v0_A10	24476022	24478435	BnaA10T0275700ZY	0	-	0	0	2413	0.0000000
zheyou73v0_A10	24484758	24487116	BnaA10T0275800ZY	0	+	0	0	2358	0.0000000
zheyou73v0_A10	24487685	24490059	BnaA10T0275900ZY	0	+	0	0	2374	0.0000000
zheyou73v0_A10	24491465	24491788	BnaA10T0276000ZY	0	-	0	0	323	0.0000000
zheyou73v0_A10	24494210	24497152	BnaA10T0276100ZY	0	-	0	0	2942	0.0000000
zheyou73v0_A10	24504954	24506668	BnaA10T0276200ZY	0	+	0	0	1714	0.0000000
zheyou73v0_A10	24507464	24511179	BnaA10T0276300ZY	0	+	0	0	3715	0.0000000
zheyou73v0_A10	24513982	24515727	BnaA10T0276400ZY	0	+	0	0	1745	0.0000000
zheyou73v0_A10	24522682	24525345	BnaA10T0276500ZY	0	-	2	19	2663	0.0071348
zheyou73v0_A10	24530279	24532003	BnaA10T0276600ZY	0	+	0	0	1724	0.0000000
zheyou73v0_A10	24532200	24535250	BnaA10T0276700ZY	0	-	73	589	3050	0.1931148
zheyou73v0_A10	24537091	24537959	BnaA10T0276800ZY	0	+	0	0	868	0.0000000
zheyou73v0_A10	24538237	24540693	BnaA10T0276900ZY	0	-	0	0	2456	0.0000000
zheyou73v0_A10	24538237	24540693	BnaA10T0276900ZY.1	0	-	0	0	2456	0.0000000
zheyou73v0_A10	24538237	24540693	BnaA10T0276900ZY.2	0	-	0	0	2456	0.0000000
zheyou73v0_A10	24549261	24550705	BnaA10T0277000ZY	0	+	0	0	1444	0.0000000
zheyou73v0_A10	24549665	24550705	BnaA10T0277000ZY.1	0	+	0	0	1040	0.0000000
zheyou73v0_A10	24552768	24556697	BnaA10T0277100ZY	0	+	0	0	3929	0.0000000
zheyou73v0_A10	24552768	24556697	BnaA10T0277100ZY.1	0	+	0	0	3929	0.0000000
zheyou73v0_A10	24557551	24558857	BnaA10T0277200ZY	0	-	0	0	1306	0.0000000
zheyou73v0_A10	24560982	24561750	BnaA10T0277300ZY	0	-	0	0	768	0.0000000
zheyou73v0_A10	24565838	24568668	BnaA10T0277400ZY	0	+	0	0	2830	0.0000000
zheyou73v0_A10	24572768	24581472	BnaA10T0277500ZY	0	+	2	262	8704	0.0301011
zheyou73v0_A10	24583222	24584500	BnaA10T0277600ZY	0	+	0	0	1278	0.0000000
